coverage,genome_size,contig_name,contig_rank,contig_size,contig_prop,contig_cumsum,contig_cumsum_prop
5x,180779525,scaffold_26,1,1547814,0.00856189,1547814,0.00856189
5x,180779525,contig_53,1,1524818,0.00843468,3072632,0.0169966
5x,180779525,contig_607,1,1422414,0.00786823,4495046,0.0248648
5x,180779525,scaffold_474,1,1357693,0.00751021,5852739,0.032375
5x,180779525,contig_570,1,1256974,0.00695308,7109713,0.0393281
5x,180779525,contig_8,1,1234428,0.00682836,8344141,0.0461564
5x,180779525,scaffold_18,1,1220578,0.00675175,9564719,0.0529082
5x,180779525,contig_991,1,1195341,0.00661215,10760060,0.0595203
5x,180779525,contig_397,1,1158082,0.00640605,11918142,0.0659264
5x,180779525,contig_52,1,1103988,0.00610682,13022130,0.0720332
5x,180779525,contig_720,1,1102829,0.00610041,14124959,0.0781336
5x,180779525,contig_857,1,1092949,0.00604576,15217908,0.0841794
5x,180779525,contig_401,1,1082586,0.00598843,16300494,0.0901678
5x,180779525,contig_462,1,1071185,0.00592537,17371679,0.0960932
5x,180779525,contig_990,1,1056914,0.00584643,18428593,0.10194
5x,180779525,contig_333,1,1053590,0.00582804,19482183,0.107768
5x,180779525,contig_27,1,1035277,0.00572674,20517460,0.113494
5x,180779525,contig_778,1,1031188,0.00570412,21548648,0.119198
5x,180779525,contig_34,1,991849,0.00548651,22540497,0.124685
5x,180779525,contig_49,1,969100,0.00536067,23509597,0.130046
5x,180779525,contig_263,1,963776,0.00533122,24473373,0.135377
5x,180779525,contig_1038,1,939164,0.00519508,25412537,0.140572
5x,180779525,contig_212,1,938407,0.00519089,26350944,0.145763
5x,180779525,contig_549,1,888825,0.00491662,27239769,0.15068
5x,180779525,contig_736,1,886294,0.00490262,28126063,0.155582
5x,180779525,contig_439,1,885933,0.00490063,29011996,0.160483
5x,180779525,contig_756,1,879264,0.00486374,29891260,0.165346
5x,180779525,contig_507,1,878617,0.00486016,30769877,0.170207
5x,180779525,contig_675,1,877445,0.00485367,31647322,0.17506
5x,180779525,contig_222,1,867064,0.00479625,32514386,0.179857
5x,180779525,contig_794,1,852247,0.00471429,33366633,0.184571
5x,180779525,contig_382,1,843710,0.00466707,34210343,0.189238
5x,180779525,contig_101,1,834302,0.00461502,35044645,0.193853
5x,180779525,scaffold_904,1,830526,0.00459414,35875171,0.198447
5x,180779525,contig_380,1,825858,0.00456832,36701029,0.203015
5x,180779525,contig_46,1,821070,0.00454183,37522099,0.207557
5x,180779525,contig_422,1,813655,0.00450081,38335754,0.212058
5x,180779525,contig_861,1,811099,0.00448668,39146853,0.216545
5x,180779525,contig_113,1,795767,0.00440186,39942620,0.220947
5x,180779525,contig_317,1,778277,0.00430512,40720897,0.225252
5x,180779525,contig_555,1,770773,0.00426361,41491670,0.229515
5x,180779525,contig_78,1,751468,0.00415682,42243138,0.233672
5x,180779525,contig_492,1,709012,0.00392197,42952150,0.237594
5x,180779525,contig_13,1,698414,0.00386335,43650564,0.241457
5x,180779525,contig_229,1,697398,0.00385773,44347962,0.245315
5x,180779525,scaffold_436,1,687169,0.00380114,45035131,0.249116
5x,180779525,contig_658,1,686630,0.00379816,45721761,0.252914
5x,180779525,contig_106,1,684785,0.00378796,46406546,0.256702
5x,180779525,contig_566,1,682709,0.00377647,47089255,0.260479
5x,180779525,contig_355,1,679596,0.00375925,47768851,0.264238
5x,180779525,contig_137,1,674591,0.00373157,48443442,0.26797
5x,180779525,contig_429,1,673297,0.00372441,49116739,0.271694
5x,180779525,contig_29,1,673151,0.0037236,49789890,0.275418
5x,180779525,contig_450,1,672821,0.00372178,50462711,0.27914
5x,180779525,scaffold_700,1,672791,0.00372161,51135502,0.282861
5x,180779525,contig_9,1,671597,0.00371501,51807099,0.286576
5x,180779525,contig_102,1,665350,0.00368045,52472449,0.290257
5x,180779525,contig_162,1,663029,0.00366761,53135478,0.293924
5x,180779525,contig_381,1,651275,0.00360259,53786753,0.297527
5x,180779525,contig_93,1,637541,0.00352662,54424294,0.301053
5x,180779525,contig_308,1,636478,0.00352074,55060772,0.304574
5x,180779525,contig_12,1,634266,0.00350851,55695038,0.308083
5x,180779525,contig_318,1,627134,0.00346905,56322172,0.311552
5x,180779525,contig_133,1,624432,0.00345411,56946604,0.315006
5x,180779525,contig_70,1,613741,0.00339497,57560345,0.318401
5x,180779525,contig_684,1,608756,0.00336739,58169101,0.321768
5x,180779525,contig_221,1,608640,0.00336675,58777741,0.325135
5x,180779525,contig_665,1,604984,0.00334653,59382725,0.328481
5x,180779525,contig_1001,1,604611,0.00334447,59987336,0.331826
5x,180779525,contig_269,1,604412,0.00334337,60591748,0.335169
5x,180779525,contig_713,1,602754,0.00333419,61194502,0.338504
5x,180779525,contig_515,1,600226,0.00332021,61794728,0.341824
5x,180779525,contig_750,1,596760,0.00330104,62391488,0.345125
5x,180779525,contig_645,1,592089,0.0032752,62983577,0.3484
5x,180779525,contig_167,1,580116,0.00320897,63563693,0.351609
5x,180779525,contig_316,1,577219,0.00319294,64140912,0.354802
5x,180779525,contig_344,1,575404,0.0031829,64716316,0.357985
5x,180779525,contig_539,1,567160,0.0031373,65283476,0.361122
5x,180779525,contig_103,1,563608,0.00311765,65847084,0.36424
5x,180779525,contig_249,1,556632,0.00307907,66403716,0.367319
5x,180779525,contig_408,1,537838,0.0029751,66941554,0.370294
5x,180779525,contig_72,1,534227,0.00295513,67475781,0.373249
5x,180779525,contig_964,1,533316,0.00295009,68009097,0.376199
5x,180779525,contig_403,1,531521,0.00294016,68540618,0.379139
5x,180779525,contig_96,1,527563,0.00291827,69068181,0.382058
5x,180779525,contig_262,1,526223,0.00291086,69594404,0.384968
5x,180779525,contig_130,1,516756,0.00285849,70111160,0.387827
5x,180779525,contig_297,1,512395,0.00283436,70623555,0.390661
5x,180779525,contig_958,1,503701,0.00278627,71127256,0.393448
5x,180779525,contig_464,1,501273,0.00277284,71628529,0.39622
5x,180779525,contig_980,1,498727,0.00275876,72127256,0.398979
5x,180779525,contig_613,1,498719,0.00275871,72625975,0.401738
5x,180779525,contig_271,1,495451,0.00274064,73121426,0.404478
5x,180779525,scaffold_746,1,492625,0.002725,73614051,0.407203
5x,180779525,contig_902,1,492063,0.0027219,74106114,0.409925
5x,180779525,contig_307,1,483355,0.00267373,74589469,0.412599
5x,180779525,contig_170,1,482123,0.00266691,75071592,0.415266
5x,180779525,contig_279,1,476703,0.00263693,75548295,0.417903
5x,180779525,contig_789,1,474234,0.00262327,76022529,0.420526
5x,180779525,contig_143,1,471606,0.00260874,76494135,0.423135
5x,180779525,contig_644,1,468093,0.0025893,76962228,0.425724
5x,180779525,contig_83,1,467054,0.00258356,77429282,0.428308
5x,180779525,contig_537,1,459932,0.00254416,77889214,0.430852
5x,180779525,contig_123,1,456027,0.00252256,78345241,0.433375
5x,180779525,contig_885,1,452151,0.00250112,78797392,0.435876
5x,180779525,contig_699,1,448682,0.00248193,79246074,0.438358
5x,180779525,contig_425,1,443547,0.00245352,79689621,0.440811
5x,180779525,contig_814,1,443402,0.00245272,80133023,0.443264
5x,180779525,contig_652,1,439218,0.00242958,80572241,0.445693
5x,180779525,contig_647,1,438950,0.0024281,81011191,0.448121
5x,180779525,contig_118,1,431506,0.00238692,81442697,0.450508
5x,180779525,contig_848,1,429987,0.00237852,81872684,0.452887
5x,180779525,contig_325,1,424113,0.00234602,82296797,0.455233
5x,180779525,contig_856,1,423376,0.00234195,82720173,0.457575
5x,180779525,contig_491,1,422747,0.00233847,83142920,0.459913
5x,180779525,contig_14,1,418457,0.00231474,83561377,0.462228
5x,180779525,contig_190,1,418083,0.00231267,83979460,0.464541
5x,180779525,contig_351,1,417759,0.00231088,84397219,0.466852
5x,180779525,contig_489,1,412547,0.00228204,84809766,0.469134
5x,180779525,contig_365,1,412446,0.00228149,85222212,0.471415
5x,180779525,contig_938,1,404236,0.00223607,85626448,0.473651
5x,180779525,contig_873,1,394011,0.00217951,86020459,0.475831
5x,180779525,contig_834,1,389743,0.0021559,86410202,0.477987
5x,180779525,contig_1063,1,389276,0.00215332,86799478,0.48014
5x,180779525,contig_282,1,387529,0.00214366,87187007,0.482284
5x,180779525,contig_127,1,384491,0.00212685,87571498,0.48441
5x,180779525,contig_277,1,384064,0.00212449,87955562,0.486535
5x,180779525,contig_173,1,383205,0.00211974,88338767,0.488655
5x,180779525,contig_302,1,381491,0.00211026,88720258,0.490765
5x,180779525,scaffold_650,1,380205,0.00210314,89100463,0.492868
5x,180779525,contig_526,1,380198,0.0021031,89480661,0.494971
5x,180779525,contig_296,1,375373,0.00207641,89856034,0.497048
5x,180779525,contig_524,1,372359,0.00205974,90228393,0.499107
5x,180779525,contig_107,1,371636,0.00205574,90600029,0.501163
5x,180779525,contig_220,1,371300,0.00205388,90971329,0.503217
5x,180779525,contig_281,1,369832,0.00204576,91341161,0.505263
5x,180779525,contig_557,1,368198,0.00203672,91709359,0.507299
5x,180779525,contig_1062,1,366652,0.00202817,92076011,0.509328
5x,180779525,contig_369,1,365634,0.00202254,92441645,0.51135
5x,180779525,contig_858,1,361751,0.00200106,92803396,0.513351
5x,180779525,contig_527,1,358779,0.00198462,93162175,0.515336
5x,180779525,contig_633,1,358369,0.00198235,93520544,0.517318
5x,180779525,contig_866,1,356863,0.00197402,93877407,0.519292
5x,180779525,contig_458,1,355092,0.00196423,94232499,0.521256
5x,180779525,contig_98,1,353072,0.00195305,94585571,0.52321
5x,180779525,contig_867,1,352841,0.00195178,94938412,0.525161
5x,180779525,contig_836,1,352076,0.00194754,95290488,0.527109
5x,180779525,scaffold_21,1,349612,0.00193391,95640100,0.529043
5x,180779525,contig_466,1,349385,0.00193266,95989485,0.530975
5x,180779525,contig_410,1,348465,0.00192757,96337950,0.532903
5x,180779525,contig_624,1,348454,0.00192751,96686404,0.534831
5x,180779525,contig_59,1,348305,0.00192668,97034709,0.536757
5x,180779525,contig_230,1,347149,0.00192029,97381858,0.538677
5x,180779525,contig_22,1,346084,0.0019144,97727942,0.540592
5x,180779525,contig_112,1,345890,0.00191333,98073832,0.542505
5x,180779525,contig_217,1,344324,0.00190466,98418156,0.54441
5x,180779525,contig_932,1,344054,0.00190317,98762210,0.546313
5x,180779525,contig_400,1,337331,0.00186598,99099541,0.548179
5x,180779525,contig_1078,1,335313,0.00185482,99434854,0.550034
5x,180779525,contig_995,1,330594,0.00182871,99765448,0.551863
5x,180779525,contig_1069,1,328585,0.0018176,100094033,0.55368
5x,180779525,contig_1043,1,323958,0.00179201,100417991,0.555472
5x,180779525,contig_92,1,316883,0.00175287,100734874,0.557225
5x,180779525,contig_313,1,313304,0.00173307,101048178,0.558958
5x,180779525,contig_367,1,309735,0.00171333,101357913,0.560671
5x,180779525,contig_460,1,304539,0.00168459,101662452,0.562356
5x,180779525,contig_754,1,303655,0.0016797,101966107,0.564036
5x,180779525,contig_501,1,303230,0.00167735,102269337,0.565713
5x,180779525,contig_1125,1,302790,0.00167491,102572127,0.567388
5x,180779525,contig_486,1,302534,0.0016735,102874661,0.569061
5x,180779525,contig_196,1,302326,0.00167235,103176987,0.570734
5x,180779525,contig_136,1,299702,0.00165783,103476689,0.572392
5x,180779525,contig_618,1,298343,0.00165031,103775032,0.574042
5x,180779525,contig_505,1,297529,0.00164581,104072561,0.575688
5x,180779525,contig_110,1,297398,0.00164509,104369959,0.577333
5x,180779525,contig_531,1,295163,0.00163272,104665122,0.578966
5x,180779525,contig_784,1,295133,0.00163256,104960255,0.580598
5x,180779525,contig_470,1,293510,0.00162358,105253765,0.582222
5x,180779525,contig_490,1,288729,0.00159713,105542494,0.583819
5x,180779525,contig_391,1,287859,0.00159232,105830353,0.585411
5x,180779525,contig_792,1,284092,0.00157148,106114445,0.586983
5x,180779525,contig_587,1,280238,0.00155016,106394683,0.588533
5x,180779525,contig_649,1,277987,0.00153771,106672670,0.590071
5x,180779525,contig_1028,1,274901,0.00152064,106947571,0.591591
5x,180779525,contig_1051,1,272657,0.00150823,107220228,0.593099
5x,180779525,contig_431,1,269948,0.00149324,107490176,0.594593
5x,180779525,contig_775,1,269908,0.00149302,107760084,0.596086
5x,180779525,contig_1169,1,266966,0.00147675,108027050,0.597562
5x,180779525,contig_291,1,265678,0.00146962,108292728,0.599032
5x,180779525,contig_295,1,265538,0.00146885,108558266,0.600501
5x,180779525,contig_247,1,265015,0.00146596,108823281,0.601967
5x,180779525,contig_719,1,264979,0.00146576,109088260,0.603433
5x,180779525,contig_43,1,264723,0.00146434,109352983,0.604897
5x,180779525,contig_532,1,264237,0.00146165,109617220,0.606359
5x,180779525,contig_663,1,264036,0.00146054,109881256,0.607819
5x,180779525,contig_892,1,263335,0.00145666,110144591,0.609276
5x,180779525,contig_159,1,263120,0.00145547,110407711,0.610731
5x,180779525,contig_1037,1,256490,0.0014188,110664201,0.61215
5x,180779525,contig_1060,1,256224,0.00141733,110920425,0.613567
5x,180779525,contig_825,1,256053,0.00141638,111176478,0.614984
5x,180779525,contig_916,1,255067,0.00141093,111431545,0.616395
5x,180779525,contig_494,1,254909,0.00141005,111686454,0.617805
5x,180779525,contig_32,1,253130,0.00140021,111939584,0.619205
5x,180779525,contig_4,1,252361,0.00139596,112191945,0.620601
5x,180779525,contig_119,1,251862,0.0013932,112443807,0.621994
5x,180779525,contig_1170,1,251829,0.00139302,112695636,0.623387
5x,180779525,contig_377,1,251094,0.00138895,112946730,0.624776
5x,180779525,contig_329,1,250986,0.00138835,113197716,0.626164
5x,180779525,contig_1031,1,249556,0.00138044,113447272,0.627545
5x,180779525,contig_423,1,248941,0.00137704,113696213,0.628922
5x,180779525,contig_88,1,248333,0.00137368,113944546,0.630296
5x,180779525,contig_122,1,247863,0.00137108,114192409,0.631667
5x,180779525,contig_396,1,247019,0.00136641,114439428,0.633033
5x,180779525,contig_363,1,246368,0.00136281,114685796,0.634396
5x,180779525,contig_252,1,246182,0.00136178,114931978,0.635758
5x,180779525,contig_1059,1,244833,0.00135432,115176811,0.637112
5x,180779525,contig_568,1,238595,0.00131981,115415406,0.638432
5x,180779525,contig_463,1,235262,0.00130138,115650668,0.639733
5x,180779525,contig_457,1,235068,0.0013003,115885736,0.641034
5x,180779525,contig_154,1,234664,0.00129807,116120400,0.642332
5x,180779525,contig_319,1,233827,0.00129344,116354227,0.643625
5x,180779525,contig_132,1,232810,0.00128781,116587037,0.644913
5x,180779525,contig_1005,1,231973,0.00128318,116819010,0.646196
5x,180779525,contig_237,1,230722,0.00127626,117049732,0.647472
5x,180779525,contig_323,1,229967,0.00127209,117279699,0.648744
5x,180779525,contig_66,1,229043,0.00126697,117508742,0.650011
5x,180779525,contig_75,1,228735,0.00126527,117737477,0.651277
5x,180779525,contig_305,1,227653,0.00125929,117965130,0.652536
5x,180779525,contig_765,1,226020,0.00125025,118191150,0.653786
5x,180779525,contig_739,1,225364,0.00124662,118416514,0.655033
5x,180779525,contig_1,1,225162,0.00124551,118641676,0.656278
5x,180779525,contig_795,1,224566,0.00124221,118866242,0.65752
5x,180779525,contig_868,1,224531,0.00124202,119090773,0.658763
5x,180779525,contig_499,1,221866,0.00122727,119312639,0.65999
5x,180779525,contig_661,1,219915,0.00121648,119532554,0.661206
5x,180779525,contig_844,1,219714,0.00121537,119752268,0.662422
5x,180779525,contig_141,1,219335,0.00121327,119971603,0.663635
5x,180779525,contig_586,1,218055,0.00120619,120189658,0.664841
5x,180779525,contig_126,1,218032,0.00120607,120407690,0.666047
5x,180779525,contig_153,1,217903,0.00120535,120625593,0.667253
5x,180779525,contig_199,1,217706,0.00120426,120843299,0.668457
5x,180779525,contig_175,1,216526,0.00119774,121059825,0.669655
5x,180779525,contig_788,1,215427,0.00119166,121275252,0.670846
5x,180779525,contig_704,1,214220,0.00118498,121489472,0.672031
5x,180779525,contig_1137,1,213157,0.0011791,121702629,0.67321
5x,180779525,contig_276,1,210155,0.00116249,121912784,0.674373
5x,180779525,contig_525,1,208799,0.00115499,122121583,0.675528
5x,180779525,contig_920,1,207253,0.00114644,122328836,0.676674
5x,180779525,contig_390,1,206752,0.00114367,122535588,0.677818
5x,180779525,contig_1057,1,205815,0.00113849,122741403,0.678956
5x,180779525,contig_140,1,205791,0.00113835,122947194,0.680095
5x,180779525,contig_776,1,205331,0.00113581,123152525,0.68123
5x,180779525,contig_330,1,204892,0.00113338,123357417,0.682364
5x,180779525,contig_1097,1,203787,0.00112727,123561204,0.683491
5x,180779525,contig_761,1,201630,0.00111534,123762834,0.684606
5x,180779525,contig_1105,1,200516,0.00110917,123963350,0.685716
5x,180779525,contig_309,1,198699,0.00109912,124162049,0.686815
5x,180779525,contig_124,1,198119,0.00109592,124360168,0.687911
5x,180779525,contig_147,1,198005,0.00109528,124558173,0.689006
5x,180779525,contig_227,1,193688,0.0010714,124751861,0.690077
5x,180779525,contig_172,1,192466,0.00106464,124944327,0.691142
5x,180779525,contig_845,1,192350,0.001064,125136677,0.692206
5x,180779525,contig_6,1,191690,0.00106035,125328367,0.693266
5x,180779525,contig_855,1,190916,0.00105607,125519283,0.694322
5x,180779525,contig_881,1,190439,0.00105343,125709722,0.695376
5x,180779525,contig_693,1,189698,0.00104933,125899420,0.696425
5x,180779525,contig_838,1,188771,0.00104421,126088191,0.697469
5x,180779525,contig_420,1,188421,0.00104227,126276612,0.698512
5x,180779525,contig_894,1,187435,0.00103682,126464047,0.699549
5x,180779525,contig_567,1,187305,0.0010361,126651352,0.700585
5x,180779525,contig_963,1,186689,0.00103269,126838041,0.701617
5x,180779525,contig_912,1,184865,0.0010226,127022906,0.70264
5x,180779525,contig_609,1,184359,0.0010198,127207265,0.70366
5x,180779525,contig_578,1,184211,0.00101898,127391476,0.704679
5x,180779525,contig_530,1,183616,0.00101569,127575092,0.705694
5x,180779525,contig_298,1,183380,0.00101438,127758472,0.706709
5x,180779525,contig_596,1,182439,0.00100918,127940911,0.707718
5x,180779525,contig_897,1,182230,0.00100802,128123141,0.708726
5x,180779525,contig_311,1,180888,0.0010006,128304029,0.709727
5x,180779525,contig_745,1,180320,0.000997458,128484349,0.710724
5x,180779525,contig_706,1,180124,0.000996374,128664473,0.71172
5x,180779525,contig_872,1,180028,0.000995843,128844501,0.712716
5x,180779525,contig_896,1,179557,0.000993237,129024058,0.713709
5x,180779525,contig_854,1,178943,0.000989841,129203001,0.714699
5x,180779525,contig_625,1,178702,0.000988508,129381703,0.715688
5x,180779525,contig_811,1,177321,0.000980869,129559024,0.716669
5x,180779525,contig_1023,1,176418,0.000975874,129735442,0.717645
5x,180779525,contig_241,1,176408,0.000975818,129911850,0.71862
5x,180779525,contig_278,1,176275,0.000975083,130088125,0.719595
5x,180779525,contig_550,1,175283,0.000969595,130263408,0.720565
5x,180779525,contig_421,1,174140,0.000963273,130437548,0.721528
5x,180779525,contig_178,1,173815,0.000961475,130611363,0.72249
5x,180779525,contig_41,1,172572,0.000954599,130783935,0.723444
5x,180779525,contig_25,1,172526,0.000954345,130956461,0.724399
5x,180779525,contig_959,1,171389,0.000948055,131127850,0.725347
5x,180779525,contig_264,1,170207,0.000941517,131298057,0.726288
5x,180779525,contig_516,1,168666,0.000932993,131466723,0.727221
5x,180779525,contig_324,1,166858,0.000922992,131633581,0.728144
5x,180779525,contig_191,1,166834,0.000922859,131800415,0.729067
5x,180779525,contig_95,1,166707,0.000922156,131967122,0.729989
5x,180779525,contig_1050,1,166394,0.000920425,132133516,0.73091
5x,180779525,contig_304,1,165330,0.000914539,132298846,0.731824
5x,180779525,contig_1074,1,164863,0.000911956,132463709,0.732736
5x,180779525,contig_563,1,164779,0.000911491,132628488,0.733648
5x,180779525,contig_1096,1,164379,0.000909279,132792867,0.734557
5x,180779525,contig_766,1,163503,0.000904433,132956370,0.735461
5x,180779525,contig_1030,1,160979,0.000890471,133117349,0.736352
5x,180779525,contig_1052,1,159665,0.000883203,133277014,0.737235
5x,180779525,contig_1027,1,158812,0.000878484,133435826,0.738114
5x,180779525,contig_1033,1,157690,0.000872278,133593516,0.738986
5x,180779525,contig_877,1,156923,0.000868035,133750439,0.739854
5x,180779525,contig_192,1,156542,0.000865928,133906981,0.74072
5x,180779525,contig_913,1,155373,0.000859461,134062354,0.741579
5x,180779525,contig_1075,1,154911,0.000856906,134217265,0.742436
5x,180779525,contig_1073,1,154038,0.000852077,134371303,0.743288
5x,180779525,contig_214,1,153619,0.000849759,134524922,0.744138
5x,180779525,contig_709,1,153011,0.000846396,134677933,0.744984
5x,180779525,contig_1055,1,150400,0.000831953,134828333,0.745816
5x,180779525,contig_1111,1,150208,0.000830891,134978541,0.746647
5x,180779525,contig_1165,1,149956,0.000829497,135128497,0.747477
5x,180779525,contig_441,1,149371,0.000826261,135277868,0.748303
5x,180779525,contig_402,1,148991,0.000824159,135426859,0.749127
5x,180779525,contig_56,1,148207,0.000819822,135575066,0.749947
5x,180779525,scaffold_1084,1,148103,0.000819247,135723169,0.750766
5x,180779525,contig_729,1,147118,0.000813798,135870287,0.75158
5x,180779525,contig_694,1,146807,0.000812078,136017094,0.752392
5x,180779525,contig_558,1,145444,0.000804538,136162538,0.753197
5x,180779525,contig_395,1,144748,0.000800688,136307286,0.753997
5x,180779525,contig_223,1,143305,0.000792706,136450591,0.75479
5x,180779525,contig_950,1,141009,0.000780005,136591600,0.75557
5x,180779525,contig_475,1,139850,0.000773594,136731450,0.756344
5x,180779525,contig_357,1,138353,0.000765313,136869803,0.757109
5x,180779525,contig_301,1,138310,0.000765076,137008113,0.757874
5x,180779525,contig_968,1,138290,0.000764965,137146403,0.758639
5x,180779525,contig_503,1,137944,0.000763051,137284347,0.759402
5x,180779525,contig_322,1,137837,0.000762459,137422184,0.760165
5x,180779525,contig_253,1,137665,0.000761508,137559849,0.760926
5x,180779525,contig_933,1,137451,0.000760324,137697300,0.761686
5x,180779525,contig_1082,1,137409,0.000760092,137834709,0.762446
5x,180779525,contig_245,1,137261,0.000759273,137971970,0.763206
5x,180779525,contig_899,1,137071,0.000758222,138109041,0.763964
5x,180779525,contig_909,1,136595,0.000755589,138245636,0.76472
5x,180779525,contig_248,1,136478,0.000754942,138382114,0.765474
5x,180779525,contig_764,1,134685,0.000745024,138516799,0.76622
5x,180779525,contig_239,1,133763,0.000739923,138650562,0.766959
5x,180779525,contig_562,1,133415,0.000737998,138783977,0.767697
5x,180779525,contig_487,1,133333,0.000737545,138917310,0.768435
5x,180779525,contig_1022,1,132943,0.000735387,139050253,0.76917
5x,180779525,contig_394,1,132636,0.000733689,139182889,0.769904
5x,180779525,contig_905,1,132511,0.000732998,139315400,0.770637
5x,180779525,contig_829,1,131641,0.000728185,139447041,0.771365
5x,180779525,contig_828,1,131557,0.000727721,139578598,0.772093
5x,180779525,contig_209,1,130690,0.000722925,139709288,0.772816
5x,180779525,contig_551,1,129839,0.000718217,139839127,0.773534
5x,180779525,contig_1128,1,129558,0.000716663,139968685,0.774251
5x,180779525,contig_286,1,128503,0.000710827,140097188,0.774962
5x,180779525,contig_144,1,127999,0.000708039,140225187,0.77567
5x,180779525,contig_152,1,127808,0.000706983,140352995,0.776377
5x,180779525,contig_472,1,127677,0.000706258,140480672,0.777083
5x,180779525,contig_386,1,126855,0.000701711,140607527,0.777785
5x,180779525,contig_215,1,124590,0.000689182,140732117,0.778474
5x,180779525,contig_584,1,124478,0.000688562,140856595,0.779162
5x,180779525,contig_387,1,124435,0.000688325,140981030,0.779851
5x,180779525,contig_588,1,124087,0.0006864,141105117,0.780537
5x,180779525,contig_204,1,123879,0.000685249,141228996,0.781222
5x,180779525,contig_468,1,122985,0.000680304,141351981,0.781903
5x,180779525,contig_740,1,122860,0.000679612,141474841,0.782582
5x,180779525,contig_632,1,122730,0.000678893,141597571,0.783261
5x,180779525,contig_635,1,121382,0.000671437,141718953,0.783933
5x,180779525,contig_287,1,121361,0.00067132,141840314,0.784604
5x,180779525,contig_800,1,120142,0.000664577,141960456,0.785268
5x,180779525,contig_473,1,119475,0.000660888,142079931,0.785929
5x,180779525,contig_251,1,119019,0.000658365,142198950,0.786588
5x,180779525,contig_198,1,118594,0.000656015,142317544,0.787244
5x,180779525,contig_731,1,116584,0.000644896,142434128,0.787889
5x,180779525,contig_326,1,116414,0.000643956,142550542,0.788533
5x,180779525,contig_1042,1,115170,0.000637074,142665712,0.78917
5x,180779525,contig_213,1,115053,0.000636427,142780765,0.789806
5x,180779525,contig_808,1,114907,0.00063562,142895672,0.790442
5x,180779525,contig_724,1,114541,0.000633595,143010213,0.791075
5x,180779525,contig_535,1,114508,0.000633412,143124721,0.791709
5x,180779525,contig_726,1,112130,0.000620258,143236851,0.792329
5x,180779525,contig_85,1,111804,0.000618455,143348655,0.792947
5x,180779525,contig_589,1,111297,0.00061565,143459952,0.793563
5x,180779525,contig_290,1,111035,0.000614201,143570987,0.794177
5x,180779525,contig_889,1,110586,0.000611718,143681573,0.794789
5x,180779525,contig_751,1,110498,0.000611231,143792071,0.7954
5x,180779525,contig_1072,1,110007,0.000608515,143902078,0.796009
5x,180779525,contig_231,1,109470,0.000605544,144011548,0.796614
5x,180779525,contig_592,1,108288,0.000599006,144119836,0.797213
5x,180779525,contig_272,1,107855,0.000596611,144227691,0.79781
5x,180779525,contig_631,1,107402,0.000594105,144335093,0.798404
5x,180779525,contig_1064,1,107382,0.000593994,144442475,0.798998
5x,180779525,contig_538,1,106928,0.000591483,144549403,0.799589
5x,180779525,contig_182,1,106444,0.000588806,144655847,0.800178
5x,180779525,contig_580,1,105472,0.000583429,144761319,0.800762
5x,180779525,contig_747,1,105051,0.0005811,144866370,0.801343
5x,180779525,contig_569,1,103988,0.00057522,144970358,0.801918
5x,180779525,contig_545,1,103914,0.000574811,145074272,0.802493
5x,180779525,contig_1122,1,103540,0.000572742,145177812,0.803066
5x,180779525,contig_1049,1,103147,0.000570568,145280959,0.803636
5x,180779525,contig_579,1,103137,0.000570513,145384096,0.804207
5x,180779525,contig_373,1,102637,0.000567747,145486733,0.804774
5x,180779525,contig_449,1,102449,0.000566707,145589182,0.805341
5x,180779525,contig_1016,1,101237,0.000560003,145690419,0.805901
5x,180779525,contig_972,1,100249,0.000554537,145790668,0.806456
5x,180779525,contig_862,1,100059,0.000553486,145890727,0.807009
5x,180779525,contig_660,1,99060,0.00054796,145989787,0.807557
5x,180779525,contig_732,1,98925,0.000547214,146088712,0.808104
5x,180779525,contig_1107,1,98153,0.000542943,146186865,0.808647
5x,180779525,contig_748,1,98149,0.000542921,146285014,0.80919
5x,180779525,contig_488,1,97996,0.000542075,146383010,0.809732
5x,180779525,contig_135,1,97643,0.000540122,146480653,0.810272
5x,180779525,contig_388,1,97161,0.000537456,146577814,0.81081
5x,180779525,contig_265,1,96969,0.000536394,146674783,0.811346
5x,180779525,contig_454,1,96482,0.0005337,146771265,0.81188
5x,180779525,contig_451,1,96429,0.000533407,146867694,0.812413
5x,180779525,contig_602,1,96301,0.000532699,146963995,0.812946
5x,180779525,contig_815,1,95760,0.000529706,147059755,0.813476
5x,180779525,contig_981,1,95412,0.000527781,147155167,0.814004
5x,180779525,contig_758,1,94912,0.000525015,147250079,0.814529
5x,180779525,contig_47,1,94878,0.000524827,147344957,0.815053
5x,180779525,contig_940,1,94712,0.000523909,147439669,0.815577
5x,180779525,contig_984,1,94575,0.000523151,147534244,0.8161
5x,180779525,contig_183,1,94532,0.000522913,147628776,0.816623
5x,180779525,contig_801,1,93810,0.000518919,147722586,0.817142
5x,180779525,contig_1168,1,93697,0.000518294,147816283,0.817661
5x,180779525,contig_651,1,92830,0.000513498,147909113,0.818174
5x,180779525,contig_975,1,92486,0.000511596,148001599,0.818686
5x,180779525,contig_1104,1,92211,0.000510074,148093810,0.819196
5x,180779525,contig_1136,1,92187,0.000509942,148185997,0.819706
5x,180779525,contig_193,1,92156,0.00050977,148278153,0.820215
5x,180779525,contig_939,1,92128,0.000509615,148370281,0.820725
5x,180779525,contig_949,1,92065,0.000509267,148462346,0.821234
5x,180779525,contig_796,1,91347,0.000505295,148553693,0.82174
5x,180779525,contig_266,1,89806,0.000496771,148643499,0.822236
5x,180779525,contig_640,1,89586,0.000495554,148733085,0.822732
5x,180779525,contig_1152,1,89176,0.000493286,148822261,0.823225
5x,180779525,contig_997,1,88593,0.000490061,148910854,0.823715
5x,180779525,contig_186,1,88227,0.000488036,148999081,0.824203
5x,180779525,contig_150,1,88166,0.000487699,149087247,0.824691
5x,180779525,contig_543,1,88041,0.000487008,149175288,0.825178
5x,180779525,contig_712,1,87737,0.000485326,149263025,0.825663
5x,180779525,contig_443,1,86899,0.00048069,149349924,0.826144
5x,180779525,contig_672,1,86693,0.000479551,149436617,0.826624
5x,180779525,contig_1065,1,86180,0.000476713,149522797,0.8271
5x,180779525,contig_1145,1,85320,0.000471956,149608117,0.827572
5x,180779525,contig_852,1,85120,0.00047085,149693237,0.828043
5x,180779525,contig_759,1,84684,0.000468438,149777921,0.828512
5x,180779525,contig_128,1,84534,0.000467608,149862455,0.828979
5x,180779525,contig_288,1,84331,0.000466485,149946786,0.829446
5x,180779525,contig_992,1,82739,0.000457679,150029525,0.829903
5x,180779525,contig_703,1,82590,0.000456855,150112115,0.83036
5x,180779525,contig_954,1,81802,0.000452496,150193917,0.830813
5x,180779525,contig_623,1,80337,0.000444392,150274254,0.831257
5x,180779525,contig_406,1,80235,0.000443828,150354489,0.831701
5x,180779525,contig_234,1,79618,0.000440415,150434107,0.832141
5x,180779525,contig_315,1,78410,0.000433733,150512517,0.832575
5x,180779525,contig_80,1,77526,0.000428843,150590043,0.833004
5x,180779525,contig_774,1,77421,0.000428262,150667464,0.833432
5x,180779525,contig_777,1,76888,0.000425314,150744352,0.833857
5x,180779525,contig_61,1,76393,0.000422576,150820745,0.83428
5x,180779525,contig_1000,1,76271,0.000421901,150897016,0.834702
5x,180779525,contig_583,1,76108,0.000420999,150973124,0.835123
5x,180779525,contig_863,1,75882,0.000419749,151049006,0.835543
5x,180779525,contig_682,1,74730,0.000413376,151123736,0.835956
5x,180779525,contig_513,1,73469,0.000406401,151197205,0.836362
5x,180779525,contig_880,1,73427,0.000406169,151270632,0.836769
5x,180779525,contig_901,1,73375,0.000405881,151344007,0.837174
5x,180779525,contig_783,1,72689,0.000402086,151416696,0.837577
5x,180779525,contig_1046,1,72384,0.000400399,151489080,0.837977
5x,180779525,contig_812,1,72375,0.00040035,151561455,0.838377
5x,180779525,contig_509,1,72337,0.000400139,151633792,0.838777
5x,180779525,contig_634,1,71945,0.000397971,151705737,0.839175
5x,180779525,contig_44,1,71755,0.00039692,151777492,0.839572
5x,180779525,contig_58,1,71577,0.000395935,151849069,0.839968
5x,180779525,contig_502,1,71566,0.000395874,151920635,0.840364
5x,180779525,contig_1045,1,70312,0.000388938,151990947,0.840753
5x,180779525,contig_361,1,69701,0.000385558,152060648,0.841139
5x,180779525,contig_275,1,69646,0.000385254,152130294,0.841524
5x,180779525,contig_497,1,68279,0.000377692,152198573,0.841902
5x,180779525,contig_762,1,68206,0.000377288,152266779,0.842279
5x,180779525,contig_418,1,68051,0.000376431,152334830,0.842655
5x,180779525,contig_565,1,67745,0.000374738,152402575,0.84303
5x,180779525,contig_737,1,67538,0.000373593,152470113,0.843404
5x,180779525,contig_479,1,67516,0.000373471,152537629,0.843777
5x,180779525,contig_528,1,66650,0.000368681,152604279,0.844146
5x,180779525,contig_718,1,65320,0.000361324,152669599,0.844507
5x,180779525,contig_923,1,64504,0.00035681,152734103,0.844864
5x,180779525,contig_482,1,63820,0.000353027,152797923,0.845217
5x,180779525,contig_79,1,63747,0.000352623,152861670,0.84557
5x,180779525,contig_207,1,63654,0.000352108,152925324,0.845922
5x,180779525,contig_71,1,63644,0.000352053,152988968,0.846274
5x,180779525,contig_604,1,63312,0.000350217,153052280,0.846624
5x,180779525,contig_469,1,63172,0.000349442,153115452,0.846973
5x,180779525,contig_942,1,62770,0.000347219,153178222,0.847321
5x,180779525,contig_20,1,62718,0.000346931,153240940,0.847668
5x,180779525,contig_145,1,62646,0.000346533,153303586,0.848014
5x,180779525,contig_947,1,62498,0.000345714,153366084,0.84836
5x,180779525,contig_922,1,62353,0.000344912,153428437,0.848705
5x,180779525,contig_1067,1,62312,0.000344685,153490749,0.849049
5x,180779525,contig_428,1,62081,0.000343407,153552830,0.849393
5x,180779525,contig_283,1,61886,0.000342329,153614716,0.849735
5x,180779525,contig_548,1,61311,0.000339148,153676027,0.850074
5x,180779525,contig_512,1,60448,0.000334374,153736475,0.850409
5x,180779525,contig_280,1,59185,0.000327388,153795660,0.850736
5x,180779525,contig_149,1,58622,0.000324273,153854282,0.85106
5x,180779525,contig_314,1,58000,0.000320833,153912282,0.851381
5x,180779525,contig_599,1,57651,0.000318902,153969933,0.8517
5x,180779525,contig_851,1,57613,0.000318692,154027546,0.852019
5x,180779525,contig_536,1,56345,0.000311678,154083891,0.85233
5x,180779525,contig_73,1,55511,0.000307065,154139402,0.852637
5x,180779525,contig_976,1,55274,0.000305754,154194676,0.852943
5x,180779525,contig_155,1,55235,0.000305538,154249911,0.853249
5x,180779525,contig_188,1,55031,0.000304409,154304942,0.853553
5x,180779525,contig_412,1,54861,0.000303469,154359803,0.853857
5x,180779525,contig_914,1,54501,0.000301478,154414304,0.854158
5x,180779525,contig_446,1,54332,0.000300543,154468636,0.854459
5x,180779525,contig_176,1,53983,0.000298612,154522619,0.854757
5x,180779525,contig_556,1,53868,0.000297976,154576487,0.855055
5x,180779525,contig_455,1,53664,0.000296848,154630151,0.855352
5x,180779525,contig_760,1,53313,0.000294906,154683464,0.855647
5x,180779525,contig_711,1,53109,0.000293778,154736573,0.855941
5x,180779525,contig_611,1,53055,0.000293479,154789628,0.856234
5x,180779525,contig_721,1,52909,0.000292671,154842537,0.856527
5x,180779525,contig_440,1,52617,0.000291056,154895154,0.856818
5x,180779525,contig_448,1,52467,0.000290226,154947621,0.857108
5x,180779525,contig_859,1,52009,0.000287693,154999630,0.857396
5x,180779525,contig_203,1,51949,0.000287361,155051579,0.857683
5x,180779525,contig_343,1,51704,0.000286006,155103283,0.857969
5x,180779525,contig_934,1,51436,0.000284523,155154719,0.858254
5x,180779525,contig_467,1,50916,0.000281647,155205635,0.858535
5x,180779525,contig_256,1,50687,0.00028038,155256322,0.858816
5x,180779525,contig_773,1,50334,0.000278428,155306656,0.859094
5x,180779525,contig_696,1,50218,0.000277786,155356874,0.859372
5x,180779525,contig_821,1,50109,0.000277183,155406983,0.859649
5x,180779525,contig_244,1,49587,0.000274295,155456570,0.859924
5x,180779525,contig_1103,1,49524,0.000273947,155506094,0.860197
5x,180779525,contig_576,1,49501,0.00027382,155555595,0.860471
5x,180779525,contig_807,1,49312,0.000272774,155604907,0.860744
5x,180779525,contig_927,1,49311,0.000272769,155654218,0.861017
5x,180779525,contig_1164,1,48783,0.000269848,155703001,0.861287
5x,180779525,contig_285,1,48750,0.000269665,155751751,0.861556
5x,180779525,contig_595,1,48123,0.000266197,155799874,0.861823
5x,180779525,contig_478,1,48044,0.00026576,155847918,0.862088
5x,180779525,contig_158,1,47939,0.000265179,155895857,0.862354
5x,180779525,contig_882,1,47062,0.000260328,155942919,0.862614
5x,180779525,contig_769,1,46833,0.000259061,155989752,0.862873
5x,180779525,contig_655,1,46066,0.000254819,156035818,0.863128
5x,180779525,contig_125,1,45974,0.00025431,156081792,0.863382
5x,180779525,contig_151,1,45854,0.000253646,156127646,0.863636
5x,180779525,contig_236,1,45658,0.000252562,156173304,0.863888
5x,180779525,contig_669,1,45592,0.000252197,156218896,0.86414
5x,180779525,contig_259,1,45502,0.000251699,156264398,0.864392
5x,180779525,contig_763,1,44855,0.00024812,156309253,0.86464
5x,180779525,contig_677,1,44763,0.000247611,156354016,0.864888
5x,180779525,contig_378,1,44626,0.000246853,156398642,0.865135
5x,180779525,contig_1053,1,44079,0.000243827,156442721,0.865379
5x,180779525,contig_813,1,44055,0.000243695,156486776,0.865622
5x,180779525,contig_999,1,44049,0.000243661,156530825,0.865866
5x,180779525,contig_727,1,43834,0.000242472,156574659,0.866108
5x,180779525,contig_843,1,43770,0.000242118,156618429,0.86635
5x,180779525,contig_57,1,43430,0.000240237,156661859,0.866591
5x,180779525,contig_707,1,43419,0.000240177,156705278,0.866831
5x,180779525,contig_348,1,43100,0.000238412,156748378,0.867069
5x,180779525,contig_898,1,43097,0.000238395,156791475,0.867308
5x,180779525,contig_1157,1,42351,0.000234269,156833826,0.867542
5x,180779525,contig_216,1,42304,0.000234009,156876130,0.867776
5x,180779525,contig_228,1,42077,0.000232753,156918207,0.868009
5x,180779525,contig_823,1,41691,0.000230618,156959898,0.868239
5x,180779525,contig_702,1,41583,0.000230021,157001481,0.868469
5x,180779525,contig_657,1,40657,0.000224898,157042138,0.868694
5x,180779525,contig_134,1,40142,0.000222049,157082280,0.868916
5x,180779525,contig_523,1,39805,0.000220185,157122085,0.869137
5x,180779525,contig_715,1,39522,0.00021862,157161607,0.869355
5x,180779525,contig_541,1,38732,0.00021425,157200339,0.869569
5x,180779525,contig_430,1,37985,0.000210118,157238324,0.869779
5x,180779525,contig_772,1,37682,0.000208442,157276006,0.869988
5x,180779525,contig_952,1,37474,0.000207291,157313480,0.870195
5x,180779525,contig_226,1,37161,0.00020556,157350641,0.870401
5x,180779525,contig_876,1,36725,0.000203148,157387366,0.870604
5x,180779525,contig_833,1,36063,0.000199486,157423429,0.870803
5x,180779525,contig_741,1,35830,0.000198197,157459259,0.871002
5x,180779525,contig_1135,1,35280,0.000195155,157494539,0.871197
5x,180779525,contig_875,1,34942,0.000193285,157529481,0.87139
5x,180779525,contig_419,1,34938,0.000193263,157564419,0.871583
5x,180779525,contig_332,1,34897,0.000193036,157599316,0.871776
5x,180779525,contig_303,1,34268,0.000189557,157633584,0.871966
5x,180779525,contig_1070,1,33293,0.000184164,157666877,0.87215
5x,180779525,contig_598,1,32744,0.000181127,157699621,0.872331
5x,180779525,contig_393,1,32486,0.0001797,157732107,0.872511
5x,180779525,contig_757,1,32224,0.00017825,157764331,0.872689
5x,180779525,contig_767,1,32123,0.000177692,157796454,0.872867
5x,180779525,contig_36,1,31797,0.000175888,157828251,0.873043
5x,180779525,contig_202,1,31266,0.000172951,157859517,0.873216
5x,180779525,contig_433,1,29821,0.000164958,157889338,0.873381
5x,180779525,contig_270,1,29571,0.000163575,157918909,0.873544
5x,180779525,contig_246,1,29295,0.000162048,157948204,0.873706
5x,180779525,contig_577,1,29204,0.000161545,157977408,0.873868
5x,180779525,contig_346,1,29175,0.000161384,158006583,0.874029
5x,180779525,contig_274,1,28989,0.000160356,158035572,0.87419
5x,180779525,contig_674,1,28250,0.000156268,158063822,0.874346
5x,180779525,contig_717,1,27650,0.000152949,158091472,0.874499
5x,180779525,contig_782,1,27564,0.000152473,158119036,0.874651
5x,180779525,contig_273,1,26612,0.000147207,158145648,0.874798
5x,180779525,contig_366,1,26522,0.000146709,158172170,0.874945
5x,180779525,contig_653,1,26399,0.000146029,158198569,0.875091
5x,180779525,contig_637,1,25714,0.00014224,158224283,0.875233
5x,180779525,contig_860,1,25287,0.000139878,158249570,0.875373
5x,180779525,contig_804,1,24711,0.000136691,158274281,0.87551
5x,180779525,contig_945,1,22712,0.000125634,158296993,0.875636
5x,180779525,contig_1003,1,21876,0.000121009,158318869,0.875757
5x,180779525,contig_161,1,20897,0.000115594,158339766,0.875872
5x,180779525,contig_1009,1,20821,0.000115173,158360587,0.875987
5x,180779525,contig_268,1,20461,0.000113182,158381048,0.876101
5x,180779525,contig_353,1,20077,0.000111058,158401125,0.876212
5x,180779525,contig_986,1,19743,0.00010921,158420868,0.876321
5x,180779525,contig_931,1,19253,0.0001065,158440121,0.876427
5x,180779525,contig_415,1,19088,0.000105587,158459209,0.876533
5x,180779525,contig_511,1,18591,0.000102838,158477800,0.876636
5x,180779525,contig_37,1,18525,0.000102473,158496325,0.876738
5x,180779525,contig_847,1,18285,0.000101145,158514610,0.876839
5x,180779525,contig_771,1,18077,9.99947e-05,158532687,0.876939
5x,180779525,contig_691,1,16957,9.37993e-05,158549644,0.877033
5x,180779525,contig_1034,1,16801,9.29364e-05,158566445,0.877126
5x,180779525,contig_1068,1,16741,9.26045e-05,158583186,0.877219
5x,180779525,contig_519,1,16712,9.24441e-05,158599898,0.877311
5x,180779525,contig_1015,1,15582,8.61934e-05,158615480,0.877397
5x,180779525,contig_1146,1,15243,8.43182e-05,158630723,0.877482
5x,180779525,contig_973,1,14751,8.15966e-05,158645474,0.877563
5x,180779525,contig_23,1,14720,8.14252e-05,158660194,0.877645
5x,180779525,contig_626,1,13617,7.53238e-05,158673811,0.87772
5x,180779525,contig_755,1,13415,7.42064e-05,158687226,0.877794
5x,180779525,contig_289,1,12830,7.09704e-05,158700056,0.877865
5x,180779525,contig_994,1,12501,6.91505e-05,158712557,0.877934
5x,180779525,contig_960,1,11512,6.36798e-05,158724069,0.877998
5x,180779525,contig_97,1,11225,6.20922e-05,158735294,0.87806
5x,180779525,contig_384,1,11028,6.10025e-05,158746322,0.878121
5x,180779525,contig_575,1,10746,5.94426e-05,158757068,0.878181
5x,180779525,contig_1086,1,10104,5.58913e-05,158767172,0.878236
5x,180779525,contig_254,1,9790,5.41544e-05,158776962,0.878291
5x,180779525,contig_385,1,9753,5.39497e-05,158786715,0.878345
5x,180779525,contig_977,1,9498,5.25391e-05,158796213,0.878397
5x,180779525,contig_485,1,9492,5.25059e-05,158805705,0.87845
5x,180779525,contig_827,1,9289,5.1383e-05,158814994,0.878501
5x,180779525,contig_591,1,9053,5.00776e-05,158824047,0.878551
5x,180779525,contig_1163,1,8899,4.92257e-05,158832946,0.8786
5x,180779525,contig_200,1,8757,4.84402e-05,158841703,0.878649
5x,180779525,contig_594,1,8751,4.8407e-05,158850454,0.878697
5x,180779525,contig_398,1,8205,4.53868e-05,158858659,0.878743
5x,180779525,contig_370,1,8124,4.49387e-05,158866783,0.878787
5x,180779525,contig_481,1,7871,4.35392e-05,158874654,0.878831
5x,180779525,contig_573,1,7866,4.35116e-05,158882520,0.878875
5x,180779525,contig_184,1,7859,4.34728e-05,158890379,0.878918
5x,180779525,contig_734,1,7857,4.34618e-05,158898236,0.878961
5x,180779525,contig_383,1,7680,4.24827e-05,158905916,0.879004
5x,180779525,contig_156,1,7526,4.16308e-05,158913442,0.879046
5x,180779525,contig_442,1,7043,3.89591e-05,158920485,0.879085
5x,180779525,contig_839,1,6942,3.84004e-05,158927427,0.879123
5x,180779525,contig_1100,1,6365,3.52086e-05,158933792,0.879158
5x,180779525,contig_818,1,6303,3.48657e-05,158940095,0.879193
5x,180779525,contig_300,1,6152,3.40304e-05,158946247,0.879227
5x,180779525,contig_780,1,6079,3.36266e-05,158952326,0.879261
5x,180779525,contig_668,1,5844,3.23267e-05,158958170,0.879293
5x,180779525,contig_432,1,5800,3.20833e-05,158963970,0.879325
5x,180779525,contig_168,1,5736,3.17293e-05,158969706,0.879357
5x,180779525,contig_233,1,5520,3.05344e-05,158975226,0.879387
5x,180779525,contig_824,1,5343,2.95553e-05,158980569,0.879417
5x,180779525,contig_16,1,5336,2.95166e-05,158985905,0.879446
5x,180779525,contig_514,1,4970,2.74921e-05,158990875,0.879474
5x,180779525,contig_437,1,4741,2.62253e-05,158995616,0.8795
5x,180779525,contig_194,1,4738,2.62087e-05,159000354,0.879526
5x,180779525,contig_926,1,4701,2.60041e-05,159005055,0.879552
5x,180779525,contig_979,1,4676,2.58658e-05,159009731,0.879578
5x,180779525,contig_1153,1,4387,2.42671e-05,159014118,0.879602
5x,180779525,contig_1017,1,4265,2.35923e-05,159018383,0.879626
5x,180779525,contig_547,1,4205,2.32604e-05,159022588,0.879649
5x,180779525,contig_683,1,4081,2.25745e-05,159026669,0.879672
5x,180779525,contig_996,1,4039,2.23421e-05,159030708,0.879694
5x,180779525,contig_1083,1,4039,2.23421e-05,159034747,0.879717
5x,180779525,contig_690,1,4006,2.21596e-05,159038753,0.879739
5x,180779525,contig_10,1,4002,2.21375e-05,159042755,0.879761
5x,180779525,contig_692,1,4001,2.21319e-05,159046756,0.879783
5x,180779525,contig_943,1,3944,2.18166e-05,159050700,0.879805
5x,180779525,contig_321,1,3762,2.08099e-05,159054462,0.879826
5x,180779525,contig_961,1,3691,2.04171e-05,159058153,0.879846
5x,180779525,contig_883,1,3599,1.99082e-05,159061752,0.879866
5x,180779525,contig_1021,1,3587,1.98418e-05,159065339,0.879886
5x,180779525,contig_521,1,3503,1.93772e-05,159068842,0.879905
5x,180779525,contig_915,1,3365,1.86138e-05,159072207,0.879924
5x,180779525,contig_362,1,3345,1.85032e-05,159075552,0.879942
5x,180779525,contig_921,1,3118,1.72475e-05,159078670,0.87996
5x,180779525,contig_749,1,3045,1.68437e-05,159081715,0.879976
5x,180779525,contig_978,1,2942,1.6274e-05,159084657,0.879993
5x,180779525,contig_45,1,2937,1.62463e-05,159087594,0.880009
5x,180779525,contig_643,1,2745,1.51842e-05,159090339,0.880024
5x,180779525,contig_983,1,2648,1.46477e-05,159092987,0.880039
5x,180779525,contig_826,1,2589,1.43213e-05,159095576,0.880053
5x,180779525,contig_1124,1,2573,1.42328e-05,159098149,0.880067
5x,180779525,contig_1092,1,2572,1.42273e-05,159100721,0.880082
5x,180779525,contig_820,1,2566,1.41941e-05,159103287,0.880096
5x,180779525,contig_438,1,2535,1.40226e-05,159105822,0.88011
5x,180779525,contig_546,1,2440,1.34971e-05,159108262,0.880123
5x,180779525,contig_1130,1,2406,1.3309e-05,159110668,0.880137
5x,180779525,contig_956,1,2321,1.28388e-05,159112989,0.880149
5x,180779525,contig_822,1,2226,1.23133e-05,159115215,0.880162
5x,180779525,contig_312,1,2147,1.18763e-05,159117362,0.880174
5x,180779525,contig_434,1,2110,1.16717e-05,159119472,0.880185
5x,180779525,contig_508,1,2045,1.13121e-05,159121517,0.880197
5x,180779525,contig_799,1,1991,1.10134e-05,159123508,0.880208
5x,180779525,contig_561,1,1942,1.07424e-05,159125450,0.880218
5x,180779525,contig_1115,1,1916,1.05985e-05,159127366,0.880229
5x,180779525,contig_680,1,1603,8.86715e-06,159128969,0.880238
5x,180779525,contig_802,1,1525,8.43569e-06,159130494,0.880246
5x,180779525,contig_816,1,1519,8.4025e-06,159132013,0.880255
5x,180779525,contig_1140,1,1326,7.3349e-06,159133339,0.880262
5x,180779525,contig_830,1,1212,6.7043e-06,159134551,0.880269
5x,180779525,contig_722,1,1133,6.2673e-06,159135684,0.880275
5x,180779525,contig_667,1,1130,6.25071e-06,159136814,0.880281
5x,180779525,contig_320,1,1096,6.06263e-06,159137910,0.880287
5x,180779525,contig_1121,1,1019,5.6367e-06,159138929,0.880293
5x,180779525,contig_730,1,926,5.12226e-06,159139855,0.880298
5x,180779525,contig_261,1,922,5.10014e-06,159140777,0.880303
5x,180779525,contig_89,1,876,4.84568e-06,159141653,0.880308
5x,180779525,contig_476,1,843,4.66314e-06,159142496,0.880313
5x,180779525,contig_1141,1,802,4.43634e-06,159143298,0.880317
5x,180779525,contig_426,1,773,4.27593e-06,159144071,0.880321
5x,180779525,contig_753,1,756,4.18189e-06,159144827,0.880326
5x,180779525,contig_206,1,736,4.07126e-06,159145563,0.88033
5x,180779525,contig_1148,1,731,4.0436e-06,159146294,0.880334
5x,180779525,contig_1077,1,687,3.80021e-06,159146981,0.880337
5x,180779525,contig_989,1,595,3.2913e-06,159147576,0.880341
5x,180779525,contig_417,1,573,3.16961e-06,159148149,0.880344
5x,180779525,contig_375,1,562,3.10876e-06,159148711,0.880347
5x,180779525,contig_1048,1,550,3.04238e-06,159149261,0.88035
5x,180779525,contig_179,1,537,2.97047e-06,159149798,0.880353
5x,180779525,contig_791,1,535,2.95941e-06,159150333,0.880356
5x,180779525,contig_293,1,535,2.95941e-06,159150868,0.880359
15x,180779525,scaffold_58,1,29036111,0.160616,29036111,0.160616
15x,180779525,contig_10,1,25452330,0.140792,54488441,0.301408
15x,180779525,scaffold_37,1,24539593,0.135743,79028034,0.437151
15x,180779525,contig_13,1,20660646,0.114286,99688680,0.551438
15x,180779525,scaffold_5,1,13112274,0.0725319,112800954,0.62397
15x,180779525,contig_25,1,9554231,0.0528502,122355185,0.67682
15x,180779525,contig_70,1,5270833,0.0291561,127626018,0.705976
15x,180779525,scaffold_92,1,3698915,0.0204609,131324933,0.726437
15x,180779525,contig_82,1,3662640,0.0202603,134987573,0.746697
15x,180779525,contig_14,1,3375514,0.018672,138363087,0.765369
15x,180779525,contig_17,1,3322200,0.0183771,141685287,0.783746
15x,180779525,scaffold_40,1,3146449,0.0174049,144831736,0.801151
15x,180779525,contig_59,1,3043540,0.0168356,147875276,0.817987
15x,180779525,contig_75,1,2866742,0.0158577,150742018,0.833845
15x,180779525,contig_60,1,1775486,0.00982128,152517504,0.843666
15x,180779525,scaffold_26,1,1425993,0.00788802,153943497,0.851554
15x,180779525,contig_6,1,1318930,0.00729579,155262427,0.85885
15x,180779525,contig_28,1,1318928,0.00729578,156581355,0.866145
15x,180779525,scaffold_23,1,1195905,0.00661527,157777260,0.872761
15x,180779525,contig_112,1,1134836,0.00627746,158912096,0.879038
15x,180779525,contig_51,1,1106536,0.00612091,160018632,0.885159
15x,180779525,contig_31,1,1057519,0.00584977,161076151,0.891009
15x,180779525,contig_83,1,1016993,0.0056256,162093144,0.896634
15x,180779525,contig_30,1,937797,0.00518752,163030941,0.901822
15x,180779525,contig_11,1,831546,0.00459978,163862487,0.906422
15x,180779525,contig_86,1,815957,0.00451355,164678444,0.910935
15x,180779525,contig_9,1,781986,0.00432563,165460430,0.915261
15x,180779525,contig_157,1,702515,0.00388603,166162945,0.919147
15x,180779525,scaffold_29,1,653725,0.00361615,166816670,0.922763
15x,180779525,contig_4,1,652232,0.00360789,167468902,0.926371
15x,180779525,contig_12,1,562879,0.00311362,168031781,0.929485
15x,180779525,contig_38,1,541239,0.00299392,168573020,0.932478
15x,180779525,contig_49,1,464634,0.00257017,169037654,0.935049
15x,180779525,contig_48,1,462076,0.00255602,169499730,0.937605
15x,180779525,contig_18,1,426016,0.00235655,169925746,0.939961
15x,180779525,contig_41,1,348546,0.00192802,170274292,0.941889
15x,180779525,contig_54,1,343651,0.00190094,170617943,0.94379
15x,180779525,contig_39,1,339936,0.00188039,170957879,0.945671
15x,180779525,scaffold_65,1,305304,0.00168882,171263183,0.947359
15x,180779525,contig_165,1,300407,0.00166173,171563590,0.949021
15x,180779525,contig_258,1,285350,0.00157844,171848940,0.9506
15x,180779525,contig_129,1,261735,0.00144781,172110675,0.952047
15x,180779525,contig_22,1,232496,0.00128607,172343171,0.953333
15x,180779525,contig_73,1,232325,0.00128513,172575496,0.954619
15x,180779525,contig_81,1,200554,0.00110938,172776050,0.955728
15x,180779525,contig_72,1,200286,0.0011079,172976336,0.956836
15x,180779525,contig_33,1,194064,0.00107348,173170400,0.957909
15x,180779525,contig_145,1,185322,0.00102513,173355722,0.958934
15x,180779525,contig_262,1,184534,0.00102077,173540256,0.959955
15x,180779525,contig_195,1,183017,0.00101238,173723273,0.960968
15x,180779525,contig_43,1,177773,0.000983369,173901046,0.961951
15x,180779525,contig_187,1,170504,0.00094316,174071550,0.962894
15x,180779525,contig_139,1,166512,0.000921078,174238062,0.963815
15x,180779525,contig_56,1,162597,0.000899422,174400659,0.964715
15x,180779525,contig_558,1,155268,0.00085888,174555927,0.965574
15x,180779525,contig_63,1,154584,0.000855097,174710511,0.966429
15x,180779525,contig_42,1,150261,0.000831184,174860772,0.96726
15x,180779525,contig_46,1,148948,0.000823921,175009720,0.968084
15x,180779525,contig_76,1,144963,0.000801877,175154683,0.968886
15x,180779525,contig_659,1,129132,0.000714307,175283815,0.9696
15x,180779525,contig_741,1,125636,0.000694968,175409451,0.970295
15x,180779525,contig_725,1,125059,0.000691776,175534510,0.970987
15x,180779525,contig_77,1,123906,0.000685398,175658416,0.971672
15x,180779525,contig_36,1,118625,0.000656186,175777041,0.972328
15x,180779525,contig_727,1,108290,0.000599017,175885331,0.972927
15x,180779525,contig_24,1,107336,0.00059374,175992667,0.973521
15x,180779525,contig_98,1,97182,0.000537572,176089849,0.974059
15x,180779525,contig_179,1,95681,0.000529269,176185530,0.974588
15x,180779525,contig_135,1,95139,0.000526271,176280669,0.975114
15x,180779525,contig_7,1,94438,0.000522393,176375107,0.975637
15x,180779525,contig_426,1,91957,0.000508669,176467064,0.976145
15x,180779525,contig_89,1,89114,0.000492943,176556178,0.976638
15x,180779525,contig_348,1,82625,0.000457048,176638803,0.977095
15x,180779525,contig_297,1,79026,0.00043714,176717829,0.977532
15x,180779525,contig_604,1,78751,0.000435619,176796580,0.977968
15x,180779525,contig_102,1,71489,0.000395449,176868069,0.978363
15x,180779525,contig_719,1,70321,0.000388988,176938390,0.978752
15x,180779525,contig_520,1,62805,0.000347412,177001195,0.9791
15x,180779525,contig_32,1,62213,0.000344137,177063408,0.979444
15x,180779525,contig_128,1,61983,0.000342865,177125391,0.979787
15x,180779525,contig_389,1,61560,0.000340525,177186951,0.980127
15x,180779525,contig_622,1,61204,0.000338556,177248155,0.980466
15x,180779525,contig_197,1,60079,0.000332333,177308234,0.980798
15x,180779525,contig_94,1,53986,0.000298629,177362220,0.981097
15x,180779525,contig_104,1,53202,0.000294292,177415422,0.981391
15x,180779525,contig_147,1,52395,0.000289828,177467817,0.981681
15x,180779525,contig_415,1,51466,0.000284689,177519283,0.981966
15x,180779525,contig_407,1,48083,0.000265976,177567366,0.982232
15x,180779525,contig_480,1,47973,0.000265367,177615339,0.982497
15x,180779525,contig_715,1,46989,0.000259924,177662328,0.982757
15x,180779525,contig_366,1,46385,0.000256583,177708713,0.983013
15x,180779525,contig_143,1,46165,0.000255366,177754878,0.983269
15x,180779525,contig_633,1,43944,0.000243081,177798822,0.983512
15x,180779525,contig_50,1,42562,0.000235436,177841384,0.983747
15x,180779525,contig_141,1,42032,0.000232504,177883416,0.98398
15x,180779525,contig_122,1,40555,0.000224334,177923971,0.984204
15x,180779525,contig_243,1,37705,0.000208569,177961676,0.984413
15x,180779525,contig_437,1,33354,0.000184501,177995030,0.984597
15x,180779525,contig_736,1,31619,0.000174904,178026649,0.984772
15x,180779525,contig_384,1,31400,0.000173692,178058049,0.984946
15x,180779525,scaffold_750,1,30421,0.000168277,178088470,0.985114
15x,180779525,contig_172,1,29571,0.000163575,178118041,0.985278
15x,180779525,contig_693,1,28728,0.000158912,178146769,0.985437
15x,180779525,contig_563,1,25914,0.000143346,178172683,0.98558
15x,180779525,contig_708,1,25497,0.000141039,178198180,0.985721
15x,180779525,contig_236,1,24501,0.00013553,178222681,0.985857
15x,180779525,contig_100,1,24014,0.000132836,178246695,0.985989
15x,180779525,contig_207,1,23618,0.000130645,178270313,0.98612
15x,180779525,contig_664,1,23484,0.000129904,178293797,0.98625
15x,180779525,contig_336,1,22591,0.000124964,178316388,0.986375
15x,180779525,contig_97,1,22188,0.000122735,178338576,0.986498
15x,180779525,contig_464,1,20989,0.000116103,178359565,0.986614
15x,180779525,contig_626,1,20311,0.000112352,178379876,0.986726
15x,180779525,contig_401,1,20058,0.000110953,178399934,0.986837
15x,180779525,contig_182,1,19337,0.000106965,178419271,0.986944
15x,180779525,contig_216,1,18934,0.000104735,178438205,0.987049
15x,180779525,contig_66,1,18066,9.99339e-05,178456271,0.987149
15x,180779525,contig_230,1,16875,9.33457e-05,178473146,0.987242
15x,180779525,contig_751,1,15215,8.41633e-05,178488361,0.987326
15x,180779525,contig_160,1,14482,8.01086e-05,178502843,0.987406
15x,180779525,contig_134,1,13669,7.56114e-05,178516512,0.987482
15x,180779525,contig_234,1,13567,7.50472e-05,178530079,0.987557
15x,180779525,contig_231,1,12845,7.10534e-05,178542924,0.987628
15x,180779525,contig_130,1,12823,7.09317e-05,178555747,0.987699
15x,180779525,contig_577,1,12294,6.80055e-05,178568041,0.987767
15x,180779525,contig_136,1,12091,6.68826e-05,178580132,0.987834
15x,180779525,contig_133,1,12053,6.66724e-05,178592185,0.987901
15x,180779525,contig_294,1,11786,6.51954e-05,178603971,0.987966
15x,180779525,contig_617,1,11535,6.3807e-05,178615506,0.98803
15x,180779525,contig_121,1,10515,5.81648e-05,178626021,0.988088
15x,180779525,contig_69,1,10471,5.79214e-05,178636492,0.988146
15x,180779525,contig_138,1,9776,5.40769e-05,178646268,0.9882
15x,180779525,contig_320,1,9717,5.37506e-05,178655985,0.988253
15x,180779525,contig_412,1,9623,5.32306e-05,178665608,0.988307
15x,180779525,contig_124,1,9602,5.31144e-05,178675210,0.98836
15x,180779525,contig_181,1,8995,4.97567e-05,178684205,0.98841
15x,180779525,contig_759,1,8526,4.71624e-05,178692731,0.988457
15x,180779525,contig_493,1,8333,4.60948e-05,178701064,0.988503
15x,180779525,contig_559,1,8255,4.56634e-05,178709319,0.988548
15x,180779525,contig_609,1,8210,4.54144e-05,178717529,0.988594
15x,180779525,contig_357,1,8133,4.49885e-05,178725662,0.988639
15x,180779525,contig_584,1,8042,4.44851e-05,178733704,0.988683
15x,180779525,contig_396,1,7777,4.30193e-05,178741481,0.988726
15x,180779525,contig_549,1,7673,4.2444e-05,178749154,0.988769
15x,180779525,contig_430,1,7565,4.18466e-05,178756719,0.988811
15x,180779525,contig_125,1,7552,4.17746e-05,178764271,0.988852
15x,180779525,contig_64,1,7118,3.93739e-05,178771389,0.988892
15x,180779525,contig_211,1,7061,3.90586e-05,178778450,0.988931
15x,180779525,contig_651,1,7034,3.89093e-05,178785484,0.98897
15x,180779525,contig_103,1,7007,3.87599e-05,178792491,0.989009
15x,180779525,contig_331,1,6892,3.81238e-05,178799383,0.989047
15x,180779525,contig_167,1,6852,3.79025e-05,178806235,0.989085
15x,180779525,contig_192,1,6744,3.73051e-05,178812979,0.989122
15x,180779525,contig_118,1,6710,3.7117e-05,178819689,0.989159
15x,180779525,contig_194,1,6229,3.44563e-05,178825918,0.989193
15x,180779525,contig_47,1,6198,3.42849e-05,178832116,0.989228
15x,180779525,contig_752,1,5982,3.309e-05,178838098,0.989261
15x,180779525,contig_385,1,5932,3.28135e-05,178844030,0.989294
15x,180779525,contig_191,1,5880,3.25258e-05,178849910,0.989326
15x,180779525,contig_226,1,5394,2.98374e-05,178855304,0.989356
15x,180779525,contig_588,1,5353,2.96107e-05,178860657,0.989386
15x,180779525,contig_146,1,5269,2.9146e-05,178865926,0.989415
15x,180779525,contig_16,1,5249,2.90354e-05,178871175,0.989444
15x,180779525,contig_213,1,5135,2.84048e-05,178876310,0.989472
15x,180779525,contig_707,1,5035,2.78516e-05,178881345,0.9895
15x,180779525,contig_91,1,4970,2.74921e-05,178886315,0.989528
15x,180779525,contig_694,1,4738,2.62087e-05,178891053,0.989554
15x,180779525,contig_619,1,4732,2.61755e-05,178895785,0.98958
15x,180779525,contig_451,1,4692,2.59543e-05,178900477,0.989606
15x,180779525,contig_649,1,4625,2.55836e-05,178905102,0.989631
15x,180779525,contig_161,1,4584,2.53569e-05,178909686,0.989657
15x,180779525,contig_369,1,4546,2.51467e-05,178914232,0.989682
15x,180779525,contig_93,1,4514,2.49696e-05,178918746,0.989707
15x,180779525,contig_99,1,4465,2.46986e-05,178923211,0.989732
15x,180779525,contig_87,1,4417,2.44331e-05,178927628,0.989756
15x,180779525,contig_222,1,4324,2.39186e-05,178931952,0.98978
15x,180779525,contig_466,1,4167,2.30502e-05,178936119,0.989803
15x,180779525,contig_519,1,4154,2.29783e-05,178940273,0.989826
15x,180779525,contig_421,1,4142,2.29119e-05,178944415,0.989849
15x,180779525,contig_489,1,4011,2.21872e-05,178948426,0.989871
15x,180779525,contig_757,1,3996,2.21043e-05,178952422,0.989893
15x,180779525,contig_279,1,3865,2.13796e-05,178956287,0.989915
15x,180779525,contig_501,1,3786,2.09426e-05,178960073,0.989936
15x,180779525,contig_465,1,3786,2.09426e-05,178963859,0.989956
15x,180779525,contig_247,1,3720,2.05776e-05,178967579,0.989977
15x,180779525,contig_599,1,3673,2.03176e-05,178971252,0.989997
15x,180779525,contig_627,1,3605,1.99414e-05,178974857,0.990017
15x,180779525,contig_590,1,3599,1.99082e-05,178978456,0.990037
15x,180779525,contig_756,1,3587,1.98418e-05,178982043,0.990057
15x,180779525,contig_748,1,3493,1.93219e-05,178985536,0.990076
15x,180779525,contig_155,1,3491,1.93108e-05,178989027,0.990096
15x,180779525,contig_666,1,3486,1.92832e-05,178992513,0.990115
15x,180779525,contig_606,1,3482,1.9261e-05,178995995,0.990134
15x,180779525,contig_726,1,3330,1.84202e-05,178999325,0.990153
15x,180779525,contig_507,1,3216,1.77896e-05,179002541,0.99017
15x,180779525,contig_524,1,3128,1.73028e-05,179005669,0.990188
15x,180779525,contig_475,1,3069,1.69765e-05,179008738,0.990205
15x,180779525,contig_443,1,3041,1.68216e-05,179011779,0.990222
15x,180779525,contig_210,1,3030,1.67607e-05,179014809,0.990238
15x,180779525,contig_137,1,3005,1.66225e-05,179017814,0.990255
15x,180779525,contig_647,1,2979,1.64786e-05,179020793,0.990271
15x,180779525,contig_738,1,2906,1.60748e-05,179023699,0.990287
15x,180779525,contig_392,1,2839,1.57042e-05,179026538,0.990303
15x,180779525,contig_455,1,2812,1.55549e-05,179029350,0.990319
15x,180779525,contig_704,1,2776,1.53557e-05,179032126,0.990334
15x,180779525,contig_342,1,2723,1.50625e-05,179034849,0.990349
15x,180779525,contig_711,1,2658,1.4703e-05,179037507,0.990364
15x,180779525,contig_463,1,2647,1.46421e-05,179040154,0.990378
15x,180779525,contig_209,1,2596,1.436e-05,179042750,0.990393
15x,180779525,contig_400,1,2559,1.41554e-05,179045309,0.990407
15x,180779525,contig_168,1,2483,1.3735e-05,179047792,0.990421
15x,180779525,contig_629,1,2409,1.33256e-05,179050201,0.990434
15x,180779525,contig_572,1,2395,1.32482e-05,179052596,0.990447
15x,180779525,contig_537,1,2364,1.30767e-05,179054960,0.99046
15x,180779525,contig_119,1,2300,1.27227e-05,179057260,0.990473
15x,180779525,contig_301,1,2288,1.26563e-05,179059548,0.990486
15x,180779525,contig_183,1,2278,1.2601e-05,179061826,0.990498
15x,180779525,contig_391,1,2207,1.22082e-05,179064033,0.990511
15x,180779525,contig_188,1,2176,1.20368e-05,179066209,0.990523
15x,180779525,contig_288,1,2088,1.155e-05,179068297,0.990534
15x,180779525,contig_645,1,2086,1.15389e-05,179070383,0.990546
15x,180779525,contig_457,1,2071,1.14559e-05,179072454,0.990557
15x,180779525,contig_419,1,2017,1.11572e-05,179074471,0.990568
15x,180779525,contig_315,1,2012,1.11296e-05,179076483,0.990579
15x,180779525,contig_386,1,2010,1.11185e-05,179078493,0.990591
15x,180779525,contig_276,1,1951,1.07922e-05,179080444,0.990601
15x,180779525,contig_201,1,1938,1.07202e-05,179082382,0.990612
15x,180779525,contig_672,1,1920,1.06207e-05,179084302,0.990623
15x,180779525,contig_703,1,1833,1.01394e-05,179086135,0.990633
15x,180779525,contig_598,1,1808,1.00011e-05,179087943,0.990643
15x,180779525,contig_422,1,1794,9.92369e-06,179089737,0.990653
15x,180779525,contig_753,1,1781,9.85178e-06,179091518,0.990663
15x,180779525,contig_57,1,1643,9.08842e-06,179093161,0.990672
15x,180779525,contig_521,1,1638,9.06076e-06,179094799,0.990681
15x,180779525,contig_762,1,1610,8.90588e-06,179096409,0.99069
15x,180779525,contig_62,1,1572,8.69568e-06,179097981,0.990698
15x,180779525,contig_223,1,1542,8.52973e-06,179099523,0.990707
15x,180779525,contig_544,1,1385,7.66127e-06,179100908,0.990715
15x,180779525,contig_534,1,1370,7.57829e-06,179102278,0.990722
15x,180779525,contig_680,1,1243,6.87578e-06,179103521,0.990729
15x,180779525,contig_454,1,1153,6.37793e-06,179104674,0.990735
15x,180779525,contig_424,1,1013,5.60351e-06,179105687,0.990741
15x,180779525,contig_522,1,1005,5.55926e-06,179106692,0.990747
15x,180779525,contig_459,1,941,5.20524e-06,179107633,0.990752
15x,180779525,contig_631,1,923,5.10567e-06,179108556,0.990757
15x,180779525,contig_163,1,866,4.79037e-06,179109422,0.990762
15x,180779525,contig_406,1,794,4.39209e-06,179110216,0.990766
15x,180779525,contig_593,1,626,3.46278e-06,179110842,0.99077
15x,180779525,contig_162,1,605,3.34662e-06,179111447,0.990773
15x,180779525,contig_610,1,561,3.10323e-06,179112008,0.990776
15x,180779525,contig_34,1,518,2.86537e-06,179112526,0.990779
25x,180779525,contig_19,1,32908869,0.182039,32908869,0.182039
25x,180779525,scaffold_2,1,29604507,0.16376,62513376,0.345799
25x,180779525,scaffold_31,1,24185131,0.133782,86698507,0.479581
25x,180779525,scaffold_194,1,21239791,0.11749,107938298,0.597071
25x,180779525,contig_6,1,18103893,0.100143,126042191,0.697215
25x,180779525,scaffold_90,1,6594192,0.0364764,132636383,0.733691
25x,180779525,contig_3,1,6531596,0.0361302,139167979,0.769822
25x,180779525,scaffold_694,1,4680841,0.0258925,143848820,0.795714
25x,180779525,contig_38,1,4519922,0.0250024,148368742,0.820717
25x,180779525,scaffold_4,1,4163966,0.0230334,152532708,0.84375
25x,180779525,contig_1,1,3063553,0.0169463,155596261,0.860696
25x,180779525,contig_13,1,3040166,0.016817,158636427,0.877513
25x,180779525,scaffold_80,1,2480129,0.0137191,161116556,0.891232
25x,180779525,contig_33,1,2251011,0.0124517,163367567,0.903684
25x,180779525,contig_10,1,1865254,0.0103178,165232821,0.914002
25x,180779525,contig_29,1,1432449,0.00792373,166665270,0.921926
25x,180779525,contig_25,1,979537,0.00541841,167644807,0.927344
25x,180779525,contig_30,1,886336,0.00490286,168531143,0.932247
25x,180779525,contig_35,1,843320,0.00466491,169374463,0.936912
25x,180779525,contig_39,1,767677,0.00424648,170142140,0.941158
25x,180779525,contig_55,1,712285,0.00394008,170854425,0.945098
25x,180779525,contig_57,1,708101,0.00391693,171562526,0.949015
25x,180779525,contig_8,1,647219,0.00358016,172209745,0.952595
25x,180779525,contig_642,1,579923,0.0032079,172789668,0.955803
25x,180779525,contig_52,1,528117,0.00292133,173317785,0.958725
25x,180779525,contig_20,1,488412,0.0027017,173806197,0.961426
25x,180779525,contig_222,1,387062,0.00214107,174193259,0.963567
25x,180779525,contig_48,1,363250,0.00200935,174556509,0.965577
25x,180779525,contig_161,1,341425,0.00188863,174897934,0.967465
25x,180779525,contig_86,1,292335,0.00161708,175190269,0.969082
25x,180779525,contig_53,1,208084,0.00115104,175398353,0.970234
25x,180779525,contig_70,1,187891,0.00103934,175586244,0.971273
25x,180779525,contig_28,1,186222,0.00103011,175772466,0.972303
25x,180779525,contig_32,1,185002,0.00102336,175957468,0.973326
25x,180779525,contig_125,1,175036,0.000968229,176132504,0.974295
25x,180779525,contig_145,1,173963,0.000962294,176306467,0.975257
25x,180779525,contig_45,1,157644,0.000872024,176464111,0.976129
25x,180779525,contig_159,1,114200,0.000631709,176578311,0.976761
25x,180779525,contig_447,1,113212,0.000626243,176691523,0.977387
25x,180779525,contig_72,1,112907,0.000624556,176804430,0.978011
25x,180779525,contig_15,1,109320,0.000604714,176913750,0.978616
25x,180779525,contig_363,1,108945,0.00060264,177022695,0.979219
25x,180779525,contig_250,1,105771,0.000585083,177128466,0.979804
25x,180779525,contig_258,1,90112,0.000498464,177218578,0.980302
25x,180779525,contig_49,1,88846,0.000491461,177307424,0.980794
25x,180779525,contig_803,1,87746,0.000485376,177395170,0.981279
25x,180779525,contig_14,1,87158,0.000482123,177482328,0.981761
25x,180779525,contig_65,1,75999,0.000420396,177558327,0.982182
25x,180779525,contig_265,1,73331,0.000405638,177631658,0.982587
25x,180779525,contig_176,1,73186,0.000404836,177704844,0.982992
25x,180779525,contig_225,1,71521,0.000395626,177776365,0.983388
25x,180779525,contig_811,1,64832,0.000358625,177841197,0.983746
25x,180779525,contig_187,1,64811,0.000358509,177906008,0.984105
25x,180779525,contig_71,1,60151,0.000332731,177966159,0.984438
25x,180779525,contig_54,1,56876,0.000314615,178023035,0.984752
25x,180779525,contig_62,1,54410,0.000300974,178077445,0.985053
25x,180779525,contig_133,1,53920,0.000298264,178131365,0.985351
25x,180779525,contig_126,1,50425,0.000278931,178181790,0.98563
25x,180779525,contig_529,1,50019,0.000276685,178231809,0.985907
25x,180779525,contig_296,1,49528,0.000273969,178281337,0.986181
25x,180779525,contig_372,1,48373,0.00026758,178329710,0.986449
25x,180779525,contig_719,1,48060,0.000265849,178377770,0.986714
25x,180779525,contig_115,1,42419,0.000234645,178420189,0.986949
25x,180779525,contig_43,1,40819,0.000225794,178461008,0.987175
25x,180779525,contig_670,1,38065,0.00021056,178499073,0.987385
25x,180779525,contig_522,1,34800,0.0001925,178533873,0.987578
25x,180779525,contig_123,1,33331,0.000184374,178567204,0.987762
25x,180779525,contig_661,1,32789,0.000181376,178599993,0.987944
25x,180779525,contig_67,1,30811,0.000170434,178630804,0.988114
25x,180779525,contig_813,1,28770,0.000159144,178659574,0.988273
25x,180779525,contig_404,1,28529,0.000157811,178688103,0.988431
25x,180779525,contig_60,1,27982,0.000154785,178716085,0.988586
25x,180779525,contig_534,1,25074,0.000138699,178741159,0.988725
25x,180779525,contig_367,1,25037,0.000138495,178766196,0.988863
25x,180779525,contig_537,1,24549,0.000135795,178790745,0.988999
25x,180779525,contig_400,1,23486,0.000129915,178814231,0.989129
25x,180779525,contig_252,1,22801,0.000126126,178837032,0.989255
25x,180779525,contig_753,1,21854,0.000120888,178858886,0.989376
25x,180779525,contig_531,1,21014,0.000116241,178879900,0.989492
25x,180779525,contig_528,1,20693,0.000114465,178900593,0.989606
25x,180779525,contig_812,1,20681,0.000114399,178921274,0.989721
25x,180779525,contig_87,1,19478,0.000107745,178940752,0.989829
25x,180779525,contig_757,1,19016,0.000105189,178959768,0.989934
25x,180779525,contig_310,1,18937,0.000104752,178978705,0.990039
25x,180779525,contig_110,1,18114,0.000100199,178996819,0.990139
25x,180779525,contig_563,1,18002,9.95799e-05,179014821,0.990238
25x,180779525,contig_461,1,17515,9.6886e-05,179032336,0.990335
25x,180779525,contig_779,1,17451,9.65319e-05,179049787,0.990432
25x,180779525,contig_160,1,16952,9.37717e-05,179066739,0.990526
25x,180779525,contig_112,1,16769,9.27594e-05,179083508,0.990618
25x,180779525,contig_325,1,16754,9.26764e-05,179100262,0.990711
25x,180779525,contig_494,1,16480,9.11608e-05,179116742,0.990802
25x,180779525,contig_91,1,15846,8.76537e-05,179132588,0.99089
25x,180779525,contig_497,1,15337,8.48381e-05,179147925,0.990975
25x,180779525,contig_422,1,14980,8.28634e-05,179162905,0.991058
25x,180779525,contig_490,1,14639,8.09771e-05,179177544,0.991138
25x,180779525,contig_104,1,14104,7.80177e-05,179191648,0.991216
25x,180779525,contig_96,1,13789,7.62752e-05,179205437,0.991293
25x,180779525,contig_309,1,13716,7.58714e-05,179219153,0.991369
25x,180779525,contig_213,1,13030,7.20767e-05,179232183,0.991441
25x,180779525,contig_806,1,12946,7.16121e-05,179245129,0.991512
25x,180779525,contig_174,1,12860,7.11364e-05,179257989,0.991583
25x,180779525,contig_664,1,12828,7.09594e-05,179270817,0.991654
25x,180779525,contig_181,1,12759,7.05777e-05,179283576,0.991725
25x,180779525,contig_323,1,12380,6.84812e-05,179295956,0.991793
25x,180779525,contig_173,1,12110,6.69877e-05,179308066,0.99186
25x,180779525,contig_9,1,11009,6.08974e-05,179319075,0.991921
25x,180779525,contig_357,1,10467,5.78993e-05,179329542,0.991979
25x,180779525,contig_74,1,9648,5.33689e-05,179339190,0.992033
25x,180779525,contig_127,1,9252,5.11784e-05,179348442,0.992084
25x,180779525,contig_77,1,9052,5.0072e-05,179357494,0.992134
25x,180779525,contig_18,1,9037,4.99891e-05,179366531,0.992184
25x,180779525,contig_329,1,9006,4.98176e-05,179375537,0.992234
25x,180779525,contig_802,1,8944,4.94746e-05,179384481,0.992283
25x,180779525,contig_445,1,8657,4.78871e-05,179393138,0.992331
25x,180779525,contig_217,1,8490,4.69633e-05,179401628,0.992378
25x,180779525,contig_84,1,8367,4.62829e-05,179409995,0.992424
25x,180779525,contig_215,1,8348,4.61778e-05,179418343,0.99247
25x,180779525,contig_443,1,8174,4.52153e-05,179426517,0.992516
25x,180779525,contig_99,1,8144,4.50493e-05,179434661,0.992561
25x,180779525,contig_302,1,8013,4.43247e-05,179442674,0.992605
25x,180779525,contig_182,1,7571,4.18797e-05,179450245,0.992647
25x,180779525,contig_78,1,7482,4.13874e-05,179457727,0.992688
25x,180779525,contig_783,1,7192,3.97833e-05,179464919,0.992728
25x,180779525,contig_734,1,7177,3.97003e-05,179472096,0.992768
25x,180779525,contig_169,1,7102,3.92854e-05,179479198,0.992807
25x,180779525,contig_142,1,6981,3.86161e-05,179486179,0.992846
25x,180779525,contig_381,1,6900,3.8168e-05,179493079,0.992884
25x,180779525,contig_368,1,6899,3.81625e-05,179499978,0.992922
25x,180779525,contig_121,1,6787,3.7543e-05,179506765,0.99296
25x,180779525,contig_620,1,6720,3.71724e-05,179513485,0.992997
25x,180779525,contig_85,1,6663,3.68571e-05,179520148,0.993034
25x,180779525,contig_264,1,6385,3.53193e-05,179526533,0.993069
25x,180779525,contig_331,1,6379,3.52861e-05,179532912,0.993104
25x,180779525,contig_266,1,6325,3.49874e-05,179539237,0.993139
25x,180779525,contig_580,1,6258,3.46168e-05,179545495,0.993174
25x,180779525,contig_184,1,6190,3.42406e-05,179551685,0.993208
25x,180779525,contig_42,1,6169,3.41244e-05,179557854,0.993242
25x,180779525,contig_124,1,6163,3.40913e-05,179564017,0.993276
25x,180779525,contig_292,1,6086,3.36653e-05,179570103,0.99331
25x,180779525,contig_535,1,6054,3.34883e-05,179576157,0.993343
25x,180779525,contig_158,1,5945,3.28854e-05,179582102,0.993376
25x,180779525,contig_151,1,5886,3.2559e-05,179587988,0.993409
25x,180779525,contig_256,1,5880,3.25258e-05,179593868,0.993441
25x,180779525,contig_828,1,5873,3.24871e-05,179599741,0.993474
25x,180779525,contig_156,1,5629,3.11374e-05,179605370,0.993505
25x,180779525,contig_560,1,5523,3.0551e-05,179610893,0.993536
25x,180779525,contig_212,1,5423,2.99979e-05,179616316,0.993566
25x,180779525,contig_554,1,5345,2.95664e-05,179621661,0.993595
25x,180779525,contig_513,1,5327,2.94668e-05,179626988,0.993625
25x,180779525,contig_189,1,5294,2.92843e-05,179632282,0.993654
25x,180779525,contig_138,1,5229,2.89247e-05,179637511,0.993683
25x,180779525,contig_345,1,5194,2.87311e-05,179642705,0.993712
25x,180779525,contig_721,1,5101,2.82167e-05,179647806,0.99374
25x,180779525,contig_533,1,5036,2.78571e-05,179652842,0.993768
25x,180779525,contig_83,1,5027,2.78074e-05,179657869,0.993795
25x,180779525,contig_97,1,5022,2.77797e-05,179662891,0.993823
25x,180779525,contig_344,1,5011,2.77188e-05,179667902,0.993851
25x,180779525,contig_505,1,4973,2.75086e-05,179672875,0.993878
25x,180779525,contig_234,1,4949,2.73759e-05,179677824,0.993906
25x,180779525,contig_572,1,4944,2.73482e-05,179682768,0.993933
25x,180779525,contig_373,1,4839,2.67674e-05,179687607,0.99396
25x,180779525,contig_318,1,4773,2.64023e-05,179692380,0.993986
25x,180779525,contig_220,1,4725,2.61368e-05,179697105,0.994012
25x,180779525,contig_185,1,4723,2.61257e-05,179701828,0.994039
25x,180779525,contig_66,1,4656,2.57551e-05,179706484,0.994064
25x,180779525,contig_321,1,4590,2.539e-05,179711074,0.99409
25x,180779525,contig_370,1,4561,2.52296e-05,179715635,0.994115
25x,180779525,contig_541,1,4507,2.49309e-05,179720142,0.99414
25x,180779525,contig_221,1,4473,2.47428e-05,179724615,0.994165
25x,180779525,contig_492,1,4470,2.47263e-05,179729085,0.994189
25x,180779525,contig_446,1,4428,2.44939e-05,179733513,0.994214
25x,180779525,contig_351,1,4381,2.42339e-05,179737894,0.994238
25x,180779525,contig_107,1,4376,2.42063e-05,179742270,0.994262
25x,180779525,contig_391,1,4373,2.41897e-05,179746643,0.994287
25x,180779525,contig_689,1,4361,2.41233e-05,179751004,0.994311
25x,180779525,contig_40,1,4352,2.40735e-05,179755356,0.994335
25x,180779525,contig_56,1,4345,2.40348e-05,179759701,0.994359
25x,180779525,contig_716,1,4334,2.3974e-05,179764035,0.994383
25x,180779525,contig_799,1,4299,2.37803e-05,179768334,0.994406
25x,180779525,contig_685,1,4234,2.34208e-05,179772568,0.99443
25x,180779525,contig_240,1,4226,2.33765e-05,179776794,0.994453
25x,180779525,contig_285,1,4176,2.31e-05,179780970,0.994476
25x,180779525,contig_686,1,4175,2.30944e-05,179785145,0.994499
25x,180779525,contig_283,1,4088,2.26132e-05,179789233,0.994522
25x,180779525,contig_574,1,4059,2.24528e-05,179793292,0.994545
25x,180779525,contig_122,1,4019,2.22315e-05,179797311,0.994567
25x,180779525,contig_299,1,3992,2.20821e-05,179801303,0.994589
25x,180779525,contig_278,1,3838,2.12303e-05,179805141,0.99461
25x,180779525,contig_36,1,3758,2.07878e-05,179808899,0.994631
25x,180779525,contig_105,1,3710,2.05222e-05,179812609,0.994651
25x,180779525,contig_801,1,3610,1.99691e-05,179816219,0.994671
25x,180779525,contig_451,1,3609,1.99635e-05,179819828,0.994691
25x,180779525,contig_254,1,3577,1.97865e-05,179823405,0.994711
25x,180779525,contig_69,1,3573,1.97644e-05,179826978,0.994731
25x,180779525,contig_316,1,3565,1.97202e-05,179830543,0.994751
25x,180779525,contig_558,1,3553,1.96538e-05,179834096,0.99477
25x,180779525,contig_238,1,3516,1.94491e-05,179837612,0.99479
25x,180779525,contig_291,1,3511,1.94214e-05,179841123,0.994809
25x,180779525,contig_180,1,3510,1.94159e-05,179844633,0.994829
25x,180779525,contig_239,1,3472,1.92057e-05,179848105,0.994848
25x,180779525,contig_79,1,3364,1.86083e-05,179851469,0.994866
25x,180779525,contig_770,1,3340,1.84755e-05,179854809,0.994885
25x,180779525,contig_166,1,3333,1.84368e-05,179858142,0.994903
25x,180779525,contig_635,1,3331,1.84258e-05,179861473,0.994922
25x,180779525,contig_359,1,3309,1.83041e-05,179864782,0.99494
25x,180779525,contig_134,1,3290,1.8199e-05,179868072,0.994958
25x,180779525,contig_300,1,3243,1.7939e-05,179871315,0.994976
25x,180779525,contig_493,1,3228,1.7856e-05,179874543,0.994994
25x,180779525,contig_263,1,3207,1.77398e-05,179877750,0.995012
25x,180779525,contig_371,1,3004,1.66169e-05,179880754,0.995028
25x,180779525,contig_411,1,2946,1.62961e-05,179883700,0.995045
25x,180779525,contig_675,1,2945,1.62906e-05,179886645,0.995061
25x,180779525,contig_473,1,2932,1.62187e-05,179889577,0.995077
25x,180779525,contig_687,1,2925,1.61799e-05,179892502,0.995093
25x,180779525,contig_487,1,2845,1.57374e-05,179895347,0.995109
25x,180779525,contig_397,1,2821,1.56046e-05,179898168,0.995125
25x,180779525,contig_408,1,2790,1.54332e-05,179900958,0.99514
25x,180779525,contig_566,1,2769,1.5317e-05,179903727,0.995155
25x,180779525,contig_470,1,2713,1.50072e-05,179906440,0.99517
25x,180779525,contig_290,1,2674,1.47915e-05,179909114,0.995185
25x,180779525,contig_306,1,2668,1.47583e-05,179911782,0.9952
25x,180779525,contig_646,1,2620,1.44928e-05,179914402,0.995214
25x,180779525,contig_832,1,2589,1.43213e-05,179916991,0.995229
25x,180779525,contig_515,1,2575,1.42439e-05,179919566,0.995243
25x,180779525,contig_729,1,2516,1.39175e-05,179922082,0.995257
25x,180779525,contig_479,1,2401,1.32814e-05,179924483,0.99527
25x,180779525,contig_267,1,2400,1.32758e-05,179926883,0.995284
25x,180779525,contig_632,1,2260,1.25014e-05,179929143,0.995296
25x,180779525,contig_544,1,2222,1.22912e-05,179931365,0.995308
25x,180779525,contig_244,1,2220,1.22802e-05,179933585,0.995321
25x,180779525,contig_617,1,2194,1.21363e-05,179935779,0.995333
25x,180779525,contig_150,1,2190,1.21142e-05,179937969,0.995345
25x,180779525,contig_790,1,2154,1.19151e-05,179940123,0.995357
25x,180779525,contig_506,1,2105,1.1644e-05,179942228,0.995368
25x,180779525,contig_782,1,2102,1.16274e-05,179944330,0.99538
25x,180779525,contig_399,1,2047,1.13232e-05,179946377,0.995391
25x,180779525,contig_454,1,2036,1.12623e-05,179948413,0.995403
25x,180779525,contig_704,1,2002,1.10743e-05,179950415,0.995414
25x,180779525,contig_475,1,1996,1.10411e-05,179952411,0.995425
25x,180779525,contig_157,1,1876,1.03773e-05,179954287,0.995435
25x,180779525,contig_356,1,1871,1.03496e-05,179956158,0.995445
25x,180779525,contig_491,1,1807,9.9956e-06,179957965,0.995455
25x,180779525,contig_482,1,1796,9.93475e-06,179959761,0.995465
25x,180779525,contig_585,1,1769,9.7854e-06,179961530,0.995475
25x,180779525,contig_248,1,1759,9.73008e-06,179963289,0.995485
25x,180779525,contig_223,1,1739,9.61945e-06,179965028,0.995495
25x,180779525,contig_352,1,1709,9.4535e-06,179966737,0.995504
25x,180779525,contig_465,1,1548,8.56292e-06,179968285,0.995513
25x,180779525,contig_677,1,1536,8.49654e-06,179969821,0.995521
25x,180779525,contig_791,1,1485,8.21443e-06,179971306,0.995529
25x,180779525,contig_797,1,1437,7.94891e-06,179972743,0.995537
25x,180779525,contig_449,1,1366,7.55617e-06,179974109,0.995545
25x,180779525,contig_128,1,1340,7.41234e-06,179975449,0.995552
25x,180779525,contig_281,1,1264,6.99194e-06,179976713,0.995559
25x,180779525,contig_615,1,1240,6.85918e-06,179977953,0.995566
25x,180779525,contig_637,1,1234,6.82599e-06,179979187,0.995573
25x,180779525,contig_233,1,1218,6.73749e-06,179980405,0.99558
25x,180779525,contig_775,1,1157,6.40006e-06,179981562,0.995586
25x,180779525,contig_625,1,1153,6.37793e-06,179982715,0.995592
25x,180779525,contig_444,1,1145,6.33368e-06,179983860,0.995599
25x,180779525,contig_314,1,1130,6.25071e-06,179984990,0.995605
25x,180779525,contig_407,1,1113,6.15667e-06,179986103,0.995611
25x,180779525,contig_328,1,1082,5.98519e-06,179987185,0.995617
25x,180779525,contig_382,1,1081,5.97966e-06,179988266,0.995623
25x,180779525,contig_519,1,1067,5.90222e-06,179989333,0.995629
25x,180779525,contig_603,1,973,5.38225e-06,179990306,0.995634
25x,180779525,contig_343,1,883,4.8844e-06,179991189,0.995639
25x,180779525,contig_622,1,867,4.7959e-06,179992056,0.995644
25x,180779525,contig_589,1,856,4.73505e-06,179992912,0.995649
25x,180779525,contig_621,1,844,4.66867e-06,179993756,0.995653
25x,180779525,contig_396,1,824,4.55804e-06,179994580,0.995658
25x,180779525,contig_380,1,814,4.50272e-06,179995394,0.995663
25x,180779525,contig_590,1,812,4.49166e-06,179996206,0.995667
25x,180779525,contig_442,1,811,4.48613e-06,179997017,0.995671
25x,180779525,contig_693,1,775,4.28699e-06,179997792,0.995676
25x,180779525,contig_722,1,747,4.13211e-06,179998539,0.99568
25x,180779525,contig_743,1,714,3.94956e-06,179999253,0.995684
25x,180779525,contig_742,1,684,3.78361e-06,179999937,0.995688
25x,180779525,contig_736,1,653,3.61213e-06,180000590,0.995691
25x,180779525,contig_170,1,630,3.48491e-06,180001220,0.995695
25x,180779525,contig_690,1,613,3.39087e-06,180001833,0.995698
25x,180779525,contig_301,1,597,3.30237e-06,180002430,0.995701
25x,180779525,contig_501,1,570,3.15301e-06,180003000,0.995705
25x,180779525,contig_155,1,561,3.10323e-06,180003561,0.995708
25x,180779525,contig_754,1,544,3.00919e-06,180004105,0.995711
25x,180779525,contig_144,1,534,2.95387e-06,180004639,0.995714
25x,180779525,contig_232,1,532,2.94281e-06,180005171,0.995717
25x,180779525,contig_641,1,522,2.8875e-06,180005693,0.995719
25x,180779525,contig_480,1,513,2.83771e-06,180006206,0.995722
25x,180779525,contig_459,1,512,2.83218e-06,180006718,0.995725
20x,180779525,contig_15,1,33210766,0.183709,33210766,0.183709
20x,180779525,scaffold_16,1,29368275,0.162454,62579041,0.346162
20x,180779525,scaffold_4,1,25922276,0.143392,88501317,0.489554
20x,180779525,scaffold_709,1,25564400,0.141412,114065717,0.630966
20x,180779525,scaffold_47,1,18063143,0.0999181,132128860,0.730884
20x,180779525,scaffold_9,1,4087121,0.0226083,136215981,0.753492
20x,180779525,contig_25,1,3545798,0.0196139,139761779,0.773106
20x,180779525,contig_5,1,3377187,0.0186812,143138966,0.791787
20x,180779525,scaffold_3,1,3152312,0.0174373,146291278,0.809225
20x,180779525,contig_34,1,3033275,0.0167789,149324553,0.826004
20x,180779525,contig_7,1,2644689,0.0146294,151969242,0.840633
20x,180779525,scaffold_77,1,2228188,0.0123254,154197430,0.852958
20x,180779525,contig_8,1,1961221,0.0108487,156158651,0.863807
20x,180779525,scaffold_97,1,1679470,0.00929016,157838121,0.873097
20x,180779525,contig_32,1,1623337,0.00897965,159461458,0.882077
20x,180779525,contig_139,1,1603754,0.00887133,161065212,0.890948
20x,180779525,scaffold_437,1,1405439,0.00777433,162470651,0.898723
20x,180779525,scaffold_31,1,1381981,0.00764457,163852632,0.906367
20x,180779525,contig_58,1,1150209,0.0063625,165002841,0.91273
20x,180779525,contig_40,1,1004950,0.00555898,166007791,0.918289
20x,180779525,contig_45,1,834549,0.00461639,166842340,0.922905
20x,180779525,contig_55,1,831315,0.0045985,167673655,0.927504
20x,180779525,contig_20,1,803984,0.00444732,168477639,0.931951
20x,180779525,contig_21,1,677827,0.00374947,169155466,0.9357
20x,180779525,contig_46,1,649716,0.00359397,169805182,0.939294
20x,180779525,contig_23,1,634630,0.00351052,170439812,0.942805
20x,180779525,contig_13,1,597432,0.00330475,171037244,0.94611
20x,180779525,contig_37,1,592202,0.00327582,171629446,0.949385
20x,180779525,contig_27,1,506949,0.00280424,172136395,0.95219
20x,180779525,contig_39,1,420412,0.00232555,172556807,0.954515
20x,180779525,contig_657,1,374914,0.00207387,172931721,0.956589
20x,180779525,contig_805,1,292051,0.00161551,173223772,0.958205
20x,180779525,contig_14,1,290090,0.00160466,173513862,0.959809
20x,180779525,contig_22,1,234205,0.00129553,173748067,0.961105
20x,180779525,contig_75,1,232201,0.00128444,173980268,0.962389
20x,180779525,contig_418,1,224267,0.00124056,174204535,0.96363
20x,180779525,contig_17,1,214284,0.00118533,174418819,0.964815
20x,180779525,contig_129,1,204620,0.00113188,174623439,0.965947
20x,180779525,contig_234,1,202181,0.00111838,174825620,0.967065
20x,180779525,contig_56,1,184993,0.00102331,175010613,0.968089
20x,180779525,contig_592,1,160148,0.000885875,175170761,0.968975
20x,180779525,contig_233,1,159001,0.00087953,175329762,0.969854
20x,180779525,contig_124,1,153166,0.000847253,175482928,0.970701
20x,180779525,contig_115,1,148506,0.000821476,175631434,0.971523
20x,180779525,contig_57,1,144738,0.000800633,175776172,0.972323
20x,180779525,contig_141,1,117524,0.000650096,175893696,0.972974
20x,180779525,contig_464,1,103120,0.000570419,175996816,0.973544
20x,180779525,contig_674,1,99177,0.000548607,176095993,0.974093
20x,180779525,contig_594,1,96003,0.00053105,176191996,0.974624
20x,180779525,contig_67,1,94806,0.000524429,176286802,0.975148
20x,180779525,contig_118,1,92884,0.000513797,176379686,0.975662
20x,180779525,contig_199,1,90947,0.000503082,176470633,0.976165
20x,180779525,contig_194,1,83364,0.000461136,176553997,0.976626
20x,180779525,contig_236,1,82269,0.000455079,176636266,0.977081
20x,180779525,contig_44,1,79478,0.00043964,176715744,0.977521
20x,180779525,contig_19,1,78652,0.000435071,176794396,0.977956
20x,180779525,contig_218,1,78329,0.000433285,176872725,0.978389
20x,180779525,contig_413,1,77529,0.000428859,176950254,0.978818
20x,180779525,contig_100,1,75337,0.000416734,177025591,0.979235
20x,180779525,contig_62,1,68529,0.000379075,177094120,0.979614
20x,180779525,contig_52,1,67682,0.00037439,177161802,0.979988
20x,180779525,contig_201,1,65335,0.000361407,177227137,0.98035
20x,180779525,contig_540,1,60560,0.000334994,177287697,0.980685
20x,180779525,contig_456,1,59122,0.000327039,177346819,0.981012
20x,180779525,contig_169,1,54710,0.000302634,177401529,0.981314
20x,180779525,contig_698,1,53842,0.000297832,177455371,0.981612
20x,180779525,contig_246,1,51908,0.000287134,177507279,0.981899
20x,180779525,contig_69,1,51104,0.000282687,177558383,0.982182
20x,180779525,contig_514,1,48818,0.000270042,177607201,0.982452
20x,180779525,contig_520,1,47764,0.000264211,177654965,0.982716
20x,180779525,contig_164,1,47071,0.000260378,177702036,0.982977
20x,180779525,contig_128,1,45067,0.000249293,177747103,0.983226
20x,180779525,contig_83,1,43576,0.000241045,177790679,0.983467
20x,180779525,contig_153,1,43342,0.000239751,177834021,0.983707
20x,180779525,contig_494,1,43245,0.000239214,177877266,0.983946
20x,180779525,contig_125,1,42645,0.000235895,177919911,0.984182
20x,180779525,contig_68,1,41855,0.000231525,177961766,0.984413
20x,180779525,contig_338,1,41787,0.000231149,178003553,0.984644
20x,180779525,contig_652,1,40996,0.000226773,178044549,0.984871
20x,180779525,contig_282,1,39461,0.000218282,178084010,0.985089
20x,180779525,contig_74,1,39212,0.000216905,178123222,0.985306
20x,180779525,contig_535,1,38801,0.000214632,178162023,0.985521
20x,180779525,contig_684,1,37617,0.000208082,178199640,0.985729
20x,180779525,contig_428,1,36481,0.000201798,178236121,0.985931
20x,180779525,contig_353,1,35293,0.000195227,178271414,0.986126
20x,180779525,contig_756,1,33938,0.000187731,178305352,0.986314
20x,180779525,contig_135,1,33764,0.000186769,178339116,0.986501
20x,180779525,contig_759,1,33482,0.000185209,178372598,0.986686
20x,180779525,contig_184,1,29799,0.000164836,178402397,0.986851
20x,180779525,contig_48,1,29311,0.000162137,178431708,0.987013
20x,180779525,contig_356,1,28947,0.000160123,178460655,0.987173
20x,180779525,contig_171,1,28562,0.000157994,178489217,0.987331
20x,180779525,contig_335,1,27641,0.000152899,178516858,0.987484
20x,180779525,contig_214,1,26880,0.000148689,178543738,0.987633
20x,180779525,contig_530,1,26012,0.000143888,178569750,0.987776
20x,180779525,contig_161,1,25246,0.000139651,178594996,0.987916
20x,180779525,contig_391,1,24594,0.000136044,178619590,0.988052
20x,180779525,contig_351,1,23609,0.000130596,178643199,0.988183
20x,180779525,contig_263,1,20998,0.000116153,178664197,0.988299
20x,180779525,contig_18,1,20659,0.000114277,178684856,0.988413
20x,180779525,contig_737,1,20039,0.000110848,178704895,0.988524
20x,180779525,contig_103,1,19398,0.000107302,178724293,0.988631
20x,180779525,contig_621,1,18554,0.000102633,178742847,0.988734
20x,180779525,contig_84,1,17908,9.90599e-05,178760755,0.988833
20x,180779525,contig_662,1,16421,9.08344e-05,178777176,0.988924
20x,180779525,contig_269,1,15263,8.44288e-05,178792439,0.989008
20x,180779525,contig_65,1,15088,8.34608e-05,178807527,0.989092
20x,180779525,contig_232,1,15057,8.32893e-05,178822584,0.989175
20x,180779525,contig_434,1,14702,8.13256e-05,178837286,0.989256
20x,180779525,contig_470,1,14494,8.0175e-05,178851780,0.989336
20x,180779525,contig_235,1,14135,7.81892e-05,178865915,0.989415
20x,180779525,contig_183,1,13713,7.58548e-05,178879628,0.989491
20x,180779525,contig_508,1,12955,7.16619e-05,178892583,0.989562
20x,180779525,contig_327,1,12851,7.10866e-05,178905434,0.989633
20x,180779525,contig_537,1,12508,6.91893e-05,178917942,0.989702
20x,180779525,contig_451,1,12185,6.74025e-05,178930127,0.98977
20x,180779525,contig_92,1,11461,6.33977e-05,178941588,0.989833
20x,180779525,contig_49,1,10715,5.92711e-05,178952303,0.989893
20x,180779525,contig_788,1,10168,5.62453e-05,178962471,0.989949
20x,180779525,contig_187,1,10030,5.54819e-05,178972501,0.990004
20x,180779525,contig_366,1,9853,5.45029e-05,178982354,0.990059
20x,180779525,scaffold_300,1,9189,5.08299e-05,178991543,0.99011
20x,180779525,contig_556,1,8913,4.93031e-05,179000456,0.990159
20x,180779525,contig_82,1,8712,4.81913e-05,179009168,0.990207
20x,180779525,contig_498,1,8347,4.61723e-05,179017515,0.990253
20x,180779525,contig_137,1,8343,4.61501e-05,179025858,0.990299
20x,180779525,contig_190,1,8174,4.52153e-05,179034032,0.990345
20x,180779525,contig_324,1,8128,4.49608e-05,179042160,0.99039
20x,180779525,contig_529,1,8006,4.4286e-05,179050166,0.990434
20x,180779525,contig_404,1,7864,4.35005e-05,179058030,0.990477
20x,180779525,contig_152,1,7745,4.28422e-05,179065775,0.99052
20x,180779525,contig_435,1,7565,4.18466e-05,179073340,0.990562
20x,180779525,contig_76,1,7562,4.183e-05,179080902,0.990604
20x,180779525,contig_352,1,7166,3.96394e-05,179088068,0.990644
20x,180779525,contig_151,1,7146,3.95288e-05,179095214,0.990683
20x,180779525,contig_165,1,7014,3.87986e-05,179102228,0.990722
20x,180779525,contig_318,1,7005,3.87489e-05,179109233,0.990761
20x,180779525,contig_198,1,6970,3.85553e-05,179116203,0.990799
20x,180779525,contig_367,1,6902,3.81791e-05,179123105,0.990837
20x,180779525,contig_600,1,6852,3.79025e-05,179129957,0.990875
20x,180779525,contig_101,1,6765,3.74213e-05,179136722,0.990913
20x,180779525,contig_274,1,6720,3.71724e-05,179143442,0.99095
20x,180779525,contig_384,1,6675,3.69234e-05,179150117,0.990987
20x,180779525,contig_798,1,6477,3.58282e-05,179156594,0.991023
20x,180779525,contig_244,1,6470,3.57895e-05,179163064,0.991058
20x,180779525,contig_317,1,6320,3.49597e-05,179169384,0.991093
20x,180779525,contig_186,1,6158,3.40636e-05,179175542,0.991127
20x,180779525,contig_608,1,6149,3.40138e-05,179181691,0.991161
20x,180779525,contig_584,1,6136,3.39419e-05,179187827,0.991195
20x,180779525,contig_653,1,6100,3.37428e-05,179193927,0.991229
20x,180779525,contig_155,1,5921,3.27526e-05,179199848,0.991262
20x,180779525,contig_487,1,5908,3.26807e-05,179205756,0.991295
20x,180779525,contig_331,1,5879,3.25203e-05,179211635,0.991327
20x,180779525,contig_221,1,5851,3.23654e-05,179217486,0.991359
20x,180779525,contig_638,1,5818,3.21828e-05,179223304,0.991392
20x,180779525,contig_511,1,5662,3.13199e-05,179228966,0.991423
20x,180779525,contig_496,1,5644,3.12203e-05,179234610,0.991454
20x,180779525,contig_405,1,5630,3.11429e-05,179240240,0.991485
20x,180779525,contig_763,1,5520,3.05344e-05,179245760,0.991516
20x,180779525,contig_704,1,5470,3.02579e-05,179251230,0.991546
20x,180779525,contig_262,1,5394,2.98374e-05,179256624,0.991576
20x,180779525,contig_553,1,5314,2.93949e-05,179261938,0.991605
20x,180779525,contig_654,1,5158,2.8532e-05,179267096,0.991634
20x,180779525,contig_714,1,5088,2.81448e-05,179272184,0.991662
20x,180779525,contig_762,1,5067,2.80286e-05,179277251,0.99169
20x,180779525,contig_291,1,5062,2.8001e-05,179282313,0.991718
20x,180779525,contig_454,1,5037,2.78627e-05,179287350,0.991746
20x,180779525,contig_249,1,5019,2.77631e-05,179292369,0.991774
20x,180779525,contig_533,1,4979,2.75418e-05,179297348,0.991801
20x,180779525,contig_742,1,4971,2.74976e-05,179302319,0.991829
20x,180779525,contig_132,1,4927,2.72542e-05,179307246,0.991856
20x,180779525,contig_409,1,4917,2.71989e-05,179312163,0.991883
20x,180779525,contig_377,1,4788,2.64853e-05,179316951,0.99191
20x,180779525,contig_303,1,4706,2.60317e-05,179321657,0.991936
20x,180779525,contig_134,1,4667,2.5816e-05,179326324,0.991961
20x,180779525,contig_663,1,4652,2.5733e-05,179330976,0.991987
20x,180779525,contig_170,1,4579,2.53292e-05,179335555,0.992013
20x,180779525,contig_363,1,4572,2.52905e-05,179340127,0.992038
20x,180779525,contig_340,1,4529,2.50526e-05,179344656,0.992063
20x,180779525,contig_411,1,4478,2.47705e-05,179349134,0.992088
20x,180779525,contig_394,1,4471,2.47318e-05,179353605,0.992112
20x,180779525,contig_619,1,4466,2.47041e-05,179358071,0.992137
20x,180779525,contig_497,1,4456,2.46488e-05,179362527,0.992162
20x,180779525,contig_260,1,4455,2.46433e-05,179366982,0.992186
20x,180779525,contig_748,1,4384,2.42505e-05,179371366,0.992211
20x,180779525,contig_590,1,4384,2.42505e-05,179375750,0.992235
20x,180779525,contig_156,1,4384,2.42505e-05,179380134,0.992259
20x,180779525,contig_306,1,4346,2.40403e-05,179384480,0.992283
20x,180779525,contig_604,1,4325,2.39242e-05,179388805,0.992307
20x,180779525,contig_733,1,4235,2.34263e-05,179393040,0.992331
20x,180779525,contig_667,1,4143,2.29174e-05,179397183,0.992353
20x,180779525,contig_461,1,4142,2.29119e-05,179401325,0.992376
20x,180779525,contig_87,1,4059,2.24528e-05,179405384,0.992399
20x,180779525,contig_729,1,4051,2.24085e-05,179409435,0.992421
20x,180779525,contig_419,1,4022,2.22481e-05,179413457,0.992443
20x,180779525,contig_450,1,3812,2.10865e-05,179417269,0.992465
20x,180779525,contig_321,1,3722,2.05886e-05,179420991,0.992485
20x,180779525,contig_720,1,3706,2.05001e-05,179424697,0.992506
20x,180779525,contig_627,1,3605,1.99414e-05,179428302,0.992526
20x,180779525,contig_640,1,3598,1.99027e-05,179431900,0.992545
20x,180779525,contig_598,1,3589,1.98529e-05,179435489,0.992565
20x,180779525,contig_334,1,3521,1.94768e-05,179439010,0.992585
20x,180779525,contig_289,1,3489,1.92998e-05,179442499,0.992604
20x,180779525,contig_606,1,3488,1.92942e-05,179445987,0.992623
20x,180779525,contig_189,1,3366,1.86194e-05,179449353,0.992642
20x,180779525,contig_479,1,3345,1.85032e-05,179452698,0.992661
20x,180779525,contig_466,1,3276,1.81215e-05,179455974,0.992679
20x,180779525,contig_806,1,3266,1.80662e-05,179459240,0.992697
20x,180779525,contig_61,1,3241,1.79279e-05,179462481,0.992715
20x,180779525,contig_323,1,3221,1.78173e-05,179465702,0.992732
20x,180779525,contig_99,1,3213,1.7773e-05,179468915,0.99275
20x,180779525,contig_700,1,3123,1.72752e-05,179472038,0.992768
20x,180779525,contig_738,1,3068,1.69709e-05,179475106,0.992784
20x,180779525,contig_144,1,2974,1.6451e-05,179478080,0.992801
20x,180779525,contig_722,1,2947,1.63016e-05,179481027,0.992817
20x,180779525,contig_672,1,2932,1.62187e-05,179483959,0.992833
20x,180779525,contig_721,1,2881,1.59365e-05,179486840,0.992849
20x,180779525,contig_690,1,2807,1.55272e-05,179489647,0.992865
20x,180779525,contig_658,1,2772,1.53336e-05,179492419,0.99288
20x,180779525,contig_126,1,2770,1.53225e-05,179495189,0.992896
20x,180779525,contig_541,1,2678,1.48136e-05,179497867,0.99291
20x,180779525,contig_764,1,2668,1.47583e-05,179500535,0.992925
20x,180779525,contig_476,1,2650,1.46587e-05,179503185,0.99294
20x,180779525,contig_196,1,2642,1.46145e-05,179505827,0.992954
20x,180779525,contig_433,1,2616,1.44707e-05,179508443,0.992969
20x,180779525,contig_680,1,2580,1.42715e-05,179511023,0.992983
20x,180779525,contig_160,1,2551,1.41111e-05,179513574,0.992997
20x,180779525,contig_311,1,2399,1.32703e-05,179515973,0.993011
20x,180779525,contig_320,1,2372,1.3121e-05,179518345,0.993024
20x,180779525,contig_337,1,2346,1.29771e-05,179520691,0.993037
20x,180779525,contig_491,1,2290,1.26674e-05,179522981,0.993049
20x,180779525,contig_373,1,2206,1.22027e-05,179525187,0.993062
20x,180779525,contig_770,1,2202,1.21806e-05,179527389,0.993074
20x,180779525,contig_354,1,2195,1.21419e-05,179529584,0.993086
20x,180779525,contig_782,1,2190,1.21142e-05,179531774,0.993098
20x,180779525,contig_397,1,2157,1.19317e-05,179533931,0.99311
20x,180779525,contig_693,1,2049,1.13342e-05,179535980,0.993121
20x,180779525,contig_645,1,2006,1.10964e-05,179537986,0.993132
20x,180779525,contig_519,1,2001,1.10687e-05,179539987,0.993143
20x,180779525,contig_191,1,1992,1.10189e-05,179541979,0.993154
20x,180779525,contig_768,1,1971,1.09028e-05,179543950,0.993165
20x,180779525,contig_465,1,1863,1.03054e-05,179545813,0.993176
20x,180779525,contig_38,1,1810,1.00122e-05,179547623,0.993186
20x,180779525,contig_651,1,1802,9.96794e-06,179549425,0.993196
20x,180779525,contig_462,1,1801,9.96241e-06,179551226,0.993206
20x,180779525,contig_561,1,1744,9.64711e-06,179552970,0.993215
20x,180779525,contig_209,1,1738,9.61392e-06,179554708,0.993225
20x,180779525,contig_429,1,1731,9.5752e-06,179556439,0.993234
20x,180779525,contig_677,1,1654,9.14927e-06,179558093,0.993244
20x,180779525,contig_284,1,1651,9.13267e-06,179559744,0.993253
20x,180779525,contig_326,1,1642,9.08289e-06,179561386,0.993262
20x,180779525,contig_716,1,1553,8.59057e-06,179562939,0.99327
20x,180779525,contig_525,1,1553,8.59057e-06,179564492,0.993279
20x,180779525,contig_477,1,1507,8.33612e-06,179565999,0.993287
20x,180779525,contig_243,1,1507,8.33612e-06,179567506,0.993296
20x,180779525,contig_807,1,1454,8.04295e-06,179568960,0.993304
20x,180779525,contig_292,1,1439,7.95997e-06,179570399,0.993312
20x,180779525,contig_109,1,1381,7.63914e-06,179571780,0.993319
20x,180779525,contig_185,1,1367,7.5617e-06,179573147,0.993327
20x,180779525,contig_140,1,1361,7.52851e-06,179574508,0.993334
20x,180779525,contig_713,1,1346,7.44553e-06,179575854,0.993342
20x,180779525,contig_213,1,1235,6.83153e-06,179577089,0.993349
20x,180779525,contig_573,1,1218,6.73749e-06,179578307,0.993355
20x,180779525,contig_734,1,1213,6.70983e-06,179579520,0.993362
20x,180779525,contig_345,1,1202,6.64898e-06,179580722,0.993369
20x,180779525,contig_238,1,1181,6.53282e-06,179581903,0.993375
20x,180779525,contig_572,1,1173,6.48857e-06,179583076,0.993382
20x,180779525,contig_286,1,1161,6.42219e-06,179584237,0.993388
20x,180779525,contig_208,1,1112,6.15114e-06,179585349,0.993394
20x,180779525,contig_611,1,998,5.52054e-06,179586347,0.9934
20x,180779525,contig_108,1,997,5.51501e-06,179587344,0.993405
20x,180779525,contig_131,1,940,5.1997e-06,179588284,0.993411
20x,180779525,contig_273,1,917,5.07248e-06,179589201,0.993416
20x,180779525,contig_575,1,847,4.68527e-06,179590048,0.99342
20x,180779525,contig_632,1,846,4.67973e-06,179590894,0.993425
20x,180779525,contig_792,1,836,4.62442e-06,179591730,0.99343
20x,180779525,contig_412,1,718,3.97169e-06,179592448,0.993434
20x,180779525,contig_448,1,695,3.84446e-06,179593143,0.993437
20x,180779525,contig_687,1,681,3.76702e-06,179593824,0.993441
20x,180779525,contig_339,1,648,3.58448e-06,179594472,0.993445
20x,180779525,contig_686,1,606,3.35215e-06,179595078,0.993448
20x,180779525,contig_773,1,591,3.26918e-06,179595669,0.993451
20x,180779525,contig_71,1,590,3.26364e-06,179596259,0.993455
20x,180779525,contig_231,1,590,3.26364e-06,179596849,0.993458
20x,180779525,contig_597,1,585,3.23599e-06,179597434,0.993461
20x,180779525,contig_789,1,531,2.93728e-06,179597965,0.993464
20x,180779525,contig_801,1,530,2.93175e-06,179598495,0.993467
20x,180779525,contig_567,1,511,2.82665e-06,179599006,0.99347
20x,180779525,contig_564,1,469,2.59432e-06,179599475,0.993472
20x,180779525,contig_63,1,461,2.55007e-06,179599936,0.993475
10x,180779525,scaffold_43,1,21448225,0.118643,21448225,0.118643
10x,180779525,scaffold_33,1,17445592,0.096502,38893817,0.215145
10x,180779525,scaffold_63,1,14356979,0.0794171,53250796,0.294562
10x,180779525,scaffold_70,1,7600592,0.0420434,60851388,0.336606
10x,180779525,scaffold_39,1,7048452,0.0389892,67899840,0.375595
10x,180779525,contig_37,1,6028614,0.0333479,73928454,0.408943
10x,180779525,contig_45,1,4693965,0.0259651,78622419,0.434908
10x,180779525,contig_1,1,4607099,0.0254846,83229518,0.460392
10x,180779525,contig_18,1,4172669,0.0230815,87402187,0.483474
10x,180779525,scaffold_382,1,3351947,0.0185416,90754134,0.502016
10x,180779525,contig_6,1,3139411,0.017366,93893545,0.519382
10x,180779525,scaffold_580,1,3137600,0.0173559,97031145,0.536737
10x,180779525,scaffold_670,1,2966348,0.0164087,99997493,0.553146
10x,180779525,scaffold_122,1,2734815,0.0151279,102732308,0.568274
10x,180779525,contig_108,1,2628701,0.0145409,105361009,0.582815
10x,180779525,contig_53,1,2611580,0.0144462,107972589,0.597261
10x,180779525,contig_38,1,2597471,0.0143682,110570060,0.611629
10x,180779525,contig_80,1,2557438,0.0141467,113127498,0.625776
10x,180779525,scaffold_176,1,2309917,0.0127775,115437415,0.638554
10x,180779525,contig_21,1,2238664,0.0123834,117676079,0.650937
10x,180779525,contig_365,1,2073088,0.0114675,119749167,0.662404
10x,180779525,contig_10,1,1896040,0.0104881,121645207,0.672893
10x,180779525,contig_133,1,1825471,0.0100978,123470678,0.68299
10x,180779525,contig_91,1,1774110,0.00981367,125244788,0.692804
10x,180779525,contig_3,1,1684301,0.00931688,126929089,0.702121
10x,180779525,contig_125,1,1656334,0.00916218,128585423,0.711283
10x,180779525,contig_78,1,1589140,0.00879049,130174563,0.720074
10x,180779525,contig_24,1,1554499,0.00859887,131729062,0.728672
10x,180779525,contig_129,1,1488972,0.0082364,133218034,0.736909
10x,180779525,scaffold_47,1,1477596,0.00817347,134695630,0.745082
10x,180779525,scaffold_67,1,1462504,0.00808999,136158134,0.753172
10x,180779525,contig_205,1,1460437,0.00807855,137618571,0.761251
10x,180779525,contig_66,1,1429290,0.00790626,139047861,0.769157
10x,180779525,scaffold_32,1,1342449,0.00742589,140390310,0.776583
10x,180779525,contig_22,1,1328964,0.0073513,141719274,0.783934
10x,180779525,contig_19,1,1283068,0.00709742,143002342,0.791032
10x,180779525,contig_159,1,1153271,0.00637943,144155613,0.797411
10x,180779525,contig_28,1,1107191,0.00612454,145262804,0.803536
10x,180779525,contig_72,1,1065437,0.00589357,146328241,0.809429
10x,180779525,contig_130,1,1052367,0.00582127,147380608,0.815251
10x,180779525,contig_149,1,972631,0.00538021,148353239,0.820631
10x,180779525,contig_737,1,875614,0.00484355,149228853,0.825474
10x,180779525,contig_25,1,859168,0.00475257,150088021,0.830227
10x,180779525,contig_58,1,847440,0.0046877,150935461,0.834915
10x,180779525,contig_34,1,801356,0.00443278,151736817,0.839347
10x,180779525,contig_194,1,764759,0.00423034,152501576,0.843578
10x,180779525,contig_5,1,763382,0.00422272,153264958,0.8478
10x,180779525,contig_44,1,709172,0.00392286,153974130,0.851723
10x,180779525,contig_435,1,677246,0.00374625,154651376,0.85547
10x,180779525,contig_4,1,664126,0.00367368,155315502,0.859143
10x,180779525,contig_180,1,628130,0.00347456,155943632,0.862618
10x,180779525,contig_27,1,612395,0.00338752,156556027,0.866005
10x,180779525,contig_197,1,584503,0.00323324,157140530,0.869239
10x,180779525,contig_52,1,533681,0.00295211,157674211,0.872191
10x,180779525,contig_212,1,519993,0.00287639,158194204,0.875067
10x,180779525,contig_61,1,517391,0.002862,158711595,0.877929
10x,180779525,contig_142,1,474255,0.00262339,159185850,0.880552
10x,180779525,contig_30,1,470468,0.00260244,159656318,0.883155
10x,180779525,contig_127,1,460454,0.00254705,160116772,0.885702
10x,180779525,scaffold_79,1,437699,0.00242118,160554471,0.888123
10x,180779525,contig_169,1,414405,0.00229232,160968876,0.890415
10x,180779525,contig_116,1,413658,0.00228819,161382534,0.892704
10x,180779525,contig_8,1,401176,0.00221915,161783710,0.894923
10x,180779525,contig_528,1,397854,0.00220077,162181564,0.897124
10x,180779525,contig_126,1,380899,0.00210698,162562463,0.899231
10x,180779525,contig_55,1,362059,0.00200277,162924522,0.901233
10x,180779525,contig_68,1,357334,0.00197663,163281856,0.90321
10x,180779525,contig_29,1,336612,0.001862,163618468,0.905072
10x,180779525,contig_73,1,336314,0.00186035,163954782,0.906932
10x,180779525,contig_337,1,334141,0.00184833,164288923,0.908781
10x,180779525,contig_105,1,327501,0.0018116,164616424,0.910592
10x,180779525,contig_60,1,324275,0.00179376,164940699,0.912386
10x,180779525,contig_207,1,323922,0.00179181,165264621,0.914178
10x,180779525,contig_138,1,301145,0.00166581,165565766,0.915844
10x,180779525,contig_186,1,290559,0.00160726,165856325,0.917451
10x,180779525,scaffold_17,1,276795,0.00153112,166133120,0.918982
10x,180779525,contig_315,1,244696,0.00135356,166377816,0.920336
10x,180779525,contig_69,1,241158,0.00133399,166618974,0.921669
10x,180779525,scaffold_83,1,239594,0.00132534,166858568,0.922995
10x,180779525,contig_111,1,234059,0.00129472,167092627,0.92429
10x,180779525,contig_241,1,225458,0.00124714,167318085,0.925537
10x,180779525,contig_445,1,216411,0.0011971,167534496,0.926734
10x,180779525,contig_156,1,212356,0.00117467,167746852,0.927908
10x,180779525,contig_26,1,206674,0.00114324,167953526,0.929052
10x,180779525,contig_7,1,199729,0.00110482,168153255,0.930157
10x,180779525,contig_154,1,196853,0.00108891,168350108,0.931245
10x,180779525,contig_282,1,182411,0.00100902,168532519,0.932254
10x,180779525,contig_118,1,181184,0.00100224,168713703,0.933257
10x,180779525,contig_95,1,177207,0.000980238,168890910,0.934237
10x,180779525,contig_74,1,174458,0.000965032,169065368,0.935202
10x,180779525,contig_64,1,172561,0.000954538,169237929,0.936157
10x,180779525,contig_93,1,172277,0.000952967,169410206,0.937109
10x,180779525,contig_774,1,171479,0.000948553,169581685,0.938058
10x,180779525,contig_342,1,170930,0.000945516,169752615,0.939004
10x,180779525,contig_143,1,163646,0.000905224,169916261,0.939909
10x,180779525,contig_82,1,161861,0.00089535,170078122,0.940804
10x,180779525,contig_98,1,160666,0.00088874,170238788,0.941693
10x,180779525,scaffold_250,1,160198,0.000886151,170398986,0.942579
10x,180779525,contig_145,1,156493,0.000865657,170555479,0.943445
10x,180779525,contig_62,1,151185,0.000836295,170706664,0.944281
10x,180779525,contig_600,1,149236,0.000825514,170855900,0.945106
10x,180779525,contig_71,1,138257,0.000764782,170994157,0.945871
10x,180779525,contig_208,1,137933,0.00076299,171132090,0.946634
10x,180779525,contig_408,1,134210,0.000742396,171266300,0.947377
10x,180779525,contig_41,1,132691,0.000733994,171398991,0.948111
10x,180779525,contig_144,1,132216,0.000731366,171531207,0.948842
10x,180779525,contig_590,1,130722,0.000723102,171661929,0.949565
10x,180779525,contig_193,1,124039,0.000686134,171785968,0.950251
10x,180779525,contig_56,1,124028,0.000686073,171909996,0.950937
10x,180779525,contig_160,1,123636,0.000683905,172033632,0.951621
10x,180779525,contig_13,1,121446,0.000671791,172155078,0.952293
10x,180779525,contig_292,1,118020,0.000652839,172273098,0.952946
10x,180779525,contig_217,1,106737,0.000590426,172379835,0.953536
10x,180779525,contig_312,1,100145,0.000553962,172479980,0.95409
10x,180779525,contig_766,1,96581,0.000534247,172576561,0.954624
10x,180779525,contig_137,1,94204,0.000521099,172670765,0.955146
10x,180779525,contig_485,1,93152,0.00051528,172763917,0.955661
10x,180779525,contig_134,1,92452,0.000511407,172856369,0.956172
10x,180779525,contig_798,1,90645,0.000501412,172947014,0.956674
10x,180779525,contig_308,1,90123,0.000498524,173037137,0.957172
10x,180779525,contig_683,1,87306,0.000482942,173124443,0.957655
10x,180779525,contig_210,1,87047,0.000481509,173211490,0.958137
10x,180779525,contig_35,1,86324,0.00047751,173297814,0.958614
10x,180779525,contig_327,1,86124,0.000476404,173383938,0.959091
10x,180779525,contig_23,1,81975,0.000453453,173465913,0.959544
10x,180779525,contig_184,1,79516,0.000439851,173545429,0.959984
10x,180779525,contig_249,1,78324,0.000433257,173623753,0.960417
10x,180779525,contig_191,1,75281,0.000416424,173699034,0.960834
10x,180779525,contig_15,1,73584,0.000407037,173772618,0.961241
10x,180779525,contig_224,1,73488,0.000406506,173846106,0.961647
10x,180779525,contig_76,1,73114,0.000404437,173919220,0.962052
10x,180779525,contig_157,1,71492,0.000395465,173990712,0.962447
10x,180779525,contig_258,1,68973,0.000381531,174059685,0.962829
10x,180779525,contig_151,1,65815,0.000364062,174125500,0.963193
10x,180779525,contig_433,1,63136,0.000349243,174188636,0.963542
10x,180779525,contig_682,1,62251,0.000344348,174250887,0.963886
10x,180779525,contig_88,1,59828,0.000330945,174310715,0.964217
10x,180779525,contig_378,1,59573,0.000329534,174370288,0.964547
10x,180779525,contig_139,1,57197,0.000316391,174427485,0.964863
10x,180779525,contig_367,1,54839,0.000303347,174482324,0.965166
10x,180779525,contig_649,1,52891,0.000292572,174535215,0.965459
10x,180779525,contig_760,1,49379,0.000273145,174584594,0.965732
10x,180779525,contig_343,1,48912,0.000270562,174633506,0.966003
10x,180779525,contig_346,1,48119,0.000266175,174681625,0.966269
10x,180779525,contig_185,1,46624,0.000257905,174728249,0.966527
10x,180779525,contig_211,1,46559,0.000257546,174774808,0.966784
10x,180779525,contig_195,1,46219,0.000255665,174821027,0.96704
10x,180779525,contig_309,1,44052,0.000243678,174865079,0.967284
10x,180779525,contig_119,1,43900,0.000242837,174908979,0.967526
10x,180779525,contig_460,1,40137,0.000222022,174949116,0.967749
10x,180779525,contig_221,1,39419,0.00021805,174988535,0.967967
10x,180779525,contig_222,1,38606,0.000213553,175027141,0.96818
10x,180779525,contig_366,1,36294,0.000200764,175063435,0.968381
10x,180779525,contig_676,1,34420,0.000190398,175097855,0.968571
10x,180779525,contig_233,1,33899,0.000187516,175131754,0.968759
10x,180779525,contig_331,1,33468,0.000185132,175165222,0.968944
10x,180779525,contig_565,1,33079,0.00018298,175198301,0.969127
10x,180779525,contig_107,1,32502,0.000179788,175230803,0.969307
10x,180779525,contig_190,1,32237,0.000178322,175263040,0.969485
10x,180779525,contig_602,1,31315,0.000173222,175294355,0.969658
10x,180779525,contig_219,1,30728,0.000169975,175325083,0.969828
10x,180779525,contig_835,1,30408,0.000168205,175355491,0.969996
10x,180779525,contig_112,1,29642,0.000163968,175385133,0.97016
10x,180779525,contig_100,1,29023,0.000160544,175414156,0.970321
10x,180779525,contig_674,1,27796,0.000153756,175441952,0.970475
10x,180779525,contig_410,1,27154,0.000150205,175469106,0.970625
10x,180779525,contig_363,1,25575,0.000141471,175494681,0.970766
10x,180779525,contig_281,1,23893,0.000132167,175518574,0.970899
10x,180779525,contig_551,1,22837,0.000126325,175541411,0.971025
10x,180779525,contig_339,1,21751,0.000120318,175563162,0.971145
10x,180779525,contig_577,1,21123,0.000116844,175584285,0.971262
10x,180779525,contig_303,1,20096,0.000111163,175604381,0.971373
10x,180779525,contig_189,1,18257,0.00010099,175622638,0.971474
10x,180779525,contig_801,1,17322,9.58184e-05,175639960,0.97157
10x,180779525,contig_90,1,17291,9.56469e-05,175657251,0.971666
10x,180779525,contig_178,1,16877,9.33568e-05,175674128,0.971759
10x,180779525,contig_326,1,15911,8.80133e-05,175690039,0.971847
10x,180779525,contig_474,1,15805,8.74269e-05,175705844,0.971934
10x,180779525,contig_347,1,15046,8.32285e-05,175720890,0.972018
10x,180779525,contig_584,1,13707,7.58216e-05,175734597,0.972093
10x,180779525,contig_244,1,13647,7.54897e-05,175748244,0.972169
10x,180779525,contig_279,1,12948,7.16232e-05,175761192,0.972241
10x,180779525,contig_615,1,12843,7.10423e-05,175774035,0.972312
10x,180779525,contig_251,1,12724,7.03841e-05,175786759,0.972382
10x,180779525,contig_175,1,12068,6.67553e-05,175798827,0.972449
10x,180779525,contig_810,1,11973,6.62298e-05,175810800,0.972515
10x,180779525,contig_261,1,11438,6.32704e-05,175822238,0.972578
10x,180779525,contig_187,1,10670,5.90222e-05,175832908,0.972637
10x,180779525,contig_328,1,10440,5.77499e-05,175843348,0.972695
10x,180779525,contig_51,1,10080,5.57585e-05,175853428,0.972751
10x,180779525,contig_654,1,9793,5.4171e-05,175863221,0.972805
10x,180779525,contig_417,1,9793,5.4171e-05,175873014,0.972859
10x,180779525,contig_117,1,9648,5.33689e-05,175882662,0.972913
10x,180779525,contig_552,1,9595,5.30757e-05,175892257,0.972966
10x,180779525,contig_177,1,9275,5.13056e-05,175901532,0.973017
10x,180779525,contig_448,1,8869,4.90598e-05,175910401,0.973066
10x,180779525,contig_446,1,8546,4.72731e-05,175918947,0.973113
10x,180779525,contig_320,1,8366,4.62774e-05,175927313,0.97316
10x,180779525,contig_253,1,8219,4.54642e-05,175935532,0.973205
10x,180779525,contig_393,1,8182,4.52596e-05,175943714,0.97325
10x,180779525,contig_288,1,8135,4.49996e-05,175951849,0.973295
10x,180779525,contig_226,1,8116,4.48945e-05,175959965,0.97334
10x,180779525,contig_216,1,7920,4.38103e-05,175967885,0.973384
10x,180779525,contig_645,1,7807,4.31852e-05,175975692,0.973427
10x,180779525,contig_259,1,7789,4.30856e-05,175983481,0.97347
10x,180779525,contig_304,1,7479,4.13708e-05,175990960,0.973512
10x,180779525,contig_334,1,7348,4.06462e-05,175998308,0.973552
10x,180779525,contig_425,1,7301,4.03862e-05,176005609,0.973593
10x,180779525,contig_182,1,7112,3.93407e-05,176012721,0.973632
10x,180779525,contig_296,1,7097,3.92578e-05,176019818,0.973671
10x,180779525,contig_146,1,7077,3.91471e-05,176026895,0.97371
10x,180779525,contig_273,1,7010,3.87765e-05,176033905,0.973749
10x,180779525,contig_20,1,6921,3.82842e-05,176040826,0.973787
10x,180779525,contig_729,1,6883,3.8074e-05,176047709,0.973825
10x,180779525,contig_96,1,6551,3.62375e-05,176054260,0.973862
10x,180779525,contig_170,1,6547,3.62154e-05,176060807,0.973898
10x,180779525,contig_712,1,6371,3.52418e-05,176067178,0.973933
10x,180779525,contig_426,1,6153,3.40359e-05,176073331,0.973967
10x,180779525,contig_277,1,6096,3.37206e-05,176079427,0.974001
10x,180779525,contig_666,1,5885,3.25535e-05,176085312,0.974033
10x,180779525,contig_839,1,5798,3.20722e-05,176091110,0.974066
10x,180779525,contig_381,1,5491,3.0374e-05,176096601,0.974096
10x,180779525,contig_499,1,5409,2.99204e-05,176102010,0.974126
10x,180779525,contig_248,1,5285,2.92345e-05,176107295,0.974155
10x,180779525,contig_752,1,5088,2.81448e-05,176112383,0.974183
10x,180779525,contig_732,1,4985,2.7575e-05,176117368,0.974211
10x,180779525,contig_202,1,4968,2.7481e-05,176122336,0.974238
10x,180779525,contig_470,1,4672,2.58436e-05,176127008,0.974264
10x,180779525,contig_696,1,4633,2.56279e-05,176131641,0.97429
10x,180779525,contig_201,1,4596,2.54232e-05,176136237,0.974315
10x,180779525,contig_188,1,4579,2.53292e-05,176140816,0.974341
10x,180779525,contig_374,1,4576,2.53126e-05,176145392,0.974366
10x,180779525,contig_534,1,4547,2.51522e-05,176149939,0.974391
10x,180779525,contig_298,1,4506,2.49254e-05,176154445,0.974416
10x,180779525,contig_637,1,4470,2.47263e-05,176158915,0.974441
10x,180779525,contig_220,1,4445,2.4588e-05,176163360,0.974465
10x,180779525,contig_493,1,4436,2.45382e-05,176167796,0.97449
10x,180779525,contig_399,1,4431,2.45105e-05,176172227,0.974514
10x,180779525,contig_815,1,4395,2.43114e-05,176176622,0.974539
10x,180779525,contig_646,1,4314,2.38633e-05,176180936,0.974562
10x,180779525,contig_659,1,4238,2.34429e-05,176185174,0.974586
10x,180779525,contig_728,1,4095,2.26519e-05,176189269,0.974609
10x,180779525,contig_398,1,4087,2.26076e-05,176193356,0.974631
10x,180779525,contig_523,1,4031,2.22979e-05,176197387,0.974653
10x,180779525,contig_546,1,3962,2.19162e-05,176201349,0.974675
10x,180779525,contig_389,1,3933,2.17558e-05,176205282,0.974697
10x,180779525,contig_576,1,3732,2.06439e-05,176209014,0.974718
10x,180779525,contig_478,1,3649,2.01848e-05,176212663,0.974738
10x,180779525,contig_792,1,3600,1.99138e-05,176216263,0.974758
10x,180779525,contig_517,1,3590,1.98584e-05,176219853,0.974778
10x,180779525,contig_274,1,3583,1.98197e-05,176223436,0.974798
10x,180779525,contig_514,1,3576,1.9781e-05,176227012,0.974817
10x,180779525,contig_227,1,3527,1.951e-05,176230539,0.974837
10x,180779525,contig_574,1,3490,1.93053e-05,176234029,0.974856
10x,180779525,contig_319,1,3490,1.93053e-05,176237519,0.974875
10x,180779525,contig_825,1,3431,1.89789e-05,176240950,0.974894
10x,180779525,contig_121,1,3381,1.87023e-05,176244331,0.974913
10x,180779525,contig_318,1,3316,1.83428e-05,176247647,0.974931
10x,180779525,contig_476,1,3274,1.81105e-05,176250921,0.97495
10x,180779525,contig_245,1,3203,1.77177e-05,176254124,0.974967
10x,180779525,contig_387,1,3136,1.73471e-05,176257260,0.974985
10x,180779525,contig_749,1,3016,1.66833e-05,176260276,0.975001
10x,180779525,contig_192,1,2993,1.65561e-05,176263269,0.975018
10x,180779525,contig_564,1,2979,1.64786e-05,176266248,0.975034
10x,180779525,contig_636,1,2969,1.64233e-05,176269217,0.975051
10x,180779525,contig_556,1,2929,1.62021e-05,176272146,0.975067
10x,180779525,contig_430,1,2915,1.61246e-05,176275061,0.975083
10x,180779525,contig_291,1,2647,1.46421e-05,176277708,0.975098
10x,180779525,contig_770,1,2587,1.43102e-05,176280295,0.975112
10x,180779525,contig_275,1,2505,1.38567e-05,176282800,0.975126
10x,180779525,contig_232,1,2312,1.27891e-05,176285112,0.975139
10x,180779525,contig_704,1,2267,1.25401e-05,176287379,0.975151
10x,180779525,contig_482,1,2241,1.23963e-05,176289620,0.975164
10x,180779525,contig_164,1,2225,1.23078e-05,176291845,0.975176
10x,180779525,contig_101,1,2196,1.21474e-05,176294041,0.975188
10x,180779525,contig_673,1,2187,1.20976e-05,176296228,0.9752
10x,180779525,contig_716,1,2124,1.17491e-05,176298352,0.975212
10x,180779525,contig_322,1,2103,1.1633e-05,176300455,0.975224
10x,180779525,contig_793,1,2025,1.12015e-05,176302480,0.975235
10x,180779525,contig_605,1,2009,1.1113e-05,176304489,0.975246
10x,180779525,contig_123,1,1951,1.07922e-05,176306440,0.975257
10x,180779525,contig_392,1,1785,9.87391e-06,176308225,0.975267
10x,180779525,contig_413,1,1693,9.365e-06,176309918,0.975276
10x,180779525,contig_89,1,1668,9.22671e-06,176311586,0.975285
10x,180779525,contig_153,1,1668,9.22671e-06,176313254,0.975294
10x,180779525,contig_773,1,1639,9.06629e-06,176314893,0.975303
10x,180779525,contig_377,1,1562,8.64036e-06,176316455,0.975312
10x,180779525,contig_757,1,1542,8.52973e-06,176317997,0.975321
10x,180779525,contig_632,1,1540,8.51866e-06,176319537,0.975329
10x,180779525,contig_763,1,1407,7.78296e-06,176320944,0.975337
10x,180779525,contig_612,1,1347,7.45107e-06,176322291,0.975344
10x,180779525,contig_823,1,1321,7.30724e-06,176323612,0.975352
10x,180779525,contig_265,1,1250,6.9145e-06,176324862,0.975359
10x,180779525,contig_717,1,1214,6.71536e-06,176326076,0.975365
10x,180779525,contig_518,1,1159,6.41112e-06,176327235,0.975372
10x,180779525,contig_411,1,1109,6.13454e-06,176328344,0.975378
10x,180779525,contig_199,1,1007,5.57032e-06,176329351,0.975383
10x,180779525,contig_437,1,875,4.84015e-06,176330226,0.975388
10x,180779525,contig_655,1,859,4.75164e-06,176331085,0.975393
10x,180779525,contig_415,1,858,4.74611e-06,176331943,0.975398
10x,180779525,contig_513,1,812,4.49166e-06,176332755,0.975402
10x,180779525,contig_394,1,783,4.33124e-06,176333538,0.975407
10x,180779525,contig_789,1,772,4.2704e-06,176334310,0.975411
10x,180779525,contig_731,1,753,4.16529e-06,176335063,0.975415
10x,180779525,contig_628,1,749,4.14317e-06,176335812,0.975419
10x,180779525,contig_400,1,721,3.98828e-06,176336533,0.975423
10x,180779525,contig_640,1,696,3.84999e-06,176337229,0.975427
10x,180779525,contig_236,1,656,3.62873e-06,176337885,0.975431
10x,180779525,contig_743,1,655,3.6232e-06,176338540,0.975434
10x,180779525,contig_549,1,617,3.413e-06,176339157,0.975438
10x,180779525,contig_527,1,534,2.95387e-06,176339691,0.975441
10x,180779525,contig_596,1,511,2.82665e-06,176340202,0.975443
10x,180779525,contig_136,1,216,1.19483e-06,176340418,0.975445
fulldata,180779525,contig_14,1,33532604,0.185489,33532604,0.185489
fulldata,180779525,scaffold_8,1,25974357,0.14368,59506961,0.329169
fulldata,180779525,contig_3,1,24809320,0.137235,84316281,0.466404
fulldata,180779525,contig_12,1,24670947,0.13647,108987228,0.602874
fulldata,180779525,scaffold_5,1,24310728,0.134477,133297956,0.737351
fulldata,180779525,contig_2,1,6533225,0.0361392,139831181,0.77349
fulldata,180779525,contig_19,1,5313860,0.0293941,145145041,0.802884
fulldata,180779525,contig_51,1,4873004,0.0269555,150018045,0.82984
fulldata,180779525,contig_13,1,3604975,0.0199413,153623020,0.849781
fulldata,180779525,contig_17,1,3563497,0.0197118,157186517,0.869493
fulldata,180779525,contig_163,1,2762273,0.0152798,159948790,0.884773
fulldata,180779525,contig_7,1,2655257,0.0146878,162604047,0.899461
fulldata,180779525,contig_30,1,1766142,0.00976959,164370189,0.90923
fulldata,180779525,scaffold_455,1,1708537,0.00945094,166078726,0.918681
fulldata,180779525,scaffold_15,1,1632696,0.00903142,167711422,0.927712
fulldata,180779525,contig_11,1,1431362,0.00791772,169142784,0.93563
fulldata,180779525,contig_78,1,1279291,0.00707653,170422075,0.942707
fulldata,180779525,contig_109,1,1036536,0.0057337,171458611,0.94844
fulldata,180779525,contig_58,1,840239,0.00464787,172298850,0.953088
fulldata,180779525,contig_9,1,603137,0.00333631,172901987,0.956425
fulldata,180779525,contig_33,1,577491,0.00319445,173479478,0.959619
fulldata,180779525,contig_156,1,519387,0.00287304,173998865,0.962492
fulldata,180779525,contig_128,1,444243,0.00245737,174443108,0.964949
fulldata,180779525,contig_41,1,432259,0.00239108,174875367,0.967341
fulldata,180779525,contig_104,1,388430,0.00214864,175263797,0.969489
fulldata,180779525,contig_25,1,351010,0.00194165,175614807,0.971431
fulldata,180779525,contig_133,1,344797,0.00190728,175959604,0.973338
fulldata,180779525,contig_110,1,291397,0.00161189,176251001,0.97495
fulldata,180779525,contig_348,1,270701,0.00149741,176521702,0.976447
fulldata,180779525,contig_342,1,247395,0.00136849,176769097,0.977816
fulldata,180779525,contig_360,1,234230,0.00129567,177003327,0.979112
fulldata,180779525,contig_275,1,203507,0.00112572,177206834,0.980237
fulldata,180779525,contig_335,1,193655,0.00107122,177400489,0.981309
fulldata,180779525,contig_476,1,183641,0.00101583,177584130,0.982324
fulldata,180779525,contig_356,1,159802,0.000883961,177743932,0.983208
fulldata,180779525,contig_130,1,154560,0.000854964,177898492,0.984063
fulldata,180779525,contig_451,1,128419,0.000710363,178026911,0.984774
fulldata,180779525,contig_426,1,124839,0.000690559,178151750,0.985464
fulldata,180779525,contig_392,1,122518,0.000677721,178274268,0.986142
fulldata,180779525,contig_482,1,119456,0.000660783,178393724,0.986803
fulldata,180779525,contig_144,1,107989,0.000597352,178501713,0.9874
fulldata,180779525,contig_436,1,106301,0.000588015,178608014,0.987988
fulldata,180779525,contig_458,1,105213,0.000581996,178713227,0.98857
fulldata,180779525,contig_541,1,93665,0.000518117,178806892,0.989088
fulldata,180779525,contig_429,1,92272,0.000510412,178899164,0.989599
fulldata,180779525,contig_372,1,87308,0.000482953,178986472,0.990082
fulldata,180779525,contig_744,1,85886,0.000475087,179072358,0.990557
fulldata,180779525,contig_175,1,85265,0.000471652,179157623,0.991028
fulldata,180779525,contig_562,1,83757,0.00046331,179241380,0.991492
fulldata,180779525,contig_223,1,80219,0.000443739,179321599,0.991935
fulldata,180779525,contig_720,1,74418,0.000411651,179396017,0.992347
fulldata,180779525,contig_509,1,71494,0.000395476,179467511,0.992742
fulldata,180779525,contig_80,1,68751,0.000380303,179536262,0.993123
fulldata,180779525,contig_367,1,64777,0.00035832,179601039,0.993481
fulldata,180779525,contig_617,1,58344,0.000322736,179659383,0.993804
fulldata,180779525,contig_82,1,49330,0.000272874,179708713,0.994077
fulldata,180779525,contig_561,1,48700,0.000269389,179757413,0.994346
fulldata,180779525,contig_368,1,45496,0.000251666,179802909,0.994598
fulldata,180779525,contig_358,1,45043,0.00024916,179847952,0.994847
fulldata,180779525,contig_257,1,44487,0.000246084,179892439,0.995093
fulldata,180779525,contig_55,1,40966,0.000226608,179933405,0.99532
fulldata,180779525,contig_537,1,40401,0.000223482,179973806,0.995543
fulldata,180779525,contig_555,1,35930,0.00019875,180009736,0.995742
fulldata,180779525,contig_329,1,33523,0.000185436,180043259,0.995927
fulldata,180779525,contig_813,1,33187,0.000183577,180076446,0.996111
fulldata,180779525,contig_345,1,30044,0.000166191,180106490,0.996277
fulldata,180779525,contig_29,1,29582,0.000163636,180136072,0.996441
fulldata,180779525,contig_35,1,28599,0.000158198,180164671,0.996599
fulldata,180779525,contig_66,1,28569,0.000158032,180193240,0.996757
fulldata,180779525,contig_400,1,28331,0.000156716,180221571,0.996914
fulldata,180779525,contig_427,1,25060,0.000138622,180246631,0.997052
fulldata,180779525,contig_443,1,18594,0.000102855,180265225,0.997155
fulldata,180779525,contig_23,1,18306,0.000101261,180283531,0.997256
fulldata,180779525,contig_546,1,17824,9.85952e-05,180301355,0.997355
fulldata,180779525,contig_473,1,16875,9.33457e-05,180318230,0.997448
fulldata,180779525,contig_453,1,15413,8.52585e-05,180333643,0.997534
fulldata,180779525,contig_204,1,15036,8.31731e-05,180348679,0.997617
fulldata,180779525,contig_787,1,14700,8.13145e-05,180363379,0.997698
fulldata,180779525,contig_448,1,14343,7.93397e-05,180377722,0.997777
fulldata,180779525,contig_428,1,13870,7.67233e-05,180391592,0.997854
fulldata,180779525,contig_397,1,13737,7.59876e-05,180405329,0.99793
fulldata,180779525,contig_39,1,13589,7.51689e-05,180418918,0.998005
fulldata,180779525,contig_661,1,13078,7.23423e-05,180431996,0.998078
fulldata,180779525,contig_20,1,12456,6.89016e-05,180444452,0.998147
fulldata,180779525,contig_330,1,10895,6.02668e-05,180455347,0.998207
fulldata,180779525,contig_779,1,10487,5.80099e-05,180465834,0.998265
fulldata,180779525,contig_712,1,9009,4.98342e-05,180474843,0.998315
fulldata,180779525,contig_320,1,8946,4.94857e-05,180483789,0.998364
fulldata,180779525,contig_311,1,8413,4.65373e-05,180492202,0.998411
fulldata,180779525,contig_399,1,8150,4.50825e-05,180500352,0.998456
fulldata,180779525,contig_761,1,8032,4.44298e-05,180508384,0.9985
fulldata,180779525,contig_487,1,7955,4.40039e-05,180516339,0.998544
fulldata,180779525,contig_301,1,7929,4.38601e-05,180524268,0.998588
fulldata,180779525,contig_670,1,7565,4.18466e-05,180531833,0.99863
fulldata,180779525,contig_337,1,6999,3.87157e-05,180538832,0.998669
fulldata,180779525,contig_387,1,6646,3.6763e-05,180545478,0.998705
fulldata,180779525,contig_488,1,6105,3.37704e-05,180551583,0.998739
fulldata,180779525,contig_321,1,5931,3.28079e-05,180557514,0.998772
fulldata,180779525,contig_535,1,5895,3.26088e-05,180563409,0.998805
fulldata,180779525,contig_808,1,5835,3.22769e-05,180569244,0.998837
fulldata,180779525,contig_610,1,5746,3.17846e-05,180574990,0.998869
fulldata,180779525,contig_459,1,5727,3.16795e-05,180580717,0.9989
fulldata,180779525,contig_376,1,5627,3.11263e-05,180586344,0.998931
fulldata,180779525,contig_739,1,5521,3.054e-05,180591865,0.998962
fulldata,180779525,contig_34,1,5150,2.84877e-05,180597015,0.99899
fulldata,180779525,contig_747,1,4972,2.75031e-05,180601987,0.999018
fulldata,180779525,contig_145,1,4899,2.70993e-05,180606886,0.999045
fulldata,180779525,contig_290,1,4845,2.68006e-05,180611731,0.999072
fulldata,180779525,contig_150,1,4538,2.51024e-05,180616269,0.999097
fulldata,180779525,contig_92,1,4465,2.46986e-05,180620734,0.999122
fulldata,180779525,contig_759,1,4428,2.44939e-05,180625162,0.999146
fulldata,180779525,contig_619,1,4397,2.43224e-05,180629559,0.99917
fulldata,180779525,contig_721,1,4381,2.42339e-05,180633940,0.999195
fulldata,180779525,contig_273,1,4308,2.38301e-05,180638248,0.999219
fulldata,180779525,contig_741,1,4247,2.34927e-05,180642495,0.999242
fulldata,180779525,contig_579,1,4199,2.32272e-05,180646694,0.999265
fulldata,180779525,contig_50,1,3985,2.20434e-05,180650679,0.999287
fulldata,180779525,contig_478,1,3947,2.18332e-05,180654626,0.999309
fulldata,180779525,contig_47,1,3914,2.16507e-05,180658540,0.999331
fulldata,180779525,contig_172,1,3824,2.11528e-05,180662364,0.999352
fulldata,180779525,contig_696,1,3818,2.11196e-05,180666182,0.999373
fulldata,180779525,contig_636,1,3719,2.0572e-05,180669901,0.999394
fulldata,180779525,contig_140,1,3710,2.05222e-05,180673611,0.999414
fulldata,180779525,contig_493,1,3673,2.03176e-05,180677284,0.999434
fulldata,180779525,contig_211,1,3611,1.99746e-05,180680895,0.999454
fulldata,180779525,contig_278,1,3603,1.99304e-05,180684498,0.999474
fulldata,180779525,contig_147,1,3561,1.9698e-05,180688059,0.999494
fulldata,180779525,contig_640,1,3476,1.92278e-05,180691535,0.999513
fulldata,180779525,contig_669,1,3453,1.91006e-05,180694988,0.999532
fulldata,180779525,contig_268,1,3377,1.86802e-05,180698365,0.999551
fulldata,180779525,contig_526,1,3291,1.82045e-05,180701656,0.999569
fulldata,180779525,contig_245,1,3246,1.79556e-05,180704902,0.999587
fulldata,180779525,contig_74,1,3154,1.74467e-05,180708056,0.999605
fulldata,180779525,contig_162,1,3035,1.67884e-05,180711091,0.999621
fulldata,180779525,contig_796,1,3031,1.67663e-05,180714122,0.999638
fulldata,180779525,contig_587,1,2950,1.63182e-05,180717072,0.999655
fulldata,180779525,contig_168,1,2932,1.62187e-05,180720004,0.999671
fulldata,180779525,contig_795,1,2876,1.59089e-05,180722880,0.999687
fulldata,180779525,contig_613,1,2871,1.58812e-05,180725751,0.999703
fulldata,180779525,contig_583,1,2828,1.56434e-05,180728579,0.999718
fulldata,180779525,contig_785,1,2783,1.53944e-05,180731362,0.999734
fulldata,180779525,contig_203,1,2773,1.53391e-05,180734135,0.999749
fulldata,180779525,contig_224,1,2656,1.46919e-05,180736791,0.999764
fulldata,180779525,contig_597,1,2443,1.35137e-05,180739234,0.999777
fulldata,180779525,contig_111,1,2242,1.24018e-05,180741476,0.99979
fulldata,180779525,contig_658,1,2196,1.21474e-05,180743672,0.999802
fulldata,180779525,contig_680,1,2020,1.11738e-05,180745692,0.999813
fulldata,180779525,contig_689,1,1896,1.04879e-05,180747588,0.999823
fulldata,180779525,contig_87,1,1879,1.03939e-05,180749467,0.999834
fulldata,180779525,contig_183,1,1832,1.01339e-05,180751299,0.999844
fulldata,180779525,contig_159,1,1637,9.05523e-06,180752936,0.999853
fulldata,180779525,contig_769,1,1614,8.928e-06,180754550,0.999862
fulldata,180779525,contig_802,1,1575,8.71227e-06,180756125,0.999871
fulldata,180779525,contig_674,1,1551,8.57951e-06,180757676,0.999879
fulldata,180779525,contig_491,1,1421,7.8604e-06,180759097,0.999887
fulldata,180779525,contig_783,1,1253,6.93109e-06,180760350,0.999894
fulldata,180779525,contig_323,1,1247,6.89791e-06,180761597,0.999901
fulldata,180779525,contig_155,1,1211,6.69877e-06,180762808,0.999908
fulldata,180779525,contig_565,1,1205,6.66558e-06,180764013,0.999914
fulldata,180779525,contig_521,1,1205,6.66558e-06,180765218,0.999921
fulldata,180779525,contig_317,1,1172,6.48304e-06,180766390,0.999927
fulldata,180779525,contig_631,1,1145,6.33368e-06,180767535,0.999934
fulldata,180779525,contig_97,1,1136,6.2839e-06,180768671,0.99994
fulldata,180779525,contig_260,1,958,5.29927e-06,180769629,0.999945
fulldata,180779525,contig_70,1,956,5.28821e-06,180770585,0.999951
fulldata,180779525,contig_270,1,925,5.11673e-06,180771510,0.999956
fulldata,180779525,contig_195,1,923,5.10567e-06,180772433,0.999961
fulldata,180779525,contig_643,1,835,4.61889e-06,180773268,0.999965
fulldata,180779525,contig_199,1,804,4.44741e-06,180774072,0.99997
fulldata,180779525,contig_536,1,798,4.41422e-06,180774870,0.999974
fulldata,180779525,contig_687,1,755,4.17636e-06,180775625,0.999978
fulldata,180779525,contig_723,1,691,3.82234e-06,180776316,0.999982
fulldata,180779525,contig_713,1,611,3.37981e-06,180776927,0.999986
fulldata,180779525,contig_90,1,583,3.22492e-06,180777510,0.999989
fulldata,180779525,contig_797,1,548,3.03132e-06,180778058,0.999992
fulldata,180779525,contig_309,1,540,2.98706e-06,180778598,0.999995
fulldata,180779525,contig_81,1,523,2.89303e-06,180779121,0.999998
fulldata,180779525,contig_236,1,404,2.23477e-06,180779525,1
30x,180779525,contig_15,1,32965397,0.182351,32965397,0.182351
30x,180779525,contig_21,1,28705438,0.158787,61670835,0.341138
30x,180779525,contig_3,1,26446775,0.146293,88117610,0.487431
30x,180779525,scaffold_2,1,25310483,0.140007,113428093,0.627439
30x,180779525,contig_17,1,20561232,0.113737,133989325,0.741175
30x,180779525,contig_164,1,5272872,0.0291674,139262197,0.770343
30x,180779525,scaffold_79,1,4497453,0.0248781,143759650,0.795221
30x,180779525,contig_7,1,3876166,0.0214414,147635816,0.816662
30x,180779525,contig_10,1,3377536,0.0186832,151013352,0.835345
30x,180779525,contig_5,1,3155196,0.0174533,154168548,0.852799
30x,180779525,contig_69,1,2553603,0.0141255,156722151,0.866924
30x,180779525,scaffold_480,1,2203694,0.01219,158925845,0.879114
30x,180779525,contig_1,1,2138651,0.0118302,161064496,0.890944
30x,180779525,contig_9,1,1875313,0.0103735,162939809,0.901318
30x,180779525,contig_70,1,1652731,0.00914225,164592540,0.91046
30x,180779525,contig_25,1,1467696,0.00811871,166060236,0.918579
30x,180779525,contig_6,1,1221379,0.00675618,167281615,0.925335
30x,180779525,contig_42,1,915296,0.00506305,168196911,0.930398
30x,180779525,contig_129,1,812021,0.00449178,169008932,0.93489
30x,180779525,contig_53,1,675670,0.00373754,169684602,0.938627
30x,180779525,contig_34,1,634944,0.00351226,170319546,0.94214
30x,180779525,contig_38,1,599556,0.0033165,170919102,0.945456
30x,180779525,contig_26,1,577880,0.0031966,171496982,0.948653
30x,180779525,contig_92,1,449411,0.00248596,171946393,0.951139
30x,180779525,contig_191,1,433298,0.00239683,172379691,0.953535
30x,180779525,contig_100,1,431396,0.00238631,172811087,0.955922
30x,180779525,contig_106,1,424957,0.00235069,173236044,0.958272
30x,180779525,contig_361,1,390967,0.00216267,173627011,0.960435
30x,180779525,contig_108,1,383958,0.0021239,174010969,0.962559
30x,180779525,contig_75,1,314236,0.00173823,174325205,0.964297
30x,180779525,contig_169,1,308196,0.00170482,174633401,0.966002
30x,180779525,contig_60,1,257551,0.00142467,174890952,0.967427
30x,180779525,contig_91,1,217766,0.00120459,175108718,0.968631
30x,180779525,contig_181,1,215637,0.00119282,175324355,0.969824
30x,180779525,contig_131,1,212705,0.0011766,175537060,0.971001
30x,180779525,contig_119,1,200167,0.00110724,175737227,0.972108
30x,180779525,contig_47,1,189378,0.00104756,175926605,0.973156
30x,180779525,contig_74,1,183077,0.00101271,176109682,0.974168
30x,180779525,contig_279,1,174955,0.000967781,176284637,0.975136
30x,180779525,contig_94,1,169110,0.000935449,176453747,0.976072
30x,180779525,contig_161,1,163849,0.000906347,176617596,0.976978
30x,180779525,contig_321,1,161423,0.000892927,176779019,0.977871
30x,180779525,contig_61,1,146014,0.000807691,176925033,0.978678
30x,180779525,contig_71,1,138027,0.00076351,177063060,0.979442
30x,180779525,contig_249,1,134011,0.000741295,177197071,0.980183
30x,180779525,contig_170,1,133157,0.000736571,177330228,0.98092
30x,180779525,contig_546,1,123821,0.000684928,177454049,0.981605
30x,180779525,contig_203,1,115912,0.000641179,177569961,0.982246
30x,180779525,contig_67,1,115206,0.000637273,177685167,0.982883
30x,180779525,contig_354,1,112017,0.000619633,177797184,0.983503
30x,180779525,contig_58,1,104705,0.000579186,177901889,0.984082
30x,180779525,contig_140,1,100786,0.000557508,178002675,0.98464
30x,180779525,contig_11,1,96945,0.000536261,178099620,0.985176
30x,180779525,contig_499,1,90623,0.00050129,178190243,0.985677
30x,180779525,contig_148,1,87409,0.000483512,178277652,0.986161
30x,180779525,contig_96,1,86423,0.000478057,178364075,0.986639
30x,180779525,contig_540,1,81751,0.000452214,178445826,0.987091
30x,180779525,contig_44,1,75516,0.000417724,178521342,0.987509
30x,180779525,contig_595,1,71880,0.000397611,178593222,0.987906
30x,180779525,contig_568,1,69912,0.000386725,178663134,0.988293
30x,180779525,contig_709,1,63540,0.000351478,178726674,0.988644
30x,180779525,contig_297,1,62967,0.000348308,178789641,0.988993
30x,180779525,contig_366,1,62309,0.000344668,178851950,0.989337
30x,180779525,contig_781,1,56055,0.000310074,178908005,0.989648
30x,180779525,contig_85,1,50042,0.000276812,178958047,0.989924
30x,180779525,contig_49,1,49823,0.000275601,179007870,0.9902
30x,180779525,contig_109,1,48329,0.000267337,179056199,0.990467
30x,180779525,contig_685,1,42835,0.000236946,179099034,0.990704
30x,180779525,contig_299,1,42792,0.000236708,179141826,0.990941
30x,180779525,contig_339,1,42138,0.000233091,179183964,0.991174
30x,180779525,contig_577,1,40911,0.000226303,179224875,0.9914
30x,180779525,contig_154,1,39967,0.000221081,179264842,0.991621
30x,180779525,contig_814,1,37772,0.00020894,179302614,0.99183
30x,180779525,contig_570,1,35818,0.000198131,179338432,0.992028
30x,180779525,contig_234,1,33647,0.000186122,179372079,0.992215
30x,180779525,contig_206,1,33346,0.000184457,179405425,0.992399
30x,180779525,contig_461,1,33037,0.000182747,179438462,0.992582
30x,180779525,contig_431,1,32980,0.000182432,179471442,0.992764
30x,180779525,contig_102,1,26807,0.000148286,179498249,0.992912
30x,180779525,contig_130,1,24483,0.00013543,179522732,0.993048
30x,180779525,contig_334,1,23993,0.00013272,179546725,0.993181
30x,180779525,contig_730,1,23861,0.00013199,179570586,0.993313
30x,180779525,contig_343,1,23631,0.000130717,179594217,0.993443
30x,180779525,contig_73,1,21035,0.000116357,179615252,0.99356
30x,180779525,contig_728,1,20909,0.00011566,179636161,0.993675
30x,180779525,contig_761,1,20778,0.000114936,179656939,0.99379
30x,180779525,contig_628,1,20697,0.000114488,179677636,0.993905
30x,180779525,contig_746,1,19763,0.000109321,179697399,0.994014
30x,180779525,contig_372,1,19378,0.000107191,179716777,0.994121
30x,180779525,contig_637,1,18199,0.00010067,179734976,0.994222
30x,180779525,contig_322,1,17736,9.81085e-05,179752712,0.99432
30x,180779525,contig_703,1,17088,9.4524e-05,179769800,0.994415
30x,180779525,contig_78,1,16885,9.34011e-05,179786685,0.994508
30x,180779525,contig_350,1,16863,9.32794e-05,179803548,0.994601
30x,180779525,contig_377,1,16178,8.94902e-05,179819726,0.994691
30x,180779525,contig_188,1,15039,8.31897e-05,179834765,0.994774
30x,180779525,contig_476,1,14067,7.7813e-05,179848832,0.994852
30x,180779525,contig_40,1,13709,7.58327e-05,179862541,0.994928
30x,180779525,contig_37,1,13587,7.51578e-05,179876128,0.995003
30x,180779525,contig_101,1,12881,7.12525e-05,179889009,0.995074
30x,180779525,contig_387,1,12462,6.89348e-05,179901471,0.995143
30x,180779525,contig_103,1,11936,6.60252e-05,179913407,0.995209
30x,180779525,contig_420,1,11328,6.2662e-05,179924735,0.995272
30x,180779525,contig_650,1,10445,5.77776e-05,179935180,0.995329
30x,180779525,contig_725,1,10321,5.70916e-05,179945501,0.995387
30x,180779525,contig_295,1,10164,5.62232e-05,179955665,0.995443
30x,180779525,contig_661,1,10138,5.60794e-05,179965803,0.995499
30x,180779525,contig_624,1,10096,5.5847e-05,179975899,0.995555
30x,180779525,contig_83,1,10052,5.56036e-05,179985951,0.99561
30x,180779525,contig_801,1,9378,5.18753e-05,179995329,0.995662
30x,180779525,contig_483,1,9172,5.07358e-05,180004501,0.995713
30x,180779525,contig_437,1,9118,5.04371e-05,180013619,0.995763
30x,180779525,contig_80,1,9003,4.9801e-05,180022622,0.995813
30x,180779525,contig_560,1,8377,4.63382e-05,180030999,0.995859
30x,180779525,contig_134,1,8339,4.6128e-05,180039338,0.995906
30x,180779525,contig_223,1,8148,4.50715e-05,180047486,0.995951
30x,180779525,contig_410,1,8093,4.47672e-05,180055579,0.995995
30x,180779525,contig_344,1,8044,4.44962e-05,180063623,0.99604
30x,180779525,contig_364,1,8027,4.44022e-05,180071650,0.996084
30x,180779525,contig_438,1,8023,4.438e-05,180079673,0.996129
30x,180779525,contig_13,1,7714,4.26708e-05,180087387,0.996171
30x,180779525,contig_291,1,7544,4.17304e-05,180094931,0.996213
30x,180779525,contig_176,1,7424,4.10666e-05,180102355,0.996254
30x,180779525,contig_717,1,7242,4.00598e-05,180109597,0.996294
30x,180779525,contig_262,1,7217,3.99216e-05,180116814,0.996334
30x,180779525,contig_489,1,7149,3.95454e-05,180123963,0.996374
30x,180779525,contig_122,1,7127,3.94237e-05,180131090,0.996413
30x,180779525,contig_139,1,7079,3.91582e-05,180138169,0.996452
30x,180779525,contig_298,1,6947,3.8428e-05,180145116,0.996491
30x,180779525,contig_705,1,6942,3.84004e-05,180152058,0.996529
30x,180779525,contig_675,1,6899,3.81625e-05,180158957,0.996567
30x,180779525,contig_237,1,6733,3.72443e-05,180165690,0.996605
30x,180779525,contig_442,1,6712,3.71281e-05,180172402,0.996642
30x,180779525,contig_39,1,6672,3.69068e-05,180179074,0.996679
30x,180779525,contig_124,1,6489,3.58946e-05,180185563,0.996714
30x,180779525,contig_201,1,6488,3.5889e-05,180192051,0.99675
30x,180779525,contig_215,1,6283,3.4755e-05,180198334,0.996785
30x,180779525,contig_270,1,6261,3.46333e-05,180204595,0.99682
30x,180779525,contig_165,1,6213,3.43678e-05,180210808,0.996854
30x,180779525,contig_690,1,6101,3.37483e-05,180216909,0.996888
30x,180779525,contig_292,1,5930,3.28024e-05,180222839,0.996921
30x,180779525,contig_256,1,5906,3.26696e-05,180228745,0.996953
30x,180779525,contig_494,1,5883,3.25424e-05,180234628,0.996986
30x,180779525,contig_747,1,5766,3.18952e-05,180240394,0.997018
30x,180779525,contig_254,1,5630,3.11429e-05,180246024,0.997049
30x,180779525,contig_645,1,5610,3.10323e-05,180251634,0.99708
30x,180779525,contig_137,1,5430,3.00366e-05,180257064,0.99711
30x,180779525,contig_82,1,5331,2.9489e-05,180262395,0.997139
30x,180779525,contig_833,1,5153,2.85043e-05,180267548,0.997168
30x,180779525,contig_664,1,5144,2.84545e-05,180272692,0.997196
30x,180779525,contig_105,1,5017,2.7752e-05,180277709,0.997224
30x,180779525,contig_63,1,5007,2.76967e-05,180282716,0.997252
30x,180779525,contig_498,1,4977,2.75308e-05,180287693,0.997279
30x,180779525,contig_439,1,4974,2.75142e-05,180292667,0.997307
30x,180779525,contig_470,1,4916,2.71933e-05,180297583,0.997334
30x,180779525,contig_187,1,4884,2.70163e-05,180302467,0.997361
30x,180779525,contig_798,1,4820,2.66623e-05,180307287,0.997388
30x,180779525,contig_144,1,4792,2.65074e-05,180312079,0.997414
30x,180779525,contig_808,1,4662,2.57883e-05,180316741,0.99744
30x,180779525,contig_831,1,4562,2.52352e-05,180321303,0.997465
30x,180779525,contig_341,1,4544,2.51356e-05,180325847,0.99749
30x,180779525,contig_695,1,4509,2.4942e-05,180330356,0.997515
30x,180779525,contig_116,1,4472,2.47373e-05,180334828,0.99754
30x,180779525,contig_537,1,4467,2.47097e-05,180339295,0.997565
30x,180779525,contig_724,1,4425,2.44773e-05,180343720,0.997589
30x,180779525,contig_359,1,4389,2.42782e-05,180348109,0.997614
30x,180779525,contig_414,1,4380,2.42284e-05,180352489,0.997638
30x,180779525,contig_242,1,4377,2.42118e-05,180356866,0.997662
30x,180779525,contig_54,1,4374,2.41952e-05,180361240,0.997686
30x,180779525,contig_462,1,4312,2.38523e-05,180365552,0.99771
30x,180779525,contig_466,1,4229,2.33931e-05,180369781,0.997733
30x,180779525,contig_173,1,4218,2.33323e-05,180373999,0.997757
30x,180779525,contig_231,1,4203,2.32493e-05,180378202,0.99778
30x,180779525,contig_77,1,4186,2.31553e-05,180382388,0.997803
30x,180779525,contig_174,1,4157,2.29949e-05,180386545,0.997826
30x,180779525,contig_392,1,4147,2.29395e-05,180390692,0.997849
30x,180779525,contig_701,1,4119,2.27847e-05,180394811,0.997872
30x,180779525,contig_428,1,4099,2.2674e-05,180398910,0.997895
30x,180779525,contig_557,1,4052,2.2414e-05,180402962,0.997917
30x,180779525,contig_471,1,4014,2.22038e-05,180406976,0.997939
30x,180779525,contig_207,1,3965,2.19328e-05,180410941,0.997961
30x,180779525,contig_510,1,3959,2.18996e-05,180414900,0.997983
30x,180779525,contig_749,1,3854,2.13188e-05,180418754,0.998004
30x,180779525,contig_722,1,3827,2.11694e-05,180422581,0.998026
30x,180779525,contig_157,1,3760,2.07988e-05,180426341,0.998046
30x,180779525,contig_390,1,3752,2.07546e-05,180430093,0.998067
30x,180779525,contig_238,1,3683,2.03729e-05,180433776,0.998087
30x,180779525,contig_745,1,3670,2.0301e-05,180437446,0.998108
30x,180779525,contig_110,1,3665,2.02733e-05,180441111,0.998128
30x,180779525,contig_474,1,3607,1.99525e-05,180444718,0.998148
30x,180779525,contig_360,1,3606,1.99469e-05,180448324,0.998168
30x,180779525,contig_196,1,3588,1.98474e-05,180451912,0.998188
30x,180779525,contig_65,1,3494,1.93274e-05,180455406,0.998207
30x,180779525,contig_756,1,3449,1.90785e-05,180458855,0.998226
30x,180779525,contig_14,1,3326,1.83981e-05,180462181,0.998245
30x,180779525,contig_281,1,3299,1.82487e-05,180465480,0.998263
30x,180779525,contig_402,1,3298,1.82432e-05,180468778,0.998281
30x,180779525,contig_424,1,3248,1.79666e-05,180472026,0.998299
30x,180779525,contig_211,1,3246,1.79556e-05,180475272,0.998317
30x,180779525,contig_160,1,2987,1.65229e-05,180478259,0.998334
30x,180779525,contig_255,1,2948,1.63072e-05,180481207,0.99835
30x,180779525,contig_731,1,2935,1.62352e-05,180484142,0.998366
30x,180779525,contig_41,1,2934,1.62297e-05,180487076,0.998382
30x,180779525,contig_673,1,2882,1.59421e-05,180489958,0.998398
30x,180779525,contig_502,1,2816,1.5577e-05,180492774,0.998414
30x,180779525,contig_121,1,2812,1.55549e-05,180495586,0.998429
30x,180779525,contig_19,1,2720,1.5046e-05,180498306,0.998444
30x,180779525,contig_351,1,2717,1.50294e-05,180501023,0.998459
30x,180779525,contig_576,1,2656,1.46919e-05,180503679,0.998474
30x,180779525,contig_265,1,2641,1.4609e-05,180506320,0.998489
30x,180779525,contig_819,1,2576,1.42494e-05,180508896,0.998503
30x,180779525,contig_678,1,2573,1.42328e-05,180511469,0.998517
30x,180779525,contig_247,1,2567,1.41996e-05,180514036,0.998531
30x,180779525,contig_221,1,2485,1.3746e-05,180516521,0.998545
30x,180779525,contig_517,1,2468,1.3652e-05,180518989,0.998559
30x,180779525,contig_699,1,2467,1.36465e-05,180521456,0.998572
30x,180779525,contig_680,1,2442,1.35082e-05,180523898,0.998586
30x,180779525,contig_706,1,2425,1.34141e-05,180526323,0.998599
30x,180779525,contig_338,1,2335,1.29163e-05,180528658,0.998612
30x,180779525,contig_835,1,2301,1.27282e-05,180530959,0.998625
30x,180779525,contig_629,1,2243,1.24074e-05,180533202,0.998637
30x,180779525,contig_409,1,2240,1.23908e-05,180535442,0.99865
30x,180779525,contig_738,1,2202,1.21806e-05,180537644,0.998662
30x,180779525,contig_133,1,2186,1.20921e-05,180539830,0.998674
30x,180779525,contig_411,1,2125,1.17546e-05,180541955,0.998686
30x,180779525,contig_222,1,2108,1.16606e-05,180544063,0.998698
30x,180779525,contig_432,1,2006,1.10964e-05,180546069,0.998709
30x,180779525,contig_478,1,1901,1.05156e-05,180547970,0.998719
30x,180779525,contig_599,1,1836,1.0156e-05,180549806,0.998729
30x,180779525,contig_822,1,1831,1.01284e-05,180551637,0.998739
30x,180779525,contig_591,1,1785,9.87391e-06,180553422,0.998749
30x,180779525,contig_258,1,1764,9.75774e-06,180555186,0.998759
30x,180779525,contig_448,1,1762,9.74668e-06,180556948,0.998769
30x,180779525,contig_611,1,1693,9.365e-06,180558641,0.998778
30x,180779525,contig_210,1,1689,9.34287e-06,180560330,0.998788
30x,180779525,contig_93,1,1629,9.01098e-06,180561959,0.998797
30x,180779525,contig_729,1,1575,8.71227e-06,180563534,0.998805
30x,180779525,contig_300,1,1571,8.69014e-06,180565105,0.998814
30x,180779525,contig_451,1,1551,8.57951e-06,180566656,0.998822
30x,180779525,contig_669,1,1436,7.94338e-06,180568092,0.99883
30x,180779525,contig_200,1,1417,7.83828e-06,180569509,0.998838
30x,180779525,contig_553,1,1403,7.76083e-06,180570912,0.998846
30x,180779525,contig_336,1,1361,7.52851e-06,180572273,0.998854
30x,180779525,contig_384,1,1290,7.13576e-06,180573563,0.998861
30x,180779525,contig_601,1,1220,6.74855e-06,180574783,0.998867
30x,180779525,contig_566,1,1219,6.74302e-06,180576002,0.998874
30x,180779525,contig_505,1,1164,6.43878e-06,180577166,0.998881
30x,180779525,contig_423,1,1149,6.35581e-06,180578315,0.998887
30x,180779525,contig_330,1,1114,6.1622e-06,180579429,0.998893
30x,180779525,contig_780,1,1068,5.90775e-06,180580497,0.998899
30x,180779525,contig_594,1,1047,5.79159e-06,180581544,0.998905
30x,180779525,contig_602,1,982,5.43203e-06,180582526,0.99891
30x,180779525,contig_648,1,878,4.85674e-06,180583404,0.998915
30x,180779525,contig_30,1,806,4.45847e-06,180584210,0.99892
30x,180779525,contig_315,1,770,4.25933e-06,180584980,0.998924
30x,180779525,contig_241,1,770,4.25933e-06,180585750,0.998928
30x,180779525,contig_689,1,754,4.17083e-06,180586504,0.998932
30x,180779525,contig_456,1,693,3.8334e-06,180587197,0.998936
30x,180779525,contig_549,1,664,3.67298e-06,180587861,0.99894
30x,180779525,contig_813,1,652,3.6066e-06,180588513,0.998943
30x,180779525,contig_618,1,601,3.32449e-06,180589114,0.998947
30x,180779525,contig_535,1,596,3.29683e-06,180589710,0.99895
30x,180779525,contig_771,1,579,3.2028e-06,180590289,0.998953
30x,180779525,contig_245,1,575,3.18067e-06,180590864,0.998956
30x,180779525,contig_772,1,511,2.82665e-06,180591375,0.998959
30x,180779525,contig_713,1,93,5.14439e-07,180591468,0.99896
