species,genome_size,contig_name,contig_rank,contig_size,contig_prop,contig_cumsum,contig_cumsum_prop
D.melanogaster,143726002,NT_033777.3,1,32079331,0.223198,32079331,0.223198
D.melanogaster,143726002,NT_037436.4,1,28110227,0.195582,60189558,0.41878
D.melanogaster,143726002,NT_033778.4,1,25286936,0.175938,85476494,0.594718
D.melanogaster,143726002,NC_004354.4,1,23542271,0.1638,109018765,0.758518
D.melanogaster,143726002,NT_033779.5,1,23513712,0.163601,132532477,0.922119
D.melanogaster,143726002,NC_024512.1,1,3667352,0.0255163,136199829,0.947635
D.melanogaster,143726002,NC_004353.4,1,1348131,0.00937987,137547960,0.957015
D.melanogaster,143726002,NW_007931083.1,1,88768,0.00061762,137636728,0.957633
D.melanogaster,143726002,NW_007931078.1,1,87365,0.000607858,137724093,0.958241
D.melanogaster,143726002,NW_007931082.1,1,86267,0.000600218,137810360,0.958841
D.melanogaster,143726002,NW_007931121.1,1,76973,0.000535554,137887333,0.959376
D.melanogaster,143726002,NW_007931076.1,1,76224,0.000530342,137963557,0.959907
D.melanogaster,143726002,NW_007931108.1,1,73091,0.000508544,138036648,0.960415
D.melanogaster,143726002,NW_007931109.1,1,66731,0.000464293,138103379,0.96088
D.melanogaster,143726002,NW_007931110.1,1,66439,0.000462262,138169818,0.961342
D.melanogaster,143726002,NW_007931086.1,1,62570,0.000435342,138232388,0.961777
D.melanogaster,143726002,NW_007931092.1,1,57785,0.00040205,138290173,0.962179
D.melanogaster,143726002,NW_001844851.1,1,50625,0.000352233,138340798,0.962531
D.melanogaster,143726002,NW_007931107.1,1,47411,0.000329871,138388209,0.962861
D.melanogaster,143726002,NW_007931089.1,1,46986,0.000326914,138435195,0.963188
D.melanogaster,143726002,NW_007931087.1,1,45120,0.000313931,138480315,0.963502
D.melanogaster,143726002,NW_007931074.1,1,44411,0.000308998,138524726,0.963811
D.melanogaster,143726002,NW_007931119.1,1,44104,0.000306862,138568830,0.964118
D.melanogaster,143726002,NW_007931100.1,1,43383,0.000301845,138612213,0.96442
D.melanogaster,143726002,NW_007931113.1,1,39041,0.000271635,138651254,0.964692
D.melanogaster,143726002,NW_007931090.1,1,37106,0.000258172,138688360,0.96495
D.melanogaster,143726002,NW_007931079.1,1,36913,0.000256829,138725273,0.965207
D.melanogaster,143726002,NW_007931084.1,1,36482,0.00025383,138761755,0.96546
D.melanogaster,143726002,NW_007931112.1,1,34521,0.000240186,138796276,0.965701
D.melanogaster,143726002,NW_007931114.1,1,34359,0.000239059,138830635,0.96594
D.melanogaster,143726002,NW_007931105.1,1,33320,0.00023183,138863955,0.966171
D.melanogaster,143726002,NW_007931111.1,1,33316,0.000231802,138897271,0.966403
D.melanogaster,143726002,NW_007931115.1,1,31460,0.000218889,138928731,0.966622
D.melanogaster,143726002,NW_007931096.1,1,29583,0.000205829,138958314,0.966828
D.melanogaster,143726002,NW_007931094.1,1,28305,0.000196937,138986619,0.967025
D.melanogaster,143726002,NW_001844994.1,1,27456,0.00019103,139014075,0.967216
D.melanogaster,143726002,NW_007931106.1,1,27447,0.000190968,139041522,0.967407
D.melanogaster,143726002,NW_007931098.1,1,26115,0.0001817,139067637,0.967589
D.melanogaster,143726002,NW_001844996.1,1,25840,0.000179787,139093477,0.967768
D.melanogaster,143726002,NW_007931117.1,1,25805,0.000179543,139119282,0.967948
D.melanogaster,143726002,NW_007931095.1,1,25698,0.000178799,139144980,0.968127
D.melanogaster,143726002,NW_007931097.1,1,25560,0.000177838,139170540,0.968305
D.melanogaster,143726002,NW_007931085.1,1,25537,0.000177678,139196077,0.968482
D.melanogaster,143726002,NW_007931103.1,1,24503,0.000170484,139220580,0.968653
D.melanogaster,143726002,NW_007931118.1,1,24380,0.000169628,139244960,0.968822
D.melanogaster,143726002,NW_007931081.1,1,23238,0.000161683,139268198,0.968984
D.melanogaster,143726002,NW_007931088.1,1,22882,0.000159206,139291080,0.969143
D.melanogaster,143726002,NW_007931080.1,1,22604,0.000157271,139313684,0.9693
D.melanogaster,143726002,NW_007931116.1,1,21921,0.000152519,139335605,0.969453
D.melanogaster,143726002,NW_001845012.1,1,21074,0.000146626,139356679,0.9696
D.melanogaster,143726002,NW_007931093.1,1,20763,0.000144462,139377442,0.969744
D.melanogaster,143726002,NW_007931073.1,1,19956,0.000138848,139397398,0.969883
D.melanogaster,143726002,NC_024511.2,1,19524,0.000135842,139416922,0.970019
D.melanogaster,143726002,NW_001844998.1,1,18299,0.000127319,139435221,0.970146
D.melanogaster,143726002,NW_007931091.1,1,16157,0.000112415,139451378,0.970259
D.melanogaster,143726002,NW_001845023.1,1,15522,0.000107997,139466900,0.970367
D.melanogaster,143726002,NW_001844918.1,1,15417,0.000107267,139482317,0.970474
D.melanogaster,143726002,NW_001845024.1,1,15068,0.000104838,139497385,0.970579
D.melanogaster,143726002,NW_001845015.1,1,14983,0.000104247,139512368,0.970683
D.melanogaster,143726002,NW_001845000.1,1,14687,0.000102187,139527055,0.970785
D.melanogaster,143726002,NW_001844930.1,1,14503,0.000100907,139541558,0.970886
D.melanogaster,143726002,NW_001845001.1,1,14199,9.87921e-05,139555757,0.970985
D.melanogaster,143726002,NW_001844935.1,1,14098,9.80894e-05,139569855,0.971083
D.melanogaster,143726002,NW_001844936.1,1,14028,9.76024e-05,139583883,0.97118
D.melanogaster,143726002,NW_001845025.1,1,14006,9.74493e-05,139597889,0.971278
D.melanogaster,143726002,NW_001844937.1,1,13940,9.69901e-05,139611829,0.971375
D.melanogaster,143726002,NW_001844938.1,1,13935,9.69553e-05,139625764,0.971472
D.melanogaster,143726002,NW_001844939.1,1,13906,9.67535e-05,139639670,0.971569
D.melanogaster,143726002,NW_001845026.1,1,13553,9.42975e-05,139653223,0.971663
D.melanogaster,143726002,NW_001844944.1,1,13549,9.42697e-05,139666772,0.971757
D.melanogaster,143726002,NW_001845013.1,1,13501,9.39357e-05,139680273,0.971851
D.melanogaster,143726002,NW_007931099.1,1,13455,9.36156e-05,139693728,0.971945
D.melanogaster,143726002,NW_001844947.1,1,13455,9.36156e-05,139707183,0.972038
D.melanogaster,143726002,NW_001844948.1,1,13416,9.33443e-05,139720599,0.972132
D.melanogaster,143726002,NW_001844949.1,1,13394,9.31912e-05,139733993,0.972225
D.melanogaster,143726002,NW_001844951.1,1,13317,9.26555e-05,139747310,0.972318
D.melanogaster,143726002,NW_001844952.1,1,13256,9.2231e-05,139760566,0.97241
D.melanogaster,143726002,NW_001844954.1,1,13234,9.2078e-05,139773800,0.972502
D.melanogaster,143726002,NW_007931075.1,1,13157,9.15422e-05,139786957,0.972593
D.melanogaster,143726002,NW_001844955.1,1,13108,9.12013e-05,139800065,0.972685
D.melanogaster,143726002,NW_001845014.1,1,13079,9.09995e-05,139813144,0.972776
D.melanogaster,143726002,NW_001845027.1,1,12856,8.9448e-05,139826000,0.972865
D.melanogaster,143726002,NW_001844958.1,1,12848,8.93923e-05,139838848,0.972954
D.melanogaster,143726002,NW_001844959.1,1,12827,8.92462e-05,139851675,0.973044
D.melanogaster,143726002,NW_007931104.1,1,12714,8.846e-05,139864389,0.973132
D.melanogaster,143726002,NW_001845017.1,1,12681,8.82304e-05,139877070,0.97322
D.melanogaster,143726002,NW_001844962.1,1,12654,8.80425e-05,139889724,0.973308
D.melanogaster,143726002,NW_007931101.1,1,12632,8.78895e-05,139902356,0.973396
D.melanogaster,143726002,NW_001844963.1,1,12632,8.78895e-05,139914988,0.973484
D.melanogaster,143726002,NW_001844964.1,1,12536,8.72215e-05,139927524,0.973571
D.melanogaster,143726002,NW_001844966.1,1,12513,8.70615e-05,139940037,0.973658
D.melanogaster,143726002,NW_001845028.1,1,12459,8.66858e-05,139952496,0.973745
D.melanogaster,143726002,NW_001844968.1,1,12424,8.64423e-05,139964920,0.973832
D.melanogaster,143726002,NW_001844967.1,1,12424,8.64423e-05,139977344,0.973918
D.melanogaster,143726002,NW_001844969.1,1,12399,8.62683e-05,139989743,0.974004
D.melanogaster,143726002,NW_001844970.1,1,12368,8.60526e-05,140002111,0.97409
D.melanogaster,143726002,NW_001844971.1,1,12354,8.59552e-05,140014465,0.974176
D.melanogaster,143726002,NW_001844974.1,1,12187,8.47933e-05,140026652,0.974261
D.melanogaster,143726002,NW_001844975.1,1,12148,8.45219e-05,140038800,0.974346
D.melanogaster,143726002,NW_001844976.1,1,12142,8.44802e-05,140050942,0.97443
D.melanogaster,143726002,NW_001844977.1,1,12095,8.41532e-05,140063037,0.974514
D.melanogaster,143726002,NW_001844978.1,1,12034,8.37288e-05,140075071,0.974598
D.melanogaster,143726002,NW_001845008.1,1,12027,8.36801e-05,140087098,0.974682
D.melanogaster,143726002,NW_001845029.1,1,12002,8.35061e-05,140099100,0.974765
D.melanogaster,143726002,NW_001844979.1,1,12001,8.34992e-05,140111101,0.974849
D.melanogaster,143726002,NW_001844981.1,1,11985,8.33878e-05,140123086,0.974932
D.melanogaster,143726002,NW_007931077.1,1,11983,8.33739e-05,140135069,0.975015
D.melanogaster,143726002,NW_001844982.1,1,11958,8.32e-05,140147027,0.975099
D.melanogaster,143726002,NW_001844983.1,1,11951,8.31513e-05,140158978,0.975182
D.melanogaster,143726002,NW_001845030.1,1,11807,8.21494e-05,140170785,0.975264
D.melanogaster,143726002,NW_001845031.1,1,11763,8.18432e-05,140182548,0.975346
D.melanogaster,143726002,NW_001844984.1,1,11743,8.17041e-05,140194291,0.975427
D.melanogaster,143726002,NW_001845032.1,1,11569,8.04934e-05,140205860,0.975508
D.melanogaster,143726002,NW_001844987.1,1,11522,8.01664e-05,140217382,0.975588
D.melanogaster,143726002,NW_007931120.1,1,11498,7.99994e-05,140228880,0.975668
D.melanogaster,143726002,NW_001844989.1,1,11430,7.95263e-05,140240310,0.975748
D.melanogaster,143726002,NW_001844990.1,1,11220,7.80652e-05,140251530,0.975826
D.melanogaster,143726002,NW_001844991.1,1,11148,7.75643e-05,140262678,0.975903
D.melanogaster,143726002,NW_001844992.1,1,11126,7.74112e-05,140273804,0.975981
D.melanogaster,143726002,NW_007931102.1,1,10091,7.021e-05,140283895,0.976051
D.melanogaster,143726002,NW_001845033.1,1,9865,6.86375e-05,140293760,0.97612
D.melanogaster,143726002,NW_001845034.1,1,9368,6.51796e-05,140303128,0.976185
D.melanogaster,143726002,NW_001845035.1,1,9341,6.49917e-05,140312469,0.97625
D.melanogaster,143726002,NW_001845037.1,1,8346,5.80688e-05,140320815,0.976308
D.melanogaster,143726002,NW_001845038.1,1,8007,5.57102e-05,140328822,0.976363
D.melanogaster,143726002,NW_001845039.1,1,7722,5.37272e-05,140336544,0.976417
D.melanogaster,143726002,NW_001845040.1,1,7314,5.08885e-05,140343858,0.976468
D.melanogaster,143726002,NW_001845042.1,1,7123,4.95596e-05,140350981,0.976518
D.melanogaster,143726002,NW_001845043.1,1,7003,4.87247e-05,140357984,0.976566
D.melanogaster,143726002,NW_001845044.1,1,6936,4.82585e-05,140364920,0.976615
D.melanogaster,143726002,NW_001845046.1,1,6900,4.8008e-05,140371820,0.976663
D.melanogaster,143726002,NW_001845048.1,1,6860,4.77297e-05,140378680,0.97671
D.melanogaster,143726002,NW_001845047.1,1,6860,4.77297e-05,140385540,0.976758
D.melanogaster,143726002,NW_001845049.1,1,6825,4.74862e-05,140392365,0.976806
D.melanogaster,143726002,NW_001845051.1,1,6698,4.66026e-05,140399063,0.976852
D.melanogaster,143726002,NW_001845052.1,1,6546,4.5545e-05,140405609,0.976898
D.melanogaster,143726002,NW_001845056.1,1,6396,4.45013e-05,140412005,0.976942
D.melanogaster,143726002,NW_001845057.1,1,6294,4.37917e-05,140418299,0.976986
D.melanogaster,143726002,NW_001845058.1,1,6237,4.33951e-05,140424536,0.977029
D.melanogaster,143726002,NW_001845059.1,1,6193,4.30889e-05,140430729,0.977073
D.melanogaster,143726002,NW_001845061.1,1,6076,4.22749e-05,140436805,0.977115
D.melanogaster,143726002,NW_001845062.1,1,6062,4.21775e-05,140442867,0.977157
D.melanogaster,143726002,NW_001845063.1,1,6041,4.20314e-05,140448908,0.977199
D.melanogaster,143726002,NW_001845065.1,1,6000,4.17461e-05,140454908,0.977241
D.melanogaster,143726002,NW_001845067.1,1,5984,4.16348e-05,140460892,0.977282
D.melanogaster,143726002,NW_001845069.1,1,5968,4.15235e-05,140466860,0.977324
D.melanogaster,143726002,NW_001845070.1,1,5952,4.14121e-05,140472812,0.977365
D.melanogaster,143726002,NW_001845071.1,1,5915,4.11547e-05,140478727,0.977406
D.melanogaster,143726002,NW_001845072.1,1,5891,4.09877e-05,140484618,0.977447
D.melanogaster,143726002,NW_001845073.1,1,5832,4.05772e-05,140490450,0.977488
D.melanogaster,143726002,NW_001845074.1,1,5772,4.01597e-05,140496222,0.977528
D.melanogaster,143726002,NW_001845076.1,1,5698,3.96449e-05,140501920,0.977568
D.melanogaster,143726002,NW_001845077.1,1,5564,3.87125e-05,140507484,0.977607
D.melanogaster,143726002,NW_001845078.1,1,5555,3.86499e-05,140513039,0.977645
D.melanogaster,143726002,NW_001845079.1,1,5520,3.84064e-05,140518559,0.977684
D.melanogaster,143726002,NW_001845081.1,1,5465,3.80237e-05,140524024,0.977722
D.melanogaster,143726002,NW_001845082.1,1,5463,3.80098e-05,140529487,0.97776
D.melanogaster,143726002,NW_001845084.1,1,5387,3.7481e-05,140534874,0.977797
D.melanogaster,143726002,NW_001845085.1,1,5383,3.74532e-05,140540257,0.977835
D.melanogaster,143726002,NW_001845086.1,1,5360,3.72932e-05,140545617,0.977872
D.melanogaster,143726002,NW_001845087.1,1,5324,3.70427e-05,140550941,0.977909
D.melanogaster,143726002,NW_001845088.1,1,5323,3.70357e-05,140556264,0.977946
D.melanogaster,143726002,NW_001845089.1,1,5316,3.6987e-05,140561580,0.977983
D.melanogaster,143726002,NW_001845090.1,1,5281,3.67435e-05,140566861,0.97802
D.melanogaster,143726002,NW_001845092.1,1,5232,3.64026e-05,140572093,0.978056
D.melanogaster,143726002,NW_001845093.1,1,5189,3.61034e-05,140577282,0.978092
D.melanogaster,143726002,NW_001845094.1,1,5182,3.60547e-05,140582464,0.978128
D.melanogaster,143726002,NW_001845095.1,1,5098,3.54703e-05,140587562,0.978164
D.melanogaster,143726002,NW_001845096.1,1,5061,3.52128e-05,140592623,0.978199
D.melanogaster,143726002,NW_001845097.1,1,5060,3.52059e-05,140597683,0.978234
D.melanogaster,143726002,NW_001845098.1,1,5057,3.5185e-05,140602740,0.978269
D.melanogaster,143726002,NW_001845099.1,1,5026,3.49693e-05,140607766,0.978304
D.melanogaster,143726002,NW_001845100.1,1,5000,3.47884e-05,140612766,0.978339
D.melanogaster,143726002,NW_001845101.1,1,4996,3.47606e-05,140617762,0.978374
D.melanogaster,143726002,NW_001845102.1,1,4994,3.47467e-05,140622756,0.978409
D.melanogaster,143726002,NW_001845103.1,1,4986,3.4691e-05,140627742,0.978443
D.melanogaster,143726002,NW_001845104.1,1,4967,3.45588e-05,140632709,0.978478
D.melanogaster,143726002,NW_001845105.1,1,4939,3.4364e-05,140637648,0.978512
D.melanogaster,143726002,NW_001845106.1,1,4933,3.43223e-05,140642581,0.978547
D.melanogaster,143726002,NW_001845107.1,1,4917,3.42109e-05,140647498,0.978581
D.melanogaster,143726002,NW_001845108.1,1,4903,3.41135e-05,140652401,0.978615
D.melanogaster,143726002,NW_001845109.1,1,4888,3.40092e-05,140657289,0.978649
D.melanogaster,143726002,NW_001845110.1,1,4879,3.39465e-05,140662168,0.978683
D.melanogaster,143726002,NW_001845111.1,1,4865,3.38491e-05,140667033,0.978717
D.melanogaster,143726002,NW_001845113.1,1,4820,3.3536e-05,140671853,0.97875
D.melanogaster,143726002,NW_001845114.1,1,4815,3.35012e-05,140676668,0.978784
D.melanogaster,143726002,NW_001845117.1,1,4785,3.32925e-05,140681453,0.978817
D.melanogaster,143726002,NW_001845121.1,1,4705,3.27359e-05,140686158,0.97885
D.melanogaster,143726002,NW_001845122.1,1,4701,3.27081e-05,140690859,0.978882
D.melanogaster,143726002,NW_001845126.1,1,4608,3.2061e-05,140695467,0.978914
D.melanogaster,143726002,NW_001845128.1,1,4581,3.18731e-05,140700048,0.978946
D.melanogaster,143726002,NW_001845129.1,1,4573,3.18175e-05,140704621,0.978978
D.melanogaster,143726002,NW_001845130.1,1,4553,3.16783e-05,140709174,0.97901
D.melanogaster,143726002,NW_001845132.1,1,4515,3.14139e-05,140713689,0.979041
D.melanogaster,143726002,NW_001845133.1,1,4471,3.11078e-05,140718160,0.979072
D.melanogaster,143726002,NW_001845134.1,1,4465,3.10661e-05,140722625,0.979103
D.melanogaster,143726002,NW_001845135.1,1,4452,3.09756e-05,140727077,0.979134
D.melanogaster,143726002,NW_001845137.1,1,4436,3.08643e-05,140731513,0.979165
D.melanogaster,143726002,NW_001845138.1,1,4400,3.06138e-05,140735913,0.979196
D.melanogaster,143726002,NW_001845140.1,1,4395,3.0579e-05,140740308,0.979226
D.melanogaster,143726002,NW_001845142.1,1,4381,3.04816e-05,140744689,0.979257
D.melanogaster,143726002,NW_001845143.1,1,4378,3.04607e-05,140749067,0.979287
D.melanogaster,143726002,NW_001845144.1,1,4377,3.04538e-05,140753444,0.979318
D.melanogaster,143726002,NW_001845145.1,1,4370,3.04051e-05,140757814,0.979348
D.melanogaster,143726002,NW_001845147.1,1,4361,3.03425e-05,140762175,0.979379
D.melanogaster,143726002,NW_001845148.1,1,4336,3.01685e-05,140766511,0.979409
D.melanogaster,143726002,NW_001845151.1,1,4310,2.99876e-05,140770821,0.979439
D.melanogaster,143726002,NW_001845150.1,1,4310,2.99876e-05,140775131,0.979469
D.melanogaster,143726002,NW_001845152.1,1,4305,2.99528e-05,140779436,0.979499
D.melanogaster,143726002,NW_001845153.1,1,4295,2.98832e-05,140783731,0.979529
D.melanogaster,143726002,NW_001845154.1,1,4289,2.98415e-05,140788020,0.979558
D.melanogaster,143726002,NW_001845155.1,1,4273,2.97302e-05,140792293,0.979588
D.melanogaster,143726002,NW_001845156.1,1,4272,2.97232e-05,140796565,0.979618
D.melanogaster,143726002,NW_001845157.1,1,4256,2.96119e-05,140800821,0.979648
D.melanogaster,143726002,NW_001845159.1,1,4231,2.9438e-05,140805052,0.979677
D.melanogaster,143726002,NW_001845160.1,1,4225,2.93962e-05,140809277,0.979706
D.melanogaster,143726002,NW_001845162.1,1,4222,2.93753e-05,140813499,0.979736
D.melanogaster,143726002,NW_001845161.1,1,4222,2.93753e-05,140817721,0.979765
D.melanogaster,143726002,NW_001845163.1,1,4202,2.92362e-05,140821923,0.979794
D.melanogaster,143726002,NW_001845164.1,1,4197,2.92014e-05,140826120,0.979824
D.melanogaster,143726002,NW_001845165.1,1,4188,2.91388e-05,140830308,0.979853
D.melanogaster,143726002,NW_001845166.1,1,4183,2.9104e-05,140834491,0.979882
D.melanogaster,143726002,NW_001845167.1,1,4182,2.9097e-05,140838673,0.979911
D.melanogaster,143726002,NW_001845168.1,1,4163,2.89648e-05,140842836,0.97994
D.melanogaster,143726002,NW_001845169.1,1,4150,2.88744e-05,140846986,0.979969
D.melanogaster,143726002,NW_001845170.1,1,4135,2.877e-05,140851121,0.979997
D.melanogaster,143726002,NW_001845174.1,1,4085,2.84221e-05,140855206,0.980026
D.melanogaster,143726002,NW_001845175.1,1,4081,2.83943e-05,140859287,0.980054
D.melanogaster,143726002,NW_001845177.1,1,4072,2.83317e-05,140863359,0.980083
D.melanogaster,143726002,NW_001845178.1,1,4059,2.82412e-05,140867418,0.980111
D.melanogaster,143726002,NW_001845180.1,1,4030,2.80395e-05,140871448,0.980139
D.melanogaster,143726002,NW_001845181.1,1,4013,2.79212e-05,140875461,0.980167
D.melanogaster,143726002,NW_001845182.1,1,4012,2.79142e-05,140879473,0.980195
D.melanogaster,143726002,NW_001845184.1,1,4006,2.78725e-05,140883479,0.980223
D.melanogaster,143726002,NW_001845185.1,1,3991,2.77681e-05,140887470,0.98025
D.melanogaster,143726002,NW_001845186.1,1,3984,2.77194e-05,140891454,0.980278
D.melanogaster,143726002,NW_001845187.1,1,3970,2.7622e-05,140895424,0.980306
D.melanogaster,143726002,NW_001845188.1,1,3964,2.75803e-05,140899388,0.980333
D.melanogaster,143726002,NW_001845189.1,1,3960,2.75524e-05,140903348,0.980361
D.melanogaster,143726002,NW_001845190.1,1,3950,2.74828e-05,140907298,0.980388
D.melanogaster,143726002,NW_001845192.1,1,3941,2.74202e-05,140911239,0.980416
D.melanogaster,143726002,NW_001845193.1,1,3932,2.73576e-05,140915171,0.980443
D.melanogaster,143726002,NW_001845194.1,1,3926,2.73159e-05,140919097,0.98047
D.melanogaster,143726002,NW_001845195.1,1,3924,2.73019e-05,140923021,0.980498
D.melanogaster,143726002,NW_001845196.1,1,3921,2.72811e-05,140926942,0.980525
D.melanogaster,143726002,NW_001845198.1,1,3913,2.72254e-05,140930855,0.980552
D.melanogaster,143726002,NW_001845197.1,1,3913,2.72254e-05,140934768,0.980579
D.melanogaster,143726002,NW_001845199.1,1,3906,2.71767e-05,140938674,0.980607
D.melanogaster,143726002,NW_001845202.1,1,3871,2.69332e-05,140942545,0.980634
D.melanogaster,143726002,NW_001845203.1,1,3864,2.68845e-05,140946409,0.98066
D.melanogaster,143726002,NW_001845204.1,1,3858,2.68427e-05,140950267,0.980687
D.melanogaster,143726002,NW_001845207.1,1,3818,2.65644e-05,140954085,0.980714
D.melanogaster,143726002,NW_001845208.1,1,3807,2.64879e-05,140957892,0.98074
D.melanogaster,143726002,NW_001845210.1,1,3806,2.64809e-05,140961698,0.980767
D.melanogaster,143726002,NW_001845209.1,1,3806,2.64809e-05,140965504,0.980793
D.melanogaster,143726002,NW_001845212.1,1,3775,2.62653e-05,140969279,0.98082
D.melanogaster,143726002,NW_001845214.1,1,3755,2.61261e-05,140973034,0.980846
D.melanogaster,143726002,NW_001845215.1,1,3745,2.60565e-05,140976779,0.980872
D.melanogaster,143726002,NW_001845216.1,1,3737,2.60009e-05,140980516,0.980898
D.melanogaster,143726002,NW_001845217.1,1,3730,2.59522e-05,140984246,0.980924
D.melanogaster,143726002,NW_001845218.1,1,3717,2.58617e-05,140987963,0.98095
D.melanogaster,143726002,NW_001845219.1,1,3716,2.58548e-05,140991679,0.980975
D.melanogaster,143726002,NW_001845220.1,1,3713,2.58339e-05,140995392,0.981001
D.melanogaster,143726002,NW_001845222.1,1,3708,2.57991e-05,140999100,0.981027
D.melanogaster,143726002,NW_001845225.1,1,3681,2.56112e-05,141002781,0.981053
D.melanogaster,143726002,NW_001845226.1,1,3660,2.54651e-05,141006441,0.981078
D.melanogaster,143726002,NW_001845227.1,1,3650,2.53955e-05,141010091,0.981104
D.melanogaster,143726002,NW_001845228.1,1,3649,2.53886e-05,141013740,0.981129
D.melanogaster,143726002,NW_001845229.1,1,3648,2.53816e-05,141017388,0.981154
D.melanogaster,143726002,NW_001845230.1,1,3646,2.53677e-05,141021034,0.98118
D.melanogaster,143726002,NW_001845232.1,1,3638,2.53121e-05,141024672,0.981205
D.melanogaster,143726002,NW_001845234.1,1,3622,2.52007e-05,141028294,0.98123
D.melanogaster,143726002,NW_001845233.1,1,3622,2.52007e-05,141031916,0.981255
D.melanogaster,143726002,NW_001845236.1,1,3603,2.50685e-05,141035519,0.98128
D.melanogaster,143726002,NW_001845235.1,1,3603,2.50685e-05,141039122,0.981306
D.melanogaster,143726002,NW_001845237.1,1,3602,2.50616e-05,141042724,0.981331
D.melanogaster,143726002,NW_001845238.1,1,3593,2.4999e-05,141046317,0.981356
D.melanogaster,143726002,NW_001845239.1,1,3582,2.49224e-05,141049899,0.981381
D.melanogaster,143726002,NW_001845240.1,1,3574,2.48668e-05,141053473,0.981405
D.melanogaster,143726002,NW_001845242.1,1,3557,2.47485e-05,141057030,0.98143
D.melanogaster,143726002,NW_001845243.1,1,3554,2.47276e-05,141060584,0.981455
D.melanogaster,143726002,NW_001845246.1,1,3553,2.47206e-05,141064137,0.98148
D.melanogaster,143726002,NW_001845245.1,1,3553,2.47206e-05,141067690,0.981504
D.melanogaster,143726002,NW_001845244.1,1,3553,2.47206e-05,141071243,0.981529
D.melanogaster,143726002,NW_001845248.1,1,3537,2.46093e-05,141074780,0.981554
D.melanogaster,143726002,NW_001845250.1,1,3527,2.45397e-05,141078307,0.981578
D.melanogaster,143726002,NW_001845249.1,1,3527,2.45397e-05,141081834,0.981603
D.melanogaster,143726002,NW_001845252.1,1,3523,2.45119e-05,141085357,0.981627
D.melanogaster,143726002,NW_001845253.1,1,3519,2.44841e-05,141088876,0.981652
D.melanogaster,143726002,NW_001845254.1,1,3503,2.43728e-05,141092379,0.981676
D.melanogaster,143726002,NW_001845255.1,1,3502,2.43658e-05,141095881,0.9817
D.melanogaster,143726002,NW_001845256.1,1,3499,2.43449e-05,141099380,0.981725
D.melanogaster,143726002,NW_001845258.1,1,3498,2.4338e-05,141102878,0.981749
D.melanogaster,143726002,NW_001845259.1,1,3490,2.42823e-05,141106368,0.981773
D.melanogaster,143726002,NW_001845260.1,1,3478,2.41988e-05,141109846,0.981798
D.melanogaster,143726002,NW_001845261.1,1,3477,2.41919e-05,141113323,0.981822
D.melanogaster,143726002,NW_001845263.1,1,3473,2.4164e-05,141116796,0.981846
D.melanogaster,143726002,NW_001845264.1,1,3466,2.41153e-05,141120262,0.98187
D.melanogaster,143726002,NW_001845265.1,1,3463,2.40945e-05,141123725,0.981894
D.melanogaster,143726002,NW_001845266.1,1,3458,2.40597e-05,141127183,0.981918
D.melanogaster,143726002,NW_001845268.1,1,3434,2.38927e-05,141130617,0.981942
D.melanogaster,143726002,NW_001845271.1,1,3402,2.367e-05,141134019,0.981966
D.melanogaster,143726002,NW_001845272.1,1,3396,2.36283e-05,141137415,0.981989
D.melanogaster,143726002,NW_001845274.1,1,3389,2.35796e-05,141140804,0.982013
D.melanogaster,143726002,NW_001845275.1,1,3386,2.35587e-05,141144190,0.982037
D.melanogaster,143726002,NW_001845276.1,1,3375,2.34822e-05,141147565,0.98206
D.melanogaster,143726002,NW_001845277.1,1,3374,2.34752e-05,141150939,0.982084
D.melanogaster,143726002,NW_001845278.1,1,3373,2.34683e-05,141154312,0.982107
D.melanogaster,143726002,NW_001845281.1,1,3365,2.34126e-05,141157677,0.98213
D.melanogaster,143726002,NW_001845283.1,1,3348,2.32943e-05,141161025,0.982154
D.melanogaster,143726002,NW_001845284.1,1,3347,2.32874e-05,141164372,0.982177
D.melanogaster,143726002,NW_001845285.1,1,3341,2.32456e-05,141167713,0.9822
D.melanogaster,143726002,NW_001845287.1,1,3313,2.30508e-05,141171026,0.982223
D.melanogaster,143726002,NW_001845288.1,1,3308,2.3016e-05,141174334,0.982246
D.melanogaster,143726002,NW_001845289.1,1,3302,2.29743e-05,141177636,0.982269
D.melanogaster,143726002,NW_001845290.1,1,3299,2.29534e-05,141180935,0.982292
D.melanogaster,143726002,NW_001845291.1,1,3290,2.28908e-05,141184225,0.982315
D.melanogaster,143726002,NW_001845292.1,1,3284,2.2849e-05,141187509,0.982338
D.melanogaster,143726002,NW_001845293.1,1,3277,2.28003e-05,141190786,0.982361
D.melanogaster,143726002,NW_001845294.1,1,3275,2.27864e-05,141194061,0.982384
D.melanogaster,143726002,NW_001845295.1,1,3268,2.27377e-05,141197329,0.982406
D.melanogaster,143726002,NW_001845296.1,1,3262,2.2696e-05,141200591,0.982429
D.melanogaster,143726002,NW_001845299.1,1,3259,2.26751e-05,141203850,0.982452
D.melanogaster,143726002,NW_001845298.1,1,3259,2.26751e-05,141207109,0.982474
D.melanogaster,143726002,NW_001845301.1,1,3254,2.26403e-05,141210363,0.982497
D.melanogaster,143726002,NW_001845302.1,1,3252,2.26264e-05,141213615,0.98252
D.melanogaster,143726002,NW_001845304.1,1,3234,2.25011e-05,141216849,0.982542
D.melanogaster,143726002,NW_001845306.1,1,3227,2.24524e-05,141220076,0.982565
D.melanogaster,143726002,NW_001845307.1,1,3223,2.24246e-05,141223299,0.982587
D.melanogaster,143726002,NW_001845309.1,1,3218,2.23898e-05,141226517,0.982609
D.melanogaster,143726002,NW_001845310.1,1,3213,2.2355e-05,141229730,0.982632
D.melanogaster,143726002,NW_001845311.1,1,3209,2.23272e-05,141232939,0.982654
D.melanogaster,143726002,NW_001845312.1,1,3206,2.23063e-05,141236145,0.982676
D.melanogaster,143726002,NW_001845315.1,1,3201,2.22715e-05,141239346,0.982699
D.melanogaster,143726002,NW_001845314.1,1,3201,2.22715e-05,141242547,0.982721
D.melanogaster,143726002,NW_001845316.1,1,3197,2.22437e-05,141245744,0.982743
D.melanogaster,143726002,NW_001845317.1,1,3196,2.22368e-05,141248940,0.982765
D.melanogaster,143726002,NW_001845318.1,1,3195,2.22298e-05,141252135,0.982788
D.melanogaster,143726002,NW_001845320.1,1,3190,2.2195e-05,141255325,0.98281
D.melanogaster,143726002,NW_001845325.1,1,3174,2.20837e-05,141258499,0.982832
D.melanogaster,143726002,NW_001845326.1,1,3173,2.20767e-05,141261672,0.982854
D.melanogaster,143726002,NW_001845327.1,1,3171,2.20628e-05,141264843,0.982876
D.melanogaster,143726002,NW_001845328.1,1,3162,2.20002e-05,141268005,0.982898
D.melanogaster,143726002,NW_001845329.1,1,3159,2.19793e-05,141271164,0.98292
D.melanogaster,143726002,NW_001845330.1,1,3157,2.19654e-05,141274321,0.982942
D.melanogaster,143726002,NW_001845331.1,1,3156,2.19584e-05,141277477,0.982964
D.melanogaster,143726002,NW_001845332.1,1,3154,2.19445e-05,141280631,0.982986
D.melanogaster,143726002,NW_001845333.1,1,3144,2.1875e-05,141283775,0.983008
D.melanogaster,143726002,NW_001845334.1,1,3129,2.17706e-05,141286904,0.98303
D.melanogaster,143726002,NW_001845336.1,1,3123,2.17288e-05,141290027,0.983051
D.melanogaster,143726002,NW_001845335.1,1,3123,2.17288e-05,141293150,0.983073
D.melanogaster,143726002,NW_001845337.1,1,3120,2.1708e-05,141296270,0.983095
D.melanogaster,143726002,NW_001845338.1,1,3102,2.15827e-05,141299372,0.983116
D.melanogaster,143726002,NW_001845340.1,1,3100,2.15688e-05,141302472,0.983138
D.melanogaster,143726002,NW_001845339.1,1,3100,2.15688e-05,141305572,0.983159
D.melanogaster,143726002,NW_001845341.1,1,3089,2.14923e-05,141308661,0.983181
D.melanogaster,143726002,NW_001845342.1,1,3085,2.14645e-05,141311746,0.983202
D.melanogaster,143726002,NW_001845344.1,1,3080,2.14297e-05,141314826,0.983224
D.melanogaster,143726002,NW_001845343.1,1,3080,2.14297e-05,141317906,0.983245
D.melanogaster,143726002,NW_001845345.1,1,3077,2.14088e-05,141320983,0.983267
D.melanogaster,143726002,NW_001845346.1,1,3076,2.14018e-05,141324059,0.983288
D.melanogaster,143726002,NW_001845348.1,1,3073,2.1381e-05,141327132,0.983309
D.melanogaster,143726002,NW_001845347.1,1,3073,2.1381e-05,141330205,0.983331
D.melanogaster,143726002,NW_001845349.1,1,3065,2.13253e-05,141333270,0.983352
D.melanogaster,143726002,NW_001845350.1,1,3059,2.12836e-05,141336329,0.983373
D.melanogaster,143726002,NW_001845351.1,1,3058,2.12766e-05,141339387,0.983395
D.melanogaster,143726002,NW_001845352.1,1,3046,2.11931e-05,141342433,0.983416
D.melanogaster,143726002,NW_001845353.1,1,3044,2.11792e-05,141345477,0.983437
D.melanogaster,143726002,NW_001845354.1,1,3043,2.11722e-05,141348520,0.983458
D.melanogaster,143726002,NW_001845355.1,1,3025,2.1047e-05,141351545,0.983479
D.melanogaster,143726002,NW_001845356.1,1,3024,2.104e-05,141354569,0.9835
D.melanogaster,143726002,NW_001845357.1,1,3013,2.09635e-05,141357582,0.983521
D.melanogaster,143726002,NW_001845358.1,1,3010,2.09426e-05,141360592,0.983542
D.melanogaster,143726002,NW_001845359.1,1,3009,2.09357e-05,141363601,0.983563
D.melanogaster,143726002,NW_001845361.1,1,3002,2.0887e-05,141366603,0.983584
D.melanogaster,143726002,NW_001845363.1,1,2999,2.08661e-05,141369602,0.983605
D.melanogaster,143726002,NW_001845362.1,1,2999,2.08661e-05,141372601,0.983626
D.melanogaster,143726002,NW_001845364.1,1,2996,2.08452e-05,141375597,0.983647
D.melanogaster,143726002,NW_001845365.1,1,2991,2.08104e-05,141378588,0.983667
D.melanogaster,143726002,NW_001845366.1,1,2984,2.07617e-05,141381572,0.983688
D.melanogaster,143726002,NW_001845368.1,1,2982,2.07478e-05,141384554,0.983709
D.melanogaster,143726002,NW_001845367.1,1,2982,2.07478e-05,141387536,0.98373
D.melanogaster,143726002,NW_001845369.1,1,2971,2.06713e-05,141390507,0.98375
D.melanogaster,143726002,NW_001845370.1,1,2964,2.06226e-05,141393471,0.983771
D.melanogaster,143726002,NW_001845372.1,1,2957,2.05739e-05,141396428,0.983792
D.melanogaster,143726002,NW_001845373.1,1,2956,2.05669e-05,141399384,0.983812
D.melanogaster,143726002,NW_001845374.1,1,2945,2.04904e-05,141402329,0.983833
D.melanogaster,143726002,NW_001845375.1,1,2943,2.04765e-05,141405272,0.983853
D.melanogaster,143726002,NW_001845377.1,1,2937,2.04347e-05,141408209,0.983874
D.melanogaster,143726002,NW_001845376.1,1,2937,2.04347e-05,141411146,0.983894
D.melanogaster,143726002,NW_001845378.1,1,2928,2.03721e-05,141414074,0.983914
D.melanogaster,143726002,NW_001845379.1,1,2927,2.03651e-05,141417001,0.983935
D.melanogaster,143726002,NW_001845380.1,1,2926,2.03582e-05,141419927,0.983955
D.melanogaster,143726002,NW_001845381.1,1,2924,2.03443e-05,141422851,0.983975
D.melanogaster,143726002,NW_001845383.1,1,2922,2.03304e-05,141425773,0.983996
D.melanogaster,143726002,NW_001845382.1,1,2922,2.03304e-05,141428695,0.984016
D.melanogaster,143726002,NW_001845384.1,1,2919,2.03095e-05,141431614,0.984036
D.melanogaster,143726002,NW_001845385.1,1,2916,2.02886e-05,141434530,0.984057
D.melanogaster,143726002,NW_001845386.1,1,2914,2.02747e-05,141437444,0.984077
D.melanogaster,143726002,NW_001845387.1,1,2911,2.02538e-05,141440355,0.984097
D.melanogaster,143726002,NW_001845388.1,1,2910,2.02469e-05,141443265,0.984117
D.melanogaster,143726002,NW_001845389.1,1,2905,2.02121e-05,141446170,0.984138
D.melanogaster,143726002,NW_001845390.1,1,2904,2.02051e-05,141449074,0.984158
D.melanogaster,143726002,NW_001845391.1,1,2903,2.01982e-05,141451977,0.984178
D.melanogaster,143726002,NW_001845392.1,1,2899,2.01703e-05,141454876,0.984198
D.melanogaster,143726002,NW_001845393.1,1,2893,2.01286e-05,141457769,0.984218
D.melanogaster,143726002,NW_001845394.1,1,2889,2.01007e-05,141460658,0.984238
D.melanogaster,143726002,NW_001845395.1,1,2884,2.0066e-05,141463542,0.984259
D.melanogaster,143726002,NW_001845398.1,1,2882,2.0052e-05,141466424,0.984279
D.melanogaster,143726002,NW_001845397.1,1,2882,2.0052e-05,141469306,0.984299
D.melanogaster,143726002,NW_001845396.1,1,2882,2.0052e-05,141472188,0.984319
D.melanogaster,143726002,NW_001845400.1,1,2881,2.00451e-05,141475069,0.984339
D.melanogaster,143726002,NW_001845401.1,1,2877,2.00173e-05,141477946,0.984359
D.melanogaster,143726002,NW_001845402.1,1,2876,2.00103e-05,141480822,0.984379
D.melanogaster,143726002,NW_001845403.1,1,2871,1.99755e-05,141483693,0.984399
D.melanogaster,143726002,NW_001845406.1,1,2860,1.9899e-05,141486553,0.984419
D.melanogaster,143726002,NW_001845405.1,1,2860,1.9899e-05,141489413,0.984439
D.melanogaster,143726002,NW_001845407.1,1,2858,1.98851e-05,141492271,0.984458
D.melanogaster,143726002,NW_001845409.1,1,2855,1.98642e-05,141495126,0.984478
D.melanogaster,143726002,NW_001845411.1,1,2849,1.98224e-05,141497975,0.984498
D.melanogaster,143726002,NW_001845412.1,1,2848,1.98155e-05,141500823,0.984518
D.melanogaster,143726002,NW_001845413.1,1,2846,1.98016e-05,141503669,0.984538
D.melanogaster,143726002,NW_001845414.1,1,2844,1.97877e-05,141506513,0.984557
D.melanogaster,143726002,NW_001845415.1,1,2841,1.97668e-05,141509354,0.984577
D.melanogaster,143726002,NW_001845417.1,1,2836,1.9732e-05,141512190,0.984597
D.melanogaster,143726002,NW_001845419.1,1,2834,1.97181e-05,141515024,0.984617
D.melanogaster,143726002,NW_001845420.1,1,2833,1.97111e-05,141517857,0.984636
D.melanogaster,143726002,NW_001845421.1,1,2830,1.96902e-05,141520687,0.984656
D.melanogaster,143726002,NW_001845422.1,1,2829,1.96833e-05,141523516,0.984676
D.melanogaster,143726002,NW_001845423.1,1,2828,1.96763e-05,141526344,0.984695
D.melanogaster,143726002,NW_001845424.1,1,2825,1.96555e-05,141529169,0.984715
D.melanogaster,143726002,NW_001845425.1,1,2823,1.96415e-05,141531992,0.984735
D.melanogaster,143726002,NW_001845427.1,1,2822,1.96346e-05,141534814,0.984754
D.melanogaster,143726002,NW_001845426.1,1,2822,1.96346e-05,141537636,0.984774
D.melanogaster,143726002,NW_001845428.1,1,2820,1.96207e-05,141540456,0.984794
D.melanogaster,143726002,NW_001845429.1,1,2819,1.96137e-05,141543275,0.984813
D.melanogaster,143726002,NW_001845431.1,1,2815,1.95859e-05,141546090,0.984833
D.melanogaster,143726002,NW_001845432.1,1,2814,1.95789e-05,141548904,0.984852
D.melanogaster,143726002,NW_001845433.1,1,2811,1.9558e-05,141551715,0.984872
D.melanogaster,143726002,NW_001845434.1,1,2804,1.95093e-05,141554519,0.984892
D.melanogaster,143726002,NW_001845435.1,1,2799,1.94746e-05,141557318,0.984911
D.melanogaster,143726002,NW_001845436.1,1,2796,1.94537e-05,141560114,0.98493
D.melanogaster,143726002,NW_001845438.1,1,2795,1.94467e-05,141562909,0.98495
D.melanogaster,143726002,NW_001845437.1,1,2795,1.94467e-05,141565704,0.984969
D.melanogaster,143726002,NW_001845440.1,1,2794,1.94398e-05,141568498,0.984989
D.melanogaster,143726002,NW_001845442.1,1,2793,1.94328e-05,141571291,0.985008
D.melanogaster,143726002,NW_001845441.1,1,2793,1.94328e-05,141574084,0.985028
D.melanogaster,143726002,NW_001845443.1,1,2791,1.94189e-05,141576875,0.985047
D.melanogaster,143726002,NW_001845444.1,1,2790,1.94119e-05,141579665,0.985066
D.melanogaster,143726002,NW_001845445.1,1,2788,1.9398e-05,141582453,0.985086
D.melanogaster,143726002,NW_001845446.1,1,2787,1.93911e-05,141585240,0.985105
D.melanogaster,143726002,NW_001845448.1,1,2784,1.93702e-05,141588024,0.985125
D.melanogaster,143726002,NW_001845449.1,1,2783,1.93632e-05,141590807,0.985144
D.melanogaster,143726002,NW_001845450.1,1,2781,1.93493e-05,141593588,0.985163
D.melanogaster,143726002,NW_001845451.1,1,2765,1.9238e-05,141596353,0.985183
D.melanogaster,143726002,NW_001845453.1,1,2762,1.92171e-05,141599115,0.985202
D.melanogaster,143726002,NW_001845454.1,1,2751,1.91406e-05,141601866,0.985221
D.melanogaster,143726002,NW_001845455.1,1,2750,1.91336e-05,141604616,0.98524
D.melanogaster,143726002,NW_001845456.1,1,2745,1.90988e-05,141607361,0.985259
D.melanogaster,143726002,NW_001845457.1,1,2744,1.90919e-05,141610105,0.985278
D.melanogaster,143726002,NW_001845458.1,1,2736,1.90362e-05,141612841,0.985297
D.melanogaster,143726002,NW_001845459.1,1,2733,1.90153e-05,141615574,0.985316
D.melanogaster,143726002,NW_001845460.1,1,2728,1.89806e-05,141618302,0.985335
D.melanogaster,143726002,NW_001845464.1,1,2709,1.88484e-05,141621011,0.985354
D.melanogaster,143726002,NW_001845465.1,1,2708,1.88414e-05,141623719,0.985373
D.melanogaster,143726002,NW_001845466.1,1,2703,1.88066e-05,141626422,0.985392
D.melanogaster,143726002,NW_001845467.1,1,2698,1.87718e-05,141629120,0.985411
D.melanogaster,143726002,NW_001845469.1,1,2697,1.87649e-05,141631817,0.985429
D.melanogaster,143726002,NW_001845470.1,1,2694,1.8744e-05,141634511,0.985448
D.melanogaster,143726002,NW_001845471.1,1,2689,1.87092e-05,141637200,0.985467
D.melanogaster,143726002,NW_001845473.1,1,2688,1.87023e-05,141639888,0.985485
D.melanogaster,143726002,NW_001845472.1,1,2688,1.87023e-05,141642576,0.985504
D.melanogaster,143726002,NW_001845474.1,1,2686,1.86883e-05,141645262,0.985523
D.melanogaster,143726002,NW_001845476.1,1,2671,1.8584e-05,141647933,0.985541
D.melanogaster,143726002,NW_001845477.1,1,2670,1.8577e-05,141650603,0.98556
D.melanogaster,143726002,NW_001845478.1,1,2669,1.85701e-05,141653272,0.985579
D.melanogaster,143726002,NW_001845479.1,1,2668,1.85631e-05,141655940,0.985597
D.melanogaster,143726002,NW_001845480.1,1,2665,1.85422e-05,141658605,0.985616
D.melanogaster,143726002,NW_001845481.1,1,2664,1.85353e-05,141661269,0.985634
D.melanogaster,143726002,NW_001845482.1,1,2647,1.8417e-05,141663916,0.985653
D.melanogaster,143726002,NW_001845485.1,1,2644,1.83961e-05,141666560,0.985671
D.melanogaster,143726002,NW_001845486.1,1,2642,1.83822e-05,141669202,0.985689
D.melanogaster,143726002,NW_001845487.1,1,2641,1.83752e-05,141671843,0.985708
D.melanogaster,143726002,NW_001845489.1,1,2639,1.83613e-05,141674482,0.985726
D.melanogaster,143726002,NW_001845490.1,1,2637,1.83474e-05,141677119,0.985745
D.melanogaster,143726002,NW_001845491.1,1,2636,1.83405e-05,141679755,0.985763
D.melanogaster,143726002,NW_001845492.1,1,2635,1.83335e-05,141682390,0.985781
D.melanogaster,143726002,NW_001845494.1,1,2629,1.82917e-05,141685019,0.985799
D.melanogaster,143726002,NW_001845495.1,1,2628,1.82848e-05,141687647,0.985818
D.melanogaster,143726002,NW_001845496.1,1,2626,1.82709e-05,141690273,0.985836
D.melanogaster,143726002,NW_001845498.1,1,2618,1.82152e-05,141692891,0.985854
D.melanogaster,143726002,NW_001845499.1,1,2617,1.82083e-05,141695508,0.985872
D.melanogaster,143726002,NW_001845501.1,1,2612,1.81735e-05,141698120,0.985891
D.melanogaster,143726002,NW_001845502.1,1,2611,1.81665e-05,141700731,0.985909
D.melanogaster,143726002,NW_001845504.1,1,2605,1.81248e-05,141703336,0.985927
D.melanogaster,143726002,NW_001845506.1,1,2603,1.81108e-05,141705939,0.985945
D.melanogaster,143726002,NW_001845505.1,1,2603,1.81108e-05,141708542,0.985963
D.melanogaster,143726002,NW_001845508.1,1,2591,1.80274e-05,141711133,0.985981
D.melanogaster,143726002,NW_001845509.1,1,2588,1.80065e-05,141713721,0.985999
D.melanogaster,143726002,NW_001845510.1,1,2584,1.79787e-05,141716305,0.986017
D.melanogaster,143726002,NW_001845511.1,1,2583,1.79717e-05,141718888,0.986035
D.melanogaster,143726002,NW_001845514.1,1,2577,1.79299e-05,141721465,0.986053
D.melanogaster,143726002,NW_001845513.1,1,2577,1.79299e-05,141724042,0.986071
D.melanogaster,143726002,NW_001845515.1,1,2576,1.7923e-05,141726618,0.986089
D.melanogaster,143726002,NW_001845519.1,1,2575,1.7916e-05,141729193,0.986107
D.melanogaster,143726002,NW_001845518.1,1,2575,1.7916e-05,141731768,0.986125
D.melanogaster,143726002,NW_001845517.1,1,2575,1.7916e-05,141734343,0.986143
D.melanogaster,143726002,NW_001845520.1,1,2574,1.79091e-05,141736917,0.986161
D.melanogaster,143726002,NW_001845521.1,1,2570,1.78812e-05,141739487,0.986178
D.melanogaster,143726002,NW_001845522.1,1,2565,1.78465e-05,141742052,0.986196
D.melanogaster,143726002,NW_001845523.1,1,2561,1.78186e-05,141744613,0.986214
D.melanogaster,143726002,NW_001845524.1,1,2557,1.77908e-05,141747170,0.986232
D.melanogaster,143726002,NW_001845525.1,1,2556,1.77838e-05,141749726,0.98625
D.melanogaster,143726002,NW_001845527.1,1,2555,1.77769e-05,141752281,0.986267
D.melanogaster,143726002,NW_001845528.1,1,2549,1.77351e-05,141754830,0.986285
D.melanogaster,143726002,NW_001845530.1,1,2547,1.77212e-05,141757377,0.986303
D.melanogaster,143726002,NW_001845532.1,1,2541,1.76795e-05,141759918,0.986321
D.melanogaster,143726002,NW_001845531.1,1,2541,1.76795e-05,141762459,0.986338
D.melanogaster,143726002,NW_001845533.1,1,2536,1.76447e-05,141764995,0.986356
D.melanogaster,143726002,NW_001845536.1,1,2529,1.7596e-05,141767524,0.986374
D.melanogaster,143726002,NW_001845535.1,1,2529,1.7596e-05,141770053,0.986391
D.melanogaster,143726002,NW_001845538.1,1,2522,1.75473e-05,141772575,0.986409
D.melanogaster,143726002,NW_001845540.1,1,2521,1.75403e-05,141775096,0.986426
D.melanogaster,143726002,NW_001845539.1,1,2521,1.75403e-05,141777617,0.986444
D.melanogaster,143726002,NW_001845542.1,1,2520,1.75334e-05,141780137,0.986461
D.melanogaster,143726002,NW_001845541.1,1,2520,1.75334e-05,141782657,0.986479
D.melanogaster,143726002,NW_001845543.1,1,2517,1.75125e-05,141785174,0.986496
D.melanogaster,143726002,NW_001845544.1,1,2516,1.75055e-05,141787690,0.986514
D.melanogaster,143726002,NW_001845546.1,1,2511,1.74707e-05,141790201,0.986531
D.melanogaster,143726002,NW_001845545.1,1,2511,1.74707e-05,141792712,0.986549
D.melanogaster,143726002,NW_001845547.1,1,2510,1.74638e-05,141795222,0.986566
D.melanogaster,143726002,NW_001845548.1,1,2508,1.74499e-05,141797730,0.986584
D.melanogaster,143726002,NW_001845549.1,1,2505,1.7429e-05,141800235,0.986601
D.melanogaster,143726002,NW_001845550.1,1,2500,1.73942e-05,141802735,0.986619
D.melanogaster,143726002,NW_001845551.1,1,2491,1.73316e-05,141805226,0.986636
D.melanogaster,143726002,NW_001845552.1,1,2487,1.73038e-05,141807713,0.986653
D.melanogaster,143726002,NW_001845553.1,1,2479,1.72481e-05,141810192,0.98667
D.melanogaster,143726002,NW_001845555.1,1,2477,1.72342e-05,141812669,0.986688
D.melanogaster,143726002,NW_001845556.1,1,2476,1.72272e-05,141815145,0.986705
D.melanogaster,143726002,NW_001845557.1,1,2475,1.72203e-05,141817620,0.986722
D.melanogaster,143726002,NW_001845559.1,1,2473,1.72064e-05,141820093,0.986739
D.melanogaster,143726002,NW_001845560.1,1,2470,1.71855e-05,141822563,0.986756
D.melanogaster,143726002,NW_001845561.1,1,2464,1.71437e-05,141825027,0.986774
D.melanogaster,143726002,NW_001845562.1,1,2463,1.71368e-05,141827490,0.986791
D.melanogaster,143726002,NW_001845563.1,1,2462,1.71298e-05,141829952,0.986808
D.melanogaster,143726002,NW_001845564.1,1,2451,1.70533e-05,141832403,0.986825
D.melanogaster,143726002,NW_001845565.1,1,2447,1.70255e-05,141834850,0.986842
D.melanogaster,143726002,NW_001845566.1,1,2442,1.69907e-05,141837292,0.986859
D.melanogaster,143726002,NW_001845567.1,1,2439,1.69698e-05,141839731,0.986876
D.melanogaster,143726002,NW_001845570.1,1,2438,1.69628e-05,141842169,0.986893
D.melanogaster,143726002,NW_001845569.1,1,2438,1.69628e-05,141844607,0.98691
D.melanogaster,143726002,NW_001845568.1,1,2438,1.69628e-05,141847045,0.986927
D.melanogaster,143726002,NW_001845571.1,1,2435,1.6942e-05,141849480,0.986944
D.melanogaster,143726002,NW_001845572.1,1,2434,1.6935e-05,141851914,0.986961
D.melanogaster,143726002,NW_001845573.1,1,2432,1.69211e-05,141854346,0.986978
D.melanogaster,143726002,NW_001845574.1,1,2431,1.69141e-05,141856777,0.986995
D.melanogaster,143726002,NW_001845575.1,1,2429,1.69002e-05,141859206,0.987011
D.melanogaster,143726002,NW_001845576.1,1,2428,1.68933e-05,141861634,0.987028
D.melanogaster,143726002,NW_001845578.1,1,2425,1.68724e-05,141864059,0.987045
D.melanogaster,143726002,NW_001845577.1,1,2425,1.68724e-05,141866484,0.987062
D.melanogaster,143726002,NW_001845581.1,1,2421,1.68446e-05,141868905,0.987079
D.melanogaster,143726002,NW_001845580.1,1,2421,1.68446e-05,141871326,0.987096
D.melanogaster,143726002,NW_001845582.1,1,2420,1.68376e-05,141873746,0.987113
D.melanogaster,143726002,NW_001845583.1,1,2419,1.68306e-05,141876165,0.987129
D.melanogaster,143726002,NW_001845585.1,1,2417,1.68167e-05,141878582,0.987146
D.melanogaster,143726002,NW_001845586.1,1,2413,1.67889e-05,141880995,0.987163
D.melanogaster,143726002,NW_001845587.1,1,2412,1.67819e-05,141883407,0.98718
D.melanogaster,143726002,NW_001845589.1,1,2400,1.66984e-05,141885807,0.987197
D.melanogaster,143726002,NW_001845590.1,1,2394,1.66567e-05,141888201,0.987213
D.melanogaster,143726002,NW_001845593.1,1,2390,1.66289e-05,141890591,0.98723
D.melanogaster,143726002,NW_001845592.1,1,2390,1.66289e-05,141892981,0.987246
D.melanogaster,143726002,NW_001845594.1,1,2389,1.66219e-05,141895370,0.987263
D.melanogaster,143726002,NW_001845597.1,1,2385,1.65941e-05,141897755,0.98728
D.melanogaster,143726002,NW_001845596.1,1,2385,1.65941e-05,141900140,0.987296
D.melanogaster,143726002,NW_001845595.1,1,2385,1.65941e-05,141902525,0.987313
D.melanogaster,143726002,NW_001845598.1,1,2384,1.65871e-05,141904909,0.987329
D.melanogaster,143726002,NW_001845600.1,1,2383,1.65802e-05,141907292,0.987346
D.melanogaster,143726002,NW_001845599.1,1,2383,1.65802e-05,141909675,0.987363
D.melanogaster,143726002,NW_001845601.1,1,2382,1.65732e-05,141912057,0.987379
D.melanogaster,143726002,NW_001845603.1,1,2381,1.65662e-05,141914438,0.987396
D.melanogaster,143726002,NW_001845602.1,1,2381,1.65662e-05,141916819,0.987412
D.melanogaster,143726002,NW_001845605.1,1,2379,1.65523e-05,141919198,0.987429
D.melanogaster,143726002,NW_001845604.1,1,2379,1.65523e-05,141921577,0.987445
D.melanogaster,143726002,NW_001845606.1,1,2378,1.65454e-05,141923955,0.987462
D.melanogaster,143726002,NW_001845607.1,1,2375,1.65245e-05,141926330,0.987478
D.melanogaster,143726002,NW_001845608.1,1,2372,1.65036e-05,141928702,0.987495
D.melanogaster,143726002,NW_001845609.1,1,2369,1.64828e-05,141931071,0.987511
D.melanogaster,143726002,NW_001845610.1,1,2368,1.64758e-05,141933439,0.987528
D.melanogaster,143726002,NW_001845611.1,1,2366,1.64619e-05,141935805,0.987544
D.melanogaster,143726002,NW_001845612.1,1,2363,1.6441e-05,141938168,0.987561
D.melanogaster,143726002,NW_001845615.1,1,2357,1.63993e-05,141940525,0.987577
D.melanogaster,143726002,NW_001845617.1,1,2355,1.63853e-05,141942880,0.987594
D.melanogaster,143726002,NW_001845618.1,1,2354,1.63784e-05,141945234,0.98761
D.melanogaster,143726002,NW_001845619.1,1,2353,1.63714e-05,141947587,0.987626
D.melanogaster,143726002,NW_001845620.1,1,2352,1.63645e-05,141949939,0.987643
D.melanogaster,143726002,NW_001845622.1,1,2344,1.63088e-05,141952283,0.987659
D.melanogaster,143726002,NW_001845625.1,1,2342,1.62949e-05,141954625,0.987675
D.melanogaster,143726002,NW_001845624.1,1,2342,1.62949e-05,141956967,0.987692
D.melanogaster,143726002,NW_001845626.1,1,2335,1.62462e-05,141959302,0.987708
D.melanogaster,143726002,NW_001845628.1,1,2330,1.62114e-05,141961632,0.987724
D.melanogaster,143726002,NW_001845630.1,1,2328,1.61975e-05,141963960,0.98774
D.melanogaster,143726002,NW_001845629.1,1,2328,1.61975e-05,141966288,0.987756
D.melanogaster,143726002,NW_001845631.1,1,2326,1.61836e-05,141968614,0.987773
D.melanogaster,143726002,NW_001845632.1,1,2325,1.61766e-05,141970939,0.987789
D.melanogaster,143726002,NW_001845633.1,1,2322,1.61557e-05,141973261,0.987805
D.melanogaster,143726002,NW_001845634.1,1,2318,1.61279e-05,141975579,0.987821
D.melanogaster,143726002,NW_001845635.1,1,2317,1.6121e-05,141977896,0.987837
D.melanogaster,143726002,NW_001845637.1,1,2308,1.60583e-05,141980204,0.987853
D.melanogaster,143726002,NW_001845638.1,1,2307,1.60514e-05,141982511,0.987869
D.melanogaster,143726002,NW_001845639.1,1,2304,1.60305e-05,141984815,0.987885
D.melanogaster,143726002,NW_001845640.1,1,2303,1.60235e-05,141987118,0.987901
D.melanogaster,143726002,NW_001845642.1,1,2295,1.59679e-05,141989413,0.987917
D.melanogaster,143726002,NW_001845643.1,1,2293,1.5954e-05,141991706,0.987933
D.melanogaster,143726002,NW_001845644.1,1,2291,1.59401e-05,141993997,0.987949
D.melanogaster,143726002,NW_001845645.1,1,2289,1.59261e-05,141996286,0.987965
D.melanogaster,143726002,NW_001845646.1,1,2287,1.59122e-05,141998573,0.987981
D.melanogaster,143726002,NW_001845647.1,1,2286,1.59053e-05,142000859,0.987997
D.melanogaster,143726002,NW_001845648.1,1,2284,1.58913e-05,142003143,0.988013
D.melanogaster,143726002,NW_001845649.1,1,2283,1.58844e-05,142005426,0.988029
D.melanogaster,143726002,NW_001845650.1,1,2282,1.58774e-05,142007708,0.988045
D.melanogaster,143726002,NW_001845651.1,1,2273,1.58148e-05,142009981,0.98806
D.melanogaster,143726002,NW_001845652.1,1,2270,1.57939e-05,142012251,0.988076
D.melanogaster,143726002,NW_001845653.1,1,2269,1.5787e-05,142014520,0.988092
D.melanogaster,143726002,NW_001845655.1,1,2266,1.57661e-05,142016786,0.988108
D.melanogaster,143726002,NW_001845657.1,1,2259,1.57174e-05,142019045,0.988124
D.melanogaster,143726002,NW_001845656.1,1,2259,1.57174e-05,142021304,0.988139
D.melanogaster,143726002,NW_001845658.1,1,2253,1.56757e-05,142023557,0.988155
D.melanogaster,143726002,NW_001845659.1,1,2248,1.56409e-05,142025805,0.988171
D.melanogaster,143726002,NW_001845660.1,1,2247,1.56339e-05,142028052,0.988186
D.melanogaster,143726002,NW_001845663.1,1,2237,1.55643e-05,142030289,0.988202
D.melanogaster,143726002,NW_001845664.1,1,2234,1.55435e-05,142032523,0.988217
D.melanogaster,143726002,NW_001845667.1,1,2232,1.55295e-05,142034755,0.988233
D.melanogaster,143726002,NW_001845666.1,1,2232,1.55295e-05,142036987,0.988248
D.melanogaster,143726002,NW_001845668.1,1,2228,1.55017e-05,142039215,0.988264
D.melanogaster,143726002,NW_001845669.1,1,2227,1.54948e-05,142041442,0.988279
D.melanogaster,143726002,NW_001845671.1,1,2223,1.54669e-05,142043665,0.988295
D.melanogaster,143726002,NW_001845672.1,1,2221,1.5453e-05,142045886,0.98831
D.melanogaster,143726002,NW_001845673.1,1,2220,1.54461e-05,142048106,0.988326
D.melanogaster,143726002,NW_001845674.1,1,2217,1.54252e-05,142050323,0.988341
D.melanogaster,143726002,NW_001845675.1,1,2216,1.54182e-05,142052539,0.988357
D.melanogaster,143726002,NW_001845676.1,1,2210,1.53765e-05,142054749,0.988372
D.melanogaster,143726002,NW_001845677.1,1,2209,1.53695e-05,142056958,0.988387
D.melanogaster,143726002,NW_001845678.1,1,2207,1.53556e-05,142059165,0.988403
D.melanogaster,143726002,NW_001845679.1,1,2206,1.53486e-05,142061371,0.988418
D.melanogaster,143726002,NW_001845680.1,1,2205,1.53417e-05,142063576,0.988433
D.melanogaster,143726002,NW_001845682.1,1,2201,1.53139e-05,142065777,0.988449
D.melanogaster,143726002,NW_001845683.1,1,2200,1.53069e-05,142067977,0.988464
D.melanogaster,143726002,NW_001845685.1,1,2198,1.5293e-05,142070175,0.988479
D.melanogaster,143726002,NW_001845684.1,1,2198,1.5293e-05,142072373,0.988495
D.melanogaster,143726002,NW_001845686.1,1,2196,1.52791e-05,142074569,0.98851
D.melanogaster,143726002,NW_001845688.1,1,2192,1.52512e-05,142076761,0.988525
D.melanogaster,143726002,NW_001845689.1,1,2190,1.52373e-05,142078951,0.98854
D.melanogaster,143726002,NW_001845691.1,1,2189,1.52304e-05,142081140,0.988556
D.melanogaster,143726002,NW_001845690.1,1,2189,1.52304e-05,142083329,0.988571
D.melanogaster,143726002,NW_001845692.1,1,2187,1.52165e-05,142085516,0.988586
D.melanogaster,143726002,NW_001845693.1,1,2185,1.52025e-05,142087701,0.988601
D.melanogaster,143726002,NW_001845695.1,1,2177,1.51469e-05,142089878,0.988616
D.melanogaster,143726002,NW_001845696.1,1,2176,1.51399e-05,142092054,0.988632
D.melanogaster,143726002,NW_001845697.1,1,2173,1.5119e-05,142094227,0.988647
D.melanogaster,143726002,NW_001845698.1,1,2166,1.50703e-05,142096393,0.988662
D.melanogaster,143726002,NW_001845701.1,1,2161,1.50356e-05,142098554,0.988677
D.melanogaster,143726002,NW_001845700.1,1,2161,1.50356e-05,142100715,0.988692
D.melanogaster,143726002,NW_001845703.1,1,2157,1.50077e-05,142102872,0.988707
D.melanogaster,143726002,NW_001845704.1,1,2147,1.49381e-05,142105019,0.988722
D.melanogaster,143726002,NW_001845706.1,1,2139,1.48825e-05,142107158,0.988737
D.melanogaster,143726002,NW_001845708.1,1,2132,1.48338e-05,142109290,0.988751
D.melanogaster,143726002,NW_001845710.1,1,2129,1.48129e-05,142111419,0.988766
D.melanogaster,143726002,NW_001845712.1,1,2126,1.4792e-05,142113545,0.988781
D.melanogaster,143726002,NW_001845714.1,1,2124,1.47781e-05,142115669,0.988796
D.melanogaster,143726002,NW_001845713.1,1,2124,1.47781e-05,142117793,0.988811
D.melanogaster,143726002,NW_001845715.1,1,2119,1.47433e-05,142119912,0.988825
D.melanogaster,143726002,NW_001845716.1,1,2117,1.47294e-05,142122029,0.98884
D.melanogaster,143726002,NW_001845717.1,1,2114,1.47085e-05,142124143,0.988855
D.melanogaster,143726002,NW_001845720.1,1,2113,1.47016e-05,142126256,0.988869
D.melanogaster,143726002,NW_001845719.1,1,2113,1.47016e-05,142128369,0.988884
D.melanogaster,143726002,NW_001845718.1,1,2113,1.47016e-05,142130482,0.988899
D.melanogaster,143726002,NW_001845721.1,1,2112,1.46946e-05,142132594,0.988914
D.melanogaster,143726002,NW_001845722.1,1,2109,1.46738e-05,142134703,0.988928
D.melanogaster,143726002,NW_001845723.1,1,2108,1.46668e-05,142136811,0.988943
D.melanogaster,143726002,NW_001845725.1,1,2105,1.46459e-05,142138916,0.988958
D.melanogaster,143726002,NW_001845724.1,1,2105,1.46459e-05,142141021,0.988972
D.melanogaster,143726002,NW_001845726.1,1,2103,1.4632e-05,142143124,0.988987
D.melanogaster,143726002,NW_001845727.1,1,2102,1.46251e-05,142145226,0.989001
D.melanogaster,143726002,NW_001845731.1,1,2096,1.45833e-05,142147322,0.989016
D.melanogaster,143726002,NW_001845730.1,1,2096,1.45833e-05,142149418,0.989031
D.melanogaster,143726002,NW_001845733.1,1,2094,1.45694e-05,142151512,0.989045
D.melanogaster,143726002,NW_001845732.1,1,2094,1.45694e-05,142153606,0.98906
D.melanogaster,143726002,NW_001845734.1,1,2092,1.45555e-05,142155698,0.989074
D.melanogaster,143726002,NW_001845735.1,1,2090,1.45416e-05,142157788,0.989089
D.melanogaster,143726002,NW_001845736.1,1,2089,1.45346e-05,142159877,0.989103
D.melanogaster,143726002,NW_001845737.1,1,2088,1.45276e-05,142161965,0.989118
D.melanogaster,143726002,NW_001845739.1,1,2087,1.45207e-05,142164052,0.989132
D.melanogaster,143726002,NW_001845738.1,1,2087,1.45207e-05,142166139,0.989147
D.melanogaster,143726002,NW_001845741.1,1,2086,1.45137e-05,142168225,0.989161
D.melanogaster,143726002,NW_001845743.1,1,2084,1.44998e-05,142170309,0.989176
D.melanogaster,143726002,NW_001845745.1,1,2081,1.44789e-05,142172390,0.98919
D.melanogaster,143726002,NW_001845747.1,1,2079,1.4465e-05,142174469,0.989205
D.melanogaster,143726002,NW_001845746.1,1,2079,1.4465e-05,142176548,0.989219
D.melanogaster,143726002,NW_001845748.1,1,2078,1.44581e-05,142178626,0.989234
D.melanogaster,143726002,NW_001845749.1,1,2076,1.44442e-05,142180702,0.989248
D.melanogaster,143726002,NW_001845751.1,1,2068,1.43885e-05,142182770,0.989263
D.melanogaster,143726002,NW_001845752.1,1,2064,1.43607e-05,142184834,0.989277
D.melanogaster,143726002,NW_001845754.1,1,2063,1.43537e-05,142186897,0.989291
D.melanogaster,143726002,NW_001845753.1,1,2063,1.43537e-05,142188960,0.989306
D.melanogaster,143726002,NW_001845755.1,1,2062,1.43467e-05,142191022,0.98932
D.melanogaster,143726002,NW_001845758.1,1,2060,1.43328e-05,142193082,0.989334
D.melanogaster,143726002,NW_001845757.1,1,2060,1.43328e-05,142195142,0.989349
D.melanogaster,143726002,NW_001845756.1,1,2060,1.43328e-05,142197202,0.989363
D.melanogaster,143726002,NW_001845759.1,1,2059,1.43259e-05,142199261,0.989377
D.melanogaster,143726002,NW_001845760.1,1,2050,1.42633e-05,142201311,0.989392
D.melanogaster,143726002,NW_001845761.1,1,2046,1.42354e-05,142203357,0.989406
D.melanogaster,143726002,NW_001845763.1,1,2044,1.42215e-05,142205401,0.98942
D.melanogaster,143726002,NW_001845764.1,1,2043,1.42145e-05,142207444,0.989434
D.melanogaster,143726002,NW_001845766.1,1,2035,1.41589e-05,142209479,0.989449
D.melanogaster,143726002,NW_001845768.1,1,2033,1.4145e-05,142211512,0.989463
D.melanogaster,143726002,NW_001845767.1,1,2033,1.4145e-05,142213545,0.989477
D.melanogaster,143726002,NW_001845769.1,1,2030,1.41241e-05,142215575,0.989491
D.melanogaster,143726002,NW_001845770.1,1,2027,1.41032e-05,142217602,0.989505
D.melanogaster,143726002,NW_001845772.1,1,2021,1.40615e-05,142219623,0.989519
D.melanogaster,143726002,NW_001845773.1,1,2020,1.40545e-05,142221643,0.989533
D.melanogaster,143726002,NW_001845774.1,1,2017,1.40336e-05,142223660,0.989547
D.melanogaster,143726002,NW_001845775.1,1,2014,1.40128e-05,142225674,0.989561
D.melanogaster,143726002,NW_001845776.1,1,2010,1.39849e-05,142227684,0.989575
D.melanogaster,143726002,NW_001845777.1,1,2009,1.3978e-05,142229693,0.989589
D.melanogaster,143726002,NW_001845778.1,1,2008,1.3971e-05,142231701,0.989603
D.melanogaster,143726002,NW_001845780.1,1,2006,1.39571e-05,142233707,0.989617
D.melanogaster,143726002,NW_001845779.1,1,2006,1.39571e-05,142235713,0.989631
D.melanogaster,143726002,NW_001845782.1,1,2005,1.39502e-05,142237718,0.989645
D.melanogaster,143726002,NW_001845781.1,1,2005,1.39502e-05,142239723,0.989659
D.melanogaster,143726002,NW_001845787.1,1,1998,1.39015e-05,142241721,0.989673
D.melanogaster,143726002,NW_001845786.1,1,1998,1.39015e-05,142243719,0.989687
D.melanogaster,143726002,NW_001845785.1,1,1998,1.39015e-05,142245717,0.989701
D.melanogaster,143726002,NW_001845788.1,1,1995,1.38806e-05,142247712,0.989715
D.melanogaster,143726002,NW_001845789.1,1,1993,1.38667e-05,142249705,0.989728
D.melanogaster,143726002,NW_001845791.1,1,1990,1.38458e-05,142251695,0.989742
D.melanogaster,143726002,NW_001845790.1,1,1990,1.38458e-05,142253685,0.989756
D.melanogaster,143726002,NW_001845792.1,1,1988,1.38319e-05,142255673,0.98977
D.melanogaster,143726002,NW_001845794.1,1,1986,1.3818e-05,142257659,0.989784
D.melanogaster,143726002,NW_001845793.1,1,1986,1.3818e-05,142259645,0.989798
D.melanogaster,143726002,NW_001845795.1,1,1980,1.37762e-05,142261625,0.989811
D.melanogaster,143726002,NW_001845796.1,1,1978,1.37623e-05,142263603,0.989825
D.melanogaster,143726002,NW_001845798.1,1,1976,1.37484e-05,142265579,0.989839
D.melanogaster,143726002,NW_001845797.1,1,1976,1.37484e-05,142267555,0.989853
D.melanogaster,143726002,NW_001845799.1,1,1975,1.37414e-05,142269530,0.989866
D.melanogaster,143726002,NW_001845800.1,1,1974,1.37345e-05,142271504,0.98988
D.melanogaster,143726002,NW_001845801.1,1,1970,1.37066e-05,142273474,0.989894
D.melanogaster,143726002,NW_001845804.1,1,1966,1.36788e-05,142275440,0.989907
D.melanogaster,143726002,NW_001845803.1,1,1966,1.36788e-05,142277406,0.989921
D.melanogaster,143726002,NW_001845802.1,1,1966,1.36788e-05,142279372,0.989935
D.melanogaster,143726002,NW_001845807.1,1,1964,1.36649e-05,142281336,0.989948
D.melanogaster,143726002,NW_001845808.1,1,1963,1.36579e-05,142283299,0.989962
D.melanogaster,143726002,NW_001845811.1,1,1962,1.3651e-05,142285261,0.989976
D.melanogaster,143726002,NW_001845810.1,1,1962,1.3651e-05,142287223,0.989989
D.melanogaster,143726002,NW_001845809.1,1,1962,1.3651e-05,142289185,0.990003
D.melanogaster,143726002,NW_001845814.1,1,1961,1.3644e-05,142291146,0.990017
D.melanogaster,143726002,NW_001845813.1,1,1961,1.3644e-05,142293107,0.99003
D.melanogaster,143726002,NW_001845812.1,1,1961,1.3644e-05,142295068,0.990044
D.melanogaster,143726002,NW_001845816.1,1,1956,1.36092e-05,142297024,0.990058
D.melanogaster,143726002,NW_001845815.1,1,1956,1.36092e-05,142298980,0.990071
D.melanogaster,143726002,NW_001845819.1,1,1947,1.35466e-05,142300927,0.990085
D.melanogaster,143726002,NW_001845818.1,1,1947,1.35466e-05,142302874,0.990098
D.melanogaster,143726002,NW_001845817.1,1,1947,1.35466e-05,142304821,0.990112
D.melanogaster,143726002,NW_001845820.1,1,1946,1.35397e-05,142306767,0.990125
D.melanogaster,143726002,NW_001845821.1,1,1945,1.35327e-05,142308712,0.990139
D.melanogaster,143726002,NW_001845822.1,1,1944,1.35257e-05,142310656,0.990152
D.melanogaster,143726002,NW_001845823.1,1,1943,1.35188e-05,142312599,0.990166
D.melanogaster,143726002,NW_001845824.1,1,1939,1.34909e-05,142314538,0.990179
D.melanogaster,143726002,NW_001845828.1,1,1936,1.34701e-05,142316474,0.990193
D.melanogaster,143726002,NW_001845827.1,1,1936,1.34701e-05,142318410,0.990206
D.melanogaster,143726002,NW_001845829.1,1,1935,1.34631e-05,142320345,0.99022
D.melanogaster,143726002,NW_001845831.1,1,1933,1.34492e-05,142322278,0.990233
D.melanogaster,143726002,NW_001845830.1,1,1933,1.34492e-05,142324211,0.990247
D.melanogaster,143726002,NW_001845832.1,1,1931,1.34353e-05,142326142,0.99026
D.melanogaster,143726002,NW_001845833.1,1,1929,1.34214e-05,142328071,0.990274
D.melanogaster,143726002,NW_001845835.1,1,1928,1.34144e-05,142329999,0.990287
D.melanogaster,143726002,NW_001845834.1,1,1928,1.34144e-05,142331927,0.9903
D.melanogaster,143726002,NW_001845836.1,1,1927,1.34075e-05,142333854,0.990314
D.melanogaster,143726002,NW_001845838.1,1,1926,1.34005e-05,142335780,0.990327
D.melanogaster,143726002,NW_001845837.1,1,1926,1.34005e-05,142337706,0.990341
D.melanogaster,143726002,NW_001845839.1,1,1924,1.33866e-05,142339630,0.990354
D.melanogaster,143726002,NW_001845841.1,1,1920,1.33588e-05,142341550,0.990367
D.melanogaster,143726002,NW_001845842.1,1,1917,1.33379e-05,142343467,0.990381
D.melanogaster,143726002,NW_001845845.1,1,1916,1.33309e-05,142345383,0.990394
D.melanogaster,143726002,NW_001845844.1,1,1916,1.33309e-05,142347299,0.990407
D.melanogaster,143726002,NW_001845846.1,1,1907,1.32683e-05,142349206,0.990421
D.melanogaster,143726002,NW_001845847.1,1,1906,1.32613e-05,142351112,0.990434
D.melanogaster,143726002,NW_001845848.1,1,1905,1.32544e-05,142353017,0.990447
D.melanogaster,143726002,NW_001845849.1,1,1904,1.32474e-05,142354921,0.99046
D.melanogaster,143726002,NW_001845852.1,1,1903,1.32405e-05,142356824,0.990474
D.melanogaster,143726002,NW_001845851.1,1,1903,1.32405e-05,142358727,0.990487
D.melanogaster,143726002,NW_001845850.1,1,1903,1.32405e-05,142360630,0.9905
D.melanogaster,143726002,NW_001845853.1,1,1902,1.32335e-05,142362532,0.990513
D.melanogaster,143726002,NW_001845854.1,1,1901,1.32266e-05,142364433,0.990527
D.melanogaster,143726002,NW_001845856.1,1,1900,1.32196e-05,142366333,0.99054
D.melanogaster,143726002,NW_001845855.1,1,1900,1.32196e-05,142368233,0.990553
D.melanogaster,143726002,NW_001845857.1,1,1899,1.32126e-05,142370132,0.990566
D.melanogaster,143726002,NW_001845859.1,1,1895,1.31848e-05,142372027,0.990579
D.melanogaster,143726002,NW_001845858.1,1,1895,1.31848e-05,142373922,0.990593
D.melanogaster,143726002,NW_001845860.1,1,1893,1.31709e-05,142375815,0.990606
D.melanogaster,143726002,NW_001845861.1,1,1891,1.3157e-05,142377706,0.990619
D.melanogaster,143726002,NW_001845863.1,1,1890,1.315e-05,142379596,0.990632
D.melanogaster,143726002,NW_001845862.1,1,1890,1.315e-05,142381486,0.990645
D.melanogaster,143726002,NW_001845865.1,1,1888,1.31361e-05,142383374,0.990658
D.melanogaster,143726002,NW_001845866.1,1,1882,1.30944e-05,142385256,0.990672
D.melanogaster,143726002,NW_001845868.1,1,1872,1.30248e-05,142387128,0.990685
D.melanogaster,143726002,NW_001845867.1,1,1872,1.30248e-05,142389000,0.990698
D.melanogaster,143726002,NW_001845869.1,1,1871,1.30178e-05,142390871,0.990711
D.melanogaster,143726002,NW_001845871.1,1,1870,1.30109e-05,142392741,0.990724
D.melanogaster,143726002,NW_001845870.1,1,1870,1.30109e-05,142394611,0.990737
D.melanogaster,143726002,NW_001845874.1,1,1869,1.30039e-05,142396480,0.99075
D.melanogaster,143726002,NW_001845873.1,1,1869,1.30039e-05,142398349,0.990763
D.melanogaster,143726002,NW_001845872.1,1,1869,1.30039e-05,142400218,0.990776
D.melanogaster,143726002,NW_001845875.1,1,1868,1.2997e-05,142402086,0.990789
D.melanogaster,143726002,NW_001845876.1,1,1865,1.29761e-05,142403951,0.990802
D.melanogaster,143726002,NW_001845878.1,1,1863,1.29622e-05,142405814,0.990815
D.melanogaster,143726002,NW_001845877.1,1,1863,1.29622e-05,142407677,0.990828
D.melanogaster,143726002,NW_001845879.1,1,1856,1.29135e-05,142409533,0.99084
D.melanogaster,143726002,NW_001845880.1,1,1854,1.28995e-05,142411387,0.990853
D.melanogaster,143726002,NW_001845881.1,1,1851,1.28787e-05,142413238,0.990866
D.melanogaster,143726002,NW_001845882.1,1,1849,1.28648e-05,142415087,0.990879
D.melanogaster,143726002,NW_001845886.1,1,1843,1.2823e-05,142416930,0.990892
D.melanogaster,143726002,NW_001845885.1,1,1843,1.2823e-05,142418773,0.990905
D.melanogaster,143726002,NW_001845884.1,1,1843,1.2823e-05,142420616,0.990918
D.melanogaster,143726002,NW_001845883.1,1,1843,1.2823e-05,142422459,0.99093
D.melanogaster,143726002,NW_001845887.1,1,1842,1.28161e-05,142424301,0.990943
D.melanogaster,143726002,NW_001845889.1,1,1841,1.28091e-05,142426142,0.990956
D.melanogaster,143726002,NW_001845888.1,1,1841,1.28091e-05,142427983,0.990969
D.melanogaster,143726002,NW_001845891.1,1,1832,1.27465e-05,142429815,0.990982
D.melanogaster,143726002,NW_001845890.1,1,1832,1.27465e-05,142431647,0.990994
D.melanogaster,143726002,NW_001845892.1,1,1830,1.27326e-05,142433477,0.991007
D.melanogaster,143726002,NW_001845894.1,1,1829,1.27256e-05,142435306,0.99102
D.melanogaster,143726002,NW_001845893.1,1,1829,1.27256e-05,142437135,0.991032
D.melanogaster,143726002,NW_001845895.1,1,1826,1.27047e-05,142438961,0.991045
D.melanogaster,143726002,NW_001845896.1,1,1819,1.2656e-05,142440780,0.991058
D.melanogaster,143726002,NW_001845898.1,1,1818,1.26491e-05,142442598,0.99107
D.melanogaster,143726002,NW_001845897.1,1,1818,1.26491e-05,142444416,0.991083
D.melanogaster,143726002,NW_001845900.1,1,1813,1.26143e-05,142446229,0.991096
D.melanogaster,143726002,NW_001845899.1,1,1813,1.26143e-05,142448042,0.991108
D.melanogaster,143726002,NW_001845903.1,1,1806,1.25656e-05,142449848,0.991121
D.melanogaster,143726002,NW_001845904.1,1,1803,1.25447e-05,142451651,0.991133
D.melanogaster,143726002,NW_001845905.1,1,1802,1.25377e-05,142453453,0.991146
D.melanogaster,143726002,NW_001845906.1,1,1801,1.25308e-05,142455254,0.991159
D.melanogaster,143726002,NW_001845908.1,1,1800,1.25238e-05,142457054,0.991171
D.melanogaster,143726002,NW_001845907.1,1,1800,1.25238e-05,142458854,0.991184
D.melanogaster,143726002,NW_001845909.1,1,1798,1.25099e-05,142460652,0.991196
D.melanogaster,143726002,NW_001845910.1,1,1797,1.2503e-05,142462449,0.991209
D.melanogaster,143726002,NW_001845911.1,1,1793,1.24751e-05,142464242,0.991221
D.melanogaster,143726002,NW_001845912.1,1,1792,1.24682e-05,142466034,0.991234
D.melanogaster,143726002,NW_001845914.1,1,1787,1.24334e-05,142467821,0.991246
D.melanogaster,143726002,NW_001845915.1,1,1786,1.24264e-05,142469607,0.991258
D.melanogaster,143726002,NW_001845918.1,1,1785,1.24195e-05,142471392,0.991271
D.melanogaster,143726002,NW_001845917.1,1,1785,1.24195e-05,142473177,0.991283
D.melanogaster,143726002,NW_001845919.1,1,1776,1.23568e-05,142474953,0.991296
D.melanogaster,143726002,NW_001845922.1,1,1775,1.23499e-05,142476728,0.991308
D.melanogaster,143726002,NW_001845921.1,1,1775,1.23499e-05,142478503,0.99132
D.melanogaster,143726002,NW_001845920.1,1,1775,1.23499e-05,142480278,0.991333
D.melanogaster,143726002,NW_001845924.1,1,1770,1.23151e-05,142482048,0.991345
D.melanogaster,143726002,NW_001845925.1,1,1769,1.23081e-05,142483817,0.991357
D.melanogaster,143726002,NW_001845926.1,1,1766,1.22873e-05,142485583,0.99137
D.melanogaster,143726002,NW_001845928.1,1,1761,1.22525e-05,142487344,0.991382
D.melanogaster,143726002,NW_001845930.1,1,1756,1.22177e-05,142489100,0.991394
D.melanogaster,143726002,NW_001845931.1,1,1754,1.22038e-05,142490854,0.991406
D.melanogaster,143726002,NW_001845932.1,1,1751,1.21829e-05,142492605,0.991418
D.melanogaster,143726002,NW_001845935.1,1,1747,1.21551e-05,142494352,0.991431
D.melanogaster,143726002,NW_001845934.1,1,1747,1.21551e-05,142496099,0.991443
D.melanogaster,143726002,NW_001845933.1,1,1747,1.21551e-05,142497846,0.991455
D.melanogaster,143726002,NW_001845936.1,1,1743,1.21272e-05,142499589,0.991467
D.melanogaster,143726002,NW_001845937.1,1,1741,1.21133e-05,142501330,0.991479
D.melanogaster,143726002,NW_001845938.1,1,1738,1.20925e-05,142503068,0.991491
D.melanogaster,143726002,NW_001845939.1,1,1737,1.20855e-05,142504805,0.991503
D.melanogaster,143726002,NW_001845940.1,1,1734,1.20646e-05,142506539,0.991515
D.melanogaster,143726002,NW_001845941.1,1,1733,1.20577e-05,142508272,0.991527
D.melanogaster,143726002,NW_001845942.1,1,1732,1.20507e-05,142510004,0.991539
D.melanogaster,143726002,NW_001845943.1,1,1728,1.20229e-05,142511732,0.991551
D.melanogaster,143726002,NW_001845946.1,1,1724,1.1995e-05,142513456,0.991563
D.melanogaster,143726002,NW_001845945.1,1,1724,1.1995e-05,142515180,0.991575
D.melanogaster,143726002,NW_001845948.1,1,1719,1.19603e-05,142516899,0.991587
D.melanogaster,143726002,NW_001845947.1,1,1719,1.19603e-05,142518618,0.991599
D.melanogaster,143726002,NW_001845950.1,1,1716,1.19394e-05,142520334,0.991611
D.melanogaster,143726002,NW_001845949.1,1,1716,1.19394e-05,142522050,0.991623
D.melanogaster,143726002,NW_001845951.1,1,1715,1.19324e-05,142523765,0.991635
D.melanogaster,143726002,NW_001845952.1,1,1714,1.19255e-05,142525479,0.991647
D.melanogaster,143726002,NW_001845953.1,1,1713,1.19185e-05,142527192,0.991659
D.melanogaster,143726002,NW_001845954.1,1,1712,1.19116e-05,142528904,0.991671
D.melanogaster,143726002,NW_001845956.1,1,1710,1.18976e-05,142530614,0.991683
D.melanogaster,143726002,NW_001845955.1,1,1710,1.18976e-05,142532324,0.991695
D.melanogaster,143726002,NW_001845957.1,1,1709,1.18907e-05,142534033,0.991707
D.melanogaster,143726002,NW_001845958.1,1,1708,1.18837e-05,142535741,0.991719
D.melanogaster,143726002,NW_001845959.1,1,1704,1.18559e-05,142537445,0.99173
D.melanogaster,143726002,NW_001845961.1,1,1703,1.18489e-05,142539148,0.991742
D.melanogaster,143726002,NW_001845960.1,1,1703,1.18489e-05,142540851,0.991754
D.melanogaster,143726002,NW_001845962.1,1,1696,1.18002e-05,142542547,0.991766
D.melanogaster,143726002,NW_001845964.1,1,1690,1.17585e-05,142544237,0.991778
D.melanogaster,143726002,NW_001845963.1,1,1690,1.17585e-05,142545927,0.991789
D.melanogaster,143726002,NW_001845966.1,1,1687,1.17376e-05,142547614,0.991801
D.melanogaster,143726002,NW_001845967.1,1,1685,1.17237e-05,142549299,0.991813
D.melanogaster,143726002,NW_001845970.1,1,1683,1.17098e-05,142550982,0.991825
D.melanogaster,143726002,NW_001845969.1,1,1683,1.17098e-05,142552665,0.991836
D.melanogaster,143726002,NW_001845968.1,1,1683,1.17098e-05,142554348,0.991848
D.melanogaster,143726002,NW_001845971.1,1,1680,1.16889e-05,142556028,0.99186
D.melanogaster,143726002,NW_001845972.1,1,1679,1.1682e-05,142557707,0.991871
D.melanogaster,143726002,NW_001845973.1,1,1678,1.1675e-05,142559385,0.991883
D.melanogaster,143726002,NW_001845974.1,1,1675,1.16541e-05,142561060,0.991895
D.melanogaster,143726002,NW_001845975.1,1,1667,1.15985e-05,142562727,0.991906
D.melanogaster,143726002,NW_001845977.1,1,1657,1.15289e-05,142564384,0.991918
D.melanogaster,143726002,NW_001845978.1,1,1650,1.14802e-05,142566034,0.991929
D.melanogaster,143726002,NW_001845979.1,1,1645,1.14454e-05,142567679,0.991941
D.melanogaster,143726002,NW_001845981.1,1,1643,1.14315e-05,142569322,0.991952
D.melanogaster,143726002,NW_001845980.1,1,1643,1.14315e-05,142570965,0.991964
D.melanogaster,143726002,NW_001845982.1,1,1641,1.14176e-05,142572606,0.991975
D.melanogaster,143726002,NW_001845985.1,1,1637,1.13897e-05,142574243,0.991986
D.melanogaster,143726002,NW_001845984.1,1,1637,1.13897e-05,142575880,0.991998
D.melanogaster,143726002,NW_001845983.1,1,1637,1.13897e-05,142577517,0.992009
D.melanogaster,143726002,NW_001845986.1,1,1636,1.13828e-05,142579153,0.992021
D.melanogaster,143726002,NW_001845987.1,1,1630,1.1341e-05,142580783,0.992032
D.melanogaster,143726002,NW_001845988.1,1,1629,1.13341e-05,142582412,0.992043
D.melanogaster,143726002,NW_001845990.1,1,1625,1.13062e-05,142584037,0.992055
D.melanogaster,143726002,NW_001845989.1,1,1625,1.13062e-05,142585662,0.992066
D.melanogaster,143726002,NW_001845991.1,1,1623,1.12923e-05,142587285,0.992077
D.melanogaster,143726002,NW_001845992.1,1,1622,1.12854e-05,142588907,0.992088
D.melanogaster,143726002,NW_001845995.1,1,1619,1.12645e-05,142590526,0.9921
D.melanogaster,143726002,NW_001845996.1,1,1614,1.12297e-05,142592140,0.992111
D.melanogaster,143726002,NW_001845998.1,1,1611,1.12088e-05,142593751,0.992122
D.melanogaster,143726002,NW_001846001.1,1,1610,1.12019e-05,142595361,0.992133
D.melanogaster,143726002,NW_001845999.1,1,1610,1.12019e-05,142596971,0.992145
D.melanogaster,143726002,NW_001846002.1,1,1608,1.1188e-05,142598579,0.992156
D.melanogaster,143726002,NW_001846003.1,1,1597,1.11114e-05,142600176,0.992167
D.melanogaster,143726002,NW_001846004.1,1,1595,1.10975e-05,142601771,0.992178
D.melanogaster,143726002,NW_001846005.1,1,1594,1.10905e-05,142603365,0.992189
D.melanogaster,143726002,NW_001846009.1,1,1586,1.10349e-05,142604951,0.9922
D.melanogaster,143726002,NW_001846008.1,1,1586,1.10349e-05,142606537,0.992211
D.melanogaster,143726002,NW_001846007.1,1,1586,1.10349e-05,142608123,0.992222
D.melanogaster,143726002,NW_001846010.1,1,1581,1.10001e-05,142609704,0.992233
D.melanogaster,143726002,NW_001846012.1,1,1577,1.09723e-05,142611281,0.992244
D.melanogaster,143726002,NW_001846011.1,1,1577,1.09723e-05,142612858,0.992255
D.melanogaster,143726002,NW_001846013.1,1,1575,1.09584e-05,142614433,0.992266
D.melanogaster,143726002,NW_001846014.1,1,1573,1.09444e-05,142616006,0.992277
D.melanogaster,143726002,NW_001846015.1,1,1571,1.09305e-05,142617577,0.992288
D.melanogaster,143726002,NW_001846016.1,1,1567,1.09027e-05,142619144,0.992299
D.melanogaster,143726002,NW_001846017.1,1,1566,1.08957e-05,142620710,0.99231
D.melanogaster,143726002,NW_001846019.1,1,1560,1.0854e-05,142622270,0.992321
D.melanogaster,143726002,NW_001846018.1,1,1560,1.0854e-05,142623830,0.992331
D.melanogaster,143726002,NW_001846020.1,1,1558,1.08401e-05,142625388,0.992342
D.melanogaster,143726002,NW_001846022.1,1,1556,1.08262e-05,142626944,0.992353
D.melanogaster,143726002,NW_001846021.1,1,1556,1.08262e-05,142628500,0.992364
D.melanogaster,143726002,NW_001846023.1,1,1555,1.08192e-05,142630055,0.992375
D.melanogaster,143726002,NW_001846024.1,1,1553,1.08053e-05,142631608,0.992386
D.melanogaster,143726002,NW_001846025.1,1,1552,1.07983e-05,142633160,0.992396
D.melanogaster,143726002,NW_001846027.1,1,1550,1.07844e-05,142634710,0.992407
D.melanogaster,143726002,NW_001846026.1,1,1550,1.07844e-05,142636260,0.992418
D.melanogaster,143726002,NW_001846028.1,1,1549,1.07775e-05,142637809,0.992429
D.melanogaster,143726002,NW_001846029.1,1,1546,1.07566e-05,142639355,0.992439
D.melanogaster,143726002,NW_001846030.1,1,1544,1.07427e-05,142640899,0.99245
D.melanogaster,143726002,NW_001846031.1,1,1543,1.07357e-05,142642442,0.992461
D.melanogaster,143726002,NW_001846034.1,1,1541,1.07218e-05,142643983,0.992472
D.melanogaster,143726002,NW_001846035.1,1,1540,1.07148e-05,142645523,0.992482
D.melanogaster,143726002,NW_001846037.1,1,1538,1.07009e-05,142647061,0.992493
D.melanogaster,143726002,NW_001846038.1,1,1534,1.06731e-05,142648595,0.992504
D.melanogaster,143726002,NW_001846040.1,1,1533,1.06661e-05,142650128,0.992514
D.melanogaster,143726002,NW_001846039.1,1,1533,1.06661e-05,142651661,0.992525
D.melanogaster,143726002,NW_001846041.1,1,1532,1.06592e-05,142653193,0.992536
D.melanogaster,143726002,NW_001846042.1,1,1529,1.06383e-05,142654722,0.992546
D.melanogaster,143726002,NW_001846043.1,1,1527,1.06244e-05,142656249,0.992557
D.melanogaster,143726002,NW_001846047.1,1,1525,1.06105e-05,142657774,0.992568
D.melanogaster,143726002,NW_001846046.1,1,1525,1.06105e-05,142659299,0.992578
D.melanogaster,143726002,NW_001846045.1,1,1525,1.06105e-05,142660824,0.992589
D.melanogaster,143726002,NW_001846049.1,1,1521,1.05826e-05,142662345,0.992599
D.melanogaster,143726002,NW_001846051.1,1,1520,1.05757e-05,142663865,0.99261
D.melanogaster,143726002,NW_001846052.1,1,1519,1.05687e-05,142665384,0.992621
D.melanogaster,143726002,NW_001846053.1,1,1518,1.05618e-05,142666902,0.992631
D.melanogaster,143726002,NW_001846054.1,1,1516,1.05478e-05,142668418,0.992642
D.melanogaster,143726002,NW_001846056.1,1,1510,1.05061e-05,142669928,0.992652
D.melanogaster,143726002,NW_001846057.1,1,1509,1.04991e-05,142671437,0.992663
D.melanogaster,143726002,NW_001846058.1,1,1508,1.04922e-05,142672945,0.992673
D.melanogaster,143726002,NW_001846060.1,1,1504,1.04644e-05,142674449,0.992684
D.melanogaster,143726002,NW_001846059.1,1,1504,1.04644e-05,142675953,0.992694
D.melanogaster,143726002,NW_001846061.1,1,1502,1.04504e-05,142677455,0.992705
D.melanogaster,143726002,NW_001846062.1,1,1494,1.03948e-05,142678949,0.992715
D.melanogaster,143726002,NW_001846064.1,1,1492,1.03809e-05,142680441,0.992725
D.melanogaster,143726002,NW_001846063.1,1,1492,1.03809e-05,142681933,0.992736
D.melanogaster,143726002,NW_001846065.1,1,1490,1.03669e-05,142683423,0.992746
D.melanogaster,143726002,NW_001846066.1,1,1489,1.036e-05,142684912,0.992756
D.melanogaster,143726002,NW_001846067.1,1,1488,1.0353e-05,142686400,0.992767
D.melanogaster,143726002,NW_001846069.1,1,1487,1.03461e-05,142687887,0.992777
D.melanogaster,143726002,NW_001846068.1,1,1487,1.03461e-05,142689374,0.992787
D.melanogaster,143726002,NW_001846070.1,1,1485,1.03322e-05,142690859,0.992798
D.melanogaster,143726002,NW_001846071.1,1,1484,1.03252e-05,142692343,0.992808
D.melanogaster,143726002,NW_001846072.1,1,1482,1.03113e-05,142693825,0.992818
D.melanogaster,143726002,NW_001846074.1,1,1478,1.02835e-05,142695303,0.992829
D.melanogaster,143726002,NW_001846075.1,1,1476,1.02695e-05,142696779,0.992839
D.melanogaster,143726002,NW_001846076.1,1,1475,1.02626e-05,142698254,0.992849
D.melanogaster,143726002,NW_001846078.1,1,1473,1.02487e-05,142699727,0.99286
D.melanogaster,143726002,NW_001846081.1,1,1471,1.02348e-05,142701198,0.99287
D.melanogaster,143726002,NW_001846085.1,1,1468,1.02139e-05,142702666,0.99288
D.melanogaster,143726002,NW_001846086.1,1,1467,1.02069e-05,142704133,0.99289
D.melanogaster,143726002,NW_001846087.1,1,1466,1.02e-05,142705599,0.9929
D.melanogaster,143726002,NW_001846088.1,1,1464,1.0186e-05,142707063,0.992911
D.melanogaster,143726002,NW_001846091.1,1,1462,1.01721e-05,142708525,0.992921
D.melanogaster,143726002,NW_001846093.1,1,1461,1.01652e-05,142709986,0.992931
D.melanogaster,143726002,NW_001846092.1,1,1461,1.01652e-05,142711447,0.992941
D.melanogaster,143726002,NW_001846094.1,1,1459,1.01513e-05,142712906,0.992951
D.melanogaster,143726002,NW_001846095.1,1,1458,1.01443e-05,142714364,0.992961
D.melanogaster,143726002,NW_001846096.1,1,1456,1.01304e-05,142715820,0.992971
D.melanogaster,143726002,NW_001846098.1,1,1453,1.01095e-05,142717273,0.992982
D.melanogaster,143726002,NW_001846100.1,1,1452,1.01026e-05,142718725,0.992992
D.melanogaster,143726002,NW_001846099.1,1,1452,1.01026e-05,142720177,0.993002
D.melanogaster,143726002,NW_001846101.1,1,1451,1.00956e-05,142721628,0.993012
D.melanogaster,143726002,NW_001846105.1,1,1446,1.00608e-05,142723074,0.993022
D.melanogaster,143726002,NW_001846104.1,1,1446,1.00608e-05,142724520,0.993032
D.melanogaster,143726002,NW_001846106.1,1,1445,1.00539e-05,142725965,0.993042
D.melanogaster,143726002,NW_001846107.1,1,1443,1.00399e-05,142727408,0.993052
D.melanogaster,143726002,NW_001846108.1,1,1441,1.0026e-05,142728849,0.993062
D.melanogaster,143726002,NW_001846109.1,1,1440,1.00191e-05,142730289,0.993072
D.melanogaster,143726002,NW_001846111.1,1,1436,9.99123e-06,142731725,0.993082
D.melanogaster,143726002,NW_001846116.1,1,1432,9.9634e-06,142733157,0.993092
D.melanogaster,143726002,NW_001846115.1,1,1432,9.9634e-06,142734589,0.993102
D.melanogaster,143726002,NW_001846114.1,1,1432,9.9634e-06,142736021,0.993112
D.melanogaster,143726002,NW_001846117.1,1,1430,9.94949e-06,142737451,0.993122
D.melanogaster,143726002,NW_001846120.1,1,1429,9.94253e-06,142738880,0.993132
D.melanogaster,143726002,NW_001846119.1,1,1429,9.94253e-06,142740309,0.993142
D.melanogaster,143726002,NW_001846121.1,1,1425,9.9147e-06,142741734,0.993152
D.melanogaster,143726002,NW_001846125.1,1,1424,9.90774e-06,142743158,0.993162
D.melanogaster,143726002,NW_001846123.1,1,1424,9.90774e-06,142744582,0.993172
D.melanogaster,143726002,NW_001846122.1,1,1424,9.90774e-06,142746006,0.993181
D.melanogaster,143726002,NW_001846126.1,1,1423,9.90078e-06,142747429,0.993191
D.melanogaster,143726002,NW_001846127.1,1,1422,9.89383e-06,142748851,0.993201
D.melanogaster,143726002,NW_001846128.1,1,1421,9.88687e-06,142750272,0.993211
D.melanogaster,143726002,NW_001846129.1,1,1419,9.87295e-06,142751691,0.993221
D.melanogaster,143726002,NW_001846132.1,1,1416,9.85208e-06,142753107,0.993231
D.melanogaster,143726002,NW_001846131.1,1,1416,9.85208e-06,142754523,0.993241
D.melanogaster,143726002,NW_001846130.1,1,1416,9.85208e-06,142755939,0.993251
D.melanogaster,143726002,NW_001846133.1,1,1415,9.84512e-06,142757354,0.99326
D.melanogaster,143726002,NW_001846135.1,1,1412,9.82425e-06,142758766,0.99327
D.melanogaster,143726002,NW_001846134.1,1,1412,9.82425e-06,142760178,0.99328
D.melanogaster,143726002,NW_001846136.1,1,1411,9.81729e-06,142761589,0.99329
D.melanogaster,143726002,NW_001846137.1,1,1410,9.81033e-06,142762999,0.9933
D.melanogaster,143726002,NW_001846140.1,1,1408,9.79642e-06,142764407,0.99331
D.melanogaster,143726002,NW_001846139.1,1,1408,9.79642e-06,142765815,0.993319
D.melanogaster,143726002,NW_001846141.1,1,1407,9.78946e-06,142767222,0.993329
D.melanogaster,143726002,NW_001846142.1,1,1406,9.7825e-06,142768628,0.993339
D.melanogaster,143726002,NW_001846144.1,1,1404,9.76859e-06,142770032,0.993349
D.melanogaster,143726002,NW_001846146.1,1,1402,9.75467e-06,142771434,0.993358
D.melanogaster,143726002,NW_001846150.1,1,1395,9.70597e-06,142772829,0.993368
D.melanogaster,143726002,NW_001846151.1,1,1394,9.69901e-06,142774223,0.993378
D.melanogaster,143726002,NW_001846152.1,1,1393,9.69205e-06,142775616,0.993388
D.melanogaster,143726002,NW_001846158.1,1,1391,9.67814e-06,142777007,0.993397
D.melanogaster,143726002,NW_001846155.1,1,1391,9.67814e-06,142778398,0.993407
D.melanogaster,143726002,NW_001846154.1,1,1391,9.67814e-06,142779789,0.993417
D.melanogaster,143726002,NW_001846160.1,1,1386,9.64335e-06,142781175,0.993426
D.melanogaster,143726002,NW_001846159.1,1,1386,9.64335e-06,142782561,0.993436
D.melanogaster,143726002,NW_001846161.1,1,1385,9.63639e-06,142783946,0.993445
D.melanogaster,143726002,NW_001846163.1,1,1384,9.62943e-06,142785330,0.993455
D.melanogaster,143726002,NW_001846164.1,1,1383,9.62248e-06,142786713,0.993465
D.melanogaster,143726002,NW_001846165.1,1,1382,9.61552e-06,142788095,0.993474
D.melanogaster,143726002,NW_001846168.1,1,1381,9.60856e-06,142789476,0.993484
D.melanogaster,143726002,NW_001846167.1,1,1381,9.60856e-06,142790857,0.993494
D.melanogaster,143726002,NW_001846170.1,1,1380,9.6016e-06,142792237,0.993503
D.melanogaster,143726002,NW_001846169.1,1,1380,9.6016e-06,142793617,0.993513
D.melanogaster,143726002,NW_001846171.1,1,1379,9.59465e-06,142794996,0.993522
D.melanogaster,143726002,NW_001846173.1,1,1378,9.58769e-06,142796374,0.993532
D.melanogaster,143726002,NW_001846178.1,1,1377,9.58073e-06,142797751,0.993542
D.melanogaster,143726002,NW_001846177.1,1,1377,9.58073e-06,142799128,0.993551
D.melanogaster,143726002,NW_001846176.1,1,1377,9.58073e-06,142800505,0.993561
D.melanogaster,143726002,NW_001846175.1,1,1377,9.58073e-06,142801882,0.99357
D.melanogaster,143726002,NW_001846179.1,1,1376,9.57377e-06,142803258,0.99358
D.melanogaster,143726002,NW_001846183.1,1,1375,9.56681e-06,142804633,0.993589
D.melanogaster,143726002,NW_001846185.1,1,1374,9.55986e-06,142806007,0.993599
D.melanogaster,143726002,NW_001846184.1,1,1374,9.55986e-06,142807381,0.993609
D.melanogaster,143726002,NW_001846186.1,1,1373,9.5529e-06,142808754,0.993618
D.melanogaster,143726002,NW_001846187.1,1,1371,9.53898e-06,142810125,0.993628
D.melanogaster,143726002,NW_001846188.1,1,1369,9.52507e-06,142811494,0.993637
D.melanogaster,143726002,NW_001846190.1,1,1368,9.51811e-06,142812862,0.993647
D.melanogaster,143726002,NW_001846193.1,1,1366,9.5042e-06,142814228,0.993656
D.melanogaster,143726002,NW_001846196.1,1,1361,9.46941e-06,142815589,0.993666
D.melanogaster,143726002,NW_001846197.1,1,1360,9.46245e-06,142816949,0.993675
D.melanogaster,143726002,NW_001846199.1,1,1356,9.43462e-06,142818305,0.993685
D.melanogaster,143726002,NW_001846198.1,1,1356,9.43462e-06,142819661,0.993694
D.melanogaster,143726002,NW_001846202.1,1,1355,9.42766e-06,142821016,0.993703
D.melanogaster,143726002,NW_001846200.1,1,1355,9.42766e-06,142822371,0.993713
D.melanogaster,143726002,NW_001846205.1,1,1352,9.40679e-06,142823723,0.993722
D.melanogaster,143726002,NW_001846206.1,1,1351,9.39983e-06,142825074,0.993732
D.melanogaster,143726002,NW_001846209.1,1,1347,9.372e-06,142826421,0.993741
D.melanogaster,143726002,NW_001846208.1,1,1347,9.372e-06,142827768,0.99375
D.melanogaster,143726002,NW_001846210.1,1,1346,9.36504e-06,142829114,0.99376
D.melanogaster,143726002,NW_001846211.1,1,1344,9.35113e-06,142830458,0.993769
D.melanogaster,143726002,NW_001846212.1,1,1343,9.34417e-06,142831801,0.993778
D.melanogaster,143726002,NW_001846213.1,1,1341,9.33025e-06,142833142,0.993788
D.melanogaster,143726002,NW_001846217.1,1,1340,9.3233e-06,142834482,0.993797
D.melanogaster,143726002,NW_001846216.1,1,1340,9.3233e-06,142835822,0.993806
D.melanogaster,143726002,NW_001846215.1,1,1340,9.3233e-06,142837162,0.993816
D.melanogaster,143726002,NW_001846219.1,1,1339,9.31634e-06,142838501,0.993825
D.melanogaster,143726002,NW_001846218.1,1,1339,9.31634e-06,142839840,0.993834
D.melanogaster,143726002,NW_001846222.1,1,1337,9.30242e-06,142841177,0.993844
D.melanogaster,143726002,NW_001846221.1,1,1337,9.30242e-06,142842514,0.993853
D.melanogaster,143726002,NW_001846224.1,1,1336,9.29546e-06,142843850,0.993862
D.melanogaster,143726002,NW_001846227.1,1,1334,9.28155e-06,142845184,0.993872
D.melanogaster,143726002,NW_001846231.1,1,1333,9.27459e-06,142846517,0.993881
D.melanogaster,143726002,NW_001846230.1,1,1333,9.27459e-06,142847850,0.99389
D.melanogaster,143726002,NW_001846229.1,1,1333,9.27459e-06,142849183,0.993899
D.melanogaster,143726002,NW_001846232.1,1,1332,9.26763e-06,142850515,0.993909
D.melanogaster,143726002,NW_001846234.1,1,1330,9.25372e-06,142851845,0.993918
D.melanogaster,143726002,NW_001846233.1,1,1330,9.25372e-06,142853175,0.993927
D.melanogaster,143726002,NW_001846237.1,1,1328,9.2398e-06,142854503,0.993936
D.melanogaster,143726002,NW_001846240.1,1,1327,9.23285e-06,142855830,0.993946
D.melanogaster,143726002,NW_001846242.1,1,1326,9.22589e-06,142857156,0.993955
D.melanogaster,143726002,NW_001846241.1,1,1326,9.22589e-06,142858482,0.993964
D.melanogaster,143726002,NW_001846244.1,1,1323,9.20501e-06,142859805,0.993973
D.melanogaster,143726002,NW_001846243.1,1,1323,9.20501e-06,142861128,0.993982
D.melanogaster,143726002,NW_001846245.1,1,1322,9.19806e-06,142862450,0.993992
D.melanogaster,143726002,NW_001846249.1,1,1316,9.15631e-06,142863766,0.994001
D.melanogaster,143726002,NW_001846253.1,1,1315,9.14935e-06,142865081,0.99401
D.melanogaster,143726002,NW_001846252.1,1,1315,9.14935e-06,142866396,0.994019
D.melanogaster,143726002,NW_001846251.1,1,1315,9.14935e-06,142867711,0.994028
D.melanogaster,143726002,NW_001846250.1,1,1315,9.14935e-06,142869026,0.994037
D.melanogaster,143726002,NW_001846254.1,1,1312,9.12848e-06,142870338,0.994047
D.melanogaster,143726002,NW_001846257.1,1,1311,9.12152e-06,142871649,0.994056
D.melanogaster,143726002,NW_001846256.1,1,1311,9.12152e-06,142872960,0.994065
D.melanogaster,143726002,NW_001846261.1,1,1310,9.11457e-06,142874270,0.994074
D.melanogaster,143726002,NW_001846259.1,1,1310,9.11457e-06,142875580,0.994083
D.melanogaster,143726002,NW_001846263.1,1,1309,9.10761e-06,142876889,0.994092
D.melanogaster,143726002,NW_001846265.1,1,1308,9.10065e-06,142878197,0.994101
D.melanogaster,143726002,NW_001846267.1,1,1306,9.08673e-06,142879503,0.99411
D.melanogaster,143726002,NW_001846273.1,1,1304,9.07282e-06,142880807,0.994119
D.melanogaster,143726002,NW_001846272.1,1,1304,9.07282e-06,142882111,0.994128
D.melanogaster,143726002,NW_001846271.1,1,1304,9.07282e-06,142883415,0.994138
D.melanogaster,143726002,NW_001846268.1,1,1304,9.07282e-06,142884719,0.994147
D.melanogaster,143726002,NW_001846275.1,1,1303,9.06586e-06,142886022,0.994156
D.melanogaster,143726002,NW_001846274.1,1,1303,9.06586e-06,142887325,0.994165
D.melanogaster,143726002,NW_001846276.1,1,1302,9.0589e-06,142888627,0.994174
D.melanogaster,143726002,NW_001846279.1,1,1301,9.05195e-06,142889928,0.994183
D.melanogaster,143726002,NW_001846277.1,1,1301,9.05195e-06,142891229,0.994192
D.melanogaster,143726002,NW_001846280.1,1,1299,9.03803e-06,142892528,0.994201
D.melanogaster,143726002,NW_001846283.1,1,1297,9.02412e-06,142893825,0.99421
D.melanogaster,143726002,NW_001846282.1,1,1297,9.02412e-06,142895122,0.994219
D.melanogaster,143726002,NW_001846281.1,1,1297,9.02412e-06,142896419,0.994228
D.melanogaster,143726002,NW_001846284.1,1,1296,9.01716e-06,142897715,0.994237
D.melanogaster,143726002,NW_001846285.1,1,1295,9.0102e-06,142899010,0.994246
D.melanogaster,143726002,NW_001846288.1,1,1294,9.00324e-06,142900304,0.994255
D.melanogaster,143726002,NW_001846287.1,1,1294,9.00324e-06,142901598,0.994264
D.melanogaster,143726002,NW_001846286.1,1,1294,9.00324e-06,142902892,0.994273
D.melanogaster,143726002,NW_001846289.1,1,1293,8.99628e-06,142904185,0.994282
D.melanogaster,143726002,NW_001846291.1,1,1291,8.98237e-06,142905476,0.994291
D.melanogaster,143726002,NW_001846293.1,1,1290,8.97541e-06,142906766,0.9943
D.melanogaster,143726002,NW_001846294.1,1,1289,8.96845e-06,142908055,0.994309
D.melanogaster,143726002,NW_001846296.1,1,1287,8.95454e-06,142909342,0.994318
D.melanogaster,143726002,NW_001846299.1,1,1286,8.94758e-06,142910628,0.994327
D.melanogaster,143726002,NW_001846300.1,1,1285,8.94062e-06,142911913,0.994336
D.melanogaster,143726002,NW_001846302.1,1,1284,8.93367e-06,142913197,0.994345
D.melanogaster,143726002,NW_001846301.1,1,1284,8.93367e-06,142914481,0.994354
D.melanogaster,143726002,NW_001846304.1,1,1283,8.92671e-06,142915764,0.994363
D.melanogaster,143726002,NW_001846303.1,1,1283,8.92671e-06,142917047,0.994372
D.melanogaster,143726002,NW_001846305.1,1,1282,8.91975e-06,142918329,0.99438
D.melanogaster,143726002,NW_001846306.1,1,1281,8.91279e-06,142919610,0.994389
D.melanogaster,143726002,NW_001846309.1,1,1280,8.90583e-06,142920890,0.994398
D.melanogaster,143726002,NW_001846308.1,1,1280,8.90583e-06,142922170,0.994407
D.melanogaster,143726002,NW_001846311.1,1,1279,8.89888e-06,142923449,0.994416
D.melanogaster,143726002,NW_001846315.1,1,1278,8.89192e-06,142924727,0.994425
D.melanogaster,143726002,NW_001846314.1,1,1278,8.89192e-06,142926005,0.994434
D.melanogaster,143726002,NW_001846313.1,1,1278,8.89192e-06,142927283,0.994443
D.melanogaster,143726002,NW_001846318.1,1,1277,8.88496e-06,142928560,0.994452
D.melanogaster,143726002,NW_001846317.1,1,1277,8.88496e-06,142929837,0.994461
D.melanogaster,143726002,NW_001846316.1,1,1277,8.88496e-06,142931114,0.994469
D.melanogaster,143726002,NW_001846319.1,1,1276,8.878e-06,142932390,0.994478
D.melanogaster,143726002,NW_001846321.1,1,1275,8.87105e-06,142933665,0.994487
D.melanogaster,143726002,NW_001846320.1,1,1275,8.87105e-06,142934940,0.994496
D.melanogaster,143726002,NW_001846325.1,1,1274,8.86409e-06,142936214,0.994505
D.melanogaster,143726002,NW_001846324.1,1,1274,8.86409e-06,142937488,0.994514
D.melanogaster,143726002,NW_001846327.1,1,1272,8.85017e-06,142938760,0.994523
D.melanogaster,143726002,NW_001846334.1,1,1271,8.84322e-06,142940031,0.994531
D.melanogaster,143726002,NW_001846333.1,1,1271,8.84322e-06,142941302,0.99454
D.melanogaster,143726002,NW_001846332.1,1,1271,8.84322e-06,142942573,0.994549
D.melanogaster,143726002,NW_001846331.1,1,1271,8.84322e-06,142943844,0.994558
D.melanogaster,143726002,NW_001846330.1,1,1271,8.84322e-06,142945115,0.994567
D.melanogaster,143726002,NW_001846337.1,1,1270,8.83626e-06,142946385,0.994576
D.melanogaster,143726002,NW_001846336.1,1,1270,8.83626e-06,142947655,0.994585
D.melanogaster,143726002,NW_001846335.1,1,1270,8.83626e-06,142948925,0.994593
D.melanogaster,143726002,NW_001846338.1,1,1269,8.8293e-06,142950194,0.994602
D.melanogaster,143726002,NW_001846340.1,1,1268,8.82234e-06,142951462,0.994611
D.melanogaster,143726002,NW_001846339.1,1,1268,8.82234e-06,142952730,0.99462
D.melanogaster,143726002,NW_001846342.1,1,1266,8.80843e-06,142953996,0.994629
D.melanogaster,143726002,NW_001846343.1,1,1265,8.80147e-06,142955261,0.994637
D.melanogaster,143726002,NW_001846344.1,1,1264,8.79451e-06,142956525,0.994646
D.melanogaster,143726002,NW_001846348.1,1,1263,8.78755e-06,142957788,0.994655
D.melanogaster,143726002,NW_001846347.1,1,1263,8.78755e-06,142959051,0.994664
D.melanogaster,143726002,NW_001846345.1,1,1263,8.78755e-06,142960314,0.994673
D.melanogaster,143726002,NW_001846354.1,1,1262,8.7806e-06,142961576,0.994681
D.melanogaster,143726002,NW_001846353.1,1,1262,8.7806e-06,142962838,0.99469
D.melanogaster,143726002,NW_001846351.1,1,1262,8.7806e-06,142964100,0.994699
D.melanogaster,143726002,NW_001846356.1,1,1261,8.77364e-06,142965361,0.994708
D.melanogaster,143726002,NW_001846355.1,1,1261,8.77364e-06,142966622,0.994716
D.melanogaster,143726002,NW_001846361.1,1,1260,8.76668e-06,142967882,0.994725
D.melanogaster,143726002,NW_001846360.1,1,1260,8.76668e-06,142969142,0.994734
D.melanogaster,143726002,NW_001846359.1,1,1260,8.76668e-06,142970402,0.994743
D.melanogaster,143726002,NW_001846357.1,1,1260,8.76668e-06,142971662,0.994752
D.melanogaster,143726002,NW_001846362.1,1,1259,8.75972e-06,142972921,0.99476
D.melanogaster,143726002,NW_001846366.1,1,1258,8.75277e-06,142974179,0.994769
D.melanogaster,143726002,NW_001846365.1,1,1258,8.75277e-06,142975437,0.994778
D.melanogaster,143726002,NW_001846363.1,1,1258,8.75277e-06,142976695,0.994787
D.melanogaster,143726002,NW_001846367.1,1,1257,8.74581e-06,142977952,0.994795
D.melanogaster,143726002,NW_001846369.1,1,1253,8.71798e-06,142979205,0.994804
D.melanogaster,143726002,NW_001846368.1,1,1253,8.71798e-06,142980458,0.994813
D.melanogaster,143726002,NW_001846370.1,1,1252,8.71102e-06,142981710,0.994821
D.melanogaster,143726002,NW_001846374.1,1,1251,8.70406e-06,142982961,0.99483
D.melanogaster,143726002,NW_001846373.1,1,1251,8.70406e-06,142984212,0.994839
D.melanogaster,143726002,NW_001846372.1,1,1251,8.70406e-06,142985463,0.994848
D.melanogaster,143726002,NW_001846371.1,1,1251,8.70406e-06,142986714,0.994856
D.melanogaster,143726002,NW_001846375.1,1,1250,8.6971e-06,142987964,0.994865
D.melanogaster,143726002,NW_001846376.1,1,1249,8.69015e-06,142989213,0.994874
D.melanogaster,143726002,NW_001846377.1,1,1248,8.68319e-06,142990461,0.994882
D.melanogaster,143726002,NW_001846378.1,1,1247,8.67623e-06,142991708,0.994891
D.melanogaster,143726002,NW_001846381.1,1,1246,8.66927e-06,142992954,0.9949
D.melanogaster,143726002,NW_001846380.1,1,1246,8.66927e-06,142994200,0.994908
D.melanogaster,143726002,NW_001846385.1,1,1244,8.65536e-06,142995444,0.994917
D.melanogaster,143726002,NW_001846386.1,1,1243,8.6484e-06,142996687,0.994926
D.melanogaster,143726002,NW_001846387.1,1,1242,8.64144e-06,142997929,0.994934
D.melanogaster,143726002,NW_001846390.1,1,1241,8.63448e-06,142999170,0.994943
D.melanogaster,143726002,NW_001846389.1,1,1241,8.63448e-06,143000411,0.994952
D.melanogaster,143726002,NW_001846388.1,1,1241,8.63448e-06,143001652,0.99496
D.melanogaster,143726002,NW_001846394.1,1,1240,8.62753e-06,143002892,0.994969
D.melanogaster,143726002,NW_001846393.1,1,1240,8.62753e-06,143004132,0.994977
D.melanogaster,143726002,NW_001846391.1,1,1240,8.62753e-06,143005372,0.994986
D.melanogaster,143726002,NW_001846396.1,1,1239,8.62057e-06,143006611,0.994995
D.melanogaster,143726002,NW_001846401.1,1,1238,8.61361e-06,143007849,0.995003
D.melanogaster,143726002,NW_001846400.1,1,1238,8.61361e-06,143009087,0.995012
D.melanogaster,143726002,NW_001846399.1,1,1238,8.61361e-06,143010325,0.995021
D.melanogaster,143726002,NW_001846398.1,1,1238,8.61361e-06,143011563,0.995029
D.melanogaster,143726002,NW_001846402.1,1,1237,8.60665e-06,143012800,0.995038
D.melanogaster,143726002,NW_001846406.1,1,1236,8.5997e-06,143014036,0.995046
D.melanogaster,143726002,NW_001846408.1,1,1235,8.59274e-06,143015271,0.995055
D.melanogaster,143726002,NW_001846407.1,1,1235,8.59274e-06,143016506,0.995064
D.melanogaster,143726002,NW_001846414.1,1,1234,8.58578e-06,143017740,0.995072
D.melanogaster,143726002,NW_001846412.1,1,1234,8.58578e-06,143018974,0.995081
D.melanogaster,143726002,NW_001846411.1,1,1234,8.58578e-06,143020208,0.995089
D.melanogaster,143726002,NW_001846416.1,1,1233,8.57882e-06,143021441,0.995098
D.melanogaster,143726002,NW_001846415.1,1,1233,8.57882e-06,143022674,0.995106
D.melanogaster,143726002,NW_001846419.1,1,1232,8.57187e-06,143023906,0.995115
D.melanogaster,143726002,NW_001846425.1,1,1231,8.56491e-06,143025137,0.995124
D.melanogaster,143726002,NW_001846423.1,1,1231,8.56491e-06,143026368,0.995132
D.melanogaster,143726002,NW_001846422.1,1,1231,8.56491e-06,143027599,0.995141
D.melanogaster,143726002,NW_001846421.1,1,1231,8.56491e-06,143028830,0.995149
D.melanogaster,143726002,NW_001846426.1,1,1230,8.55795e-06,143030060,0.995158
D.melanogaster,143726002,NW_001846429.1,1,1229,8.55099e-06,143031289,0.995166
D.melanogaster,143726002,NW_001846427.1,1,1229,8.55099e-06,143032518,0.995175
D.melanogaster,143726002,NW_001846430.1,1,1228,8.54404e-06,143033746,0.995184
D.melanogaster,143726002,NW_001846437.1,1,1227,8.53708e-06,143034973,0.995192
D.melanogaster,143726002,NW_001846435.1,1,1227,8.53708e-06,143036200,0.995201
D.melanogaster,143726002,NW_001846433.1,1,1227,8.53708e-06,143037427,0.995209
D.melanogaster,143726002,NW_001846432.1,1,1227,8.53708e-06,143038654,0.995218
D.melanogaster,143726002,NW_001846440.1,1,1226,8.53012e-06,143039880,0.995226
D.melanogaster,143726002,NW_001846439.1,1,1226,8.53012e-06,143041106,0.995235
D.melanogaster,143726002,NW_001846438.1,1,1226,8.53012e-06,143042332,0.995243
D.melanogaster,143726002,NW_001846446.1,1,1225,8.52316e-06,143043557,0.995252
D.melanogaster,143726002,NW_001846445.1,1,1225,8.52316e-06,143044782,0.99526
D.melanogaster,143726002,NW_001846444.1,1,1225,8.52316e-06,143046007,0.995269
D.melanogaster,143726002,NW_001846443.1,1,1225,8.52316e-06,143047232,0.995277
D.melanogaster,143726002,NW_001846442.1,1,1225,8.52316e-06,143048457,0.995286
D.melanogaster,143726002,NW_001846441.1,1,1225,8.52316e-06,143049682,0.995294
D.melanogaster,143726002,NW_001846450.1,1,1224,8.5162e-06,143050906,0.995303
D.melanogaster,143726002,NW_001846449.1,1,1224,8.5162e-06,143052130,0.995311
D.melanogaster,143726002,NW_001846448.1,1,1224,8.5162e-06,143053354,0.99532
D.melanogaster,143726002,NW_001846447.1,1,1224,8.5162e-06,143054578,0.995328
D.melanogaster,143726002,NW_001846453.1,1,1223,8.50925e-06,143055801,0.995337
D.melanogaster,143726002,NW_001846452.1,1,1223,8.50925e-06,143057024,0.995345
D.melanogaster,143726002,NW_001846451.1,1,1223,8.50925e-06,143058247,0.995354
D.melanogaster,143726002,NW_001846455.1,1,1222,8.50229e-06,143059469,0.995362
D.melanogaster,143726002,NW_001846454.1,1,1222,8.50229e-06,143060691,0.995371
D.melanogaster,143726002,NW_001846456.1,1,1221,8.49533e-06,143061912,0.995379
D.melanogaster,143726002,NW_001846461.1,1,1220,8.48837e-06,143063132,0.995388
D.melanogaster,143726002,NW_001846458.1,1,1220,8.48837e-06,143064352,0.995396
D.melanogaster,143726002,NW_001846465.1,1,1219,8.48142e-06,143065571,0.995405
D.melanogaster,143726002,NW_001846463.1,1,1219,8.48142e-06,143066790,0.995413
D.melanogaster,143726002,NW_001846462.1,1,1219,8.48142e-06,143068009,0.995422
D.melanogaster,143726002,NW_001846467.1,1,1218,8.47446e-06,143069227,0.99543
D.melanogaster,143726002,NW_001846466.1,1,1218,8.47446e-06,143070445,0.995439
D.melanogaster,143726002,NW_001846470.1,1,1214,8.44663e-06,143071659,0.995447
D.melanogaster,143726002,NW_001846471.1,1,1213,8.43967e-06,143072872,0.995456
D.melanogaster,143726002,NW_001846475.1,1,1212,8.43271e-06,143074084,0.995464
D.melanogaster,143726002,NW_001846473.1,1,1212,8.43271e-06,143075296,0.995473
D.melanogaster,143726002,NW_001846479.1,1,1211,8.42575e-06,143076507,0.995481
D.melanogaster,143726002,NW_001846478.1,1,1211,8.42575e-06,143077718,0.995489
D.melanogaster,143726002,NW_001846481.1,1,1210,8.4188e-06,143078928,0.995498
D.melanogaster,143726002,NW_001846487.1,1,1209,8.41184e-06,143080137,0.995506
D.melanogaster,143726002,NW_001846484.1,1,1209,8.41184e-06,143081346,0.995515
D.melanogaster,143726002,NW_001846483.1,1,1209,8.41184e-06,143082555,0.995523
D.melanogaster,143726002,NW_001846492.1,1,1208,8.40488e-06,143083763,0.995532
D.melanogaster,143726002,NW_001846490.1,1,1208,8.40488e-06,143084971,0.99554
D.melanogaster,143726002,NW_001846489.1,1,1208,8.40488e-06,143086179,0.995548
D.melanogaster,143726002,NW_001846488.1,1,1208,8.40488e-06,143087387,0.995557
D.melanogaster,143726002,NW_001846493.1,1,1207,8.39792e-06,143088594,0.995565
D.melanogaster,143726002,NW_001846494.1,1,1206,8.39097e-06,143089800,0.995574
D.melanogaster,143726002,NW_001846500.1,1,1205,8.38401e-06,143091005,0.995582
D.melanogaster,143726002,NW_001846498.1,1,1205,8.38401e-06,143092210,0.99559
D.melanogaster,143726002,NW_001846497.1,1,1205,8.38401e-06,143093415,0.995599
D.melanogaster,143726002,NW_001846507.1,1,1203,8.37009e-06,143094618,0.995607
D.melanogaster,143726002,NW_001846505.1,1,1203,8.37009e-06,143095821,0.995615
D.melanogaster,143726002,NW_001846504.1,1,1203,8.37009e-06,143097024,0.995624
D.melanogaster,143726002,NW_001846509.1,1,1202,8.36314e-06,143098226,0.995632
D.melanogaster,143726002,NW_001846508.1,1,1202,8.36314e-06,143099428,0.99564
D.melanogaster,143726002,NW_001846510.1,1,1201,8.35618e-06,143100629,0.995649
D.melanogaster,143726002,NW_001846514.1,1,1200,8.34922e-06,143101829,0.995657
D.melanogaster,143726002,NW_001846513.1,1,1200,8.34922e-06,143103029,0.995666
D.melanogaster,143726002,NW_001846512.1,1,1200,8.34922e-06,143104229,0.995674
D.melanogaster,143726002,NW_001846516.1,1,1199,8.34226e-06,143105428,0.995682
D.melanogaster,143726002,NW_001846515.1,1,1199,8.34226e-06,143106627,0.995691
D.melanogaster,143726002,NW_001846518.1,1,1198,8.3353e-06,143107825,0.995699
D.melanogaster,143726002,NW_001846517.1,1,1198,8.3353e-06,143109023,0.995707
D.melanogaster,143726002,NW_001846522.1,1,1197,8.32835e-06,143110220,0.995716
D.melanogaster,143726002,NW_001846519.1,1,1197,8.32835e-06,143111417,0.995724
D.melanogaster,143726002,NW_001846529.1,1,1195,8.31443e-06,143112612,0.995732
D.melanogaster,143726002,NW_001846528.1,1,1195,8.31443e-06,143113807,0.995741
D.melanogaster,143726002,NW_001846527.1,1,1195,8.31443e-06,143115002,0.995749
D.melanogaster,143726002,NW_001846525.1,1,1195,8.31443e-06,143116197,0.995757
D.melanogaster,143726002,NW_001846524.1,1,1195,8.31443e-06,143117392,0.995765
D.melanogaster,143726002,NW_001846531.1,1,1194,8.30747e-06,143118586,0.995774
D.melanogaster,143726002,NW_001846536.1,1,1193,8.30052e-06,143119779,0.995782
D.melanogaster,143726002,NW_001846535.1,1,1193,8.30052e-06,143120972,0.99579
D.melanogaster,143726002,NW_001846534.1,1,1193,8.30052e-06,143122165,0.995799
D.melanogaster,143726002,NW_001846532.1,1,1193,8.30052e-06,143123358,0.995807
D.melanogaster,143726002,NW_001846540.1,1,1192,8.29356e-06,143124550,0.995815
D.melanogaster,143726002,NW_001846539.1,1,1192,8.29356e-06,143125742,0.995824
D.melanogaster,143726002,NW_001846538.1,1,1192,8.29356e-06,143126934,0.995832
D.melanogaster,143726002,NW_001846542.1,1,1191,8.2866e-06,143128125,0.99584
D.melanogaster,143726002,NW_001846541.1,1,1191,8.2866e-06,143129316,0.995848
D.melanogaster,143726002,NW_001846545.1,1,1190,8.27964e-06,143130506,0.995857
D.melanogaster,143726002,NW_001846544.1,1,1190,8.27964e-06,143131696,0.995865
D.melanogaster,143726002,NW_001846543.1,1,1190,8.27964e-06,143132886,0.995873
D.melanogaster,143726002,NW_001846551.1,1,1189,8.27269e-06,143134075,0.995882
D.melanogaster,143726002,NW_001846550.1,1,1189,8.27269e-06,143135264,0.99589
D.melanogaster,143726002,NW_001846549.1,1,1189,8.27269e-06,143136453,0.995898
D.melanogaster,143726002,NW_001846548.1,1,1189,8.27269e-06,143137642,0.995906
D.melanogaster,143726002,NW_001846547.1,1,1189,8.27269e-06,143138831,0.995915
D.melanogaster,143726002,NW_001846546.1,1,1189,8.27269e-06,143140020,0.995923
D.melanogaster,143726002,NW_001846552.1,1,1188,8.26573e-06,143141208,0.995931
D.melanogaster,143726002,NW_001846557.1,1,1186,8.25181e-06,143142394,0.995939
D.melanogaster,143726002,NW_001846556.1,1,1186,8.25181e-06,143143580,0.995948
D.melanogaster,143726002,NW_001846555.1,1,1186,8.25181e-06,143144766,0.995956
D.melanogaster,143726002,NW_001846554.1,1,1186,8.25181e-06,143145952,0.995964
D.melanogaster,143726002,NW_001846553.1,1,1186,8.25181e-06,143147138,0.995972
D.melanogaster,143726002,NW_001846564.1,1,1185,8.24485e-06,143148323,0.995981
D.melanogaster,143726002,NW_001846562.1,1,1185,8.24485e-06,143149508,0.995989
D.melanogaster,143726002,NW_001846560.1,1,1185,8.24485e-06,143150693,0.995997
D.melanogaster,143726002,NW_001846559.1,1,1185,8.24485e-06,143151878,0.996005
D.melanogaster,143726002,NW_001846570.1,1,1184,8.2379e-06,143153062,0.996014
D.melanogaster,143726002,NW_001846569.1,1,1184,8.2379e-06,143154246,0.996022
D.melanogaster,143726002,NW_001846567.1,1,1184,8.2379e-06,143155430,0.99603
D.melanogaster,143726002,NW_001846566.1,1,1184,8.2379e-06,143156614,0.996038
D.melanogaster,143726002,NW_001846573.1,1,1182,8.22398e-06,143157796,0.996047
D.melanogaster,143726002,NW_001846572.1,1,1182,8.22398e-06,143158978,0.996055
D.melanogaster,143726002,NW_001846577.1,1,1181,8.21702e-06,143160159,0.996063
D.melanogaster,143726002,NW_001846576.1,1,1181,8.21702e-06,143161340,0.996071
D.melanogaster,143726002,NW_001846574.1,1,1181,8.21702e-06,143162521,0.996079
D.melanogaster,143726002,NW_001846581.1,1,1179,8.20311e-06,143163700,0.996088
D.melanogaster,143726002,NW_001846580.1,1,1179,8.20311e-06,143164879,0.996096
D.melanogaster,143726002,NW_001846579.1,1,1179,8.20311e-06,143166058,0.996104
D.melanogaster,143726002,NW_001846589.1,1,1178,8.19615e-06,143167236,0.996112
D.melanogaster,143726002,NW_001846588.1,1,1178,8.19615e-06,143168414,0.99612
D.melanogaster,143726002,NW_001846587.1,1,1178,8.19615e-06,143169592,0.996129
D.melanogaster,143726002,NW_001846586.1,1,1178,8.19615e-06,143170770,0.996137
D.melanogaster,143726002,NW_001846585.1,1,1178,8.19615e-06,143171948,0.996145
D.melanogaster,143726002,NW_001846583.1,1,1178,8.19615e-06,143173126,0.996153
D.melanogaster,143726002,NW_001846590.1,1,1177,8.18919e-06,143174303,0.996161
D.melanogaster,143726002,NW_001846591.1,1,1176,8.18224e-06,143175479,0.99617
D.melanogaster,143726002,NW_001846593.1,1,1175,8.17528e-06,143176654,0.996178
D.melanogaster,143726002,NW_001846592.1,1,1175,8.17528e-06,143177829,0.996186
D.melanogaster,143726002,NW_001846595.1,1,1174,8.16832e-06,143179003,0.996194
D.melanogaster,143726002,NW_001846594.1,1,1174,8.16832e-06,143180177,0.996202
D.melanogaster,143726002,NW_001846600.1,1,1173,8.16136e-06,143181350,0.99621
D.melanogaster,143726002,NW_001846599.1,1,1173,8.16136e-06,143182523,0.996219
D.melanogaster,143726002,NW_001846598.1,1,1173,8.16136e-06,143183696,0.996227
D.melanogaster,143726002,NW_001846605.1,1,1171,8.14745e-06,143184867,0.996235
D.melanogaster,143726002,NW_001846604.1,1,1171,8.14745e-06,143186038,0.996243
D.melanogaster,143726002,NW_001846603.1,1,1171,8.14745e-06,143187209,0.996251
D.melanogaster,143726002,NW_001846602.1,1,1171,8.14745e-06,143188380,0.996259
D.melanogaster,143726002,NW_001846607.1,1,1170,8.14049e-06,143189550,0.996268
D.melanogaster,143726002,NW_001846609.1,1,1169,8.13353e-06,143190719,0.996276
D.melanogaster,143726002,NW_001846608.1,1,1169,8.13353e-06,143191888,0.996284
D.melanogaster,143726002,NW_001846611.1,1,1168,8.12657e-06,143193056,0.996292
D.melanogaster,143726002,NW_001846614.1,1,1167,8.11962e-06,143194223,0.9963
D.melanogaster,143726002,NW_001846613.1,1,1167,8.11962e-06,143195390,0.996308
D.melanogaster,143726002,NW_001846612.1,1,1167,8.11962e-06,143196557,0.996316
D.melanogaster,143726002,NW_001846619.1,1,1166,8.11266e-06,143197723,0.996324
D.melanogaster,143726002,NW_001846618.1,1,1166,8.11266e-06,143198889,0.996333
D.melanogaster,143726002,NW_001846617.1,1,1166,8.11266e-06,143200055,0.996341
D.melanogaster,143726002,NW_001846615.1,1,1166,8.11266e-06,143201221,0.996349
D.melanogaster,143726002,NW_001846622.1,1,1165,8.1057e-06,143202386,0.996357
D.melanogaster,143726002,NW_001846620.1,1,1165,8.1057e-06,143203551,0.996365
D.melanogaster,143726002,NW_001846623.1,1,1164,8.09874e-06,143204715,0.996373
D.melanogaster,143726002,NW_001846629.1,1,1163,8.09179e-06,143205878,0.996381
D.melanogaster,143726002,NW_001846628.1,1,1163,8.09179e-06,143207041,0.996389
D.melanogaster,143726002,NW_001846627.1,1,1163,8.09179e-06,143208204,0.996397
D.melanogaster,143726002,NW_001846626.1,1,1163,8.09179e-06,143209367,0.996405
D.melanogaster,143726002,NW_001846625.1,1,1163,8.09179e-06,143210530,0.996414
D.melanogaster,143726002,NW_001846624.1,1,1163,8.09179e-06,143211693,0.996422
D.melanogaster,143726002,NW_001846632.1,1,1162,8.08483e-06,143212855,0.99643
D.melanogaster,143726002,NW_001846631.1,1,1162,8.08483e-06,143214017,0.996438
D.melanogaster,143726002,NW_001846630.1,1,1162,8.08483e-06,143215179,0.996446
D.melanogaster,143726002,NW_001846640.1,1,1161,8.07787e-06,143216340,0.996454
D.melanogaster,143726002,NW_001846638.1,1,1161,8.07787e-06,143217501,0.996462
D.melanogaster,143726002,NW_001846634.1,1,1161,8.07787e-06,143218662,0.99647
D.melanogaster,143726002,NW_001846645.1,1,1160,8.07091e-06,143219822,0.996478
D.melanogaster,143726002,NW_001846643.1,1,1160,8.07091e-06,143220982,0.996486
D.melanogaster,143726002,NW_001846642.1,1,1160,8.07091e-06,143222142,0.996494
D.melanogaster,143726002,NW_001846650.1,1,1159,8.06395e-06,143223301,0.996502
D.melanogaster,143726002,NW_001846649.1,1,1159,8.06395e-06,143224460,0.99651
D.melanogaster,143726002,NW_001846648.1,1,1159,8.06395e-06,143225619,0.996518
D.melanogaster,143726002,NW_001846647.1,1,1159,8.06395e-06,143226778,0.996527
D.melanogaster,143726002,NW_001846646.1,1,1159,8.06395e-06,143227937,0.996535
D.melanogaster,143726002,NW_001846653.1,1,1158,8.057e-06,143229095,0.996543
D.melanogaster,143726002,NW_001846652.1,1,1158,8.057e-06,143230253,0.996551
D.melanogaster,143726002,NW_001846651.1,1,1158,8.057e-06,143231411,0.996559
D.melanogaster,143726002,NW_001846657.1,1,1157,8.05004e-06,143232568,0.996567
D.melanogaster,143726002,NW_001846654.1,1,1157,8.05004e-06,143233725,0.996575
D.melanogaster,143726002,NW_001846660.1,1,1156,8.04308e-06,143234881,0.996583
D.melanogaster,143726002,NW_001846659.1,1,1156,8.04308e-06,143236037,0.996591
D.melanogaster,143726002,NW_001846667.1,1,1155,8.03612e-06,143237192,0.996599
D.melanogaster,143726002,NW_001846665.1,1,1155,8.03612e-06,143238347,0.996607
D.melanogaster,143726002,NW_001846664.1,1,1155,8.03612e-06,143239502,0.996615
D.melanogaster,143726002,NW_001846663.1,1,1155,8.03612e-06,143240657,0.996623
D.melanogaster,143726002,NW_001846672.1,1,1154,8.02917e-06,143241811,0.996631
D.melanogaster,143726002,NW_001846671.1,1,1154,8.02917e-06,143242965,0.996639
D.melanogaster,143726002,NW_001846670.1,1,1154,8.02917e-06,143244119,0.996647
D.melanogaster,143726002,NW_001846668.1,1,1154,8.02917e-06,143245273,0.996655
D.melanogaster,143726002,NW_001846675.1,1,1153,8.02221e-06,143246426,0.996663
D.melanogaster,143726002,NW_001846674.1,1,1153,8.02221e-06,143247579,0.996671
D.melanogaster,143726002,NW_001846673.1,1,1153,8.02221e-06,143248732,0.996679
D.melanogaster,143726002,NW_001846679.1,1,1152,8.01525e-06,143249884,0.996687
D.melanogaster,143726002,NW_001846678.1,1,1152,8.01525e-06,143251036,0.996695
D.melanogaster,143726002,NW_001846677.1,1,1152,8.01525e-06,143252188,0.996703
D.melanogaster,143726002,NW_001846676.1,1,1152,8.01525e-06,143253340,0.996711
D.melanogaster,143726002,NW_001846681.1,1,1151,8.00829e-06,143254491,0.996719
D.melanogaster,143726002,NW_001846684.1,1,1150,8.00134e-06,143255641,0.996727
D.melanogaster,143726002,NW_001846682.1,1,1150,8.00134e-06,143256791,0.996735
D.melanogaster,143726002,NW_001846692.1,1,1148,7.98742e-06,143257939,0.996743
D.melanogaster,143726002,NW_001846690.1,1,1148,7.98742e-06,143259087,0.996751
D.melanogaster,143726002,NW_001846689.1,1,1148,7.98742e-06,143260235,0.996759
D.melanogaster,143726002,NW_001846688.1,1,1148,7.98742e-06,143261383,0.996767
D.melanogaster,143726002,NW_001846687.1,1,1148,7.98742e-06,143262531,0.996775
D.melanogaster,143726002,NW_001846686.1,1,1148,7.98742e-06,143263679,0.996783
D.melanogaster,143726002,NW_001846699.1,1,1147,7.98046e-06,143264826,0.996791
D.melanogaster,143726002,NW_001846698.1,1,1147,7.98046e-06,143265973,0.996799
D.melanogaster,143726002,NW_001846696.1,1,1147,7.98046e-06,143267120,0.996807
D.melanogaster,143726002,NW_001846705.1,1,1146,7.97351e-06,143268266,0.996815
D.melanogaster,143726002,NW_001846704.1,1,1146,7.97351e-06,143269412,0.996823
D.melanogaster,143726002,NW_001846700.1,1,1146,7.97351e-06,143270558,0.996831
D.melanogaster,143726002,NW_001846707.1,1,1145,7.96655e-06,143271703,0.996839
D.melanogaster,143726002,NW_001846712.1,1,1144,7.95959e-06,143272847,0.996847
D.melanogaster,143726002,NW_001846711.1,1,1144,7.95959e-06,143273991,0.996855
D.melanogaster,143726002,NW_001846710.1,1,1144,7.95959e-06,143275135,0.996863
D.melanogaster,143726002,NW_001846709.1,1,1144,7.95959e-06,143276279,0.996871
D.melanogaster,143726002,NW_001846708.1,1,1144,7.95959e-06,143277423,0.996879
D.melanogaster,143726002,NW_001846714.1,1,1143,7.95263e-06,143278566,0.996887
D.melanogaster,143726002,NW_001846713.1,1,1143,7.95263e-06,143279709,0.996895
D.melanogaster,143726002,NW_001846717.1,1,1142,7.94567e-06,143280851,0.996903
D.melanogaster,143726002,NW_001846716.1,1,1142,7.94567e-06,143281993,0.996911
D.melanogaster,143726002,NW_001846715.1,1,1142,7.94567e-06,143283135,0.996919
D.melanogaster,143726002,NW_001846719.1,1,1141,7.93872e-06,143284276,0.996927
D.melanogaster,143726002,NW_001846718.1,1,1141,7.93872e-06,143285417,0.996935
D.melanogaster,143726002,NW_001846726.1,1,1140,7.93176e-06,143286557,0.996942
D.melanogaster,143726002,NW_001846725.1,1,1140,7.93176e-06,143287697,0.99695
D.melanogaster,143726002,NW_001846723.1,1,1140,7.93176e-06,143288837,0.996958
D.melanogaster,143726002,NW_001846722.1,1,1140,7.93176e-06,143289977,0.996966
D.melanogaster,143726002,NW_001846731.1,1,1139,7.9248e-06,143291116,0.996974
D.melanogaster,143726002,NW_001846730.1,1,1139,7.9248e-06,143292255,0.996982
D.melanogaster,143726002,NW_001846729.1,1,1139,7.9248e-06,143293394,0.99699
D.melanogaster,143726002,NW_001846728.1,1,1139,7.9248e-06,143294533,0.996998
D.melanogaster,143726002,NW_001846727.1,1,1139,7.9248e-06,143295672,0.997006
D.melanogaster,143726002,NW_001846732.1,1,1138,7.91784e-06,143296810,0.997014
D.melanogaster,143726002,NW_001846737.1,1,1137,7.91089e-06,143297947,0.997022
D.melanogaster,143726002,NW_001846742.1,1,1136,7.90393e-06,143299083,0.99703
D.melanogaster,143726002,NW_001846741.1,1,1136,7.90393e-06,143300219,0.997038
D.melanogaster,143726002,NW_001846740.1,1,1136,7.90393e-06,143301355,0.997045
D.melanogaster,143726002,NW_001846739.1,1,1136,7.90393e-06,143302491,0.997053
D.melanogaster,143726002,NW_001846746.1,1,1135,7.89697e-06,143303626,0.997061
D.melanogaster,143726002,NW_001846745.1,1,1135,7.89697e-06,143304761,0.997069
D.melanogaster,143726002,NW_001846743.1,1,1135,7.89697e-06,143305896,0.997077
D.melanogaster,143726002,NW_001846751.1,1,1134,7.89001e-06,143307030,0.997085
D.melanogaster,143726002,NW_001846750.1,1,1134,7.89001e-06,143308164,0.997093
D.melanogaster,143726002,NW_001846749.1,1,1134,7.89001e-06,143309298,0.997101
D.melanogaster,143726002,NW_001846748.1,1,1134,7.89001e-06,143310432,0.997109
D.melanogaster,143726002,NW_001846755.1,1,1133,7.88306e-06,143311565,0.997116
D.melanogaster,143726002,NW_001846754.1,1,1133,7.88306e-06,143312698,0.997124
D.melanogaster,143726002,NW_001846753.1,1,1133,7.88306e-06,143313831,0.997132
D.melanogaster,143726002,NW_001846759.1,1,1132,7.8761e-06,143314963,0.99714
D.melanogaster,143726002,NW_001846758.1,1,1132,7.8761e-06,143316095,0.997148
D.melanogaster,143726002,NW_001846757.1,1,1132,7.8761e-06,143317227,0.997156
D.melanogaster,143726002,NW_001846756.1,1,1132,7.8761e-06,143318359,0.997164
D.melanogaster,143726002,NW_001846762.1,1,1131,7.86914e-06,143319490,0.997172
D.melanogaster,143726002,NW_001846761.1,1,1131,7.86914e-06,143320621,0.997179
D.melanogaster,143726002,NW_001846760.1,1,1131,7.86914e-06,143321752,0.997187
D.melanogaster,143726002,NW_001846766.1,1,1130,7.86218e-06,143322882,0.997195
D.melanogaster,143726002,NW_001846765.1,1,1130,7.86218e-06,143324012,0.997203
D.melanogaster,143726002,NW_001846764.1,1,1130,7.86218e-06,143325142,0.997211
D.melanogaster,143726002,NW_001846772.1,1,1129,7.85522e-06,143326271,0.997219
D.melanogaster,143726002,NW_001846771.1,1,1129,7.85522e-06,143327400,0.997227
D.melanogaster,143726002,NW_001846770.1,1,1129,7.85522e-06,143328529,0.997235
D.melanogaster,143726002,NW_001846767.1,1,1129,7.85522e-06,143329658,0.997242
D.melanogaster,143726002,NW_001846779.1,1,1127,7.84131e-06,143330785,0.99725
D.melanogaster,143726002,NW_001846777.1,1,1127,7.84131e-06,143331912,0.997258
D.melanogaster,143726002,NW_001846785.1,1,1126,7.83435e-06,143333038,0.997266
D.melanogaster,143726002,NW_001846784.1,1,1126,7.83435e-06,143334164,0.997274
D.melanogaster,143726002,NW_001846783.1,1,1126,7.83435e-06,143335290,0.997282
D.melanogaster,143726002,NW_001846781.1,1,1126,7.83435e-06,143336416,0.997289
D.melanogaster,143726002,NW_001846780.1,1,1126,7.83435e-06,143337542,0.997297
D.melanogaster,143726002,NW_001846787.1,1,1125,7.82739e-06,143338667,0.997305
D.melanogaster,143726002,NW_001846786.1,1,1125,7.82739e-06,143339792,0.997313
D.melanogaster,143726002,NW_001846790.1,1,1124,7.82044e-06,143340916,0.997321
D.melanogaster,143726002,NW_001846789.1,1,1124,7.82044e-06,143342040,0.997329
D.melanogaster,143726002,NW_001846798.1,1,1123,7.81348e-06,143343163,0.997336
D.melanogaster,143726002,NW_001846795.1,1,1123,7.81348e-06,143344286,0.997344
D.melanogaster,143726002,NW_001846794.1,1,1123,7.81348e-06,143345409,0.997352
D.melanogaster,143726002,NW_001846793.1,1,1123,7.81348e-06,143346532,0.99736
D.melanogaster,143726002,NW_001846792.1,1,1123,7.81348e-06,143347655,0.997368
D.melanogaster,143726002,NW_001846801.1,1,1122,7.80652e-06,143348777,0.997375
D.melanogaster,143726002,NW_001846803.1,1,1121,7.79956e-06,143349898,0.997383
D.melanogaster,143726002,NW_001846804.1,1,1120,7.79261e-06,143351018,0.997391
D.melanogaster,143726002,NW_001846807.1,1,1119,7.78565e-06,143352137,0.997399
D.melanogaster,143726002,NW_001846806.1,1,1119,7.78565e-06,143353256,0.997407
D.melanogaster,143726002,NW_001846812.1,1,1118,7.77869e-06,143354374,0.997414
D.melanogaster,143726002,NW_001846811.1,1,1118,7.77869e-06,143355492,0.997422
D.melanogaster,143726002,NW_001846810.1,1,1118,7.77869e-06,143356610,0.99743
D.melanogaster,143726002,NW_001846809.1,1,1118,7.77869e-06,143357728,0.997438
D.melanogaster,143726002,NW_001846819.1,1,1117,7.77173e-06,143358845,0.997445
D.melanogaster,143726002,NW_001846818.1,1,1117,7.77173e-06,143359962,0.997453
D.melanogaster,143726002,NW_001846817.1,1,1117,7.77173e-06,143361079,0.997461
D.melanogaster,143726002,NW_001846816.1,1,1117,7.77173e-06,143362196,0.997469
D.melanogaster,143726002,NW_001846815.1,1,1117,7.77173e-06,143363313,0.997477
D.melanogaster,143726002,NW_001846814.1,1,1117,7.77173e-06,143364430,0.997484
D.melanogaster,143726002,NW_001846825.1,1,1116,7.76477e-06,143365546,0.997492
D.melanogaster,143726002,NW_001846824.1,1,1116,7.76477e-06,143366662,0.9975
D.melanogaster,143726002,NW_001846823.1,1,1116,7.76477e-06,143367778,0.997508
D.melanogaster,143726002,NW_001846822.1,1,1116,7.76477e-06,143368894,0.997515
D.melanogaster,143726002,NW_001846821.1,1,1116,7.76477e-06,143370010,0.997523
D.melanogaster,143726002,NW_001846820.1,1,1116,7.76477e-06,143371126,0.997531
D.melanogaster,143726002,NW_001846828.1,1,1115,7.75782e-06,143372241,0.997539
D.melanogaster,143726002,NW_001846827.1,1,1115,7.75782e-06,143373356,0.997546
D.melanogaster,143726002,NW_001846826.1,1,1115,7.75782e-06,143374471,0.997554
D.melanogaster,143726002,NW_001846834.1,1,1114,7.75086e-06,143375585,0.997562
D.melanogaster,143726002,NW_001846833.1,1,1114,7.75086e-06,143376699,0.99757
D.melanogaster,143726002,NW_001846832.1,1,1114,7.75086e-06,143377813,0.997577
D.melanogaster,143726002,NW_001846831.1,1,1114,7.75086e-06,143378927,0.997585
D.melanogaster,143726002,NW_001846830.1,1,1114,7.75086e-06,143380041,0.997593
D.melanogaster,143726002,NW_001846829.1,1,1114,7.75086e-06,143381155,0.997601
D.melanogaster,143726002,NW_001846839.1,1,1112,7.73694e-06,143382267,0.997608
D.melanogaster,143726002,NW_001846838.1,1,1112,7.73694e-06,143383379,0.997616
D.melanogaster,143726002,NW_001846837.1,1,1112,7.73694e-06,143384491,0.997624
D.melanogaster,143726002,NW_001846836.1,1,1112,7.73694e-06,143385603,0.997632
D.melanogaster,143726002,NW_001846841.1,1,1111,7.72999e-06,143386714,0.997639
D.melanogaster,143726002,NW_001846849.1,1,1110,7.72303e-06,143387824,0.997647
D.melanogaster,143726002,NW_001846848.1,1,1110,7.72303e-06,143388934,0.997655
D.melanogaster,143726002,NW_001846847.1,1,1110,7.72303e-06,143390044,0.997663
D.melanogaster,143726002,NW_001846846.1,1,1110,7.72303e-06,143391154,0.99767
D.melanogaster,143726002,NW_001846854.1,1,1109,7.71607e-06,143392263,0.997678
D.melanogaster,143726002,NW_001846852.1,1,1109,7.71607e-06,143393372,0.997686
D.melanogaster,143726002,NW_001846851.1,1,1109,7.71607e-06,143394481,0.997693
D.melanogaster,143726002,NW_001846850.1,1,1109,7.71607e-06,143395590,0.997701
D.melanogaster,143726002,NW_001846858.1,1,1108,7.70911e-06,143396698,0.997709
D.melanogaster,143726002,NW_001846856.1,1,1108,7.70911e-06,143397806,0.997717
D.melanogaster,143726002,NW_001846862.1,1,1107,7.70216e-06,143398913,0.997724
D.melanogaster,143726002,NW_001846861.1,1,1107,7.70216e-06,143400020,0.997732
D.melanogaster,143726002,NW_001846860.1,1,1107,7.70216e-06,143401127,0.99774
D.melanogaster,143726002,NW_001846864.1,1,1106,7.6952e-06,143402233,0.997747
D.melanogaster,143726002,NW_001846863.1,1,1106,7.6952e-06,143403339,0.997755
D.melanogaster,143726002,NW_001846873.1,1,1105,7.68824e-06,143404444,0.997763
D.melanogaster,143726002,NW_001846872.1,1,1105,7.68824e-06,143405549,0.99777
D.melanogaster,143726002,NW_001846871.1,1,1105,7.68824e-06,143406654,0.997778
D.melanogaster,143726002,NW_001846870.1,1,1105,7.68824e-06,143407759,0.997786
D.melanogaster,143726002,NW_001846868.1,1,1105,7.68824e-06,143408864,0.997793
D.melanogaster,143726002,NW_001846867.1,1,1105,7.68824e-06,143409969,0.997801
D.melanogaster,143726002,NW_001846877.1,1,1103,7.67432e-06,143411072,0.997809
D.melanogaster,143726002,NW_001846876.1,1,1103,7.67432e-06,143412175,0.997816
D.melanogaster,143726002,NW_001846874.1,1,1103,7.67432e-06,143413278,0.997824
D.melanogaster,143726002,NW_001846881.1,1,1102,7.66737e-06,143414380,0.997832
D.melanogaster,143726002,NW_001846880.1,1,1102,7.66737e-06,143415482,0.99784
D.melanogaster,143726002,NW_001846878.1,1,1102,7.66737e-06,143416584,0.997847
D.melanogaster,143726002,NW_001846884.1,1,1101,7.66041e-06,143417685,0.997855
D.melanogaster,143726002,NW_001846883.1,1,1101,7.66041e-06,143418786,0.997862
D.melanogaster,143726002,NW_001846882.1,1,1101,7.66041e-06,143419887,0.99787
D.melanogaster,143726002,NW_001846888.1,1,1100,7.65345e-06,143420987,0.997878
D.melanogaster,143726002,NW_001846886.1,1,1100,7.65345e-06,143422087,0.997885
D.melanogaster,143726002,NW_001846891.1,1,1099,7.64649e-06,143423186,0.997893
D.melanogaster,143726002,NW_001846890.1,1,1099,7.64649e-06,143424285,0.997901
D.melanogaster,143726002,NW_001846894.1,1,1098,7.63954e-06,143425383,0.997908
D.melanogaster,143726002,NW_001846893.1,1,1098,7.63954e-06,143426481,0.997916
D.melanogaster,143726002,NW_001846892.1,1,1098,7.63954e-06,143427579,0.997924
D.melanogaster,143726002,NW_001846897.1,1,1097,7.63258e-06,143428676,0.997931
D.melanogaster,143726002,NW_001846896.1,1,1097,7.63258e-06,143429773,0.997939
D.melanogaster,143726002,NW_001846895.1,1,1097,7.63258e-06,143430870,0.997947
D.melanogaster,143726002,NW_001846899.1,1,1096,7.62562e-06,143431966,0.997954
D.melanogaster,143726002,NW_001846898.1,1,1096,7.62562e-06,143433062,0.997962
D.melanogaster,143726002,NW_001846903.1,1,1094,7.61171e-06,143434156,0.997969
D.melanogaster,143726002,NW_001846906.1,1,1093,7.60475e-06,143435249,0.997977
D.melanogaster,143726002,NW_001846907.1,1,1092,7.59779e-06,143436341,0.997985
D.melanogaster,143726002,NW_001846910.1,1,1091,7.59083e-06,143437432,0.997992
D.melanogaster,143726002,NW_001846909.1,1,1091,7.59083e-06,143438523,0.998
D.melanogaster,143726002,NW_001846916.1,1,1090,7.58387e-06,143439613,0.998007
D.melanogaster,143726002,NW_001846914.1,1,1090,7.58387e-06,143440703,0.998015
D.melanogaster,143726002,NW_001846913.1,1,1090,7.58387e-06,143441793,0.998023
D.melanogaster,143726002,NW_001846912.1,1,1090,7.58387e-06,143442883,0.99803
D.melanogaster,143726002,NW_001846911.1,1,1090,7.58387e-06,143443973,0.998038
D.melanogaster,143726002,NW_001846919.1,1,1089,7.57692e-06,143445062,0.998045
D.melanogaster,143726002,NW_001846917.1,1,1089,7.57692e-06,143446151,0.998053
D.melanogaster,143726002,NW_001846925.1,1,1088,7.56996e-06,143447239,0.99806
D.melanogaster,143726002,NW_001846924.1,1,1088,7.56996e-06,143448327,0.998068
D.melanogaster,143726002,NW_001846923.1,1,1088,7.56996e-06,143449415,0.998076
D.melanogaster,143726002,NW_001846921.1,1,1088,7.56996e-06,143450503,0.998083
D.melanogaster,143726002,NW_001846931.1,1,1087,7.563e-06,143451590,0.998091
D.melanogaster,143726002,NW_001846930.1,1,1087,7.563e-06,143452677,0.998098
D.melanogaster,143726002,NW_001846929.1,1,1087,7.563e-06,143453764,0.998106
D.melanogaster,143726002,NW_001846937.1,1,1086,7.55604e-06,143454850,0.998113
D.melanogaster,143726002,NW_001846936.1,1,1086,7.55604e-06,143455936,0.998121
D.melanogaster,143726002,NW_001846935.1,1,1086,7.55604e-06,143457022,0.998129
D.melanogaster,143726002,NW_001846932.1,1,1086,7.55604e-06,143458108,0.998136
D.melanogaster,143726002,NW_001846943.1,1,1084,7.54213e-06,143459192,0.998144
D.melanogaster,143726002,NW_001846942.1,1,1084,7.54213e-06,143460276,0.998151
D.melanogaster,143726002,NW_001846940.1,1,1084,7.54213e-06,143461360,0.998159
D.melanogaster,143726002,NW_001846939.1,1,1084,7.54213e-06,143462444,0.998166
D.melanogaster,143726002,NW_001846938.1,1,1084,7.54213e-06,143463528,0.998174
D.melanogaster,143726002,NW_001846946.1,1,1083,7.53517e-06,143464611,0.998181
D.melanogaster,143726002,NW_001846945.1,1,1083,7.53517e-06,143465694,0.998189
D.melanogaster,143726002,NW_001846944.1,1,1083,7.53517e-06,143466777,0.998196
D.melanogaster,143726002,NW_001846949.1,1,1082,7.52821e-06,143467859,0.998204
D.melanogaster,143726002,NW_001846948.1,1,1082,7.52821e-06,143468941,0.998211
D.melanogaster,143726002,NW_001846953.1,1,1081,7.52126e-06,143470022,0.998219
D.melanogaster,143726002,NW_001846950.1,1,1081,7.52126e-06,143471103,0.998226
D.melanogaster,143726002,NW_001846957.1,1,1080,7.5143e-06,143472183,0.998234
D.melanogaster,143726002,NW_001846956.1,1,1080,7.5143e-06,143473263,0.998242
D.melanogaster,143726002,NW_001846955.1,1,1080,7.5143e-06,143474343,0.998249
D.melanogaster,143726002,NW_001846960.1,1,1079,7.50734e-06,143475422,0.998257
D.melanogaster,143726002,NW_001846959.1,1,1079,7.50734e-06,143476501,0.998264
D.melanogaster,143726002,NW_001846965.1,1,1078,7.50038e-06,143477579,0.998272
D.melanogaster,143726002,NW_001846964.1,1,1078,7.50038e-06,143478657,0.998279
D.melanogaster,143726002,NW_001846962.1,1,1078,7.50038e-06,143479735,0.998287
D.melanogaster,143726002,NW_001846961.1,1,1078,7.50038e-06,143480813,0.998294
D.melanogaster,143726002,NW_001846968.1,1,1077,7.49342e-06,143481890,0.998302
D.melanogaster,143726002,NW_001846967.1,1,1077,7.49342e-06,143482967,0.998309
D.melanogaster,143726002,NW_001846973.1,1,1076,7.48647e-06,143484043,0.998317
D.melanogaster,143726002,NW_001846972.1,1,1076,7.48647e-06,143485119,0.998324
D.melanogaster,143726002,NW_001846971.1,1,1076,7.48647e-06,143486195,0.998331
D.melanogaster,143726002,NW_001846970.1,1,1076,7.48647e-06,143487271,0.998339
D.melanogaster,143726002,NW_001846977.1,1,1075,7.47951e-06,143488346,0.998346
D.melanogaster,143726002,NW_001846976.1,1,1075,7.47951e-06,143489421,0.998354
D.melanogaster,143726002,NW_001846975.1,1,1075,7.47951e-06,143490496,0.998361
D.melanogaster,143726002,NW_001846974.1,1,1075,7.47951e-06,143491571,0.998369
D.melanogaster,143726002,NW_001846983.1,1,1074,7.47255e-06,143492645,0.998376
D.melanogaster,143726002,NW_001846982.1,1,1074,7.47255e-06,143493719,0.998384
D.melanogaster,143726002,NW_001846981.1,1,1074,7.47255e-06,143494793,0.998391
D.melanogaster,143726002,NW_001846980.1,1,1074,7.47255e-06,143495867,0.998399
D.melanogaster,143726002,NW_001846985.1,1,1073,7.46559e-06,143496940,0.998406
D.melanogaster,143726002,NW_001846990.1,1,1072,7.45864e-06,143498012,0.998414
D.melanogaster,143726002,NW_001846987.1,1,1072,7.45864e-06,143499084,0.998421
D.melanogaster,143726002,NW_001846996.1,1,1071,7.45168e-06,143500155,0.998429
D.melanogaster,143726002,NW_001846992.1,1,1071,7.45168e-06,143501226,0.998436
D.melanogaster,143726002,NW_001847001.1,1,1070,7.44472e-06,143502296,0.998444
D.melanogaster,143726002,NW_001847000.1,1,1070,7.44472e-06,143503366,0.998451
D.melanogaster,143726002,NW_001846998.1,1,1070,7.44472e-06,143504436,0.998458
D.melanogaster,143726002,NW_001847006.1,1,1069,7.43776e-06,143505505,0.998466
D.melanogaster,143726002,NW_001847003.1,1,1069,7.43776e-06,143506574,0.998473
D.melanogaster,143726002,NW_001847007.1,1,1068,7.43081e-06,143507642,0.998481
D.melanogaster,143726002,NW_001847013.1,1,1067,7.42385e-06,143508709,0.998488
D.melanogaster,143726002,NW_001847012.1,1,1067,7.42385e-06,143509776,0.998496
D.melanogaster,143726002,NW_001847011.1,1,1067,7.42385e-06,143510843,0.998503
D.melanogaster,143726002,NW_001847014.1,1,1066,7.41689e-06,143511909,0.99851
D.melanogaster,143726002,NW_001847021.1,1,1064,7.40298e-06,143512973,0.998518
D.melanogaster,143726002,NW_001847018.1,1,1064,7.40298e-06,143514037,0.998525
D.melanogaster,143726002,NW_001847017.1,1,1064,7.40298e-06,143515101,0.998533
D.melanogaster,143726002,NW_001847030.1,1,1063,7.39602e-06,143516164,0.99854
D.melanogaster,143726002,NW_001847029.1,1,1063,7.39602e-06,143517227,0.998547
D.melanogaster,143726002,NW_001847028.1,1,1063,7.39602e-06,143518290,0.998555
D.melanogaster,143726002,NW_001847027.1,1,1063,7.39602e-06,143519353,0.998562
D.melanogaster,143726002,NW_001847026.1,1,1063,7.39602e-06,143520416,0.99857
D.melanogaster,143726002,NW_001847025.1,1,1063,7.39602e-06,143521479,0.998577
D.melanogaster,143726002,NW_001847024.1,1,1063,7.39602e-06,143522542,0.998584
D.melanogaster,143726002,NW_001847022.1,1,1063,7.39602e-06,143523605,0.998592
D.melanogaster,143726002,NW_001847036.1,1,1062,7.38906e-06,143524667,0.998599
D.melanogaster,143726002,NW_001847035.1,1,1062,7.38906e-06,143525729,0.998607
D.melanogaster,143726002,NW_001847034.1,1,1062,7.38906e-06,143526791,0.998614
D.melanogaster,143726002,NW_001847032.1,1,1062,7.38906e-06,143527853,0.998621
D.melanogaster,143726002,NW_001847031.1,1,1062,7.38906e-06,143528915,0.998629
D.melanogaster,143726002,NW_001847037.1,1,1061,7.3821e-06,143529976,0.998636
D.melanogaster,143726002,NW_001847040.1,1,1060,7.37514e-06,143531036,0.998643
D.melanogaster,143726002,NW_001847039.1,1,1060,7.37514e-06,143532096,0.998651
D.melanogaster,143726002,NW_001847038.1,1,1060,7.37514e-06,143533156,0.998658
D.melanogaster,143726002,NW_001847043.1,1,1059,7.36819e-06,143534215,0.998666
D.melanogaster,143726002,NW_001847042.1,1,1059,7.36819e-06,143535274,0.998673
D.melanogaster,143726002,NW_001847041.1,1,1059,7.36819e-06,143536333,0.99868
D.melanogaster,143726002,NW_001847049.1,1,1058,7.36123e-06,143537391,0.998688
D.melanogaster,143726002,NW_001847046.1,1,1058,7.36123e-06,143538449,0.998695
D.melanogaster,143726002,NW_001847045.1,1,1058,7.36123e-06,143539507,0.998702
D.melanogaster,143726002,NW_001847044.1,1,1058,7.36123e-06,143540565,0.99871
D.melanogaster,143726002,NW_001847051.1,1,1057,7.35427e-06,143541622,0.998717
D.melanogaster,143726002,NW_001847056.1,1,1056,7.34731e-06,143542678,0.998724
D.melanogaster,143726002,NW_001847055.1,1,1056,7.34731e-06,143543734,0.998732
D.melanogaster,143726002,NW_001847054.1,1,1056,7.34731e-06,143544790,0.998739
D.melanogaster,143726002,NW_001847053.1,1,1056,7.34731e-06,143545846,0.998747
D.melanogaster,143726002,NW_001847060.1,1,1055,7.34036e-06,143546901,0.998754
D.melanogaster,143726002,NW_001847059.1,1,1055,7.34036e-06,143547956,0.998761
D.melanogaster,143726002,NW_001847058.1,1,1055,7.34036e-06,143549011,0.998769
D.melanogaster,143726002,NW_001847062.1,1,1054,7.3334e-06,143550065,0.998776
D.melanogaster,143726002,NW_001847061.1,1,1054,7.3334e-06,143551119,0.998783
D.melanogaster,143726002,NW_001847069.1,1,1053,7.32644e-06,143552172,0.998791
D.melanogaster,143726002,NW_001847067.1,1,1053,7.32644e-06,143553225,0.998798
D.melanogaster,143726002,NW_001847065.1,1,1053,7.32644e-06,143554278,0.998805
D.melanogaster,143726002,NW_001847064.1,1,1053,7.32644e-06,143555331,0.998813
D.melanogaster,143726002,NW_001847063.1,1,1053,7.32644e-06,143556384,0.99882
D.melanogaster,143726002,NW_001847072.1,1,1052,7.31948e-06,143557436,0.998827
D.melanogaster,143726002,NW_001847071.1,1,1052,7.31948e-06,143558488,0.998834
D.melanogaster,143726002,NW_001847070.1,1,1052,7.31948e-06,143559540,0.998842
D.melanogaster,143726002,NW_001847079.1,1,1051,7.31253e-06,143560591,0.998849
D.melanogaster,143726002,NW_001847078.1,1,1051,7.31253e-06,143561642,0.998856
D.melanogaster,143726002,NW_001847077.1,1,1051,7.31253e-06,143562693,0.998864
D.melanogaster,143726002,NW_001847075.1,1,1051,7.31253e-06,143563744,0.998871
D.melanogaster,143726002,NW_001847074.1,1,1051,7.31253e-06,143564795,0.998878
D.melanogaster,143726002,NW_001847082.1,1,1050,7.30557e-06,143565845,0.998886
D.melanogaster,143726002,NW_001847081.1,1,1050,7.30557e-06,143566895,0.998893
D.melanogaster,143726002,NW_001847087.1,1,1049,7.29861e-06,143567944,0.9989
D.melanogaster,143726002,NW_001847086.1,1,1049,7.29861e-06,143568993,0.998908
D.melanogaster,143726002,NW_001847085.1,1,1049,7.29861e-06,143570042,0.998915
D.melanogaster,143726002,NW_001847084.1,1,1049,7.29861e-06,143571091,0.998922
D.melanogaster,143726002,NW_001847083.1,1,1049,7.29861e-06,143572140,0.998929
D.melanogaster,143726002,NW_001847096.1,1,1048,7.29165e-06,143573188,0.998937
D.melanogaster,143726002,NW_001847095.1,1,1048,7.29165e-06,143574236,0.998944
D.melanogaster,143726002,NW_001847092.1,1,1048,7.29165e-06,143575284,0.998951
D.melanogaster,143726002,NW_001847091.1,1,1048,7.29165e-06,143576332,0.998959
D.melanogaster,143726002,NW_001847090.1,1,1048,7.29165e-06,143577380,0.998966
D.melanogaster,143726002,NW_001847102.1,1,1047,7.28469e-06,143578427,0.998973
D.melanogaster,143726002,NW_001847101.1,1,1047,7.28469e-06,143579474,0.998981
D.melanogaster,143726002,NW_001847099.1,1,1047,7.28469e-06,143580521,0.998988
D.melanogaster,143726002,NW_001847097.1,1,1047,7.28469e-06,143581568,0.998995
D.melanogaster,143726002,NW_001847105.1,1,1046,7.27774e-06,143582614,0.999002
D.melanogaster,143726002,NW_001847111.1,1,1045,7.27078e-06,143583659,0.99901
D.melanogaster,143726002,NW_001847110.1,1,1045,7.27078e-06,143584704,0.999017
D.melanogaster,143726002,NW_001847109.1,1,1045,7.27078e-06,143585749,0.999024
D.melanogaster,143726002,NW_001847107.1,1,1045,7.27078e-06,143586794,0.999031
D.melanogaster,143726002,NW_001847115.1,1,1044,7.26382e-06,143587838,0.999039
D.melanogaster,143726002,NW_001847114.1,1,1044,7.26382e-06,143588882,0.999046
D.melanogaster,143726002,NW_001847112.1,1,1044,7.26382e-06,143589926,0.999053
D.melanogaster,143726002,NW_001847117.1,1,1043,7.25686e-06,143590969,0.99906
D.melanogaster,143726002,NW_001847116.1,1,1043,7.25686e-06,143592012,0.999068
D.melanogaster,143726002,NW_001847128.1,1,1042,7.24991e-06,143593054,0.999075
D.melanogaster,143726002,NW_001847127.1,1,1042,7.24991e-06,143594096,0.999082
D.melanogaster,143726002,NW_001847125.1,1,1042,7.24991e-06,143595138,0.999089
D.melanogaster,143726002,NW_001847122.1,1,1042,7.24991e-06,143596180,0.999097
D.melanogaster,143726002,NW_001847121.1,1,1042,7.24991e-06,143597222,0.999104
D.melanogaster,143726002,NW_001847131.1,1,1041,7.24295e-06,143598263,0.999111
D.melanogaster,143726002,NW_001847130.1,1,1041,7.24295e-06,143599304,0.999118
D.melanogaster,143726002,NW_001847129.1,1,1041,7.24295e-06,143600345,0.999126
D.melanogaster,143726002,NW_001847137.1,1,1040,7.23599e-06,143601385,0.999133
D.melanogaster,143726002,NW_001847136.1,1,1040,7.23599e-06,143602425,0.99914
D.melanogaster,143726002,NW_001847135.1,1,1040,7.23599e-06,143603465,0.999147
D.melanogaster,143726002,NW_001847134.1,1,1040,7.23599e-06,143604505,0.999155
D.melanogaster,143726002,NW_001847140.1,1,1039,7.22903e-06,143605544,0.999162
D.melanogaster,143726002,NW_001847139.1,1,1039,7.22903e-06,143606583,0.999169
D.melanogaster,143726002,NW_001847138.1,1,1039,7.22903e-06,143607622,0.999176
D.melanogaster,143726002,NW_001847143.1,1,1038,7.22208e-06,143608660,0.999184
D.melanogaster,143726002,NW_001847142.1,1,1038,7.22208e-06,143609698,0.999191
D.melanogaster,143726002,NW_001847141.1,1,1038,7.22208e-06,143610736,0.999198
D.melanogaster,143726002,NW_001847147.1,1,1037,7.21512e-06,143611773,0.999205
D.melanogaster,143726002,NW_001847146.1,1,1037,7.21512e-06,143612810,0.999212
D.melanogaster,143726002,NW_001847145.1,1,1037,7.21512e-06,143613847,0.99922
D.melanogaster,143726002,NW_001847144.1,1,1037,7.21512e-06,143614884,0.999227
D.melanogaster,143726002,NW_001847149.1,1,1036,7.20816e-06,143615920,0.999234
D.melanogaster,143726002,NW_001847148.1,1,1036,7.20816e-06,143616956,0.999241
D.melanogaster,143726002,NW_001847157.1,1,1035,7.2012e-06,143617991,0.999248
D.melanogaster,143726002,NW_001847156.1,1,1035,7.2012e-06,143619026,0.999256
D.melanogaster,143726002,NW_001847154.1,1,1035,7.2012e-06,143620061,0.999263
D.melanogaster,143726002,NW_001847153.1,1,1035,7.2012e-06,143621096,0.99927
D.melanogaster,143726002,NW_001847152.1,1,1035,7.2012e-06,143622131,0.999277
D.melanogaster,143726002,NW_001847163.1,1,1033,7.18729e-06,143623164,0.999284
D.melanogaster,143726002,NW_001847162.1,1,1033,7.18729e-06,143624197,0.999292
D.melanogaster,143726002,NW_001847161.1,1,1033,7.18729e-06,143625230,0.999299
D.melanogaster,143726002,NW_001847159.1,1,1033,7.18729e-06,143626263,0.999306
D.melanogaster,143726002,NW_001847167.1,1,1032,7.18033e-06,143627295,0.999313
D.melanogaster,143726002,NW_001847165.1,1,1032,7.18033e-06,143628327,0.99932
D.melanogaster,143726002,NW_001847164.1,1,1032,7.18033e-06,143629359,0.999328
D.melanogaster,143726002,NW_001847171.1,1,1031,7.17337e-06,143630390,0.999335
D.melanogaster,143726002,NW_001847169.1,1,1031,7.17337e-06,143631421,0.999342
D.melanogaster,143726002,NW_001847168.1,1,1031,7.17337e-06,143632452,0.999349
D.melanogaster,143726002,NW_001847175.1,1,1030,7.16641e-06,143633482,0.999356
D.melanogaster,143726002,NW_001847174.1,1,1030,7.16641e-06,143634512,0.999363
D.melanogaster,143726002,NW_001847172.1,1,1030,7.16641e-06,143635542,0.999371
D.melanogaster,143726002,NW_001847183.1,1,1029,7.15946e-06,143636571,0.999378
D.melanogaster,143726002,NW_001847182.1,1,1029,7.15946e-06,143637600,0.999385
D.melanogaster,143726002,NW_001847181.1,1,1029,7.15946e-06,143638629,0.999392
D.melanogaster,143726002,NW_001847180.1,1,1029,7.15946e-06,143639658,0.999399
D.melanogaster,143726002,NW_001847178.1,1,1029,7.15946e-06,143640687,0.999406
D.melanogaster,143726002,NW_001847177.1,1,1029,7.15946e-06,143641716,0.999414
D.melanogaster,143726002,NW_001847176.1,1,1029,7.15946e-06,143642745,0.999421
D.melanogaster,143726002,NW_001847187.1,1,1028,7.1525e-06,143643773,0.999428
D.melanogaster,143726002,NW_001847186.1,1,1028,7.1525e-06,143644801,0.999435
D.melanogaster,143726002,NW_001847190.1,1,1027,7.14554e-06,143645828,0.999442
D.melanogaster,143726002,NW_001847189.1,1,1027,7.14554e-06,143646855,0.999449
D.melanogaster,143726002,NW_001847188.1,1,1027,7.14554e-06,143647882,0.999456
D.melanogaster,143726002,NW_001847192.1,1,1026,7.13858e-06,143648908,0.999464
D.melanogaster,143726002,NW_001847191.1,1,1026,7.13858e-06,143649934,0.999471
D.melanogaster,143726002,NW_001847196.1,1,1025,7.13163e-06,143650959,0.999478
D.melanogaster,143726002,NW_001847195.1,1,1025,7.13163e-06,143651984,0.999485
D.melanogaster,143726002,NW_001847194.1,1,1025,7.13163e-06,143653009,0.999492
D.melanogaster,143726002,NW_001847193.1,1,1025,7.13163e-06,143654034,0.999499
D.melanogaster,143726002,NW_001847200.1,1,1023,7.11771e-06,143655057,0.999506
D.melanogaster,143726002,NW_001847198.1,1,1023,7.11771e-06,143656080,0.999514
D.melanogaster,143726002,NW_001847206.1,1,1022,7.11075e-06,143657102,0.999521
D.melanogaster,143726002,NW_001847204.1,1,1022,7.11075e-06,143658124,0.999528
D.melanogaster,143726002,NW_001847202.1,1,1022,7.11075e-06,143659146,0.999535
D.melanogaster,143726002,NW_001847201.1,1,1022,7.11075e-06,143660168,0.999542
D.melanogaster,143726002,NW_001847212.1,1,1021,7.10379e-06,143661189,0.999549
D.melanogaster,143726002,NW_001847208.1,1,1021,7.10379e-06,143662210,0.999556
D.melanogaster,143726002,NW_001847207.1,1,1021,7.10379e-06,143663231,0.999563
D.melanogaster,143726002,NW_001847218.1,1,1020,7.09684e-06,143664251,0.99957
D.melanogaster,143726002,NW_001847216.1,1,1020,7.09684e-06,143665271,0.999577
D.melanogaster,143726002,NW_001847214.1,1,1020,7.09684e-06,143666291,0.999585
D.melanogaster,143726002,NW_001847227.1,1,1019,7.08988e-06,143667310,0.999592
D.melanogaster,143726002,NW_001847224.1,1,1019,7.08988e-06,143668329,0.999599
D.melanogaster,143726002,NW_001847223.1,1,1019,7.08988e-06,143669348,0.999606
D.melanogaster,143726002,NW_001847222.1,1,1019,7.08988e-06,143670367,0.999613
D.melanogaster,143726002,NW_001847221.1,1,1019,7.08988e-06,143671386,0.99962
D.melanogaster,143726002,NW_001847231.1,1,1018,7.08292e-06,143672404,0.999627
D.melanogaster,143726002,NW_001847230.1,1,1018,7.08292e-06,143673422,0.999634
D.melanogaster,143726002,NW_001847229.1,1,1018,7.08292e-06,143674440,0.999641
D.melanogaster,143726002,NW_001847228.1,1,1018,7.08292e-06,143675458,0.999648
D.melanogaster,143726002,NW_001847236.1,1,1016,7.06901e-06,143676474,0.999655
D.melanogaster,143726002,NW_001847235.1,1,1016,7.06901e-06,143677490,0.999662
D.melanogaster,143726002,NW_001847233.1,1,1016,7.06901e-06,143678506,0.99967
D.melanogaster,143726002,NW_001847239.1,1,1015,7.06205e-06,143679521,0.999677
D.melanogaster,143726002,NW_001847237.1,1,1015,7.06205e-06,143680536,0.999684
D.melanogaster,143726002,NW_001847245.1,1,1014,7.05509e-06,143681550,0.999691
D.melanogaster,143726002,NW_001847244.1,1,1014,7.05509e-06,143682564,0.999698
D.melanogaster,143726002,NW_001847243.1,1,1014,7.05509e-06,143683578,0.999705
D.melanogaster,143726002,NW_001847242.1,1,1014,7.05509e-06,143684592,0.999712
D.melanogaster,143726002,NW_001847241.1,1,1014,7.05509e-06,143685606,0.999719
D.melanogaster,143726002,NW_001847248.1,1,1013,7.04813e-06,143686619,0.999726
D.melanogaster,143726002,NW_001847247.1,1,1013,7.04813e-06,143687632,0.999733
D.melanogaster,143726002,NW_001847246.1,1,1013,7.04813e-06,143688645,0.99974
D.melanogaster,143726002,NW_001847254.1,1,1012,7.04118e-06,143689657,0.999747
D.melanogaster,143726002,NW_001847253.1,1,1012,7.04118e-06,143690669,0.999754
D.melanogaster,143726002,NW_001847252.1,1,1012,7.04118e-06,143691681,0.999761
D.melanogaster,143726002,NW_001847251.1,1,1012,7.04118e-06,143692693,0.999768
D.melanogaster,143726002,NW_001847249.1,1,1012,7.04118e-06,143693705,0.999775
D.melanogaster,143726002,NW_001847258.1,1,1011,7.03422e-06,143694716,0.999782
D.melanogaster,143726002,NW_001847257.1,1,1011,7.03422e-06,143695727,0.999789
D.melanogaster,143726002,NW_001847256.1,1,1011,7.03422e-06,143696738,0.999796
D.melanogaster,143726002,NW_001847255.1,1,1011,7.03422e-06,143697749,0.999803
D.melanogaster,143726002,NW_001847264.1,1,1010,7.02726e-06,143698759,0.99981
D.melanogaster,143726002,NW_001847263.1,1,1010,7.02726e-06,143699769,0.999817
D.melanogaster,143726002,NW_001847262.1,1,1010,7.02726e-06,143700779,0.999825
D.melanogaster,143726002,NW_001847261.1,1,1010,7.02726e-06,143701789,0.999832
D.melanogaster,143726002,NW_001847269.1,1,1008,7.01334e-06,143702797,0.999839
D.melanogaster,143726002,NW_001847268.1,1,1008,7.01334e-06,143703805,0.999846
D.melanogaster,143726002,NW_001847267.1,1,1008,7.01334e-06,143704813,0.999853
D.melanogaster,143726002,NW_001847271.1,1,1007,7.00639e-06,143705820,0.99986
D.melanogaster,143726002,NW_001847270.1,1,1007,7.00639e-06,143706827,0.999867
D.melanogaster,143726002,NW_001847274.1,1,1006,6.99943e-06,143707833,0.999874
D.melanogaster,143726002,NW_001847273.1,1,1006,6.99943e-06,143708839,0.999881
D.melanogaster,143726002,NW_001847272.1,1,1006,6.99943e-06,143709845,0.999888
D.melanogaster,143726002,NW_001847280.1,1,1005,6.99247e-06,143710850,0.999895
D.melanogaster,143726002,NW_001847278.1,1,1005,6.99247e-06,143711855,0.999902
D.melanogaster,143726002,NW_001847277.1,1,1005,6.99247e-06,143712860,0.999909
D.melanogaster,143726002,NW_001847276.1,1,1005,6.99247e-06,143713865,0.999916
D.melanogaster,143726002,NW_001847275.1,1,1005,6.99247e-06,143714870,0.999923
D.melanogaster,143726002,NW_001847286.1,1,1004,6.98551e-06,143715874,0.99993
D.melanogaster,143726002,NW_001847285.1,1,1004,6.98551e-06,143716878,0.999937
D.melanogaster,143726002,NW_001847284.1,1,1004,6.98551e-06,143717882,0.999944
D.melanogaster,143726002,NW_001847283.1,1,1004,6.98551e-06,143718886,0.99995
D.melanogaster,143726002,NW_001847287.1,1,1003,6.97856e-06,143719889,0.999957
D.melanogaster,143726002,NW_001847297.1,1,1001,6.96464e-06,143720890,0.999964
D.melanogaster,143726002,NW_001847294.1,1,1001,6.96464e-06,143721891,0.999971
D.melanogaster,143726002,NW_001847293.1,1,1001,6.96464e-06,143722892,0.999978
D.melanogaster,143726002,NW_001847292.1,1,1001,6.96464e-06,143723893,0.999985
D.melanogaster,143726002,NW_001847291.1,1,1001,6.96464e-06,143724894,0.999992
D.melanogaster,143726002,NW_001846984.2,1,564,3.92413e-06,143725458,0.999996
D.melanogaster,143726002,NW_001846855.2,1,544,3.78498e-06,143726002,1
D.bunnanda,151823105,VNKE01006001.1,1,1142480,0.00752507,1142480,0.00752507
D.bunnanda,151823105,VNKE01001092.1,1,1127760,0.00742812,2270240,0.0149532
D.bunnanda,151823105,VNKE01001790.1,1,915998,0.00603332,3186238,0.0209865
D.bunnanda,151823105,VNKE01002636.1,1,838944,0.0055258,4025182,0.0265123
D.bunnanda,151823105,VNKE01006472.1,1,795698,0.00524095,4820880,0.0317533
D.bunnanda,151823105,VNKE01003659.1,1,780685,0.00514207,5601565,0.0368953
D.bunnanda,151823105,VNKE01003950.1,1,735197,0.00484246,6336762,0.0417378
D.bunnanda,151823105,VNKE01001106.1,1,678689,0.00447026,7015451,0.0462081
D.bunnanda,151823105,VNKE01001097.1,1,669457,0.00440945,7684908,0.0506175
D.bunnanda,151823105,VNKE01004989.1,1,646232,0.00425648,8331140,0.054874
D.bunnanda,151823105,VNKE01002103.1,1,631302,0.00415814,8962442,0.0590321
D.bunnanda,151823105,VNKE01001787.1,1,628611,0.00414042,9591053,0.0631726
D.bunnanda,151823105,VNKE01001683.1,1,617933,0.00407009,10208986,0.0672426
D.bunnanda,151823105,VNKE01001101.1,1,567784,0.00373977,10776770,0.0709824
D.bunnanda,151823105,VNKE01001406.1,1,554709,0.00365365,11331479,0.0746361
D.bunnanda,151823105,VNKE01004968.1,1,534806,0.00352256,11866285,0.0781586
D.bunnanda,151823105,VNKE01001245.1,1,525073,0.00345845,12391358,0.0816171
D.bunnanda,151823105,VNKE01005989.1,1,520986,0.00343153,12912344,0.0850486
D.bunnanda,151823105,VNKE01004906.1,1,512457,0.00337536,13424801,0.088424
D.bunnanda,151823105,VNKE01006419.1,1,497416,0.00327629,13922217,0.0917003
D.bunnanda,151823105,VNKE01003447.1,1,491618,0.0032381,14413835,0.0949383
D.bunnanda,151823105,VNKE01001107.1,1,478313,0.00315046,14892148,0.0980888
D.bunnanda,151823105,VNKE01004107.1,1,478186,0.00314963,15370334,0.101238
D.bunnanda,151823105,VNKE01001132.1,1,460728,0.00303464,15831062,0.104273
D.bunnanda,151823105,VNKE01000991.1,1,458795,0.0030219,16289857,0.107295
D.bunnanda,151823105,VNKE01002708.1,1,450413,0.0029667,16740270,0.110262
D.bunnanda,151823105,VNKE01001181.1,1,449633,0.00296156,17189903,0.113223
D.bunnanda,151823105,VNKE01003471.1,1,442990,0.0029178,17632893,0.116141
D.bunnanda,151823105,VNKE01001750.1,1,439821,0.00289693,18072714,0.119038
D.bunnanda,151823105,VNKE01003347.1,1,437025,0.00287851,18509739,0.121916
D.bunnanda,151823105,VNKE01001209.1,1,435717,0.0028699,18945456,0.124786
D.bunnanda,151823105,VNKE01004443.1,1,432986,0.00285191,19378442,0.127638
D.bunnanda,151823105,VNKE01004507.1,1,428306,0.00282109,19806748,0.130459
D.bunnanda,151823105,VNKE01001918.1,1,426009,0.00280596,20232757,0.133265
D.bunnanda,151823105,VNKE01002089.1,1,402723,0.00265258,20635480,0.135918
D.bunnanda,151823105,VNKE01001273.1,1,400517,0.00263805,21035997,0.138556
D.bunnanda,151823105,VNKE01005860.1,1,392883,0.00258777,21428880,0.141144
D.bunnanda,151823105,VNKE01004941.1,1,375590,0.00247387,21804470,0.143618
D.bunnanda,151823105,VNKE01004454.1,1,372508,0.00245357,22176978,0.146071
D.bunnanda,151823105,VNKE01000998.1,1,367839,0.00242281,22544817,0.148494
D.bunnanda,151823105,VNKE01006336.1,1,367222,0.00241875,22912039,0.150913
D.bunnanda,151823105,VNKE01003054.1,1,362742,0.00238924,23274781,0.153302
D.bunnanda,151823105,VNKE01003727.1,1,362664,0.00238873,23637445,0.155691
D.bunnanda,151823105,VNKE01000334.1,1,346488,0.00228218,23983933,0.157973
D.bunnanda,151823105,VNKE01001329.1,1,345180,0.00227357,24329113,0.160246
D.bunnanda,151823105,VNKE01005297.1,1,343278,0.00226104,24672391,0.162507
D.bunnanda,151823105,VNKE01003696.1,1,341690,0.00225058,25014081,0.164758
D.bunnanda,151823105,VNKE01004342.1,1,341357,0.00224839,25355438,0.167006
D.bunnanda,151823105,VNKE01005787.1,1,340489,0.00224267,25695927,0.169249
D.bunnanda,151823105,VNKE01001540.1,1,339146,0.00223382,26035073,0.171483
D.bunnanda,151823105,VNKE01003688.1,1,338104,0.00222696,26373177,0.17371
D.bunnanda,151823105,VNKE01001574.1,1,338043,0.00222656,26711220,0.175936
D.bunnanda,151823105,VNKE01002526.1,1,337327,0.00222184,27048547,0.178158
D.bunnanda,151823105,VNKE01005985.1,1,335860,0.00221218,27384407,0.18037
D.bunnanda,151823105,VNKE01001327.1,1,335517,0.00220992,27719924,0.18258
D.bunnanda,151823105,VNKE01006410.1,1,335062,0.00220692,28054986,0.184787
D.bunnanda,151823105,VNKE01002371.1,1,334194,0.00220121,28389180,0.186989
D.bunnanda,151823105,VNKE01006075.1,1,332349,0.00218905,28721529,0.189178
D.bunnanda,151823105,VNKE01002551.1,1,331885,0.002186,29053414,0.191364
D.bunnanda,151823105,VNKE01002083.1,1,327727,0.00215861,29381141,0.193522
D.bunnanda,151823105,VNKE01004325.1,1,324560,0.00213775,29705701,0.19566
D.bunnanda,151823105,VNKE01002063.1,1,322857,0.00212653,30028558,0.197786
D.bunnanda,151823105,VNKE01005741.1,1,318395,0.00209714,30346953,0.199884
D.bunnanda,151823105,VNKE01001571.1,1,315389,0.00207735,30662342,0.201961
D.bunnanda,151823105,VNKE01004935.1,1,313943,0.00206782,30976285,0.204029
D.bunnanda,151823105,VNKE01000928.1,1,306447,0.00201845,31282732,0.206047
D.bunnanda,151823105,VNKE01000675.1,1,306039,0.00201576,31588771,0.208063
D.bunnanda,151823105,VNKE01000807.1,1,304928,0.00200844,31893699,0.210071
D.bunnanda,151823105,VNKE01004338.1,1,304164,0.00200341,32197863,0.212075
D.bunnanda,151823105,VNKE01001225.1,1,303981,0.00200221,32501844,0.214077
D.bunnanda,151823105,VNKE01003334.1,1,300949,0.00198223,32802793,0.216059
D.bunnanda,151823105,VNKE01002656.1,1,293692,0.00193444,33096485,0.217994
D.bunnanda,151823105,VNKE01001858.1,1,291829,0.00192216,33388314,0.219916
D.bunnanda,151823105,VNKE01005159.1,1,291757,0.00192169,33680071,0.221838
D.bunnanda,151823105,VNKE01003587.1,1,291517,0.00192011,33971588,0.223758
D.bunnanda,151823105,VNKE01003346.1,1,290031,0.00191032,34261619,0.225668
D.bunnanda,151823105,VNKE01004497.1,1,289183,0.00190474,34550802,0.227573
D.bunnanda,151823105,VNKE01003099.1,1,287758,0.00189535,34838560,0.229468
D.bunnanda,151823105,VNKE01002984.1,1,286678,0.00188824,35125238,0.231356
D.bunnanda,151823105,VNKE01002502.1,1,283533,0.00186752,35408771,0.233224
D.bunnanda,151823105,VNKE01000153.1,1,273281,0.0018,35682052,0.235024
D.bunnanda,151823105,VNKE01005303.1,1,273172,0.00179928,35955224,0.236823
D.bunnanda,151823105,VNKE01000191.1,1,270934,0.00178454,36226158,0.238608
D.bunnanda,151823105,VNKE01001569.1,1,270876,0.00178416,36497034,0.240392
D.bunnanda,151823105,VNKE01001582.1,1,269402,0.00177445,36766436,0.242166
D.bunnanda,151823105,VNKE01001089.1,1,268825,0.00177065,37035261,0.243937
D.bunnanda,151823105,VNKE01002161.1,1,266859,0.0017577,37302120,0.245695
D.bunnanda,151823105,VNKE01005519.1,1,265316,0.00174753,37567436,0.247442
D.bunnanda,151823105,VNKE01003588.1,1,264586,0.00174273,37832022,0.249185
D.bunnanda,151823105,VNKE01000035.1,1,260170,0.00171364,38092192,0.250899
D.bunnanda,151823105,VNKE01002695.1,1,258716,0.00170406,38350908,0.252603
D.bunnanda,151823105,VNKE01003608.1,1,258690,0.00170389,38609598,0.254306
D.bunnanda,151823105,VNKE01004502.1,1,257342,0.00169501,38866940,0.256001
D.bunnanda,151823105,VNKE01006045.1,1,257327,0.00169491,39124267,0.257696
D.bunnanda,151823105,VNKE01004985.1,1,256556,0.00168984,39380823,0.259386
D.bunnanda,151823105,VNKE01003348.1,1,251598,0.00165718,39632421,0.261043
D.bunnanda,151823105,VNKE01001204.1,1,250917,0.00165269,39883338,0.262696
D.bunnanda,151823105,VNKE01001695.1,1,250648,0.00165092,40133986,0.264347
D.bunnanda,151823105,VNKE01005799.1,1,249073,0.00164055,40383059,0.265988
D.bunnanda,151823105,VNKE01005292.1,1,248821,0.00163889,40631880,0.267626
D.bunnanda,151823105,VNKE01004879.1,1,248164,0.00163456,40880044,0.269261
D.bunnanda,151823105,VNKE01002483.1,1,247979,0.00163334,41128023,0.270894
D.bunnanda,151823105,VNKE01005417.1,1,247778,0.00163202,41375801,0.272526
D.bunnanda,151823105,VNKE01004072.1,1,247537,0.00163043,41623338,0.274157
D.bunnanda,151823105,VNKE01006280.1,1,246637,0.0016245,41869975,0.275781
D.bunnanda,151823105,VNKE01002513.1,1,244580,0.00161095,42114555,0.277392
D.bunnanda,151823105,VNKE01005307.1,1,244416,0.00160987,42358971,0.279002
D.bunnanda,151823105,VNKE01001859.1,1,244087,0.00160771,42603058,0.28061
D.bunnanda,151823105,VNKE01003888.1,1,243729,0.00160535,42846787,0.282215
D.bunnanda,151823105,VNKE01005566.1,1,243617,0.00160461,43090404,0.28382
D.bunnanda,151823105,VNKE01003321.1,1,243378,0.00160304,43333782,0.285423
D.bunnanda,151823105,VNKE01001579.1,1,242851,0.00159957,43576633,0.287022
D.bunnanda,151823105,VNKE01004307.1,1,242006,0.001594,43818639,0.288616
D.bunnanda,151823105,VNKE01003828.1,1,239092,0.00157481,44057731,0.290191
D.bunnanda,151823105,VNKE01000178.1,1,238836,0.00157312,44296567,0.291764
D.bunnanda,151823105,VNKE01001061.1,1,238802,0.0015729,44535369,0.293337
D.bunnanda,151823105,VNKE01001252.1,1,236265,0.00155619,44771634,0.294893
D.bunnanda,151823105,VNKE01006074.1,1,235925,0.00155395,45007559,0.296447
D.bunnanda,151823105,VNKE01004365.1,1,233544,0.00153826,45241103,0.297986
D.bunnanda,151823105,VNKE01001216.1,1,228301,0.00150373,45469404,0.299489
D.bunnanda,151823105,VNKE01005181.1,1,226011,0.00148865,45695415,0.300978
D.bunnanda,151823105,VNKE01005919.1,1,224995,0.00148195,45920410,0.30246
D.bunnanda,151823105,VNKE01006318.1,1,223955,0.0014751,46144365,0.303935
D.bunnanda,151823105,VNKE01003900.1,1,223392,0.0014714,46367757,0.305406
D.bunnanda,151823105,VNKE01001465.1,1,223312,0.00147087,46591069,0.306877
D.bunnanda,151823105,VNKE01000729.1,1,223154,0.00146983,46814223,0.308347
D.bunnanda,151823105,VNKE01005287.1,1,223149,0.0014698,47037372,0.309817
D.bunnanda,151823105,VNKE01000395.1,1,221311,0.00145769,47258683,0.311275
D.bunnanda,151823105,VNKE01005189.1,1,220242,0.00145065,47478925,0.312725
D.bunnanda,151823105,VNKE01005525.1,1,218525,0.00143934,47697450,0.314165
D.bunnanda,151823105,VNKE01002276.1,1,218303,0.00143788,47915753,0.315603
D.bunnanda,151823105,VNKE01004952.1,1,217516,0.00143269,48133269,0.317035
D.bunnanda,151823105,VNKE01000103.1,1,214828,0.00141499,48348097,0.31845
D.bunnanda,151823105,VNKE01006530.1,1,214682,0.00141403,48562779,0.319864
D.bunnanda,151823105,VNKE01006565.1,1,214593,0.00141344,48777372,0.321278
D.bunnanda,151823105,VNKE01004774.1,1,213743,0.00140784,48991115,0.322686
D.bunnanda,151823105,VNKE01002613.1,1,210881,0.00138899,49201996,0.324074
D.bunnanda,151823105,VNKE01003868.1,1,208927,0.00137612,49410923,0.325451
D.bunnanda,151823105,VNKE01005324.1,1,208750,0.00137496,49619673,0.326826
D.bunnanda,151823105,VNKE01005306.1,1,208578,0.00137382,49828251,0.328199
D.bunnanda,151823105,VNKE01000923.1,1,207906,0.0013694,50036157,0.329569
D.bunnanda,151823105,VNKE01001573.1,1,206165,0.00135793,50242322,0.330927
D.bunnanda,151823105,VNKE01000194.1,1,206165,0.00135793,50448487,0.332285
D.bunnanda,151823105,VNKE01003136.1,1,205926,0.00135635,50654413,0.333641
D.bunnanda,151823105,VNKE01003903.1,1,203267,0.00133884,50857680,0.33498
D.bunnanda,151823105,VNKE01004615.1,1,201771,0.00132899,51059451,0.336309
D.bunnanda,151823105,VNKE01001315.1,1,201769,0.00132897,51261220,0.337638
D.bunnanda,151823105,VNKE01000174.1,1,201069,0.00132436,51462289,0.338962
D.bunnanda,151823105,VNKE01005792.1,1,200789,0.00132252,51663078,0.340285
D.bunnanda,151823105,VNKE01000573.1,1,199876,0.00131651,51862954,0.341601
D.bunnanda,151823105,VNKE01000156.1,1,199449,0.00131369,52062403,0.342915
D.bunnanda,151823105,VNKE01005499.1,1,198668,0.00130855,52261071,0.344223
D.bunnanda,151823105,VNKE01000694.1,1,197841,0.0013031,52458912,0.345527
D.bunnanda,151823105,VNKE01000350.1,1,196923,0.00129706,52655835,0.346824
D.bunnanda,151823105,VNKE01001578.1,1,196029,0.00129117,52851864,0.348115
D.bunnanda,151823105,VNKE01000098.1,1,195969,0.00129077,53047833,0.349406
D.bunnanda,151823105,VNKE01001791.1,1,195792,0.00128961,53243625,0.350695
D.bunnanda,151823105,VNKE01001684.1,1,195036,0.00128463,53438661,0.35198
D.bunnanda,151823105,VNKE01001680.1,1,194458,0.00128082,53633119,0.353261
D.bunnanda,151823105,VNKE01001198.1,1,194020,0.00127793,53827139,0.354539
D.bunnanda,151823105,VNKE01003631.1,1,193475,0.00127434,54020614,0.355813
D.bunnanda,151823105,VNKE01002317.1,1,191246,0.00125966,54211860,0.357073
D.bunnanda,151823105,VNKE01005323.1,1,190413,0.00125418,54402273,0.358327
D.bunnanda,151823105,VNKE01003600.1,1,190387,0.00125401,54592660,0.359581
D.bunnanda,151823105,VNKE01002812.1,1,188204,0.00123963,54780864,0.36082
D.bunnanda,151823105,VNKE01006018.1,1,188200,0.0012396,54969064,0.36206
D.bunnanda,151823105,VNKE01001077.1,1,188117,0.00123905,55157181,0.363299
D.bunnanda,151823105,VNKE01003286.1,1,188116,0.00123905,55345297,0.364538
D.bunnanda,151823105,VNKE01001062.1,1,187705,0.00123634,55533002,0.365774
D.bunnanda,151823105,VNKE01003470.1,1,187354,0.00123403,55720356,0.367008
D.bunnanda,151823105,VNKE01000365.1,1,187026,0.00123187,55907382,0.36824
D.bunnanda,151823105,VNKE01006347.1,1,186247,0.00122674,56093629,0.369467
D.bunnanda,151823105,VNKE01000209.1,1,185693,0.00122309,56279322,0.37069
D.bunnanda,151823105,VNKE01004046.1,1,184920,0.001218,56464242,0.371908
D.bunnanda,151823105,VNKE01000107.1,1,184233,0.00121347,56648475,0.373122
D.bunnanda,151823105,VNKE01005838.1,1,183550,0.00120897,56832025,0.374331
D.bunnanda,151823105,VNKE01000394.1,1,183237,0.00120691,57015262,0.375537
D.bunnanda,151823105,VNKE01000483.1,1,180422,0.00118837,57195684,0.376726
D.bunnanda,151823105,VNKE01001338.1,1,180221,0.00118705,57375905,0.377913
D.bunnanda,151823105,VNKE01004384.1,1,179382,0.00118152,57555287,0.379094
D.bunnanda,151823105,VNKE01004886.1,1,178285,0.00117429,57733572,0.380269
D.bunnanda,151823105,VNKE01005319.1,1,177101,0.0011665,57910673,0.381435
D.bunnanda,151823105,VNKE01004218.1,1,176601,0.0011632,58087274,0.382598
D.bunnanda,151823105,VNKE01006201.1,1,175998,0.00115923,58263272,0.383758
D.bunnanda,151823105,VNKE01002101.1,1,173831,0.00114496,58437103,0.384903
D.bunnanda,151823105,VNKE01001688.1,1,171537,0.00112985,58608640,0.386032
D.bunnanda,151823105,VNKE01004882.1,1,171222,0.00112777,58779862,0.38716
D.bunnanda,151823105,VNKE01006555.1,1,169640,0.00111735,58949502,0.388278
D.bunnanda,151823105,VNKE01003597.1,1,169301,0.00111512,59118803,0.389393
D.bunnanda,151823105,VNKE01004373.1,1,169264,0.00111488,59288067,0.390508
D.bunnanda,151823105,VNKE01003533.1,1,168807,0.00111187,59456874,0.391619
D.bunnanda,151823105,VNKE01001780.1,1,167473,0.00110308,59624347,0.392722
D.bunnanda,151823105,VNKE01001235.1,1,167300,0.00110194,59791647,0.393824
D.bunnanda,151823105,VNKE01001461.1,1,166661,0.00109773,59958308,0.394922
D.bunnanda,151823105,VNKE01003684.1,1,166115,0.00109414,60124423,0.396016
D.bunnanda,151823105,VNKE01005580.1,1,165984,0.00109327,60290407,0.39711
D.bunnanda,151823105,VNKE01002810.1,1,165807,0.00109211,60456214,0.398202
D.bunnanda,151823105,VNKE01000960.1,1,165466,0.00108986,60621680,0.399292
D.bunnanda,151823105,VNKE01004143.1,1,165314,0.00108886,60786994,0.40038
D.bunnanda,151823105,VNKE01005988.1,1,165127,0.00108763,60952121,0.401468
D.bunnanda,151823105,VNKE01005984.1,1,163654,0.00107793,61115775,0.402546
D.bunnanda,151823105,VNKE01006549.1,1,163392,0.0010762,61279167,0.403622
D.bunnanda,151823105,VNKE01002666.1,1,162345,0.0010693,61441512,0.404691
D.bunnanda,151823105,VNKE01002756.1,1,162324,0.00106917,61603836,0.405761
D.bunnanda,151823105,VNKE01001447.1,1,161746,0.00106536,61765582,0.406826
D.bunnanda,151823105,VNKE01005461.1,1,161595,0.00106436,61927177,0.40789
D.bunnanda,151823105,VNKE01002286.1,1,161112,0.00106118,62088289,0.408952
D.bunnanda,151823105,VNKE01002535.1,1,160582,0.00105769,62248871,0.410009
D.bunnanda,151823105,VNKE01003469.1,1,159812,0.00105262,62408683,0.411062
D.bunnanda,151823105,VNKE01001091.1,1,159500,0.00105056,62568183,0.412112
D.bunnanda,151823105,VNKE01003241.1,1,159340,0.00104951,62727523,0.413162
D.bunnanda,151823105,VNKE01002107.1,1,158788,0.00104588,62886311,0.414208
D.bunnanda,151823105,VNKE01003344.1,1,158635,0.00104487,63044946,0.415253
D.bunnanda,151823105,VNKE01002833.1,1,158340,0.00104292,63203286,0.416296
D.bunnanda,151823105,VNKE01002299.1,1,157821,0.00103951,63361107,0.417335
D.bunnanda,151823105,VNKE01004599.1,1,157159,0.00103515,63518266,0.41837
D.bunnanda,151823105,VNKE01005548.1,1,155757,0.00102591,63674023,0.419396
D.bunnanda,151823105,VNKE01004627.1,1,155563,0.00102463,63829586,0.420421
D.bunnanda,151823105,VNKE01004588.1,1,154504,0.00101766,63984090,0.421438
D.bunnanda,151823105,VNKE01001781.1,1,153497,0.00101103,64137587,0.422449
D.bunnanda,151823105,VNKE01002341.1,1,151933,0.00100072,64289520,0.42345
D.bunnanda,151823105,VNKE01002801.1,1,151020,0.00099471,64440540,0.424445
D.bunnanda,151823105,VNKE01001833.1,1,150816,0.000993367,64591356,0.425438
D.bunnanda,151823105,VNKE01002514.1,1,149335,0.000983612,64740691,0.426422
D.bunnanda,151823105,VNKE01004309.1,1,149302,0.000983394,64889993,0.427405
D.bunnanda,151823105,VNKE01000353.1,1,148707,0.000979475,65038700,0.428385
D.bunnanda,151823105,VNKE01001836.1,1,148649,0.000979093,65187349,0.429364
D.bunnanda,151823105,VNKE01001960.1,1,147983,0.000974707,65335332,0.430339
D.bunnanda,151823105,VNKE01003985.1,1,147763,0.000973258,65483095,0.431312
D.bunnanda,151823105,VNKE01001104.1,1,147627,0.000972362,65630722,0.432284
D.bunnanda,151823105,VNKE01002563.1,1,147484,0.00097142,65778206,0.433256
D.bunnanda,151823105,VNKE01001514.1,1,146718,0.000966375,65924924,0.434222
D.bunnanda,151823105,VNKE01003391.1,1,146689,0.000966184,66071613,0.435188
D.bunnanda,151823105,VNKE01005581.1,1,146598,0.000965584,66218211,0.436154
D.bunnanda,151823105,VNKE01001446.1,1,146238,0.000963213,66364449,0.437117
D.bunnanda,151823105,VNKE01004986.1,1,146042,0.000961922,66510491,0.438079
D.bunnanda,151823105,VNKE01001473.1,1,145584,0.000958905,66656075,0.439038
D.bunnanda,151823105,VNKE01004971.1,1,145202,0.000956389,66801277,0.439994
D.bunnanda,151823105,VNKE01002295.1,1,144190,0.000949724,66945467,0.440944
D.bunnanda,151823105,VNKE01004257.1,1,143955,0.000948176,67089422,0.441892
D.bunnanda,151823105,VNKE01005736.1,1,143756,0.000946865,67233178,0.442839
D.bunnanda,151823105,VNKE01004076.1,1,143523,0.00094533,67376701,0.443784
D.bunnanda,151823105,VNKE01002278.1,1,143223,0.000943354,67519924,0.444728
D.bunnanda,151823105,VNKE01005111.1,1,141114,0.000929463,67661038,0.445657
D.bunnanda,151823105,VNKE01002677.1,1,140776,0.000927237,67801814,0.446584
D.bunnanda,151823105,VNKE01004772.1,1,140768,0.000927184,67942582,0.447511
D.bunnanda,151823105,VNKE01001892.1,1,139511,0.000918905,68082093,0.44843
D.bunnanda,151823105,VNKE01005115.1,1,139381,0.000918049,68221474,0.449348
D.bunnanda,151823105,VNKE01000768.1,1,139079,0.00091606,68360553,0.450264
D.bunnanda,151823105,VNKE01003636.1,1,138900,0.000914881,68499453,0.451179
D.bunnanda,151823105,VNKE01003793.1,1,138055,0.000909315,68637508,0.452089
D.bunnanda,151823105,VNKE01004630.1,1,137126,0.000903196,68774634,0.452992
D.bunnanda,151823105,VNKE01002510.1,1,137095,0.000902992,68911729,0.453895
D.bunnanda,151823105,VNKE01000208.1,1,137083,0.000902913,69048812,0.454798
D.bunnanda,151823105,VNKE01003527.1,1,136756,0.000900759,69185568,0.455699
D.bunnanda,151823105,VNKE01002345.1,1,135134,0.000890075,69320702,0.456589
D.bunnanda,151823105,VNKE01001196.1,1,135072,0.000889667,69455774,0.457478
D.bunnanda,151823105,VNKE01002547.1,1,134649,0.000886881,69590423,0.458365
D.bunnanda,151823105,VNKE01000106.1,1,134438,0.000885491,69724861,0.459251
D.bunnanda,151823105,VNKE01004887.1,1,134395,0.000885208,69859256,0.460136
D.bunnanda,151823105,VNKE01000203.1,1,134261,0.000884325,69993517,0.46102
D.bunnanda,151823105,VNKE01000967.1,1,134110,0.000883331,70127627,0.461904
D.bunnanda,151823105,VNKE01002601.1,1,133846,0.000881592,70261473,0.462785
D.bunnanda,151823105,VNKE01005112.1,1,133654,0.000880327,70395127,0.463665
D.bunnanda,151823105,VNKE01003647.1,1,133607,0.000880018,70528734,0.464545
D.bunnanda,151823105,VNKE01001896.1,1,133565,0.000879741,70662299,0.465425
D.bunnanda,151823105,VNKE01001478.1,1,131712,0.000867536,70794011,0.466293
D.bunnanda,151823105,VNKE01004509.1,1,131199,0.000864157,70925210,0.467157
D.bunnanda,151823105,VNKE01003575.1,1,130627,0.000860389,71055837,0.468017
D.bunnanda,151823105,VNKE01003005.1,1,130192,0.000857524,71186029,0.468875
D.bunnanda,151823105,VNKE01004045.1,1,130058,0.000856642,71316087,0.469731
D.bunnanda,151823105,VNKE01004582.1,1,129744,0.000854573,71445831,0.470586
D.bunnanda,151823105,VNKE01001575.1,1,129483,0.000852854,71575314,0.471439
D.bunnanda,151823105,VNKE01004077.1,1,129369,0.000852104,71704683,0.472291
D.bunnanda,151823105,VNKE01006319.1,1,128837,0.000848599,71833520,0.47314
D.bunnanda,151823105,VNKE01001087.1,1,128748,0.000848013,71962268,0.473988
D.bunnanda,151823105,VNKE01001782.1,1,128408,0.000845774,72090676,0.474833
D.bunnanda,151823105,VNKE01005789.1,1,126813,0.000835268,72217489,0.475669
D.bunnanda,151823105,VNKE01002606.1,1,126488,0.000833127,72343977,0.476502
D.bunnanda,151823105,VNKE01000024.1,1,126386,0.000832456,72470363,0.477334
D.bunnanda,151823105,VNKE01000082.1,1,125972,0.000829729,72596335,0.478164
D.bunnanda,151823105,VNKE01005339.1,1,125828,0.00082878,72722163,0.478993
D.bunnanda,151823105,VNKE01001920.1,1,125580,0.000827147,72847743,0.47982
D.bunnanda,151823105,VNKE01001459.1,1,125362,0.000825711,72973105,0.480646
D.bunnanda,151823105,VNKE01003656.1,1,125357,0.000825678,73098462,0.481471
D.bunnanda,151823105,VNKE01004504.1,1,125136,0.000824222,73223598,0.482295
D.bunnanda,151823105,VNKE01003053.1,1,125113,0.000824071,73348711,0.48312
D.bunnanda,151823105,VNKE01001916.1,1,124971,0.000823136,73473682,0.483943
D.bunnanda,151823105,VNKE01003201.1,1,124501,0.00082004,73598183,0.484763
D.bunnanda,151823105,VNKE01002807.1,1,124042,0.000817017,73722225,0.48558
D.bunnanda,151823105,VNKE01002857.1,1,123331,0.000812334,73845556,0.486392
D.bunnanda,151823105,VNKE01003611.1,1,123153,0.000811161,73968709,0.487203
D.bunnanda,151823105,VNKE01001938.1,1,123052,0.000810496,74091761,0.488014
D.bunnanda,151823105,VNKE01003056.1,1,122847,0.000809146,74214608,0.488823
D.bunnanda,151823105,VNKE01006394.1,1,122697,0.000808158,74337305,0.489631
D.bunnanda,151823105,VNKE01002524.1,1,122288,0.000805464,74459593,0.490437
D.bunnanda,151823105,VNKE01006289.1,1,122142,0.000804502,74581735,0.491241
D.bunnanda,151823105,VNKE01003468.1,1,120834,0.000795887,74702569,0.492037
D.bunnanda,151823105,VNKE01003421.1,1,120626,0.000794517,74823195,0.492831
D.bunnanda,151823105,VNKE01006094.1,1,120547,0.000793996,74943742,0.493625
D.bunnanda,151823105,VNKE01001476.1,1,120290,0.000792304,75064032,0.494418
D.bunnanda,151823105,VNKE01005376.1,1,119213,0.00078521,75183245,0.495203
D.bunnanda,151823105,VNKE01000391.1,1,118838,0.00078274,75302083,0.495986
D.bunnanda,151823105,VNKE01002825.1,1,118825,0.000782654,75420908,0.496768
D.bunnanda,151823105,VNKE01002527.1,1,118578,0.000781027,75539486,0.497549
D.bunnanda,151823105,VNKE01004410.1,1,117954,0.000776917,75657440,0.498326
D.bunnanda,151823105,VNKE01000368.1,1,117623,0.000774737,75775063,0.499101
D.bunnanda,151823105,VNKE01001143.1,1,116894,0.000769936,75891957,0.499871
D.bunnanda,151823105,VNKE01000134.1,1,116592,0.000767946,76008549,0.500639
D.bunnanda,151823105,VNKE01001925.1,1,116046,0.00076435,76124595,0.501403
D.bunnanda,151823105,VNKE01006561.1,1,115856,0.000763099,76240451,0.502166
D.bunnanda,151823105,VNKE01004353.1,1,115277,0.000759285,76355728,0.502926
D.bunnanda,151823105,VNKE01004715.1,1,114096,0.000751506,76469824,0.503677
D.bunnanda,151823105,VNKE01002903.1,1,113956,0.000750584,76583780,0.504428
D.bunnanda,151823105,VNKE01000187.1,1,113866,0.000749991,76697646,0.505178
D.bunnanda,151823105,VNKE01005384.1,1,113521,0.000747719,76811167,0.505925
D.bunnanda,151823105,VNKE01000054.1,1,112953,0.000743978,76924120,0.506669
D.bunnanda,151823105,VNKE01001912.1,1,112700,0.000742311,77036820,0.507412
D.bunnanda,151823105,VNKE01000430.1,1,112659,0.000742041,77149479,0.508154
D.bunnanda,151823105,VNKE01003886.1,1,112634,0.000741877,77262113,0.508896
D.bunnanda,151823105,VNKE01003229.1,1,112556,0.000741363,77374669,0.509637
D.bunnanda,151823105,VNKE01005086.1,1,110220,0.000725976,77484889,0.510363
D.bunnanda,151823105,VNKE01005108.1,1,109669,0.000722347,77594558,0.511085
D.bunnanda,151823105,VNKE01003101.1,1,108794,0.000716584,77703352,0.511802
D.bunnanda,151823105,VNKE01003966.1,1,108476,0.000714489,77811828,0.512516
D.bunnanda,151823105,VNKE01003581.1,1,107824,0.000710195,77919652,0.513227
D.bunnanda,151823105,VNKE01006058.1,1,107678,0.000709233,78027330,0.513936
D.bunnanda,151823105,VNKE01002049.1,1,107609,0.000708779,78134939,0.514645
D.bunnanda,151823105,VNKE01006186.1,1,107558,0.000708443,78242497,0.515353
D.bunnanda,151823105,VNKE01001283.1,1,106930,0.000704307,78349427,0.516057
D.bunnanda,151823105,VNKE01000155.1,1,106398,0.000700802,78455825,0.516758
D.bunnanda,151823105,VNKE01004119.1,1,106341,0.000700427,78562166,0.517459
D.bunnanda,151823105,VNKE01005839.1,1,106319,0.000700282,78668485,0.518159
D.bunnanda,151823105,VNKE01004498.1,1,106278,0.000700012,78774763,0.518859
D.bunnanda,151823105,VNKE01003991.1,1,106114,0.000698932,78880877,0.519558
D.bunnanda,151823105,VNKE01002928.1,1,106013,0.000698267,78986890,0.520256
D.bunnanda,151823105,VNKE01005625.1,1,105941,0.000697792,79092831,0.520954
D.bunnanda,151823105,VNKE01000875.1,1,105548,0.000695204,79198379,0.521649
D.bunnanda,151823105,VNKE01003956.1,1,105532,0.000695098,79303911,0.522344
D.bunnanda,151823105,VNKE01005786.1,1,105135,0.000692484,79409046,0.523037
D.bunnanda,151823105,VNKE01001180.1,1,105023,0.000691746,79514069,0.523728
D.bunnanda,151823105,VNKE01002474.1,1,104728,0.000689803,79618797,0.524418
D.bunnanda,151823105,VNKE01005351.1,1,104141,0.000685936,79722938,0.525104
D.bunnanda,151823105,VNKE01006166.1,1,103972,0.000684823,79826910,0.525789
D.bunnanda,151823105,VNKE01003897.1,1,103911,0.000684422,79930821,0.526473
D.bunnanda,151823105,VNKE01002099.1,1,103793,0.000683644,80034614,0.527157
D.bunnanda,151823105,VNKE01006267.1,1,103635,0.000682604,80138249,0.52784
D.bunnanda,151823105,VNKE01002961.1,1,103630,0.000682571,80241879,0.528522
D.bunnanda,151823105,VNKE01002521.1,1,102569,0.000675582,80344448,0.529198
D.bunnanda,151823105,VNKE01005791.1,1,102022,0.000671979,80446470,0.52987
D.bunnanda,151823105,VNKE01004719.1,1,101178,0.00066642,80547648,0.530536
D.bunnanda,151823105,VNKE01001105.1,1,101047,0.000665557,80648695,0.531202
D.bunnanda,151823105,VNKE01000883.1,1,100322,0.000660782,80749017,0.531863
D.bunnanda,151823105,VNKE01004285.1,1,100080,0.000659188,80849097,0.532522
D.bunnanda,151823105,VNKE01000291.1,1,99370,0.000654512,80948467,0.533176
D.bunnanda,151823105,VNKE01005151.1,1,99176,0.000653234,81047643,0.533829
D.bunnanda,151823105,VNKE01005529.1,1,99133,0.000652951,81146776,0.534482
D.bunnanda,151823105,VNKE01002963.1,1,99018,0.000652193,81245794,0.535135
D.bunnanda,151823105,VNKE01005500.1,1,98546,0.000649084,81344340,0.535784
D.bunnanda,151823105,VNKE01003685.1,1,98496,0.000648755,81442836,0.536432
D.bunnanda,151823105,VNKE01000705.1,1,98390,0.000648057,81541226,0.53708
D.bunnanda,151823105,VNKE01004839.1,1,98155,0.000646509,81639381,0.537727
D.bunnanda,151823105,VNKE01002393.1,1,97348,0.000641194,81736729,0.538368
D.bunnanda,151823105,VNKE01005870.1,1,96935,0.000638473,81833664,0.539007
D.bunnanda,151823105,VNKE01006550.1,1,96475,0.000635443,81930139,0.539642
D.bunnanda,151823105,VNKE01005342.1,1,96289,0.000634218,82026428,0.540276
D.bunnanda,151823105,VNKE01004907.1,1,96149,0.000633296,82122577,0.54091
D.bunnanda,151823105,VNKE01002293.1,1,96104,0.000633,82218681,0.541543
D.bunnanda,151823105,VNKE01001785.1,1,95792,0.000630945,82314473,0.542174
D.bunnanda,151823105,VNKE01005695.1,1,95600,0.00062968,82410073,0.542803
D.bunnanda,151823105,VNKE01004243.1,1,95467,0.000628804,82505540,0.543432
D.bunnanda,151823105,VNKE01000425.1,1,95227,0.000627223,82600767,0.544059
D.bunnanda,151823105,VNKE01004635.1,1,95158,0.000626769,82695925,0.544686
D.bunnanda,151823105,VNKE01002622.1,1,94740,0.000624016,82790665,0.54531
D.bunnanda,151823105,VNKE01006117.1,1,94580,0.000622962,82885245,0.545933
D.bunnanda,151823105,VNKE01003073.1,1,94494,0.000622395,82979739,0.546555
D.bunnanda,151823105,VNKE01001526.1,1,94321,0.000621256,83074060,0.547177
D.bunnanda,151823105,VNKE01000917.1,1,94305,0.000621151,83168365,0.547798
D.bunnanda,151823105,VNKE01000838.1,1,93943,0.000618766,83262308,0.548417
D.bunnanda,151823105,VNKE01000436.1,1,93672,0.000616981,83355980,0.549034
D.bunnanda,151823105,VNKE01003055.1,1,93498,0.000615835,83449478,0.549649
D.bunnanda,151823105,VNKE01005790.1,1,93455,0.000615552,83542933,0.550265
D.bunnanda,151823105,VNKE01004778.1,1,92907,0.000611942,83635840,0.550877
D.bunnanda,151823105,VNKE01004880.1,1,92784,0.000611132,83728624,0.551488
D.bunnanda,151823105,VNKE01001677.1,1,92467,0.000609044,83821091,0.552097
D.bunnanda,151823105,VNKE01002105.1,1,92435,0.000608834,83913526,0.552706
D.bunnanda,151823105,VNKE01001164.1,1,91983,0.000605856,84005509,0.553312
D.bunnanda,151823105,VNKE01005940.1,1,91924,0.000605468,84097433,0.553917
D.bunnanda,151823105,VNKE01004629.1,1,91919,0.000605435,84189352,0.554523
D.bunnanda,151823105,VNKE01000530.1,1,91717,0.000604104,84281069,0.555127
D.bunnanda,151823105,VNKE01006046.1,1,91705,0.000604025,84372774,0.555731
D.bunnanda,151823105,VNKE01003689.1,1,91645,0.00060363,84464419,0.556334
D.bunnanda,151823105,VNKE01001835.1,1,91400,0.000602016,84555819,0.556936
D.bunnanda,151823105,VNKE01004577.1,1,91369,0.000601812,84647188,0.557538
D.bunnanda,151823105,VNKE01002620.1,1,90992,0.000599329,84738180,0.558138
D.bunnanda,151823105,VNKE01000755.1,1,90887,0.000598637,84829067,0.558736
D.bunnanda,151823105,VNKE01005338.1,1,90822,0.000598209,84919889,0.559334
D.bunnanda,151823105,VNKE01002224.1,1,90451,0.000595766,85010340,0.55993
D.bunnanda,151823105,VNKE01006269.1,1,90396,0.000595403,85100736,0.560526
D.bunnanda,151823105,VNKE01000195.1,1,90257,0.000594488,85190993,0.56112
D.bunnanda,151823105,VNKE01004346.1,1,90220,0.000594244,85281213,0.561714
D.bunnanda,151823105,VNKE01003596.1,1,89473,0.000589324,85370686,0.562304
D.bunnanda,151823105,VNKE01002522.1,1,88843,0.000585174,85459529,0.562889
D.bunnanda,151823105,VNKE01002523.1,1,88801,0.000584898,85548330,0.563474
D.bunnanda,151823105,VNKE01002473.1,1,88773,0.000584713,85637103,0.564058
D.bunnanda,151823105,VNKE01002274.1,1,88078,0.000580136,85725181,0.564639
D.bunnanda,151823105,VNKE01006308.1,1,88039,0.000579879,85813220,0.565218
D.bunnanda,151823105,VNKE01005321.1,1,87925,0.000579128,85901145,0.565798
D.bunnanda,151823105,VNKE01000464.1,1,87706,0.000577685,85988851,0.566375
D.bunnanda,151823105,VNKE01001687.1,1,87564,0.00057675,86076415,0.566952
D.bunnanda,151823105,VNKE01001681.1,1,87491,0.000576269,86163906,0.567528
D.bunnanda,151823105,VNKE01004455.1,1,87223,0.000574504,86251129,0.568103
D.bunnanda,151823105,VNKE01004302.1,1,86966,0.000572811,86338095,0.568676
D.bunnanda,151823105,VNKE01006547.1,1,86933,0.000572594,86425028,0.569248
D.bunnanda,151823105,VNKE01004141.1,1,86910,0.000572443,86511938,0.569821
D.bunnanda,151823105,VNKE01003606.1,1,86641,0.000570671,86598579,0.570391
D.bunnanda,151823105,VNKE01006307.1,1,86408,0.000569136,86684987,0.57096
D.bunnanda,151823105,VNKE01001479.1,1,86369,0.000568879,86771356,0.571529
D.bunnanda,151823105,VNKE01002275.1,1,86285,0.000568326,86857641,0.572098
D.bunnanda,151823105,VNKE01003860.1,1,85789,0.000565059,86943430,0.572663
D.bunnanda,151823105,VNKE01001103.1,1,85705,0.000564506,87029135,0.573227
D.bunnanda,151823105,VNKE01003243.1,1,85634,0.000564038,87114769,0.573791
D.bunnanda,151823105,VNKE01005073.1,1,85412,0.000562576,87200181,0.574354
D.bunnanda,151823105,VNKE01001352.1,1,85073,0.000560343,87285254,0.574914
D.bunnanda,151823105,VNKE01001357.1,1,84742,0.000558163,87369996,0.575472
D.bunnanda,151823105,VNKE01001895.1,1,84738,0.000558136,87454734,0.57603
D.bunnanda,151823105,VNKE01001094.1,1,84732,0.000558097,87539466,0.576589
D.bunnanda,151823105,VNKE01005381.1,1,84711,0.000557959,87624177,0.577147
D.bunnanda,151823105,VNKE01001948.1,1,84658,0.000557609,87708835,0.577704
D.bunnanda,151823105,VNKE01006378.1,1,84591,0.000557168,87793426,0.578261
D.bunnanda,151823105,VNKE01000169.1,1,84502,0.000556582,87877928,0.578818
D.bunnanda,151823105,VNKE01004881.1,1,84093,0.000553888,87962021,0.579372
D.bunnanda,151823105,VNKE01000919.1,1,84030,0.000553473,88046051,0.579925
D.bunnanda,151823105,VNKE01000292.1,1,84028,0.00055346,88130079,0.580479
D.bunnanda,151823105,VNKE01001580.1,1,83927,0.000552795,88214006,0.581031
D.bunnanda,151823105,VNKE01002520.1,1,83793,0.000551912,88297799,0.581583
D.bunnanda,151823105,VNKE01003694.1,1,83419,0.000549449,88381218,0.582133
D.bunnanda,151823105,VNKE01006311.1,1,83180,0.000547874,88464398,0.582681
D.bunnanda,151823105,VNKE01002770.1,1,83088,0.000547268,88547486,0.583228
D.bunnanda,151823105,VNKE01004860.1,1,82625,0.000544219,88630111,0.583772
D.bunnanda,151823105,VNKE01001222.1,1,82417,0.000542849,88712528,0.584315
D.bunnanda,151823105,VNKE01000058.1,1,82003,0.000540122,88794531,0.584855
D.bunnanda,151823105,VNKE01005934.1,1,81862,0.000539193,88876393,0.585394
D.bunnanda,151823105,VNKE01004620.1,1,81354,0.000535847,88957747,0.58593
D.bunnanda,151823105,VNKE01000591.1,1,80842,0.000532475,89038589,0.586463
D.bunnanda,151823105,VNKE01002139.1,1,80728,0.000531724,89119317,0.586994
D.bunnanda,151823105,VNKE01006138.1,1,80648,0.000531197,89199965,0.587526
D.bunnanda,151823105,VNKE01005185.1,1,80458,0.000529946,89280423,0.588056
D.bunnanda,151823105,VNKE01006326.1,1,80354,0.000529261,89360777,0.588585
D.bunnanda,151823105,VNKE01004660.1,1,79861,0.000526013,89440638,0.589111
D.bunnanda,151823105,VNKE01003223.1,1,79349,0.000522641,89519987,0.589633
D.bunnanda,151823105,VNKE01000489.1,1,79118,0.00052112,89599105,0.590155
D.bunnanda,151823105,VNKE01005752.1,1,78945,0.00051998,89678050,0.590675
D.bunnanda,151823105,VNKE01001041.1,1,78890,0.000519618,89756940,0.591194
D.bunnanda,151823105,VNKE01001212.1,1,78815,0.000519124,89835755,0.591713
D.bunnanda,151823105,VNKE01004323.1,1,78711,0.000518439,89914466,0.592232
D.bunnanda,151823105,VNKE01000152.1,1,78538,0.000517299,89993004,0.592749
D.bunnanda,151823105,VNKE01005187.1,1,78453,0.00051674,90071457,0.593266
D.bunnanda,151823105,VNKE01001568.1,1,78229,0.000515264,90149686,0.593781
D.bunnanda,151823105,VNKE01001226.1,1,78121,0.000514553,90227807,0.594296
D.bunnanda,151823105,VNKE01006546.1,1,77621,0.000511259,90305428,0.594807
D.bunnanda,151823105,VNKE01005383.1,1,77532,0.000510673,90382960,0.595318
D.bunnanda,151823105,VNKE01005794.1,1,77243,0.00050877,90460203,0.595826
D.bunnanda,151823105,VNKE01001510.1,1,76936,0.000506748,90537139,0.596333
D.bunnanda,151823105,VNKE01004329.1,1,76795,0.000505819,90613934,0.596839
D.bunnanda,151823105,VNKE01002501.1,1,76713,0.000505279,90690647,0.597344
D.bunnanda,151823105,VNKE01003127.1,1,76548,0.000504192,90767195,0.597848
D.bunnanda,151823105,VNKE01004281.1,1,76034,0.000500807,90843229,0.598349
D.bunnanda,151823105,VNKE01005436.1,1,75142,0.000494931,90918371,0.598844
D.bunnanda,151823105,VNKE01005527.1,1,75118,0.000494773,90993489,0.599339
D.bunnanda,151823105,VNKE01001812.1,1,75050,0.000494325,91068539,0.599833
D.bunnanda,151823105,VNKE01004754.1,1,75024,0.000494154,91143563,0.600327
D.bunnanda,151823105,VNKE01006316.1,1,74996,0.00049397,91218559,0.600821
D.bunnanda,151823105,VNKE01005873.1,1,74905,0.00049337,91293464,0.601315
D.bunnanda,151823105,VNKE01002155.1,1,74903,0.000493357,91368367,0.601808
D.bunnanda,151823105,VNKE01000308.1,1,74832,0.000492889,91443199,0.602301
D.bunnanda,151823105,VNKE01004595.1,1,74786,0.000492586,91517985,0.602794
D.bunnanda,151823105,VNKE01001921.1,1,74675,0.000491855,91592660,0.603285
D.bunnanda,151823105,VNKE01001411.1,1,74596,0.000491335,91667256,0.603777
D.bunnanda,151823105,VNKE01004725.1,1,73985,0.000487311,91741241,0.604264
D.bunnanda,151823105,VNKE01000168.1,1,73914,0.000486843,91815155,0.604751
D.bunnanda,151823105,VNKE01001870.1,1,73715,0.000485532,91888870,0.605236
D.bunnanda,151823105,VNKE01005462.1,1,73681,0.000485308,91962551,0.605722
D.bunnanda,151823105,VNKE01006634.1,1,73672,0.000485249,92036223,0.606207
D.bunnanda,151823105,VNKE01006082.1,1,73506,0.000484156,92109729,0.606691
D.bunnanda,151823105,VNKE01000982.1,1,73473,0.000483938,92183202,0.607175
D.bunnanda,151823105,VNKE01004807.1,1,73390,0.000483392,92256592,0.607658
D.bunnanda,151823105,VNKE01003773.1,1,73362,0.000483207,92329954,0.608142
D.bunnanda,151823105,VNKE01000543.1,1,73204,0.000482166,92403158,0.608624
D.bunnanda,151823105,VNKE01001839.1,1,73173,0.000481962,92476331,0.609106
D.bunnanda,151823105,VNKE01002302.1,1,72798,0.000479492,92549129,0.609585
D.bunnanda,151823105,VNKE01000511.1,1,72787,0.00047942,92621916,0.610065
D.bunnanda,151823105,VNKE01001009.1,1,72749,0.000479169,92694665,0.610544
D.bunnanda,151823105,VNKE01002717.1,1,72698,0.000478834,92767363,0.611023
D.bunnanda,151823105,VNKE01000529.1,1,72488,0.00047745,92839851,0.6115
D.bunnanda,151823105,VNKE01002086.1,1,72398,0.000476858,92912249,0.611977
D.bunnanda,151823105,VNKE01002832.1,1,72338,0.000476462,92984587,0.612453
D.bunnanda,151823105,VNKE01000008.1,1,72288,0.000476133,93056875,0.61293
D.bunnanda,151823105,VNKE01003686.1,1,72280,0.00047608,93129155,0.613406
D.bunnanda,151823105,VNKE01001747.1,1,72120,0.000475027,93201275,0.613881
D.bunnanda,151823105,VNKE01000752.1,1,72091,0.000474836,93273366,0.614356
D.bunnanda,151823105,VNKE01001008.1,1,72076,0.000474737,93345442,0.61483
D.bunnanda,151823105,VNKE01001828.1,1,71947,0.000473887,93417389,0.615304
D.bunnanda,151823105,VNKE01000198.1,1,71786,0.000472827,93489175,0.615777
D.bunnanda,151823105,VNKE01005019.1,1,71758,0.000472642,93560933,0.61625
D.bunnanda,151823105,VNKE01005541.1,1,71696,0.000472234,93632629,0.616722
D.bunnanda,151823105,VNKE01000947.1,1,71624,0.00047176,93704253,0.617194
D.bunnanda,151823105,VNKE01001556.1,1,71452,0.000470627,93775705,0.617664
D.bunnanda,151823105,VNKE01001576.1,1,71219,0.000469092,93846924,0.618133
D.bunnanda,151823105,VNKE01003882.1,1,70885,0.000466892,93917809,0.6186
D.bunnanda,151823105,VNKE01004993.1,1,70748,0.00046599,93988557,0.619066
D.bunnanda,151823105,VNKE01001474.1,1,70665,0.000465443,94059222,0.619532
D.bunnanda,151823105,VNKE01003814.1,1,70430,0.000463895,94129652,0.619996
D.bunnanda,151823105,VNKE01004219.1,1,70336,0.000463276,94199988,0.620459
D.bunnanda,151823105,VNKE01001471.1,1,70145,0.000462018,94270133,0.620921
D.bunnanda,151823105,VNKE01006190.1,1,70113,0.000461807,94340246,0.621383
D.bunnanda,151823105,VNKE01005549.1,1,70049,0.000461386,94410295,0.621844
D.bunnanda,151823105,VNKE01006604.1,1,69773,0.000459568,94480068,0.622304
D.bunnanda,151823105,VNKE01005624.1,1,69324,0.00045661,94549392,0.62276
D.bunnanda,151823105,VNKE01005078.1,1,69033,0.000454694,94618425,0.623215
D.bunnanda,151823105,VNKE01005190.1,1,69017,0.000454588,94687442,0.62367
D.bunnanda,151823105,VNKE01001897.1,1,68999,0.00045447,94756441,0.624124
D.bunnanda,151823105,VNKE01004976.1,1,68976,0.000454318,94825417,0.624578
D.bunnanda,151823105,VNKE01001676.1,1,68964,0.000454239,94894381,0.625033
D.bunnanda,151823105,VNKE01000404.1,1,68815,0.000453258,94963196,0.625486
D.bunnanda,151823105,VNKE01006381.1,1,68664,0.000452263,95031860,0.625938
D.bunnanda,151823105,VNKE01001577.1,1,68566,0.000451618,95100426,0.62639
D.bunnanda,151823105,VNKE01002100.1,1,68455,0.000450887,95168881,0.626841
D.bunnanda,151823105,VNKE01004284.1,1,68156,0.000448917,95237037,0.627289
D.bunnanda,151823105,VNKE01002693.1,1,68086,0.000448456,95305123,0.627738
D.bunnanda,151823105,VNKE01006084.1,1,68036,0.000448127,95373159,0.628186
D.bunnanda,151823105,VNKE01004543.1,1,67943,0.000447514,95441102,0.628634
D.bunnanda,151823105,VNKE01005521.1,1,67864,0.000446994,95508966,0.629081
D.bunnanda,151823105,VNKE01002518.1,1,67744,0.000446203,95576710,0.629527
D.bunnanda,151823105,VNKE01005192.1,1,67683,0.000445802,95644393,0.629973
D.bunnanda,151823105,VNKE01002803.1,1,67634,0.000445479,95712027,0.630418
D.bunnanda,151823105,VNKE01004762.1,1,67484,0.000444491,95779511,0.630863
D.bunnanda,151823105,VNKE01000738.1,1,67070,0.000441764,95846581,0.631304
D.bunnanda,151823105,VNKE01000571.1,1,67008,0.000441356,95913589,0.631746
D.bunnanda,151823105,VNKE01001460.1,1,66697,0.000439307,95980286,0.632185
D.bunnanda,151823105,VNKE01000744.1,1,66616,0.000438774,96046902,0.632624
D.bunnanda,151823105,VNKE01004505.1,1,66551,0.000438346,96113453,0.633062
D.bunnanda,151823105,VNKE01000478.1,1,66483,0.000437898,96179936,0.6335
D.bunnanda,151823105,VNKE01002884.1,1,66295,0.000436659,96246231,0.633937
D.bunnanda,151823105,VNKE01001922.1,1,66165,0.000435803,96312396,0.634372
D.bunnanda,151823105,VNKE01006457.1,1,65961,0.00043446,96378357,0.634807
D.bunnanda,151823105,VNKE01002816.1,1,65946,0.000434361,96444303,0.635241
D.bunnanda,151823105,VNKE01005325.1,1,65926,0.000434229,96510229,0.635676
D.bunnanda,151823105,VNKE01002997.1,1,65832,0.00043361,96576061,0.636109
D.bunnanda,151823105,VNKE01000179.1,1,65815,0.000433498,96641876,0.636543
D.bunnanda,151823105,VNKE01004456.1,1,65596,0.000432055,96707472,0.636975
D.bunnanda,151823105,VNKE01005618.1,1,65553,0.000431772,96773025,0.637406
D.bunnanda,151823105,VNKE01001439.1,1,65403,0.000430784,96838428,0.637837
D.bunnanda,151823105,VNKE01003612.1,1,65282,0.000429987,96903710,0.638267
D.bunnanda,151823105,VNKE01000669.1,1,65180,0.000429315,96968890,0.638697
D.bunnanda,151823105,VNKE01003071.1,1,65141,0.000429059,97034031,0.639126
D.bunnanda,151823105,VNKE01002941.1,1,64837,0.000427056,97098868,0.639553
D.bunnanda,151823105,VNKE01004362.1,1,64726,0.000426325,97163594,0.639979
D.bunnanda,151823105,VNKE01002525.1,1,64574,0.000425324,97228168,0.640404
D.bunnanda,151823105,VNKE01001308.1,1,64435,0.000424408,97292603,0.640829
D.bunnanda,151823105,VNKE01003177.1,1,64397,0.000424158,97357000,0.641253
D.bunnanda,151823105,VNKE01000222.1,1,64098,0.000422189,97421098,0.641675
D.bunnanda,151823105,VNKE01003280.1,1,64083,0.00042209,97485181,0.642097
D.bunnanda,151823105,VNKE01005655.1,1,64064,0.000421965,97549245,0.642519
D.bunnanda,151823105,VNKE01002250.1,1,63870,0.000420687,97613115,0.64294
D.bunnanda,151823105,VNKE01004457.1,1,63826,0.000420397,97676941,0.64336
D.bunnanda,151823105,VNKE01004695.1,1,63769,0.000420022,97740710,0.64378
D.bunnanda,151823105,VNKE01005263.1,1,63768,0.000420015,97804478,0.6442
D.bunnanda,151823105,VNKE01001445.1,1,63680,0.000419436,97868158,0.64462
D.bunnanda,151823105,VNKE01005598.1,1,63560,0.000418645,97931718,0.645038
D.bunnanda,151823105,VNKE01000516.1,1,63415,0.00041769,97995133,0.645456
D.bunnanda,151823105,VNKE01005072.1,1,63368,0.00041738,98058501,0.645873
D.bunnanda,151823105,VNKE01005090.1,1,63220,0.000416406,98121721,0.64629
D.bunnanda,151823105,VNKE01001969.1,1,63150,0.000415945,98184871,0.646706
D.bunnanda,151823105,VNKE01005532.1,1,63121,0.000415754,98247992,0.647121
D.bunnanda,151823105,VNKE01001538.1,1,63055,0.000415319,98311047,0.647537
D.bunnanda,151823105,VNKE01003604.1,1,62792,0.000413587,98373839,0.64795
D.bunnanda,151823105,VNKE01002298.1,1,62770,0.000413442,98436609,0.648364
D.bunnanda,151823105,VNKE01005550.1,1,62689,0.000412908,98499298,0.648777
D.bunnanda,151823105,VNKE01000505.1,1,62601,0.000412329,98561899,0.649189
D.bunnanda,151823105,VNKE01001788.1,1,62567,0.000412105,98624466,0.649601
D.bunnanda,151823105,VNKE01001527.1,1,62251,0.000410023,98686717,0.650011
D.bunnanda,151823105,VNKE01002132.1,1,62139,0.000409286,98748856,0.65042
D.bunnanda,151823105,VNKE01000973.1,1,62096,0.000409002,98810952,0.650829
D.bunnanda,151823105,VNKE01004594.1,1,61957,0.000408087,98872909,0.651238
D.bunnanda,151823105,VNKE01005531.1,1,61811,0.000407125,98934720,0.651645
D.bunnanda,151823105,VNKE01003085.1,1,61757,0.000406769,98996477,0.652051
D.bunnanda,151823105,VNKE01000427.1,1,61645,0.000406032,99058122,0.652457
D.bunnanda,151823105,VNKE01001131.1,1,61372,0.000404234,99119494,0.652862
D.bunnanda,151823105,VNKE01004209.1,1,61318,0.000403878,99180812,0.653266
D.bunnanda,151823105,VNKE01005524.1,1,61305,0.000403792,99242117,0.653669
D.bunnanda,151823105,VNKE01005109.1,1,61186,0.000403008,99303303,0.654072
D.bunnanda,151823105,VNKE01004303.1,1,61103,0.000402462,99364406,0.654475
D.bunnanda,151823105,VNKE01004091.1,1,61049,0.000402106,99425455,0.654877
D.bunnanda,151823105,VNKE01004917.1,1,60958,0.000401507,99486413,0.655278
D.bunnanda,151823105,VNKE01001956.1,1,60922,0.00040127,99547335,0.65568
D.bunnanda,151823105,VNKE01001792.1,1,60740,0.000400071,99608075,0.65608
D.bunnanda,151823105,VNKE01000267.1,1,60604,0.000399175,99668679,0.656479
D.bunnanda,151823105,VNKE01004123.1,1,60573,0.000398971,99729252,0.656878
D.bunnanda,151823105,VNKE01005605.1,1,60328,0.000397357,99789580,0.657275
D.bunnanda,151823105,VNKE01001345.1,1,60270,0.000396975,99849850,0.657672
D.bunnanda,151823105,VNKE01002615.1,1,60022,0.000395342,99909872,0.658068
D.bunnanda,151823105,VNKE01001638.1,1,59973,0.000395019,99969845,0.658463
D.bunnanda,151823105,VNKE01002653.1,1,59811,0.000393952,100029656,0.658857
D.bunnanda,151823105,VNKE01001748.1,1,59788,0.0003938,100089444,0.65925
D.bunnanda,151823105,VNKE01006016.1,1,59778,0.000393735,100149222,0.659644
D.bunnanda,151823105,VNKE01005091.1,1,59535,0.000392134,100208757,0.660036
D.bunnanda,151823105,VNKE01005191.1,1,59437,0.000391489,100268194,0.660428
D.bunnanda,151823105,VNKE01006248.1,1,59075,0.000389104,100327269,0.660817
D.bunnanda,151823105,VNKE01001704.1,1,58771,0.000387102,100386040,0.661204
D.bunnanda,151823105,VNKE01002028.1,1,58651,0.000386311,100444691,0.66159
D.bunnanda,151823105,VNKE01001183.1,1,58642,0.000386252,100503333,0.661977
D.bunnanda,151823105,VNKE01004888.1,1,58583,0.000385864,100561916,0.662362
D.bunnanda,151823105,VNKE01000497.1,1,58511,0.000385389,100620427,0.662748
D.bunnanda,151823105,VNKE01005186.1,1,58384,0.000384553,100678811,0.663132
D.bunnanda,151823105,VNKE01004884.1,1,58370,0.000384461,100737181,0.663517
D.bunnanda,151823105,VNKE01004500.1,1,58347,0.000384309,100795528,0.663901
D.bunnanda,151823105,VNKE01003330.1,1,58241,0.000383611,100853769,0.664285
D.bunnanda,151823105,VNKE01001570.1,1,58231,0.000383545,100912000,0.664668
D.bunnanda,151823105,VNKE01003576.1,1,58005,0.000382056,100970005,0.66505
D.bunnanda,151823105,VNKE01004563.1,1,57951,0.000381701,101027956,0.665432
D.bunnanda,151823105,VNKE01001777.1,1,57799,0.0003807,101085755,0.665813
D.bunnanda,151823105,VNKE01006112.1,1,57728,0.000380232,101143483,0.666193
D.bunnanda,151823105,VNKE01003614.1,1,57689,0.000379975,101201172,0.666573
D.bunnanda,151823105,VNKE01005113.1,1,57658,0.000379771,101258830,0.666953
D.bunnanda,151823105,VNKE01003074.1,1,57653,0.000379738,101316483,0.667332
D.bunnanda,151823105,VNKE01002106.1,1,57576,0.000379231,101374059,0.667712
D.bunnanda,151823105,VNKE01004854.1,1,57450,0.000378401,101431509,0.66809
D.bunnanda,151823105,VNKE01001889.1,1,57447,0.000378381,101488956,0.668468
D.bunnanda,151823105,VNKE01002296.1,1,57372,0.000377887,101546328,0.668846
D.bunnanda,151823105,VNKE01005310.1,1,57171,0.000376563,101603499,0.669223
D.bunnanda,151823105,VNKE01006474.1,1,57157,0.000376471,101660656,0.669599
D.bunnanda,151823105,VNKE01006335.1,1,57111,0.000376168,101717767,0.669976
D.bunnanda,151823105,VNKE01000763.1,1,57099,0.000376089,101774866,0.670352
D.bunnanda,151823105,VNKE01004573.1,1,57064,0.000375858,101831930,0.670727
D.bunnanda,151823105,VNKE01005124.1,1,56673,0.000373283,101888603,0.671101
D.bunnanda,151823105,VNKE01005308.1,1,56492,0.000372091,101945095,0.671473
D.bunnanda,151823105,VNKE01004621.1,1,56367,0.000371268,102001462,0.671844
D.bunnanda,151823105,VNKE01006157.1,1,56193,0.000370122,102057655,0.672214
D.bunnanda,151823105,VNKE01006321.1,1,56164,0.000369931,102113819,0.672584
D.bunnanda,151823105,VNKE01000378.1,1,56066,0.000369285,102169885,0.672953
D.bunnanda,151823105,VNKE01004217.1,1,55987,0.000368765,102225872,0.673322
D.bunnanda,151823105,VNKE01002674.1,1,55744,0.000367164,102281616,0.673689
D.bunnanda,151823105,VNKE01001908.1,1,55698,0.000366861,102337314,0.674056
D.bunnanda,151823105,VNKE01000396.1,1,55641,0.000366486,102392955,0.674423
D.bunnanda,151823105,VNKE01001837.1,1,55635,0.000366446,102448590,0.674789
D.bunnanda,151823105,VNKE01002034.1,1,55585,0.000366117,102504175,0.675155
D.bunnanda,151823105,VNKE01006605.1,1,55378,0.000364753,102559553,0.67552
D.bunnanda,151823105,VNKE01001524.1,1,55282,0.000364121,102614835,0.675884
D.bunnanda,151823105,VNKE01001581.1,1,54934,0.000361829,102669769,0.676246
D.bunnanda,151823105,VNKE01000466.1,1,54740,0.000360551,102724509,0.676607
D.bunnanda,151823105,VNKE01004466.1,1,54587,0.000359543,102779096,0.676966
D.bunnanda,151823105,VNKE01000072.1,1,54560,0.000359366,102833656,0.677325
D.bunnanda,151823105,VNKE01003088.1,1,54521,0.000359109,102888177,0.677685
D.bunnanda,151823105,VNKE01001387.1,1,54433,0.000358529,102942610,0.678043
D.bunnanda,151823105,VNKE01005795.1,1,54398,0.000358299,102997008,0.678401
D.bunnanda,151823105,VNKE01002519.1,1,54369,0.000358108,103051377,0.67876
D.bunnanda,151823105,VNKE01005445.1,1,54221,0.000357133,103105598,0.679117
D.bunnanda,151823105,VNKE01003555.1,1,54144,0.000356626,103159742,0.679473
D.bunnanda,151823105,VNKE01005739.1,1,53847,0.000354669,103213589,0.679828
D.bunnanda,151823105,VNKE01004435.1,1,53792,0.000354307,103267381,0.680182
D.bunnanda,151823105,VNKE01000563.1,1,53714,0.000353793,103321095,0.680536
D.bunnanda,151823105,VNKE01002939.1,1,53686,0.000353609,103374781,0.68089
D.bunnanda,151823105,VNKE01005194.1,1,53489,0.000352311,103428270,0.681242
D.bunnanda,151823105,VNKE01005400.1,1,53484,0.000352278,103481754,0.681594
D.bunnanda,151823105,VNKE01004997.1,1,53476,0.000352226,103535230,0.681946
D.bunnanda,151823105,VNKE01005188.1,1,53403,0.000351745,103588633,0.682298
D.bunnanda,151823105,VNKE01003401.1,1,53290,0.000351001,103641923,0.682649
D.bunnanda,151823105,VNKE01003678.1,1,53063,0.000349505,103694986,0.682999
D.bunnanda,151823105,VNKE01005865.1,1,53051,0.000349426,103748037,0.683348
D.bunnanda,151823105,VNKE01003952.1,1,53035,0.000349321,103801072,0.683697
D.bunnanda,151823105,VNKE01002882.1,1,52985,0.000348992,103854057,0.684046
D.bunnanda,151823105,VNKE01005746.1,1,52976,0.000348932,103907033,0.684395
D.bunnanda,151823105,VNKE01004508.1,1,52610,0.000346522,103959643,0.684742
D.bunnanda,151823105,VNKE01004607.1,1,52606,0.000346495,104012249,0.685088
D.bunnanda,151823105,VNKE01003150.1,1,52468,0.000345586,104064717,0.685434
D.bunnanda,151823105,VNKE01000463.1,1,52423,0.00034529,104117140,0.685779
D.bunnanda,151823105,VNKE01001712.1,1,52421,0.000345277,104169561,0.686125
D.bunnanda,151823105,VNKE01004313.1,1,52323,0.000344631,104221884,0.686469
D.bunnanda,151823105,VNKE01004789.1,1,52143,0.000343446,104274027,0.686813
D.bunnanda,151823105,VNKE01000417.1,1,52097,0.000343143,104326124,0.687156
D.bunnanda,151823105,VNKE01005309.1,1,51711,0.0003406,104377835,0.687496
D.bunnanda,151823105,VNKE01003406.1,1,51598,0.000339856,104429433,0.687836
D.bunnanda,151823105,VNKE01005528.1,1,51538,0.000339461,104480971,0.688176
D.bunnanda,151823105,VNKE01002459.1,1,51532,0.000339421,104532503,0.688515
D.bunnanda,151823105,VNKE01005011.1,1,51509,0.00033927,104584012,0.688854
D.bunnanda,151823105,VNKE01002294.1,1,51509,0.00033927,104635521,0.689194
D.bunnanda,151823105,VNKE01001272.1,1,51474,0.000339039,104686995,0.689533
D.bunnanda,151823105,VNKE01004711.1,1,51429,0.000338743,104738424,0.689871
D.bunnanda,151823105,VNKE01005002.1,1,51377,0.0003384,104789801,0.69021
D.bunnanda,151823105,VNKE01005081.1,1,51260,0.00033763,104841061,0.690547
D.bunnanda,151823105,VNKE01004085.1,1,51260,0.00033763,104892321,0.690885
D.bunnanda,151823105,VNKE01003375.1,1,50981,0.000335792,104943302,0.691221
D.bunnanda,151823105,VNKE01006414.1,1,50954,0.000335614,104994256,0.691557
D.bunnanda,151823105,VNKE01003963.1,1,50697,0.000333922,105044953,0.69189
D.bunnanda,151823105,VNKE01005087.1,1,50375,0.000331801,105095328,0.692222
D.bunnanda,151823105,VNKE01003318.1,1,50342,0.000331583,105145670,0.692554
D.bunnanda,151823105,VNKE01001893.1,1,50303,0.000331326,105195973,0.692885
D.bunnanda,151823105,VNKE01003169.1,1,50220,0.00033078,105246193,0.693216
D.bunnanda,151823105,VNKE01001529.1,1,50202,0.000330661,105296395,0.693547
D.bunnanda,151823105,VNKE01003544.1,1,50169,0.000330444,105346564,0.693877
D.bunnanda,151823105,VNKE01003016.1,1,50058,0.000329713,105396622,0.694207
D.bunnanda,151823105,VNKE01000600.1,1,49969,0.000329126,105446591,0.694536
D.bunnanda,151823105,VNKE01001344.1,1,49921,0.00032881,105496512,0.694865
D.bunnanda,151823105,VNKE01006621.1,1,49851,0.000328349,105546363,0.695193
D.bunnanda,151823105,VNKE01005510.1,1,49731,0.000327559,105596094,0.695521
D.bunnanda,151823105,VNKE01004720.1,1,49685,0.000327256,105645779,0.695848
D.bunnanda,151823105,VNKE01000304.1,1,49685,0.000327256,105695464,0.696175
D.bunnanda,151823105,VNKE01002639.1,1,49654,0.000327052,105745118,0.696502
D.bunnanda,151823105,VNKE01000649.1,1,49627,0.000326874,105794745,0.696829
D.bunnanda,151823105,VNKE01002163.1,1,49544,0.000326327,105844289,0.697155
D.bunnanda,151823105,VNKE01001236.1,1,49300,0.00032472,105893589,0.69748
D.bunnanda,151823105,VNKE01005610.1,1,49156,0.000323772,105942745,0.697804
D.bunnanda,151823105,VNKE01005717.1,1,49088,0.000323324,105991833,0.698127
D.bunnanda,151823105,VNKE01002037.1,1,49028,0.000322928,106040861,0.69845
D.bunnanda,151823105,VNKE01003595.1,1,48956,0.000322454,106089817,0.698773
D.bunnanda,151823105,VNKE01000918.1,1,48935,0.000322316,106138752,0.699095
D.bunnanda,151823105,VNKE01003990.1,1,48870,0.000321888,106187622,0.699417
D.bunnanda,151823105,VNKE01002200.1,1,48825,0.000321591,106236447,0.699738
D.bunnanda,151823105,VNKE01001493.1,1,48819,0.000321552,106285266,0.70006
D.bunnanda,151823105,VNKE01000223.1,1,48762,0.000321176,106334028,0.700381
D.bunnanda,151823105,VNKE01004371.1,1,48705,0.000320801,106382733,0.700702
D.bunnanda,151823105,VNKE01003541.1,1,48673,0.00032059,106431406,0.701022
D.bunnanda,151823105,VNKE01004624.1,1,48648,0.000320426,106480054,0.701343
D.bunnanda,151823105,VNKE01005981.1,1,48565,0.000319879,106528619,0.701663
D.bunnanda,151823105,VNKE01000075.1,1,48544,0.000319741,106577163,0.701983
D.bunnanda,151823105,VNKE01006129.1,1,48398,0.000318779,106625561,0.702301
D.bunnanda,151823105,VNKE01006163.1,1,48252,0.000317817,106673813,0.702619
D.bunnanda,151823105,VNKE01000985.1,1,48236,0.000317712,106722049,0.702937
D.bunnanda,151823105,VNKE01003885.1,1,47903,0.000315519,106769952,0.703252
D.bunnanda,151823105,VNKE01003929.1,1,47901,0.000315505,106817853,0.703568
D.bunnanda,151823105,VNKE01003237.1,1,47842,0.000315117,106865695,0.703883
D.bunnanda,151823105,VNKE01002301.1,1,47839,0.000315097,106913534,0.704198
D.bunnanda,151823105,VNKE01004139.1,1,47822,0.000314985,106961356,0.704513
D.bunnanda,151823105,VNKE01002383.1,1,47783,0.000314728,107009139,0.704828
D.bunnanda,151823105,VNKE01006557.1,1,47628,0.000313707,107056767,0.705141
D.bunnanda,151823105,VNKE01003373.1,1,47587,0.000313437,107104354,0.705455
D.bunnanda,151823105,VNKE01000480.1,1,47546,0.000313167,107151900,0.705768
D.bunnanda,151823105,VNKE01006345.1,1,47410,0.000312271,107199310,0.70608
D.bunnanda,151823105,VNKE01001697.1,1,47372,0.000312021,107246682,0.706392
D.bunnanda,151823105,VNKE01001098.1,1,47155,0.000310592,107293837,0.706703
D.bunnanda,151823105,VNKE01005976.1,1,46955,0.000309274,107340792,0.707012
D.bunnanda,151823105,VNKE01006323.1,1,46922,0.000309057,107387714,0.707321
D.bunnanda,151823105,VNKE01001708.1,1,46594,0.000306897,107434308,0.707628
D.bunnanda,151823105,VNKE01004591.1,1,46546,0.00030658,107480854,0.707935
D.bunnanda,151823105,VNKE01002485.1,1,46502,0.000306291,107527356,0.708241
D.bunnanda,151823105,VNKE01005656.1,1,46469,0.000306073,107573825,0.708547
D.bunnanda,151823105,VNKE01005938.1,1,46416,0.000305724,107620241,0.708853
D.bunnanda,151823105,VNKE01003105.1,1,46326,0.000305131,107666567,0.709158
D.bunnanda,151823105,VNKE01001589.1,1,46256,0.00030467,107712823,0.709463
D.bunnanda,151823105,VNKE01005796.1,1,46128,0.000303827,107758951,0.709766
D.bunnanda,151823105,VNKE01003998.1,1,46111,0.000303715,107805062,0.71007
D.bunnanda,151823105,VNKE01002604.1,1,46037,0.000303228,107851099,0.710373
D.bunnanda,151823105,VNKE01003902.1,1,46018,0.000303103,107897117,0.710677
D.bunnanda,151823105,VNKE01006174.1,1,45930,0.000302523,107943047,0.710979
D.bunnanda,151823105,VNKE01005241.1,1,45791,0.000301608,107988838,0.711281
D.bunnanda,151823105,VNKE01002061.1,1,45780,0.000301535,108034618,0.711582
D.bunnanda,151823105,VNKE01004877.1,1,45761,0.00030141,108080379,0.711884
D.bunnanda,151823105,VNKE01002493.1,1,45728,0.000301193,108126107,0.712185
D.bunnanda,151823105,VNKE01000749.1,1,45688,0.000300929,108171795,0.712486
D.bunnanda,151823105,VNKE01001789.1,1,45635,0.00030058,108217430,0.712786
D.bunnanda,151823105,VNKE01004028.1,1,45598,0.000300336,108263028,0.713087
D.bunnanda,151823105,VNKE01005193.1,1,45555,0.000300053,108308583,0.713387
D.bunnanda,151823105,VNKE01004655.1,1,45543,0.000299974,108354126,0.713687
D.bunnanda,151823105,VNKE01003067.1,1,45465,0.00029946,108399591,0.713986
D.bunnanda,151823105,VNKE01001962.1,1,45458,0.000299414,108445049,0.714286
D.bunnanda,151823105,VNKE01000942.1,1,45455,0.000299394,108490504,0.714585
D.bunnanda,151823105,VNKE01004701.1,1,45398,0.000299019,108535902,0.714884
D.bunnanda,151823105,VNKE01003925.1,1,45356,0.000298742,108581258,0.715183
D.bunnanda,151823105,VNKE01006062.1,1,45280,0.000298242,108626538,0.715481
D.bunnanda,151823105,VNKE01005176.1,1,45044,0.000296687,108671582,0.715778
D.bunnanda,151823105,VNKE01000147.1,1,44918,0.000295857,108716500,0.716073
D.bunnanda,151823105,VNKE01002326.1,1,44882,0.00029562,108761382,0.716369
D.bunnanda,151823105,VNKE01004526.1,1,44775,0.000294916,108806157,0.716664
D.bunnanda,151823105,VNKE01001840.1,1,44734,0.000294646,108850891,0.716959
D.bunnanda,151823105,VNKE01006338.1,1,44719,0.000294547,108895610,0.717253
D.bunnanda,151823105,VNKE01004567.1,1,44585,0.000293664,108940195,0.717547
D.bunnanda,151823105,VNKE01006175.1,1,44502,0.000293117,108984697,0.71784
D.bunnanda,151823105,VNKE01002536.1,1,44296,0.000291761,109028993,0.718132
D.bunnanda,151823105,VNKE01001924.1,1,44228,0.000291313,109073221,0.718423
D.bunnanda,151823105,VNKE01004698.1,1,44148,0.000290786,109117369,0.718714
D.bunnanda,151823105,VNKE01001179.1,1,44109,0.000290529,109161478,0.719004
D.bunnanda,151823105,VNKE01000190.1,1,43897,0.000289133,109205375,0.719294
D.bunnanda,151823105,VNKE01005707.1,1,43869,0.000288948,109249244,0.719582
D.bunnanda,151823105,VNKE01001784.1,1,43829,0.000288685,109293073,0.719871
D.bunnanda,151823105,VNKE01000916.1,1,43797,0.000288474,109336870,0.72016
D.bunnanda,151823105,VNKE01001604.1,1,43629,0.000287367,109380499,0.720447
D.bunnanda,151823105,VNKE01005107.1,1,43605,0.000287209,109424104,0.720734
D.bunnanda,151823105,VNKE01000860.1,1,43452,0.000286201,109467556,0.72102
D.bunnanda,151823105,VNKE01002759.1,1,43418,0.000285978,109510974,0.721306
D.bunnanda,151823105,VNKE01001786.1,1,43415,0.000285958,109554389,0.721592
D.bunnanda,151823105,VNKE01000740.1,1,43352,0.000285543,109597741,0.721878
D.bunnanda,151823105,VNKE01002981.1,1,43229,0.000284733,109640970,0.722163
D.bunnanda,151823105,VNKE01004657.1,1,43176,0.000284384,109684146,0.722447
D.bunnanda,151823105,VNKE01005698.1,1,43142,0.00028416,109727288,0.722731
D.bunnanda,151823105,VNKE01002760.1,1,43092,0.00028383,109770380,0.723015
D.bunnanda,151823105,VNKE01004118.1,1,42826,0.000282078,109813206,0.723297
D.bunnanda,151823105,VNKE01001031.1,1,42770,0.000281709,109855976,0.723579
D.bunnanda,151823105,VNKE01004129.1,1,42756,0.000281617,109898732,0.72386
D.bunnanda,151823105,VNKE01006241.1,1,42481,0.000279806,109941213,0.72414
D.bunnanda,151823105,VNKE01004656.1,1,42461,0.000279674,109983674,0.72442
D.bunnanda,151823105,VNKE01006012.1,1,42437,0.000279516,110026111,0.724699
D.bunnanda,151823105,VNKE01003342.1,1,42274,0.000278442,110068385,0.724978
D.bunnanda,151823105,VNKE01003901.1,1,42265,0.000278383,110110650,0.725256
D.bunnanda,151823105,VNKE01001326.1,1,42124,0.000277454,110152774,0.725534
D.bunnanda,151823105,VNKE01001706.1,1,42114,0.000277389,110194888,0.725811
D.bunnanda,151823105,VNKE01001100.1,1,42081,0.000277171,110236969,0.726088
D.bunnanda,151823105,VNKE01001176.1,1,42058,0.00027702,110279027,0.726365
D.bunnanda,151823105,VNKE01000127.1,1,42050,0.000276967,110321077,0.726642
D.bunnanda,151823105,VNKE01003202.1,1,42019,0.000276763,110363096,0.726919
D.bunnanda,151823105,VNKE01004506.1,1,41956,0.000276348,110405052,0.727195
D.bunnanda,151823105,VNKE01002929.1,1,41954,0.000276335,110447006,0.727472
D.bunnanda,151823105,VNKE01004885.1,1,41944,0.000276269,110488950,0.727748
D.bunnanda,151823105,VNKE01002297.1,1,41839,0.000275577,110530789,0.728024
D.bunnanda,151823105,VNKE01004226.1,1,41838,0.000275571,110572627,0.728299
D.bunnanda,151823105,VNKE01005866.1,1,41799,0.000275314,110614426,0.728574
D.bunnanda,151823105,VNKE01001503.1,1,41774,0.000275149,110656200,0.72885
D.bunnanda,151823105,VNKE01002300.1,1,41766,0.000275096,110697966,0.729125
D.bunnanda,151823105,VNKE01002612.1,1,41701,0.000274668,110739667,0.729399
D.bunnanda,151823105,VNKE01004883.1,1,41573,0.000273825,110781240,0.729673
D.bunnanda,151823105,VNKE01000493.1,1,41563,0.000273759,110822803,0.729947
D.bunnanda,151823105,VNKE01004501.1,1,41459,0.000273074,110864262,0.73022
D.bunnanda,151823105,VNKE01004604.1,1,41391,0.000272626,110905653,0.730493
D.bunnanda,151823105,VNKE01002075.1,1,41309,0.000272086,110946962,0.730765
D.bunnanda,151823105,VNKE01005410.1,1,41267,0.00027181,110988229,0.731036
D.bunnanda,151823105,VNKE01001521.1,1,41112,0.000270789,111029341,0.731307
D.bunnanda,151823105,VNKE01001937.1,1,41091,0.000270651,111070432,0.731578
D.bunnanda,151823105,VNKE01002800.1,1,41070,0.000270512,111111502,0.731848
D.bunnanda,151823105,VNKE01004105.1,1,41066,0.000270486,111152568,0.732119
D.bunnanda,151823105,VNKE01004769.1,1,41022,0.000270196,111193590,0.732389
D.bunnanda,151823105,VNKE01003967.1,1,40964,0.000269814,111234554,0.732659
D.bunnanda,151823105,VNKE01001472.1,1,40915,0.000269491,111275469,0.732928
D.bunnanda,151823105,VNKE01005793.1,1,40870,0.000269195,111316339,0.733198
D.bunnanda,151823105,VNKE01006254.1,1,40851,0.00026907,111357190,0.733467
D.bunnanda,151823105,VNKE01006498.1,1,40842,0.00026901,111398032,0.733736
D.bunnanda,151823105,VNKE01004693.1,1,40826,0.000268905,111438858,0.734005
D.bunnanda,151823105,VNKE01001528.1,1,40690,0.000268009,111479548,0.734273
D.bunnanda,151823105,VNKE01002608.1,1,40638,0.000267667,111520186,0.73454
D.bunnanda,151823105,VNKE01003625.1,1,40456,0.000266468,111560642,0.734807
D.bunnanda,151823105,VNKE01000289.1,1,40435,0.00026633,111601077,0.735073
D.bunnanda,151823105,VNKE01003450.1,1,40318,0.000265559,111641395,0.735339
D.bunnanda,151823105,VNKE01002281.1,1,40252,0.000265124,111681647,0.735604
D.bunnanda,151823105,VNKE01006317.1,1,40170,0.000264584,111721817,0.735868
D.bunnanda,151823105,VNKE01002637.1,1,40138,0.000264373,111761955,0.736133
D.bunnanda,151823105,VNKE01004815.1,1,40082,0.000264005,111802037,0.736397
D.bunnanda,151823105,VNKE01005300.1,1,39937,0.00026305,111841974,0.73666
D.bunnanda,151823105,VNKE01006240.1,1,39915,0.000262905,111881889,0.736923
D.bunnanda,151823105,VNKE01000220.1,1,39866,0.000262582,111921755,0.737185
D.bunnanda,151823105,VNKE01000914.1,1,39838,0.000262397,111961593,0.737448
D.bunnanda,151823105,VNKE01005774.1,1,39793,0.000262101,112001386,0.73771
D.bunnanda,151823105,VNKE01003663.1,1,39766,0.000261923,112041152,0.737972
D.bunnanda,151823105,VNKE01005316.1,1,39661,0.000261232,112080813,0.738233
D.bunnanda,151823105,VNKE01002036.1,1,39503,0.000260191,112120316,0.738493
D.bunnanda,151823105,VNKE01006416.1,1,39459,0.000259901,112159775,0.738753
D.bunnanda,151823105,VNKE01004191.1,1,39446,0.000259816,112199221,0.739013
D.bunnanda,151823105,VNKE01006567.1,1,39432,0.000259723,112238653,0.739273
D.bunnanda,151823105,VNKE01000481.1,1,39431,0.000259717,112278084,0.739532
D.bunnanda,151823105,VNKE01003403.1,1,39422,0.000259657,112317506,0.739792
D.bunnanda,151823105,VNKE01003827.1,1,39326,0.000259025,112356832,0.740051
D.bunnanda,151823105,VNKE01005871.1,1,39272,0.000258669,112396104,0.74031
D.bunnanda,151823105,VNKE01005418.1,1,39250,0.000258525,112435354,0.740568
D.bunnanda,151823105,VNKE01000676.1,1,39085,0.000257438,112474439,0.740826
D.bunnanda,151823105,VNKE01003343.1,1,39016,0.000256983,112513455,0.741083
D.bunnanda,151823105,VNKE01000238.1,1,38927,0.000256397,112552382,0.741339
D.bunnanda,151823105,VNKE01002087.1,1,38827,0.000255738,112591209,0.741595
D.bunnanda,151823105,VNKE01002282.1,1,38726,0.000255073,112629935,0.74185
D.bunnanda,151823105,VNKE01006379.1,1,38716,0.000255007,112668651,0.742105
D.bunnanda,151823105,VNKE01005094.1,1,38664,0.000254665,112707315,0.742359
D.bunnanda,151823105,VNKE01001773.1,1,38621,0.000254382,112745936,0.742614
D.bunnanda,151823105,VNKE01000747.1,1,38607,0.000254289,112784543,0.742868
D.bunnanda,151823105,VNKE01001361.1,1,38559,0.000253973,112823102,0.743122
D.bunnanda,151823105,VNKE01002685.1,1,38516,0.00025369,112861618,0.743376
D.bunnanda,151823105,VNKE01003094.1,1,38410,0.000252992,112900028,0.743629
D.bunnanda,151823105,VNKE01003227.1,1,38285,0.000252168,112938313,0.743881
D.bunnanda,151823105,VNKE01001523.1,1,38258,0.000251991,112976571,0.744133
D.bunnanda,151823105,VNKE01004104.1,1,38254,0.000251964,113014825,0.744385
D.bunnanda,151823105,VNKE01004079.1,1,38232,0.000251819,113053057,0.744637
D.bunnanda,151823105,VNKE01001891.1,1,38163,0.000251365,113091220,0.744888
D.bunnanda,151823105,VNKE01004697.1,1,38127,0.000251128,113129347,0.745139
D.bunnanda,151823105,VNKE01000701.1,1,38119,0.000251075,113167466,0.74539
D.bunnanda,151823105,VNKE01005467.1,1,38065,0.000250719,113205531,0.745641
D.bunnanda,151823105,VNKE01003367.1,1,38022,0.000250436,113243553,0.745891
D.bunnanda,151823105,VNKE01002808.1,1,38006,0.000250331,113281559,0.746142
D.bunnanda,151823105,VNKE01000224.1,1,37846,0.000249277,113319405,0.746391
D.bunnanda,151823105,VNKE01001525.1,1,37832,0.000249185,113357237,0.74664
D.bunnanda,151823105,VNKE01002659.1,1,37738,0.000248566,113394975,0.746889
D.bunnanda,151823105,VNKE01006623.1,1,37652,0.000247999,113432627,0.747137
D.bunnanda,151823105,VNKE01001802.1,1,37650,0.000247986,113470277,0.747385
D.bunnanda,151823105,VNKE01003621.1,1,37620,0.000247788,113507897,0.747633
D.bunnanda,151823105,VNKE01002102.1,1,37616,0.000247762,113545513,0.74788
D.bunnanda,151823105,VNKE01004503.1,1,37514,0.00024709,113583027,0.748127
D.bunnanda,151823105,VNKE01001489.1,1,37480,0.000246866,113620507,0.748374
D.bunnanda,151823105,VNKE01002104.1,1,37473,0.00024682,113657980,0.748621
D.bunnanda,151823105,VNKE01000426.1,1,37414,0.000246432,113695394,0.748868
D.bunnanda,151823105,VNKE01003559.1,1,37353,0.00024603,113732747,0.749114
D.bunnanda,151823105,VNKE01003478.1,1,37265,0.00024545,113770012,0.749359
D.bunnanda,151823105,VNKE01003672.1,1,37189,0.00024495,113807201,0.749604
D.bunnanda,151823105,VNKE01006258.1,1,37187,0.000244936,113844388,0.749849
D.bunnanda,151823105,VNKE01002382.1,1,37150,0.000244693,113881538,0.750094
D.bunnanda,151823105,VNKE01001542.1,1,37098,0.00024435,113918636,0.750338
D.bunnanda,151823105,VNKE01004359.1,1,37095,0.00024433,113955731,0.750582
D.bunnanda,151823105,VNKE01003130.1,1,36978,0.00024356,113992709,0.750826
D.bunnanda,151823105,VNKE01000333.1,1,36930,0.000243244,114029639,0.751069
D.bunnanda,151823105,VNKE01003225.1,1,36895,0.000243013,114066534,0.751312
D.bunnanda,151823105,VNKE01001522.1,1,36860,0.000242783,114103394,0.751555
D.bunnanda,151823105,VNKE01002233.1,1,36794,0.000242348,114140188,0.751797
D.bunnanda,151823105,VNKE01003098.1,1,36738,0.000241979,114176926,0.752039
D.bunnanda,151823105,VNKE01006607.1,1,36720,0.00024186,114213646,0.752281
D.bunnanda,151823105,VNKE01000149.1,1,36668,0.000241518,114250314,0.752523
D.bunnanda,151823105,VNKE01004279.1,1,36411,0.000239825,114286725,0.752762
D.bunnanda,151823105,VNKE01000938.1,1,36392,0.0002397,114323117,0.753002
D.bunnanda,151823105,VNKE01000728.1,1,36329,0.000239285,114359446,0.753241
D.bunnanda,151823105,VNKE01001307.1,1,36273,0.000238916,114395719,0.75348
D.bunnanda,151823105,VNKE01005322.1,1,36247,0.000238745,114431966,0.753719
D.bunnanda,151823105,VNKE01001200.1,1,36168,0.000238225,114468134,0.753957
D.bunnanda,151823105,VNKE01000746.1,1,36128,0.000237961,114504262,0.754195
D.bunnanda,151823105,VNKE01000414.1,1,36029,0.000237309,114540291,0.754433
D.bunnanda,151823105,VNKE01004696.1,1,35986,0.000237026,114576277,0.75467
D.bunnanda,151823105,VNKE01006274.1,1,35930,0.000236657,114612207,0.754906
D.bunnanda,151823105,VNKE01005516.1,1,35923,0.000236611,114648130,0.755143
D.bunnanda,151823105,VNKE01001963.1,1,35899,0.000236453,114684029,0.755379
D.bunnanda,151823105,VNKE01000470.1,1,35892,0.000236407,114719921,0.755616
D.bunnanda,151823105,VNKE01000726.1,1,35851,0.000236137,114755772,0.755852
D.bunnanda,151823105,VNKE01000062.1,1,35832,0.000236012,114791604,0.756088
D.bunnanda,151823105,VNKE01001125.1,1,35814,0.000235893,114827418,0.756324
D.bunnanda,151823105,VNKE01006603.1,1,35804,0.000235827,114863222,0.75656
D.bunnanda,151823105,VNKE01001278.1,1,35765,0.00023557,114898987,0.756795
D.bunnanda,151823105,VNKE01004026.1,1,35745,0.000235438,114934732,0.757031
D.bunnanda,151823105,VNKE01005771.1,1,35660,0.000234879,114970392,0.757265
D.bunnanda,151823105,VNKE01002370.1,1,35613,0.000234569,115006005,0.7575
D.bunnanda,151823105,VNKE01006301.1,1,35610,0.000234549,115041615,0.757735
D.bunnanda,151823105,VNKE01005149.1,1,35605,0.000234516,115077220,0.757969
D.bunnanda,151823105,VNKE01002205.1,1,35494,0.000233785,115112714,0.758203
D.bunnanda,151823105,VNKE01001919.1,1,35493,0.000233779,115148207,0.758437
D.bunnanda,151823105,VNKE01002865.1,1,35435,0.000233397,115183642,0.75867
D.bunnanda,151823105,VNKE01003218.1,1,35429,0.000233357,115219071,0.758903
D.bunnanda,151823105,VNKE01006558.1,1,35384,0.000233061,115254455,0.759136
D.bunnanda,151823105,VNKE01001894.1,1,35365,0.000232936,115289820,0.759369
D.bunnanda,151823105,VNKE01005110.1,1,35361,0.000232909,115325181,0.759602
D.bunnanda,151823105,VNKE01003961.1,1,35196,0.000231822,115360377,0.759834
D.bunnanda,151823105,VNKE01002144.1,1,35154,0.000231546,115395531,0.760066
D.bunnanda,151823105,VNKE01005326.1,1,35137,0.000231434,115430668,0.760297
D.bunnanda,151823105,VNKE01001530.1,1,35121,0.000231328,115465789,0.760528
D.bunnanda,151823105,VNKE01003591.1,1,35064,0.000230953,115500853,0.760759
D.bunnanda,151823105,VNKE01004667.1,1,34993,0.000230485,115535846,0.76099
D.bunnanda,151823105,VNKE01004286.1,1,34909,0.000229932,115570755,0.76122
D.bunnanda,151823105,VNKE01000501.1,1,34825,0.000229379,115605580,0.761449
D.bunnanda,151823105,VNKE01000105.1,1,34804,0.00022924,115640384,0.761678
D.bunnanda,151823105,VNKE01004084.1,1,34633,0.000228114,115675017,0.761907
D.bunnanda,151823105,VNKE01005035.1,1,34600,0.000227897,115709617,0.762134
D.bunnanda,151823105,VNKE01004750.1,1,34578,0.000227752,115744195,0.762362
D.bunnanda,151823105,VNKE01000570.1,1,34569,0.000227693,115778764,0.76259
D.bunnanda,151823105,VNKE01004131.1,1,34520,0.00022737,115813284,0.762817
D.bunnanda,151823105,VNKE01002166.1,1,34483,0.000227126,115847767,0.763044
D.bunnanda,151823105,VNKE01001330.1,1,34290,0.000225855,115882057,0.76327
D.bunnanda,151823105,VNKE01003609.1,1,34281,0.000225796,115916338,0.763496
D.bunnanda,151823105,VNKE01002845.1,1,34146,0.000224906,115950484,0.763721
D.bunnanda,151823105,VNKE01003968.1,1,34074,0.000224432,115984558,0.763945
D.bunnanda,151823105,VNKE01005509.1,1,34067,0.000224386,116018625,0.76417
D.bunnanda,151823105,VNKE01006255.1,1,34061,0.000224347,116052686,0.764394
D.bunnanda,151823105,VNKE01004694.1,1,34039,0.000224202,116086725,0.764618
D.bunnanda,151823105,VNKE01001709.1,1,34023,0.000224096,116120748,0.764842
D.bunnanda,151823105,VNKE01001711.1,1,33980,0.000223813,116154728,0.765066
D.bunnanda,151823105,VNKE01002658.1,1,33915,0.000223385,116188643,0.76529
D.bunnanda,151823105,VNKE01004361.1,1,33884,0.000223181,116222527,0.765513
D.bunnanda,151823105,VNKE01000837.1,1,33878,0.000223141,116256405,0.765736
D.bunnanda,151823105,VNKE01004834.1,1,33861,0.000223029,116290266,0.765959
D.bunnanda,151823105,VNKE01001343.1,1,33844,0.000222917,116324110,0.766182
D.bunnanda,151823105,VNKE01000741.1,1,33758,0.000222351,116357868,0.766404
D.bunnanda,151823105,VNKE01002783.1,1,33718,0.000222087,116391586,0.766626
D.bunnanda,151823105,VNKE01004784.1,1,33665,0.000221738,116425251,0.766848
D.bunnanda,151823105,VNKE01002944.1,1,33579,0.000221172,116458830,0.767069
D.bunnanda,151823105,VNKE01000795.1,1,33440,0.000220256,116492270,0.767289
D.bunnanda,151823105,VNKE01006322.1,1,33416,0.000220098,116525686,0.76751
D.bunnanda,151823105,VNKE01004134.1,1,33369,0.000219789,116559055,0.767729
D.bunnanda,151823105,VNKE01000993.1,1,33368,0.000219782,116592423,0.767949
D.bunnanda,151823105,VNKE01005712.1,1,33324,0.000219492,116625747,0.768169
D.bunnanda,151823105,VNKE01005868.1,1,33300,0.000219334,116659047,0.768388
D.bunnanda,151823105,VNKE01002160.1,1,33299,0.000219328,116692346,0.768607
D.bunnanda,151823105,VNKE01004203.1,1,33236,0.000218913,116725582,0.768826
D.bunnanda,151823105,VNKE01000745.1,1,33211,0.000218748,116758793,0.769045
D.bunnanda,151823105,VNKE01005767.1,1,33208,0.000218728,116792001,0.769264
D.bunnanda,151823105,VNKE01000695.1,1,33167,0.000218458,116825168,0.769482
D.bunnanda,151823105,VNKE01001088.1,1,33111,0.000218089,116858279,0.7697
D.bunnanda,151823105,VNKE01001914.1,1,33076,0.000217859,116891355,0.769918
D.bunnanda,151823105,VNKE01003333.1,1,33073,0.000217839,116924428,0.770136
D.bunnanda,151823105,VNKE01004363.1,1,33036,0.000217595,116957464,0.770354
D.bunnanda,151823105,VNKE01005067.1,1,33034,0.000217582,116990498,0.770571
D.bunnanda,151823105,VNKE01000192.1,1,33014,0.00021745,117023512,0.770789
D.bunnanda,151823105,VNKE01001768.1,1,32977,0.000217207,117056489,0.771006
D.bunnanda,151823105,VNKE01004700.1,1,32952,0.000217042,117089441,0.771223
D.bunnanda,151823105,VNKE01005301.1,1,32908,0.000216752,117122349,0.77144
D.bunnanda,151823105,VNKE01006349.1,1,32907,0.000216746,117155256,0.771656
D.bunnanda,151823105,VNKE01002210.1,1,32766,0.000215817,117188022,0.771872
D.bunnanda,151823105,VNKE01003231.1,1,32762,0.000215791,117220784,0.772088
D.bunnanda,151823105,VNKE01002583.1,1,32752,0.000215725,117253536,0.772304
D.bunnanda,151823105,VNKE01002380.1,1,32706,0.000215422,117286242,0.772519
D.bunnanda,151823105,VNKE01000587.1,1,32675,0.000215218,117318917,0.772734
D.bunnanda,151823105,VNKE01006297.1,1,32614,0.000214816,117351531,0.772949
D.bunnanda,151823105,VNKE01000877.1,1,32525,0.00021423,117384056,0.773163
D.bunnanda,151823105,VNKE01003103.1,1,32475,0.0002139,117416531,0.773377
D.bunnanda,151823105,VNKE01001539.1,1,32455,0.000213769,117448986,0.773591
D.bunnanda,151823105,VNKE01003899.1,1,32410,0.000213472,117481396,0.773804
D.bunnanda,151823105,VNKE01001710.1,1,32409,0.000213466,117513805,0.774018
D.bunnanda,151823105,VNKE01006081.1,1,32348,0.000213064,117546153,0.774231
D.bunnanda,151823105,VNKE01000419.1,1,32342,0.000213024,117578495,0.774444
D.bunnanda,151823105,VNKE01000189.1,1,32326,0.000212919,117610821,0.774657
D.bunnanda,151823105,VNKE01001230.1,1,32241,0.000212359,117643062,0.774869
D.bunnanda,151823105,VNKE01000772.1,1,32195,0.000212056,117675257,0.775081
D.bunnanda,151823105,VNKE01003598.1,1,32109,0.00021149,117707366,0.775293
D.bunnanda,151823105,VNKE01002864.1,1,32107,0.000211476,117739473,0.775504
D.bunnanda,151823105,VNKE01006595.1,1,32060,0.000211167,117771533,0.775715
D.bunnanda,151823105,VNKE01001102.1,1,32046,0.000211075,117803579,0.775927
D.bunnanda,151823105,VNKE01004222.1,1,32020,0.000210903,117835599,0.776137
D.bunnanda,151823105,VNKE01003838.1,1,32001,0.000210778,117867600,0.776348
D.bunnanda,151823105,VNKE01005821.1,1,31954,0.000210469,117899554,0.776559
D.bunnanda,151823105,VNKE01003129.1,1,31916,0.000210218,117931470,0.776769
D.bunnanda,151823105,VNKE01001233.1,1,31908,0.000210166,117963378,0.776979
D.bunnanda,151823105,VNKE01000467.1,1,31890,0.000210047,117995268,0.777189
D.bunnanda,151823105,VNKE01005360.1,1,31833,0.000209672,118027101,0.777399
D.bunnanda,151823105,VNKE01003783.1,1,31821,0.000209593,118058922,0.777608
D.bunnanda,151823105,VNKE01005515.1,1,31789,0.000209382,118090711,0.777818
D.bunnanda,151823105,VNKE01002726.1,1,31699,0.000208789,118122410,0.778027
D.bunnanda,151823105,VNKE01001856.1,1,31638,0.000208387,118154048,0.778235
D.bunnanda,151823105,VNKE01005867.1,1,31636,0.000208374,118185684,0.778443
D.bunnanda,151823105,VNKE01004527.1,1,31584,0.000208032,118217268,0.778651
D.bunnanda,151823105,VNKE01000697.1,1,31497,0.000207459,118248765,0.778859
D.bunnanda,151823105,VNKE01000438.1,1,31384,0.000206714,118280149,0.779066
D.bunnanda,151823105,VNKE01004332.1,1,31368,0.000206609,118311517,0.779272
D.bunnanda,151823105,VNKE01001775.1,1,31362,0.000206569,118342879,0.779479
D.bunnanda,151823105,VNKE01002621.1,1,31274,0.00020599,118374153,0.779685
D.bunnanda,151823105,VNKE01000158.1,1,31258,0.000205884,118405411,0.779891
D.bunnanda,151823105,VNKE01000196.1,1,31231,0.000205707,118436642,0.780096
D.bunnanda,151823105,VNKE01006125.1,1,31057,0.00020456,118467699,0.780301
D.bunnanda,151823105,VNKE01001745.1,1,31041,0.000204455,118498740,0.780505
D.bunnanda,151823105,VNKE01004726.1,1,31026,0.000204356,118529766,0.78071
D.bunnanda,151823105,VNKE01003895.1,1,30996,0.000204159,118560762,0.780914
D.bunnanda,151823105,VNKE01003674.1,1,30941,0.000203796,118591703,0.781118
D.bunnanda,151823105,VNKE01003891.1,1,30927,0.000203704,118622630,0.781321
D.bunnanda,151823105,VNKE01004041.1,1,30926,0.000203698,118653556,0.781525
D.bunnanda,151823105,VNKE01005433.1,1,30849,0.00020319,118684405,0.781728
D.bunnanda,151823105,VNKE01001084.1,1,30791,0.000202808,118715196,0.781931
D.bunnanda,151823105,VNKE01004003.1,1,30789,0.000202795,118745985,0.782134
D.bunnanda,151823105,VNKE01006306.1,1,30761,0.000202611,118776746,0.782336
D.bunnanda,151823105,VNKE01003594.1,1,30757,0.000202584,118807503,0.782539
D.bunnanda,151823105,VNKE01000748.1,1,30725,0.000202374,118838228,0.782741
D.bunnanda,151823105,VNKE01000370.1,1,30716,0.000202314,118868944,0.782944
D.bunnanda,151823105,VNKE01005579.1,1,30700,0.000202209,118899644,0.783146
D.bunnanda,151823105,VNKE01000969.1,1,30696,0.000202183,118930340,0.783348
D.bunnanda,151823105,VNKE01004093.1,1,30656,0.000201919,118960996,0.78355
D.bunnanda,151823105,VNKE01004709.1,1,30613,0.000201636,118991609,0.783752
D.bunnanda,151823105,VNKE01005304.1,1,30599,0.000201544,119022208,0.783953
D.bunnanda,151823105,VNKE01004321.1,1,30567,0.000201333,119052775,0.784155
D.bunnanda,151823105,VNKE01004128.1,1,30547,0.000201201,119083322,0.784356
D.bunnanda,151823105,VNKE01002486.1,1,30527,0.00020107,119113849,0.784557
D.bunnanda,151823105,VNKE01003540.1,1,30522,0.000201037,119144371,0.784758
D.bunnanda,151823105,VNKE01004842.1,1,30351,0.00019991,119174722,0.784958
D.bunnanda,151823105,VNKE01000880.1,1,30301,0.000199581,119205023,0.785157
D.bunnanda,151823105,VNKE01002017.1,1,30257,0.000199291,119235280,0.785357
D.bunnanda,151823105,VNKE01003341.1,1,30254,0.000199271,119265534,0.785556
D.bunnanda,151823105,VNKE01004409.1,1,30240,0.000199179,119295774,0.785755
D.bunnanda,151823105,VNKE01000742.1,1,30234,0.00019914,119326008,0.785954
D.bunnanda,151823105,VNKE01000210.1,1,30175,0.000198751,119356183,0.786153
D.bunnanda,151823105,VNKE01006344.1,1,30151,0.000198593,119386334,0.786352
D.bunnanda,151823105,VNKE01001093.1,1,30136,0.000198494,119416470,0.78655
D.bunnanda,151823105,VNKE01000124.1,1,30083,0.000198145,119446553,0.786748
D.bunnanda,151823105,VNKE01006279.1,1,30079,0.000198119,119476632,0.786946
D.bunnanda,151823105,VNKE01004921.1,1,29947,0.000197249,119506579,0.787144
D.bunnanda,151823105,VNKE01002769.1,1,29932,0.00019715,119536511,0.787341
D.bunnanda,151823105,VNKE01001484.1,1,29909,0.000196999,119566420,0.787538
D.bunnanda,151823105,VNKE01000933.1,1,29892,0.000196887,119596312,0.787735
D.bunnanda,151823105,VNKE01002822.1,1,29855,0.000196643,119626167,0.787931
D.bunnanda,151823105,VNKE01000691.1,1,29814,0.000196373,119655981,0.788128
D.bunnanda,151823105,VNKE01001323.1,1,29704,0.000195649,119685685,0.788323
D.bunnanda,151823105,VNKE01005747.1,1,29643,0.000195247,119715328,0.788519
D.bunnanda,151823105,VNKE01005299.1,1,29579,0.000194825,119744907,0.788713
D.bunnanda,151823105,VNKE01004087.1,1,29532,0.000194516,119774439,0.788908
D.bunnanda,151823105,VNKE01004679.1,1,29524,0.000194463,119803963,0.789102
D.bunnanda,151823105,VNKE01004215.1,1,29491,0.000194246,119833454,0.789297
D.bunnanda,151823105,VNKE01000743.1,1,29474,0.000194134,119862928,0.789491
D.bunnanda,151823105,VNKE01006198.1,1,29456,0.000194015,119892384,0.789685
D.bunnanda,151823105,VNKE01004063.1,1,29447,0.000193956,119921831,0.789879
D.bunnanda,151823105,VNKE01001655.1,1,29424,0.000193804,119951255,0.790072
D.bunnanda,151823105,VNKE01004018.1,1,29269,0.000192784,119980524,0.790265
D.bunnanda,151823105,VNKE01000068.1,1,29209,0.000192388,120009733,0.790458
D.bunnanda,151823105,VNKE01005387.1,1,29199,0.000192323,120038932,0.79065
D.bunnanda,151823105,VNKE01005744.1,1,29108,0.000191723,120068040,0.790842
D.bunnanda,151823105,VNKE01003917.1,1,29103,0.00019169,120097143,0.791033
D.bunnanda,151823105,VNKE01005604.1,1,29082,0.000191552,120126225,0.791225
D.bunnanda,151823105,VNKE01005320.1,1,29047,0.000191321,120155272,0.791416
D.bunnanda,151823105,VNKE01003523.1,1,28979,0.000190873,120184251,0.791607
D.bunnanda,151823105,VNKE01001232.1,1,28968,0.000190801,120213219,0.791798
D.bunnanda,151823105,VNKE01003898.1,1,28965,0.000190781,120242184,0.791989
D.bunnanda,151823105,VNKE01001207.1,1,28875,0.000190188,120271059,0.792179
D.bunnanda,151823105,VNKE01003138.1,1,28807,0.000189741,120299866,0.792369
D.bunnanda,151823105,VNKE01005533.1,1,28763,0.000189451,120328629,0.792558
D.bunnanda,151823105,VNKE01004838.1,1,28749,0.000189359,120357378,0.792747
D.bunnanda,151823105,VNKE01000764.1,1,28706,0.000189075,120386084,0.792937
D.bunnanda,151823105,VNKE01003448.1,1,28685,0.000188937,120414769,0.793125
D.bunnanda,151823105,VNKE01003060.1,1,28614,0.000188469,120443383,0.793314
D.bunnanda,151823105,VNKE01000476.1,1,28580,0.000188245,120471963,0.793502
D.bunnanda,151823105,VNKE01004617.1,1,28550,0.000188048,120500513,0.79369
D.bunnanda,151823105,VNKE01000183.1,1,28545,0.000188015,120529058,0.793878
D.bunnanda,151823105,VNKE01004699.1,1,28526,0.00018789,120557584,0.794066
D.bunnanda,151823105,VNKE01000177.1,1,28501,0.000187725,120586085,0.794254
D.bunnanda,151823105,VNKE01001590.1,1,28448,0.000187376,120614533,0.794441
D.bunnanda,151823105,VNKE01006192.1,1,28421,0.000187198,120642954,0.794628
D.bunnanda,151823105,VNKE01001069.1,1,28356,0.00018677,120671310,0.794815
D.bunnanda,151823105,VNKE01004127.1,1,28326,0.000186572,120699636,0.795002
D.bunnanda,151823105,VNKE01000066.1,1,28237,0.000185986,120727873,0.795188
D.bunnanda,151823105,VNKE01002454.1,1,28178,0.000185598,120756051,0.795373
D.bunnanda,151823105,VNKE01006368.1,1,28174,0.000185571,120784225,0.795559
D.bunnanda,151823105,VNKE01004090.1,1,28152,0.000185426,120812377,0.795744
D.bunnanda,151823105,VNKE01002109.1,1,28049,0.000184748,120840426,0.795929
D.bunnanda,151823105,VNKE01005526.1,1,27997,0.000184405,120868423,0.796113
D.bunnanda,151823105,VNKE01006173.1,1,27914,0.000183859,120896337,0.796297
D.bunnanda,151823105,VNKE01006185.1,1,27889,0.000183694,120924226,0.796481
D.bunnanda,151823105,VNKE01004010.1,1,27883,0.000183655,120952109,0.796665
D.bunnanda,151823105,VNKE01001185.1,1,27847,0.000183417,120979956,0.796848
D.bunnanda,151823105,VNKE01001890.1,1,27823,0.000183259,121007779,0.797031
D.bunnanda,151823105,VNKE01004116.1,1,27814,0.0001832,121035593,0.797215
D.bunnanda,151823105,VNKE01001210.1,1,27808,0.000183161,121063401,0.797398
D.bunnanda,151823105,VNKE01001883.1,1,27794,0.000183068,121091195,0.797581
D.bunnanda,151823105,VNKE01002372.1,1,27789,0.000183035,121118984,0.797764
D.bunnanda,151823105,VNKE01000835.1,1,27777,0.000182956,121146761,0.797947
D.bunnanda,151823105,VNKE01004278.1,1,27755,0.000182811,121174516,0.79813
D.bunnanda,151823105,VNKE01005612.1,1,27640,0.000182054,121202156,0.798312
D.bunnanda,151823105,VNKE01005875.1,1,27623,0.000181942,121229779,0.798494
D.bunnanda,151823105,VNKE01005898.1,1,27554,0.000181488,121257333,0.798675
D.bunnanda,151823105,VNKE01001178.1,1,27548,0.000181448,121284881,0.798857
D.bunnanda,151823105,VNKE01001135.1,1,27538,0.000181382,121312419,0.799038
D.bunnanda,151823105,VNKE01002186.1,1,27517,0.000181244,121339936,0.799219
D.bunnanda,151823105,VNKE01005130.1,1,27478,0.000180987,121367414,0.7994
D.bunnanda,151823105,VNKE01002000.1,1,27467,0.000180914,121394881,0.799581
D.bunnanda,151823105,VNKE01006592.1,1,27455,0.000180835,121422336,0.799762
D.bunnanda,151823105,VNKE01000978.1,1,27455,0.000180835,121449791,0.799943
D.bunnanda,151823105,VNKE01006571.1,1,27345,0.000180111,121477136,0.800123
D.bunnanda,151823105,VNKE01003904.1,1,27333,0.000180032,121504469,0.800303
D.bunnanda,151823105,VNKE01003354.1,1,27320,0.000179946,121531789,0.800483
D.bunnanda,151823105,VNKE01004666.1,1,27294,0.000179775,121559083,0.800663
D.bunnanda,151823105,VNKE01004597.1,1,27263,0.000179571,121586346,0.800842
D.bunnanda,151823105,VNKE01004121.1,1,27252,0.000179498,121613598,0.801022
D.bunnanda,151823105,VNKE01003331.1,1,27251,0.000179492,121640849,0.801201
D.bunnanda,151823105,VNKE01000055.1,1,27151,0.000178833,121668000,0.80138
D.bunnanda,151823105,VNKE01004954.1,1,27080,0.000178365,121695080,0.801558
D.bunnanda,151823105,VNKE01004310.1,1,27060,0.000178234,121722140,0.801737
D.bunnanda,151823105,VNKE01003787.1,1,27048,0.000178155,121749188,0.801915
D.bunnanda,151823105,VNKE01003593.1,1,27046,0.000178142,121776234,0.802093
D.bunnanda,151823105,VNKE01001239.1,1,27024,0.000177997,121803258,0.802271
D.bunnanda,151823105,VNKE01002849.1,1,27003,0.000177858,121830261,0.802449
D.bunnanda,151823105,VNKE01004326.1,1,26991,0.000177779,121857252,0.802627
D.bunnanda,151823105,VNKE01003561.1,1,26896,0.000177154,121884148,0.802804
D.bunnanda,151823105,VNKE01004495.1,1,26805,0.000176554,121910953,0.80298
D.bunnanda,151823105,VNKE01000162.1,1,26804,0.000176548,121937757,0.803157
D.bunnanda,151823105,VNKE01003349.1,1,26794,0.000176482,121964551,0.803333
D.bunnanda,151823105,VNKE01001005.1,1,26783,0.000176409,121991334,0.80351
D.bunnanda,151823105,VNKE01004787.1,1,26778,0.000176376,122018112,0.803686
D.bunnanda,151823105,VNKE01003558.1,1,26729,0.000176054,122044841,0.803862
D.bunnanda,151823105,VNKE01000758.1,1,26729,0.000176054,122071570,0.804038
D.bunnanda,151823105,VNKE01002450.1,1,26698,0.000175849,122098268,0.804214
D.bunnanda,151823105,VNKE01003922.1,1,26645,0.0001755,122124913,0.80439
D.bunnanda,151823105,VNKE01001023.1,1,26534,0.000174769,122151447,0.804564
D.bunnanda,151823105,VNKE01002407.1,1,26506,0.000174585,122177953,0.804739
D.bunnanda,151823105,VNKE01003283.1,1,26484,0.00017444,122204437,0.804913
D.bunnanda,151823105,VNKE01003669.1,1,26388,0.000173808,122230825,0.805087
D.bunnanda,151823105,VNKE01003319.1,1,26311,0.0001733,122257136,0.80526
D.bunnanda,151823105,VNKE01003299.1,1,26301,0.000173235,122283437,0.805434
D.bunnanda,151823105,VNKE01005872.1,1,26276,0.00017307,122309713,0.805607
D.bunnanda,151823105,VNKE01005037.1,1,26258,0.000172951,122335971,0.80578
D.bunnanda,151823105,VNKE01004721.1,1,26198,0.000172556,122362169,0.805952
D.bunnanda,151823105,VNKE01004316.1,1,26192,0.000172517,122388361,0.806125
D.bunnanda,151823105,VNKE01004893.1,1,26186,0.000172477,122414547,0.806297
D.bunnanda,151823105,VNKE01004587.1,1,26152,0.000172253,122440699,0.806469
D.bunnanda,151823105,VNKE01001156.1,1,26141,0.000172181,122466840,0.806642
D.bunnanda,151823105,VNKE01004304.1,1,26136,0.000172148,122492976,0.806814
D.bunnanda,151823105,VNKE01000221.1,1,26107,0.000171957,122519083,0.806986
D.bunnanda,151823105,VNKE01003624.1,1,26100,0.000171911,122545183,0.807158
D.bunnanda,151823105,VNKE01003831.1,1,26029,0.000171443,122571212,0.807329
D.bunnanda,151823105,VNKE01006080.1,1,25989,0.000171179,122597201,0.8075
D.bunnanda,151823105,VNKE01005114.1,1,25985,0.000171153,122623186,0.807671
D.bunnanda,151823105,VNKE01002603.1,1,25926,0.000170765,122649112,0.807842
D.bunnanda,151823105,VNKE01003630.1,1,25908,0.000170646,122675020,0.808013
D.bunnanda,151823105,VNKE01005759.1,1,25885,0.000170494,122700905,0.808183
D.bunnanda,151823105,VNKE01001714.1,1,25883,0.000170481,122726788,0.808354
D.bunnanda,151823105,VNKE01003472.1,1,25880,0.000170462,122752668,0.808524
D.bunnanda,151823105,VNKE01004631.1,1,25875,0.000170429,122778543,0.808695
D.bunnanda,151823105,VNKE01003776.1,1,25811,0.000170007,122804354,0.808865
D.bunnanda,151823105,VNKE01001339.1,1,25780,0.000169803,122830134,0.809035
D.bunnanda,151823105,VNKE01003083.1,1,25757,0.000169651,122855891,0.809204
D.bunnanda,151823105,VNKE01005150.1,1,25748,0.000169592,122881639,0.809374
D.bunnanda,151823105,VNKE01000688.1,1,25736,0.000169513,122907375,0.809543
D.bunnanda,151823105,VNKE01002080.1,1,25716,0.000169381,122933091,0.809713
D.bunnanda,151823105,VNKE01000962.1,1,25534,0.000168183,122958625,0.809881
D.bunnanda,151823105,VNKE01004306.1,1,25481,0.000167833,122984106,0.810049
D.bunnanda,151823105,VNKE01001961.1,1,25466,0.000167735,123009572,0.810216
D.bunnanda,151823105,VNKE01003603.1,1,25457,0.000167675,123035029,0.810384
D.bunnanda,151823105,VNKE01002406.1,1,25455,0.000167662,123060484,0.810552
D.bunnanda,151823105,VNKE01006268.1,1,25439,0.000167557,123085923,0.810719
D.bunnanda,151823105,VNKE01002689.1,1,25418,0.000167419,123111341,0.810887
D.bunnanda,151823105,VNKE01003041.1,1,25407,0.000167346,123136748,0.811054
D.bunnanda,151823105,VNKE01001211.1,1,25407,0.000167346,123162155,0.811221
D.bunnanda,151823105,VNKE01003199.1,1,25367,0.000167083,123187522,0.811389
D.bunnanda,151823105,VNKE01001240.1,1,25287,0.000166556,123212809,0.811555
D.bunnanda,151823105,VNKE01000186.1,1,25224,0.000166141,123238033,0.811721
D.bunnanda,151823105,VNKE01003790.1,1,25220,0.000166114,123263253,0.811887
D.bunnanda,151823105,VNKE01003089.1,1,25211,0.000166055,123288464,0.812053
D.bunnanda,151823105,VNKE01003610.1,1,25205,0.000166016,123313669,0.812219
D.bunnanda,151823105,VNKE01002362.1,1,25204,0.000166009,123338873,0.812385
D.bunnanda,151823105,VNKE01006048.1,1,25037,0.000164909,123363910,0.81255
D.bunnanda,151823105,VNKE01000263.1,1,25014,0.000164758,123388924,0.812715
D.bunnanda,151823105,VNKE01000683.1,1,25000,0.000164665,123413924,0.81288
D.bunnanda,151823105,VNKE01002280.1,1,24995,0.000164632,123438919,0.813044
D.bunnanda,151823105,VNKE01006314.1,1,24984,0.00016456,123463903,0.813209
D.bunnanda,151823105,VNKE01000945.1,1,24779,0.00016321,123488682,0.813372
D.bunnanda,151823105,VNKE01004135.1,1,24760,0.000163085,123513442,0.813535
D.bunnanda,151823105,VNKE01000817.1,1,24749,0.000163012,123538191,0.813698
D.bunnanda,151823105,VNKE01004318.1,1,24734,0.000162913,123562925,0.813861
D.bunnanda,151823105,VNKE01000474.1,1,24724,0.000162847,123587649,0.814024
D.bunnanda,151823105,VNKE01003324.1,1,24689,0.000162617,123612338,0.814187
D.bunnanda,151823105,VNKE01003619.1,1,24661,0.000162432,123636999,0.814349
D.bunnanda,151823105,VNKE01004488.1,1,24607,0.000162077,123661606,0.814511
D.bunnanda,151823105,VNKE01004294.1,1,24573,0.000161853,123686179,0.814673
D.bunnanda,151823105,VNKE01005479.1,1,24564,0.000161794,123710743,0.814835
D.bunnanda,151823105,VNKE01004781.1,1,24550,0.000161701,123735293,0.814996
D.bunnanda,151823105,VNKE01005637.1,1,24521,0.00016151,123759814,0.815158
D.bunnanda,151823105,VNKE01004632.1,1,24489,0.0001613,123784303,0.815319
D.bunnanda,151823105,VNKE01003068.1,1,24488,0.000161293,123808791,0.815481
D.bunnanda,151823105,VNKE01002313.1,1,24487,0.000161286,123833278,0.815642
D.bunnanda,151823105,VNKE01005478.1,1,24485,0.000161273,123857763,0.815803
D.bunnanda,151823105,VNKE01004861.1,1,24473,0.000161194,123882236,0.815964
D.bunnanda,151823105,VNKE01002902.1,1,24464,0.000161135,123906700,0.816125
D.bunnanda,151823105,VNKE01002610.1,1,24405,0.000160746,123931105,0.816286
D.bunnanda,151823105,VNKE01002819.1,1,24390,0.000160647,123955495,0.816447
D.bunnanda,151823105,VNKE01006601.1,1,24366,0.000160489,123979861,0.816607
D.bunnanda,151823105,VNKE01006302.1,1,24276,0.000159897,124004137,0.816767
D.bunnanda,151823105,VNKE01004590.1,1,24268,0.000159844,124028405,0.816927
D.bunnanda,151823105,VNKE01000067.1,1,24263,0.000159811,124052668,0.817087
D.bunnanda,151823105,VNKE01005859.1,1,24235,0.000159627,124076903,0.817247
D.bunnanda,151823105,VNKE01002051.1,1,24219,0.000159521,124101122,0.817406
D.bunnanda,151823105,VNKE01001991.1,1,24204,0.000159422,124125326,0.817565
D.bunnanda,151823105,VNKE01005217.1,1,24187,0.00015931,124149513,0.817725
D.bunnanda,151823105,VNKE01006597.1,1,24170,0.000159198,124173683,0.817884
D.bunnanda,151823105,VNKE01000796.1,1,24170,0.000159198,124197853,0.818043
D.bunnanda,151823105,VNKE01001951.1,1,24132,0.000158948,124221985,0.818202
D.bunnanda,151823105,VNKE01006089.1,1,24063,0.000158494,124246048,0.818361
D.bunnanda,151823105,VNKE01004783.1,1,24052,0.000158421,124270100,0.818519
D.bunnanda,151823105,VNKE01002050.1,1,23990,0.000158013,124294090,0.818677
D.bunnanda,151823105,VNKE01001197.1,1,23861,0.000157163,124317951,0.818834
D.bunnanda,151823105,VNKE01004790.1,1,23792,0.000156709,124341743,0.818991
D.bunnanda,151823105,VNKE01006383.1,1,23750,0.000156432,124365493,0.819147
D.bunnanda,151823105,VNKE01005540.1,1,23711,0.000156175,124389204,0.819304
D.bunnanda,151823105,VNKE01006596.1,1,23698,0.00015609,124412902,0.81946
D.bunnanda,151823105,VNKE01002645.1,1,23692,0.00015605,124436594,0.819616
D.bunnanda,151823105,VNKE01001237.1,1,23686,0.000156011,124460280,0.819772
D.bunnanda,151823105,VNKE01001455.1,1,23684,0.000155997,124483964,0.819928
D.bunnanda,151823105,VNKE01005046.1,1,23623,0.000155596,124507587,0.820083
D.bunnanda,151823105,VNKE01005715.1,1,23611,0.000155517,124531198,0.820239
D.bunnanda,151823105,VNKE01006132.1,1,23602,0.000155457,124554800,0.820394
D.bunnanda,151823105,VNKE01006369.1,1,23575,0.000155279,124578375,0.82055
D.bunnanda,151823105,VNKE01001223.1,1,23545,0.000155082,124601920,0.820705
D.bunnanda,151823105,VNKE01006014.1,1,23466,0.000154561,124625386,0.820859
D.bunnanda,151823105,VNKE01002761.1,1,23451,0.000154463,124648837,0.821014
D.bunnanda,151823105,VNKE01003927.1,1,23446,0.00015443,124672283,0.821168
D.bunnanda,151823105,VNKE01005318.1,1,23419,0.000154252,124695702,0.821322
D.bunnanda,151823105,VNKE01004061.1,1,23409,0.000154186,124719111,0.821476
D.bunnanda,151823105,VNKE01005966.1,1,23384,0.000154021,124742495,0.821631
D.bunnanda,151823105,VNKE01003843.1,1,23375,0.000153962,124765870,0.821784
D.bunnanda,151823105,VNKE01000026.1,1,23363,0.000153883,124789233,0.821938
D.bunnanda,151823105,VNKE01006495.1,1,23357,0.000153844,124812590,0.822092
D.bunnanda,151823105,VNKE01004462.1,1,23339,0.000153725,124835929,0.822246
D.bunnanda,151823105,VNKE01005465.1,1,23263,0.000153224,124859192,0.822399
D.bunnanda,151823105,VNKE01001238.1,1,23234,0.000153033,124882426,0.822552
D.bunnanda,151823105,VNKE01005437.1,1,23206,0.000152849,124905632,0.822705
D.bunnanda,151823105,VNKE01003930.1,1,23177,0.000152658,124928809,0.822858
D.bunnanda,151823105,VNKE01000418.1,1,23143,0.000152434,124951952,0.82301
D.bunnanda,151823105,VNKE01003072.1,1,23134,0.000152375,124975086,0.823162
D.bunnanda,151823105,VNKE01004944.1,1,23066,0.000151927,124998152,0.823314
D.bunnanda,151823105,VNKE01005998.1,1,23006,0.000151532,125021158,0.823466
D.bunnanda,151823105,VNKE01002376.1,1,22998,0.000151479,125044156,0.823617
D.bunnanda,151823105,VNKE01004606.1,1,22938,0.000151084,125067094,0.823769
D.bunnanda,151823105,VNKE01005438.1,1,22925,0.000150998,125090019,0.82392
D.bunnanda,151823105,VNKE01003119.1,1,22920,0.000150965,125112939,0.82407
D.bunnanda,151823105,VNKE01006606.1,1,22919,0.000150959,125135858,0.824221
D.bunnanda,151823105,VNKE01003226.1,1,22873,0.000150656,125158731,0.824372
D.bunnanda,151823105,VNKE01006333.1,1,22868,0.000150623,125181599,0.824523
D.bunnanda,151823105,VNKE01001888.1,1,22865,0.000150603,125204464,0.824673
D.bunnanda,151823105,VNKE01004377.1,1,22813,0.00015026,125227277,0.824824
D.bunnanda,151823105,VNKE01004596.1,1,22795,0.000150142,125250072,0.824974
D.bunnanda,151823105,VNKE01005344.1,1,22734,0.00014974,125272806,0.825123
D.bunnanda,151823105,VNKE01005305.1,1,22651,0.000149193,125295457,0.825273
D.bunnanda,151823105,VNKE01003605.1,1,22644,0.000149147,125318101,0.825422
D.bunnanda,151823105,VNKE01004113.1,1,22625,0.000149022,125340726,0.825571
D.bunnanda,151823105,VNKE01003792.1,1,22608,0.00014891,125363334,0.82572
D.bunnanda,151823105,VNKE01001713.1,1,22539,0.000148456,125385873,0.825868
D.bunnanda,151823105,VNKE01004095.1,1,22528,0.000148383,125408401,0.826017
D.bunnanda,151823105,VNKE01004216.1,1,22519,0.000148324,125430920,0.826165
D.bunnanda,151823105,VNKE01004086.1,1,22445,0.000147837,125453365,0.826313
D.bunnanda,151823105,VNKE01000477.1,1,22433,0.000147757,125475798,0.82646
D.bunnanda,151823105,VNKE01006271.1,1,22410,0.000147606,125498208,0.826608
D.bunnanda,151823105,VNKE01003405.1,1,22395,0.000147507,125520603,0.826756
D.bunnanda,151823105,VNKE01001410.1,1,22381,0.000147415,125542984,0.826903
D.bunnanda,151823105,VNKE01004776.1,1,22367,0.000147323,125565351,0.82705
D.bunnanda,151823105,VNKE01002573.1,1,22359,0.00014727,125587710,0.827198
D.bunnanda,151823105,VNKE01003031.1,1,22341,0.000147152,125610051,0.827345
D.bunnanda,151823105,VNKE01003584.1,1,22323,0.000147033,125632374,0.827492
D.bunnanda,151823105,VNKE01000479.1,1,22305,0.000146914,125654679,0.827639
D.bunnanda,151823105,VNKE01000475.1,1,22290,0.000146816,125676969,0.827786
D.bunnanda,151823105,VNKE01001694.1,1,22269,0.000146677,125699238,0.827932
D.bunnanda,151823105,VNKE01001778.1,1,22249,0.000146546,125721487,0.828079
D.bunnanda,151823105,VNKE01004337.1,1,22242,0.000146499,125743729,0.828225
D.bunnanda,151823105,VNKE01004200.1,1,22225,0.000146387,125765954,0.828372
D.bunnanda,151823105,VNKE01000453.1,1,22210,0.000146289,125788164,0.828518
D.bunnanda,151823105,VNKE01000469.1,1,22134,0.000145788,125810298,0.828664
D.bunnanda,151823105,VNKE01002453.1,1,22114,0.000145656,125832412,0.828809
D.bunnanda,151823105,VNKE01003102.1,1,22093,0.000145518,125854505,0.828955
D.bunnanda,151823105,VNKE01005937.1,1,22083,0.000145452,125876588,0.8291
D.bunnanda,151823105,VNKE01000472.1,1,22022,0.00014505,125898610,0.829245
D.bunnanda,151823105,VNKE01002820.1,1,22002,0.000144919,125920612,0.82939
D.bunnanda,151823105,VNKE01005834.1,1,21986,0.000144813,125942598,0.829535
D.bunnanda,151823105,VNKE01003626.1,1,21981,0.00014478,125964579,0.82968
D.bunnanda,151823105,VNKE01002806.1,1,21980,0.000144774,125986559,0.829825
D.bunnanda,151823105,VNKE01006475.1,1,21925,0.000144411,126008484,0.829969
D.bunnanda,151823105,VNKE01005775.1,1,21912,0.000144326,126030396,0.830113
D.bunnanda,151823105,VNKE01000765.1,1,21910,0.000144313,126052306,0.830258
D.bunnanda,151823105,VNKE01003019.1,1,21832,0.000143799,126074138,0.830402
D.bunnanda,151823105,VNKE01003607.1,1,21828,0.000143773,126095966,0.830545
D.bunnanda,151823105,VNKE01002390.1,1,21823,0.00014374,126117789,0.830689
D.bunnanda,151823105,VNKE01006068.1,1,21821,0.000143726,126139610,0.830833
D.bunnanda,151823105,VNKE01004126.1,1,21817,0.0001437,126161427,0.830976
D.bunnanda,151823105,VNKE01004098.1,1,21799,0.000143582,126183226,0.83112
D.bunnanda,151823105,VNKE01004315.1,1,21797,0.000143568,126205023,0.831264
D.bunnanda,151823105,VNKE01000727.1,1,21777,0.000143437,126226800,0.831407
D.bunnanda,151823105,VNKE01001071.1,1,21749,0.000143252,126248549,0.83155
D.bunnanda,151823105,VNKE01001332.1,1,21739,0.000143186,126270288,0.831693
D.bunnanda,151823105,VNKE01000704.1,1,21708,0.000142982,126291996,0.831836
D.bunnanda,151823105,VNKE01002614.1,1,21702,0.000142943,126313698,0.831979
D.bunnanda,151823105,VNKE01000679.1,1,21608,0.000142324,126335306,0.832122
D.bunnanda,151823105,VNKE01004132.1,1,21607,0.000142317,126356913,0.832264
D.bunnanda,151823105,VNKE01003069.1,1,21602,0.000142284,126378515,0.832406
D.bunnanda,151823105,VNKE01001615.1,1,21582,0.000142152,126400097,0.832548
D.bunnanda,151823105,VNKE01002609.1,1,21579,0.000142133,126421676,0.832691
D.bunnanda,151823105,VNKE01000184.1,1,21577,0.000142119,126443253,0.832833
D.bunnanda,151823105,VNKE01005444.1,1,21573,0.000142093,126464826,0.832975
D.bunnanda,151823105,VNKE01002605.1,1,21541,0.000141882,126486367,0.833117
D.bunnanda,151823105,VNKE01001428.1,1,21532,0.000141823,126507899,0.833259
D.bunnanda,151823105,VNKE01003408.1,1,21519,0.000141737,126529418,0.8334
D.bunnanda,151823105,VNKE01006341.1,1,21518,0.000141731,126550936,0.833542
D.bunnanda,151823105,VNKE01001214.1,1,21515,0.000141711,126572451,0.833684
D.bunnanda,151823105,VNKE01006305.1,1,21475,0.000141448,126593926,0.833825
D.bunnanda,151823105,VNKE01000737.1,1,21468,0.000141401,126615394,0.833967
D.bunnanda,151823105,VNKE01003467.1,1,21449,0.000141276,126636843,0.834108
D.bunnanda,151823105,VNKE01003537.1,1,21443,0.000141237,126658286,0.834249
D.bunnanda,151823105,VNKE01001917.1,1,21386,0.000140861,126679672,0.83439
D.bunnanda,151823105,VNKE01000164.1,1,21341,0.000140565,126701013,0.834531
D.bunnanda,151823105,VNKE01004532.1,1,21312,0.000140374,126722325,0.834671
D.bunnanda,151823105,VNKE01003075.1,1,21301,0.000140301,126743626,0.834811
D.bunnanda,151823105,VNKE01001481.1,1,21286,0.000140203,126764912,0.834951
D.bunnanda,151823105,VNKE01004130.1,1,21256,0.000140005,126786168,0.835091
D.bunnanda,151823105,VNKE01005030.1,1,21241,0.000139906,126807409,0.835231
D.bunnanda,151823105,VNKE01005313.1,1,21238,0.000139886,126828647,0.835371
D.bunnanda,151823105,VNKE01003052.1,1,21179,0.000139498,126849826,0.835511
D.bunnanda,151823105,VNKE01000677.1,1,21169,0.000139432,126870995,0.83565
D.bunnanda,151823105,VNKE01004352.1,1,21156,0.000139346,126892151,0.835789
D.bunnanda,151823105,VNKE01004062.1,1,21137,0.000139221,126913288,0.835929
D.bunnanda,151823105,VNKE01004366.1,1,21117,0.00013909,126934405,0.836068
D.bunnanda,151823105,VNKE01005379.1,1,21108,0.00013903,126955513,0.836207
D.bunnanda,151823105,VNKE01001728.1,1,21068,0.000138767,126976581,0.836346
D.bunnanda,151823105,VNKE01001116.1,1,21017,0.000138431,126997598,0.836484
D.bunnanda,151823105,VNKE01005405.1,1,20982,0.0001382,127018580,0.836622
D.bunnanda,151823105,VNKE01003660.1,1,20979,0.000138181,127039559,0.83676
D.bunnanda,151823105,VNKE01002713.1,1,20941,0.00013793,127060500,0.836898
D.bunnanda,151823105,VNKE01000989.1,1,20845,0.000137298,127081345,0.837036
D.bunnanda,151823105,VNKE01000409.1,1,20821,0.00013714,127102166,0.837173
D.bunnanda,151823105,VNKE01003175.1,1,20810,0.000137067,127122976,0.83731
D.bunnanda,151823105,VNKE01001945.1,1,20806,0.000137041,127143782,0.837447
D.bunnanda,151823105,VNKE01001607.1,1,20799,0.000136995,127164581,0.837584
D.bunnanda,151823105,VNKE01003262.1,1,20761,0.000136745,127185342,0.837721
D.bunnanda,151823105,VNKE01005296.1,1,20730,0.00013654,127206072,0.837857
D.bunnanda,151823105,VNKE01002826.1,1,20722,0.000136488,127226794,0.837994
D.bunnanda,151823105,VNKE01005748.1,1,20692,0.00013629,127247486,0.83813
D.bunnanda,151823105,VNKE01002898.1,1,20692,0.00013629,127268178,0.838266
D.bunnanda,151823105,VNKE01001123.1,1,20689,0.00013627,127288867,0.838402
D.bunnanda,151823105,VNKE01001146.1,1,20685,0.000136244,127309552,0.838539
D.bunnanda,151823105,VNKE01003065.1,1,20662,0.000136093,127330214,0.838675
D.bunnanda,151823105,VNKE01001884.1,1,20642,0.000135961,127350856,0.838811
D.bunnanda,151823105,VNKE01000870.1,1,20611,0.000135757,127371467,0.838947
D.bunnanda,151823105,VNKE01006449.1,1,20583,0.000135572,127392050,0.839082
D.bunnanda,151823105,VNKE01006602.1,1,20579,0.000135546,127412629,0.839218
D.bunnanda,151823105,VNKE01004813.1,1,20565,0.000135454,127433194,0.839353
D.bunnanda,151823105,VNKE01003785.1,1,20565,0.000135454,127453759,0.839489
D.bunnanda,151823105,VNKE01000420.1,1,20551,0.000135361,127474310,0.839624
D.bunnanda,151823105,VNKE01006452.1,1,20549,0.000135348,127494859,0.839759
D.bunnanda,151823105,VNKE01001776.1,1,20532,0.000135236,127515391,0.839895
D.bunnanda,151823105,VNKE01006468.1,1,20495,0.000134993,127535886,0.840029
D.bunnanda,151823105,VNKE01006303.1,1,20495,0.000134993,127556381,0.840164
D.bunnanda,151823105,VNKE01000994.1,1,20489,0.000134953,127576870,0.840299
D.bunnanda,151823105,VNKE01003522.1,1,20441,0.000134637,127597311,0.840434
D.bunnanda,151823105,VNKE01003355.1,1,20441,0.000134637,127617752,0.840569
D.bunnanda,151823105,VNKE01004364.1,1,20323,0.00013386,127638075,0.840703
D.bunnanda,151823105,VNKE01001390.1,1,20320,0.00013384,127658395,0.840836
D.bunnanda,151823105,VNKE01005913.1,1,20304,0.000133735,127678699,0.84097
D.bunnanda,151823105,VNKE01001950.1,1,20285,0.000133609,127698984,0.841104
D.bunnanda,151823105,VNKE01003667.1,1,20258,0.000133432,127719242,0.841237
D.bunnanda,151823105,VNKE01003695.1,1,20252,0.000133392,127739494,0.841371
D.bunnanda,151823105,VNKE01003592.1,1,20229,0.000133241,127759723,0.841504
D.bunnanda,151823105,VNKE01004959.1,1,20225,0.000133214,127779948,0.841637
D.bunnanda,151823105,VNKE01001122.1,1,20223,0.000133201,127800171,0.84177
D.bunnanda,151823105,VNKE01002809.1,1,20212,0.000133129,127820383,0.841903
D.bunnanda,151823105,VNKE01004757.1,1,20208,0.000133102,127840591,0.842036
D.bunnanda,151823105,VNKE01002607.1,1,20172,0.000132865,127860763,0.842169
D.bunnanda,151823105,VNKE01004345.1,1,20163,0.000132806,127880926,0.842302
D.bunnanda,151823105,VNKE01002088.1,1,20154,0.000132747,127901080,0.842435
D.bunnanda,151823105,VNKE01003352.1,1,20128,0.000132575,127921208,0.842567
D.bunnanda,151823105,VNKE01000709.1,1,20109,0.00013245,127941317,0.8427
D.bunnanda,151823105,VNKE01000188.1,1,20102,0.000132404,127961419,0.842832
D.bunnanda,151823105,VNKE01002458.1,1,20054,0.000132088,127981473,0.842964
D.bunnanda,151823105,VNKE01003266.1,1,20048,0.000132048,128001521,0.843096
D.bunnanda,151823105,VNKE01002691.1,1,20048,0.000132048,128021569,0.843228
D.bunnanda,151823105,VNKE01002150.1,1,19999,0.000131726,128041568,0.84336
D.bunnanda,151823105,VNKE01003282.1,1,19919,0.000131199,128061487,0.843491
D.bunnanda,151823105,VNKE01005835.1,1,19907,0.00013112,128081394,0.843623
D.bunnanda,151823105,VNKE01003836.1,1,19900,0.000131074,128101294,0.843754
D.bunnanda,151823105,VNKE01004089.1,1,19894,0.000131034,128121188,0.843885
D.bunnanda,151823105,VNKE01003628.1,1,19889,0.000131001,128141077,0.844016
D.bunnanda,151823105,VNKE01001596.1,1,19872,0.000130889,128160949,0.844147
D.bunnanda,151823105,VNKE01005710.1,1,19839,0.000130672,128180788,0.844277
D.bunnanda,151823105,VNKE01001016.1,1,19839,0.000130672,128200627,0.844408
D.bunnanda,151823105,VNKE01003884.1,1,19820,0.000130547,128220447,0.844538
D.bunnanda,151823105,VNKE01002957.1,1,19811,0.000130487,128240258,0.844669
D.bunnanda,151823105,VNKE01004160.1,1,19779,0.000130277,128260037,0.844799
D.bunnanda,151823105,VNKE01006077.1,1,19712,0.000129835,128279749,0.844929
D.bunnanda,151823105,VNKE01003451.1,1,19690,0.00012969,128299439,0.845059
D.bunnanda,151823105,VNKE01003455.1,1,19677,0.000129605,128319116,0.845188
D.bunnanda,151823105,VNKE01004739.1,1,19675,0.000129592,128338791,0.845318
D.bunnanda,151823105,VNKE01000471.1,1,19674,0.000129585,128358465,0.845448
D.bunnanda,151823105,VNKE01001953.1,1,19636,0.000129335,128378101,0.845577
D.bunnanda,151823105,VNKE01000992.1,1,19604,0.000129124,128397705,0.845706
D.bunnanda,151823105,VNKE01000926.1,1,19506,0.000128478,128417211,0.845834
D.bunnanda,151823105,VNKE01005349.1,1,19487,0.000128353,128436698,0.845963
D.bunnanda,151823105,VNKE01000939.1,1,19472,0.000128255,128456170,0.846091
D.bunnanda,151823105,VNKE01005251.1,1,19457,0.000128156,128475627,0.846219
D.bunnanda,151823105,VNKE01003281.1,1,19426,0.000127952,128495053,0.846347
D.bunnanda,151823105,VNKE01006124.1,1,19385,0.000127681,128514438,0.846475
D.bunnanda,151823105,VNKE01000413.1,1,19374,0.000127609,128533812,0.846602
D.bunnanda,151823105,VNKE01003784.1,1,19368,0.00012757,128553180,0.84673
D.bunnanda,151823105,VNKE01004875.1,1,19356,0.00012749,128572536,0.846858
D.bunnanda,151823105,VNKE01001873.1,1,19341,0.000127392,128591877,0.846985
D.bunnanda,151823105,VNKE01000966.1,1,19338,0.000127372,128611215,0.847112
D.bunnanda,151823105,VNKE01006360.1,1,19331,0.000127326,128630546,0.84724
D.bunnanda,151823105,VNKE01002466.1,1,19319,0.000127247,128649865,0.847367
D.bunnanda,151823105,VNKE01002885.1,1,19294,0.000127082,128669159,0.847494
D.bunnanda,151823105,VNKE01004004.1,1,19259,0.000126852,128688418,0.847621
D.bunnanda,151823105,VNKE01006170.1,1,19251,0.000126799,128707669,0.847748
D.bunnanda,151823105,VNKE01000658.1,1,19245,0.000126759,128726914,0.847874
D.bunnanda,151823105,VNKE01005442.1,1,19219,0.000126588,128746133,0.848001
D.bunnanda,151823105,VNKE01004360.1,1,19175,0.000126298,128765308,0.848127
D.bunnanda,151823105,VNKE01004145.1,1,19141,0.000126074,128784449,0.848253
D.bunnanda,151823105,VNKE01003839.1,1,19127,0.000125982,128803576,0.848379
D.bunnanda,151823105,VNKE01000953.1,1,19102,0.000125817,128822678,0.848505
D.bunnanda,151823105,VNKE01006406.1,1,19076,0.000125646,128841754,0.848631
D.bunnanda,151823105,VNKE01005653.1,1,19075,0.00012564,128860829,0.848756
D.bunnanda,151823105,VNKE01006599.1,1,19060,0.000125541,128879889,0.848882
D.bunnanda,151823105,VNKE01004000.1,1,19055,0.000125508,128898944,0.849007
D.bunnanda,151823105,VNKE01004638.1,1,19048,0.000125462,128917992,0.849133
D.bunnanda,151823105,VNKE01005443.1,1,19045,0.000125442,128937037,0.849258
D.bunnanda,151823105,VNKE01003805.1,1,18997,0.000125126,128956034,0.849383
D.bunnanda,151823105,VNKE01006296.1,1,18991,0.000125086,128975025,0.849509
D.bunnanda,151823105,VNKE01000959.1,1,18970,0.000124948,128993995,0.849633
D.bunnanda,151823105,VNKE01001234.1,1,18927,0.000124665,129012922,0.849758
D.bunnanda,151823105,VNKE01000931.1,1,18898,0.000124474,129031820,0.849883
D.bunnanda,151823105,VNKE01005693.1,1,18850,0.000124158,129050670,0.850007
D.bunnanda,151823105,VNKE01005811.1,1,18841,0.000124098,129069511,0.850131
D.bunnanda,151823105,VNKE01004948.1,1,18830,0.000124026,129088341,0.850255
D.bunnanda,151823105,VNKE01002887.1,1,18828,0.000124013,129107169,0.850379
D.bunnanda,151823105,VNKE01004367.1,1,18825,0.000123993,129125994,0.850503
D.bunnanda,151823105,VNKE01003340.1,1,18778,0.000123683,129144772,0.850627
D.bunnanda,151823105,VNKE01005371.1,1,18753,0.000123519,129163525,0.85075
D.bunnanda,151823105,VNKE01000335.1,1,18744,0.000123459,129182269,0.850874
D.bunnanda,151823105,VNKE01003155.1,1,18733,0.000123387,129201002,0.850997
D.bunnanda,151823105,VNKE01003673.1,1,18688,0.000123091,129219690,0.85112
D.bunnanda,151823105,VNKE01001534.1,1,18683,0.000123058,129238373,0.851243
D.bunnanda,151823105,VNKE01005806.1,1,18663,0.000122926,129257036,0.851366
D.bunnanda,151823105,VNKE01004288.1,1,18623,0.000122662,129275659,0.851489
D.bunnanda,151823105,VNKE01005498.1,1,18622,0.000122656,129294281,0.851611
D.bunnanda,151823105,VNKE01002664.1,1,18585,0.000122412,129312866,0.851734
D.bunnanda,151823105,VNKE01004142.1,1,18583,0.000122399,129331449,0.851856
D.bunnanda,151823105,VNKE01004047.1,1,18574,0.00012234,129350023,0.851979
D.bunnanda,151823105,VNKE01002149.1,1,18567,0.000122294,129368590,0.852101
D.bunnanda,151823105,VNKE01006275.1,1,18561,0.000122254,129387151,0.852223
D.bunnanda,151823105,VNKE01005504.1,1,18545,0.000122149,129405696,0.852345
D.bunnanda,151823105,VNKE01005507.1,1,18514,0.000121945,129424210,0.852467
D.bunnanda,151823105,VNKE01002012.1,1,18489,0.00012178,129442699,0.852589
D.bunnanda,151823105,VNKE01001653.1,1,18465,0.000121622,129461164,0.852711
D.bunnanda,151823105,VNKE01000647.1,1,18459,0.000121582,129479623,0.852832
D.bunnanda,151823105,VNKE01004354.1,1,18449,0.000121516,129498072,0.852954
D.bunnanda,151823105,VNKE01004436.1,1,18432,0.000121404,129516504,0.853075
D.bunnanda,151823105,VNKE01002859.1,1,18419,0.000121319,129534923,0.853196
D.bunnanda,151823105,VNKE01003032.1,1,18399,0.000121187,129553322,0.853318
D.bunnanda,151823105,VNKE01000986.1,1,18389,0.000121121,129571711,0.853439
D.bunnanda,151823105,VNKE01004939.1,1,18383,0.000121082,129590094,0.85356
D.bunnanda,151823105,VNKE01000310.1,1,18362,0.000120943,129608456,0.853681
D.bunnanda,151823105,VNKE01003409.1,1,18359,0.000120924,129626815,0.853802
D.bunnanda,151823105,VNKE01006115.1,1,18330,0.000120733,129645145,0.853922
D.bunnanda,151823105,VNKE01001182.1,1,18291,0.000120476,129663436,0.854043
D.bunnanda,151823105,VNKE01003350.1,1,18282,0.000120416,129681718,0.854163
D.bunnanda,151823105,VNKE01005917.1,1,18215,0.000119975,129699933,0.854283
D.bunnanda,151823105,VNKE01004942.1,1,18189,0.000119804,129718122,0.854403
D.bunnanda,151823105,VNKE01001999.1,1,18188,0.000119797,129736310,0.854523
D.bunnanda,151823105,VNKE01001142.1,1,18170,0.000119679,129754480,0.854643
D.bunnanda,151823105,VNKE01006118.1,1,18163,0.000119633,129772643,0.854762
D.bunnanda,151823105,VNKE01006600.1,1,18146,0.000119521,129790789,0.854882
D.bunnanda,151823105,VNKE01003809.1,1,18134,0.000119442,129808923,0.855001
D.bunnanda,151823105,VNKE01005314.1,1,18132,0.000119428,129827055,0.855121
D.bunnanda,151823105,VNKE01000934.1,1,18107,0.000119264,129845162,0.85524
D.bunnanda,151823105,VNKE01003267.1,1,18089,0.000119145,129863251,0.855359
D.bunnanda,151823105,VNKE01000881.1,1,18088,0.000119139,129881339,0.855478
D.bunnanda,151823105,VNKE01000799.1,1,18062,0.000118967,129899401,0.855597
D.bunnanda,151823105,VNKE01002183.1,1,18043,0.000118842,129917444,0.855716
D.bunnanda,151823105,VNKE01001375.1,1,18041,0.000118829,129935485,0.855835
D.bunnanda,151823105,VNKE01000473.1,1,18034,0.000118783,129953519,0.855954
D.bunnanda,151823105,VNKE01002862.1,1,17999,0.000118552,129971518,0.856072
D.bunnanda,151823105,VNKE01000415.1,1,17969,0.000118355,129989487,0.85619
D.bunnanda,151823105,VNKE01003620.1,1,17961,0.000118302,130007448,0.856309
D.bunnanda,151823105,VNKE01002599.1,1,17936,0.000118137,130025384,0.856427
D.bunnanda,151823105,VNKE01000990.1,1,17924,0.000118058,130043308,0.856545
D.bunnanda,151823105,VNKE01000247.1,1,17919,0.000118026,130061227,0.856663
D.bunnanda,151823105,VNKE01000689.1,1,17918,0.000118019,130079145,0.856781
D.bunnanda,151823105,VNKE01004432.1,1,17892,0.000117848,130097037,0.856899
D.bunnanda,151823105,VNKE01006199.1,1,17878,0.000117755,130114915,0.857017
D.bunnanda,151823105,VNKE01001968.1,1,17848,0.000117558,130132763,0.857134
D.bunnanda,151823105,VNKE01002209.1,1,17839,0.000117499,130150602,0.857252
D.bunnanda,151823105,VNKE01000849.1,1,17816,0.000117347,130168418,0.857369
D.bunnanda,151823105,VNKE01001707.1,1,17767,0.000117024,130186185,0.857486
D.bunnanda,151823105,VNKE01002027.1,1,17765,0.000117011,130203950,0.857603
D.bunnanda,151823105,VNKE01005116.1,1,17763,0.000116998,130221713,0.85772
D.bunnanda,151823105,VNKE01005008.1,1,17758,0.000116965,130239471,0.857837
D.bunnanda,151823105,VNKE01003097.1,1,17758,0.000116965,130257229,0.857954
D.bunnanda,151823105,VNKE01000439.1,1,17741,0.000116853,130274970,0.858071
D.bunnanda,151823105,VNKE01002487.1,1,17730,0.000116781,130292700,0.858188
D.bunnanda,151823105,VNKE01004940.1,1,17711,0.000116655,130310411,0.858304
D.bunnanda,151823105,VNKE01004022.1,1,17711,0.000116655,130328122,0.858421
D.bunnanda,151823105,VNKE01000146.1,1,17690,0.000116517,130345812,0.858537
D.bunnanda,151823105,VNKE01006187.1,1,17674,0.000116412,130363486,0.858654
D.bunnanda,151823105,VNKE01001735.1,1,17646,0.000116227,130381132,0.85877
D.bunnanda,151823105,VNKE01000708.1,1,17639,0.000116181,130398771,0.858886
D.bunnanda,151823105,VNKE01001090.1,1,17634,0.000116148,130416405,0.859002
D.bunnanda,151823105,VNKE01000402.1,1,17632,0.000116135,130434037,0.859118
D.bunnanda,151823105,VNKE01003320.1,1,17611,0.000115997,130451648,0.859234
D.bunnanda,151823105,VNKE01001115.1,1,17605,0.000115957,130469253,0.85935
D.bunnanda,151823105,VNKE01002811.1,1,17568,0.000115714,130486821,0.859466
D.bunnanda,151823105,VNKE01004088.1,1,17560,0.000115661,130504381,0.859582
D.bunnanda,151823105,VNKE01004984.1,1,17554,0.000115621,130521935,0.859697
D.bunnanda,151823105,VNKE01005244.1,1,17542,0.000115542,130539477,0.859813
D.bunnanda,151823105,VNKE01003623.1,1,17509,0.000115325,130556986,0.859928
D.bunnanda,151823105,VNKE01003791.1,1,17473,0.000115088,130574459,0.860043
D.bunnanda,151823105,VNKE01000929.1,1,17470,0.000115068,130591929,0.860158
D.bunnanda,151823105,VNKE01003123.1,1,17465,0.000115035,130609394,0.860274
D.bunnanda,151823105,VNKE01004785.1,1,17440,0.000114871,130626834,0.860388
D.bunnanda,151823105,VNKE01003585.1,1,17436,0.000114844,130644270,0.860503
D.bunnanda,151823105,VNKE01006560.1,1,17395,0.000114574,130661665,0.860618
D.bunnanda,151823105,VNKE01004094.1,1,17381,0.000114482,130679046,0.860732
D.bunnanda,151823105,VNKE01004878.1,1,17367,0.00011439,130696413,0.860847
D.bunnanda,151823105,VNKE01002623.1,1,17366,0.000114383,130713779,0.860961
D.bunnanda,151823105,VNKE01005001.1,1,17327,0.000114126,130731106,0.861075
D.bunnanda,151823105,VNKE01004207.1,1,17324,0.000114106,130748430,0.861189
D.bunnanda,151823105,VNKE01002271.1,1,17308,0.000114001,130765738,0.861303
D.bunnanda,151823105,VNKE01005140.1,1,17303,0.000113968,130783041,0.861417
D.bunnanda,151823105,VNKE01004164.1,1,17296,0.000113922,130800337,0.861531
D.bunnanda,151823105,VNKE01000586.1,1,17292,0.000113896,130817629,0.861645
D.bunnanda,151823105,VNKE01004570.1,1,17264,0.000113711,130834893,0.861759
D.bunnanda,151823105,VNKE01005688.1,1,17216,0.000113395,130852109,0.861872
D.bunnanda,151823105,VNKE01000696.1,1,17166,0.000113066,130869275,0.861985
D.bunnanda,151823105,VNKE01005365.1,1,17158,0.000113013,130886433,0.862098
D.bunnanda,151823105,VNKE01005914.1,1,17105,0.000112664,130903538,0.862211
D.bunnanda,151823105,VNKE01002254.1,1,17099,0.000112624,130920637,0.862324
D.bunnanda,151823105,VNKE01000690.1,1,17077,0.00011248,130937714,0.862436
D.bunnanda,151823105,VNKE01000829.1,1,17058,0.000112354,130954772,0.862548
D.bunnanda,151823105,VNKE01000643.1,1,17055,0.000112335,130971827,0.862661
D.bunnanda,151823105,VNKE01005583.1,1,17052,0.000112315,130988879,0.862773
D.bunnanda,151823105,VNKE01005916.1,1,17025,0.000112137,131005904,0.862885
D.bunnanda,151823105,VNKE01000484.1,1,17025,0.000112137,131022929,0.862997
D.bunnanda,151823105,VNKE01000252.1,1,17024,0.00011213,131039953,0.863109
D.bunnanda,151823105,VNKE01004524.1,1,17006,0.000112012,131056959,0.863221
D.bunnanda,151823105,VNKE01001165.1,1,17001,0.000111979,131073960,0.863333
D.bunnanda,151823105,VNKE01005616.1,1,16995,0.000111939,131090955,0.863445
D.bunnanda,151823105,VNKE01005040.1,1,16968,0.000111762,131107923,0.863557
D.bunnanda,151823105,VNKE01001270.1,1,16948,0.00011163,131124871,0.863669
D.bunnanda,151823105,VNKE01005760.1,1,16930,0.000111511,131141801,0.86378
D.bunnanda,151823105,VNKE01006131.1,1,16899,0.000111307,131158700,0.863892
D.bunnanda,151823105,VNKE01005327.1,1,16899,0.000111307,131175599,0.864003
D.bunnanda,151823105,VNKE01001320.1,1,16890,0.000111248,131192489,0.864114
D.bunnanda,151823105,VNKE01006133.1,1,16871,0.000111123,131209360,0.864225
D.bunnanda,151823105,VNKE01005607.1,1,16870,0.000111116,131226230,0.864336
D.bunnanda,151823105,VNKE01002455.1,1,16866,0.00011109,131243096,0.864447
D.bunnanda,151823105,VNKE01004530.1,1,16865,0.000111083,131259961,0.864559
D.bunnanda,151823105,VNKE01002436.1,1,16860,0.00011105,131276821,0.86467
D.bunnanda,151823105,VNKE01005411.1,1,16850,0.000110984,131293671,0.864781
D.bunnanda,151823105,VNKE01006041.1,1,16843,0.000110938,131310514,0.864892
D.bunnanda,151823105,VNKE01005133.1,1,16836,0.000110892,131327350,0.865002
D.bunnanda,151823105,VNKE01005389.1,1,16828,0.00011084,131344178,0.865113
D.bunnanda,151823105,VNKE01006459.1,1,16827,0.000110833,131361005,0.865224
D.bunnanda,151823105,VNKE01000214.1,1,16827,0.000110833,131377832,0.865335
D.bunnanda,151823105,VNKE01000988.1,1,16822,0.0001108,131394654,0.865446
D.bunnanda,151823105,VNKE01005439.1,1,16816,0.00011076,131411470,0.865556
D.bunnanda,151823105,VNKE01003682.1,1,16811,0.000110728,131428281,0.865667
D.bunnanda,151823105,VNKE01005476.1,1,16805,0.000110688,131445086,0.865778
D.bunnanda,151823105,VNKE01000809.1,1,16767,0.000110438,131461853,0.865888
D.bunnanda,151823105,VNKE01004678.1,1,16762,0.000110405,131478615,0.865999
D.bunnanda,151823105,VNKE01004301.1,1,16686,0.000109904,131495301,0.866109
D.bunnanda,151823105,VNKE01004804.1,1,16682,0.000109878,131511983,0.866219
D.bunnanda,151823105,VNKE01000692.1,1,16663,0.000109753,131528646,0.866328
D.bunnanda,151823105,VNKE01002137.1,1,16647,0.000109647,131545293,0.866438
D.bunnanda,151823105,VNKE01000909.1,1,16616,0.000109443,131561909,0.866547
D.bunnanda,151823105,VNKE01005751.1,1,16608,0.00010939,131578517,0.866657
D.bunnanda,151823105,VNKE01005530.1,1,16606,0.000109377,131595123,0.866766
D.bunnanda,151823105,VNKE01005701.1,1,16578,0.000109193,131611701,0.866875
D.bunnanda,151823105,VNKE01004381.1,1,16575,0.000109173,131628276,0.866984
D.bunnanda,151823105,VNKE01001342.1,1,16573,0.00010916,131644849,0.867094
D.bunnanda,151823105,VNKE01003893.1,1,16564,0.000109101,131661413,0.867203
D.bunnanda,151823105,VNKE01005042.1,1,16543,0.000108962,131677956,0.867312
D.bunnanda,151823105,VNKE01001370.1,1,16519,0.000108804,131694475,0.867421
D.bunnanda,151823105,VNKE01001954.1,1,16503,0.000108699,131710978,0.867529
D.bunnanda,151823105,VNKE01000506.1,1,16496,0.000108653,131727474,0.867638
D.bunnanda,151823105,VNKE01001934.1,1,16486,0.000108587,131743960,0.867746
D.bunnanda,151823105,VNKE01004569.1,1,16419,0.000108146,131760379,0.867855
D.bunnanda,151823105,VNKE01000642.1,1,16418,0.000108139,131776797,0.867963
D.bunnanda,151823105,VNKE01005312.1,1,16402,0.000108034,131793199,0.868071
D.bunnanda,151823105,VNKE01003745.1,1,16395,0.000107988,131809594,0.868179
D.bunnanda,151823105,VNKE01006128.1,1,16379,0.000107882,131825973,0.868287
D.bunnanda,151823105,VNKE01005044.1,1,16378,0.000107876,131842351,0.868395
D.bunnanda,151823105,VNKE01003808.1,1,16371,0.000107829,131858722,0.868502
D.bunnanda,151823105,VNKE01002778.1,1,16358,0.000107744,131875080,0.86861
D.bunnanda,151823105,VNKE01001559.1,1,16306,0.000107401,131891386,0.868717
D.bunnanda,151823105,VNKE01004936.1,1,16287,0.000107276,131907673,0.868825
D.bunnanda,151823105,VNKE01000388.1,1,16275,0.000107197,131923948,0.868932
D.bunnanda,151823105,VNKE01001392.1,1,16273,0.000107184,131940221,0.869039
D.bunnanda,151823105,VNKE01000943.1,1,16270,0.000107164,131956491,0.869146
D.bunnanda,151823105,VNKE01006548.1,1,16262,0.000107111,131972753,0.869253
D.bunnanda,151823105,VNKE01004489.1,1,16260,0.000107098,131989013,0.869361
D.bunnanda,151823105,VNKE01005440.1,1,16220,0.000106835,132005233,0.869467
D.bunnanda,151823105,VNKE01004115.1,1,16202,0.000106716,132021435,0.869574
D.bunnanda,151823105,VNKE01001799.1,1,16179,0.000106565,132037614,0.869681
D.bunnanda,151823105,VNKE01000215.1,1,16119,0.00010617,132053733,0.869787
D.bunnanda,151823105,VNKE01004437.1,1,16082,0.000105926,132069815,0.869893
D.bunnanda,151823105,VNKE01005663.1,1,16079,0.000105906,132085894,0.869999
D.bunnanda,151823105,VNKE01004280.1,1,16059,0.000105774,132101953,0.870104
D.bunnanda,151823105,VNKE01006588.1,1,16042,0.000105662,132117995,0.87021
D.bunnanda,151823105,VNKE01006473.1,1,16035,0.000105616,132134030,0.870316
D.bunnanda,151823105,VNKE01001595.1,1,16011,0.000105458,132150041,0.870421
D.bunnanda,151823105,VNKE01002846.1,1,16003,0.000105406,132166044,0.870527
D.bunnanda,151823105,VNKE01003064.1,1,15934,0.000104951,132181978,0.870632
D.bunnanda,151823105,VNKE01002692.1,1,15917,0.000104839,132197895,0.870736
D.bunnanda,151823105,VNKE01002805.1,1,15892,0.000104674,132213787,0.870841
D.bunnanda,151823105,VNKE01001467.1,1,15881,0.000104602,132229668,0.870946
D.bunnanda,151823105,VNKE01000848.1,1,15861,0.00010447,132245529,0.87105
D.bunnanda,151823105,VNKE01002804.1,1,15807,0.000104115,132261336,0.871154
D.bunnanda,151823105,VNKE01006216.1,1,15785,0.00010397,132277121,0.871258
D.bunnanda,151823105,VNKE01003928.1,1,15764,0.000103831,132292885,0.871362
D.bunnanda,151823105,VNKE01005762.1,1,15725,0.000103574,132308610,0.871466
D.bunnanda,151823105,VNKE01002617.1,1,15720,0.000103542,132324330,0.871569
D.bunnanda,151823105,VNKE01001231.1,1,15719,0.000103535,132340049,0.871673
D.bunnanda,151823105,VNKE01000715.1,1,15708,0.000103463,132355757,0.871776
D.bunnanda,151823105,VNKE01006127.1,1,15704,0.000103436,132371461,0.87188
D.bunnanda,151823105,VNKE01003528.1,1,15690,0.000103344,132387151,0.871983
D.bunnanda,151823105,VNKE01006343.1,1,15674,0.000103239,132402825,0.872086
D.bunnanda,151823105,VNKE01003070.1,1,15641,0.000103021,132418466,0.872189
D.bunnanda,151823105,VNKE01003715.1,1,15604,0.000102778,132434070,0.872292
D.bunnanda,151823105,VNKE01002724.1,1,15597,0.000102731,132449667,0.872395
D.bunnanda,151823105,VNKE01001386.1,1,15561,0.000102494,132465228,0.872497
D.bunnanda,151823105,VNKE01000719.1,1,15560,0.000102488,132480788,0.8726
D.bunnanda,151823105,VNKE01006320.1,1,15529,0.000102284,132496317,0.872702
D.bunnanda,151823105,VNKE01002650.1,1,15496,0.000102066,132511813,0.872804
D.bunnanda,151823105,VNKE01000122.1,1,15463,0.000101849,132527276,0.872906
D.bunnanda,151823105,VNKE01005121.1,1,15420,0.000101566,132542696,0.873007
D.bunnanda,151823105,VNKE01000217.1,1,15412,0.000101513,132558108,0.873109
D.bunnanda,151823105,VNKE01006159.1,1,15362,0.000101184,132573470,0.87321
D.bunnanda,151823105,VNKE01002868.1,1,15351,0.000101111,132588821,0.873311
D.bunnanda,151823105,VNKE01000495.1,1,15335,0.000101006,132604156,0.873412
D.bunnanda,151823105,VNKE01002024.1,1,15311,0.000100848,132619467,0.873513
D.bunnanda,151823105,VNKE01000099.1,1,15306,0.000100815,132634773,0.873614
D.bunnanda,151823105,VNKE01000693.1,1,15305,0.000100808,132650078,0.873715
D.bunnanda,151823105,VNKE01001947.1,1,15295,0.000100742,132665373,0.873815
D.bunnanda,151823105,VNKE01006469.1,1,15285,0.000100676,132680658,0.873916
D.bunnanda,151823105,VNKE01002291.1,1,15283,0.000100663,132695941,0.874017
D.bunnanda,151823105,VNKE01004058.1,1,15276,0.000100617,132711217,0.874117
D.bunnanda,151823105,VNKE01000345.1,1,15248,0.000100433,132726465,0.874218
D.bunnanda,151823105,VNKE01004898.1,1,15221,0.000100255,132741686,0.874318
D.bunnanda,151823105,VNKE01003613.1,1,15185,0.000100018,132756871,0.874418
D.bunnanda,151823105,VNKE01004602.1,1,15180,9.99848e-05,132772051,0.874518
D.bunnanda,151823105,VNKE01001118.1,1,15180,9.99848e-05,132787231,0.874618
D.bunnanda,151823105,VNKE01003014.1,1,15174,9.99453e-05,132802405,0.874718
D.bunnanda,151823105,VNKE01005282.1,1,15173,9.99387e-05,132817578,0.874818
D.bunnanda,151823105,VNKE01001177.1,1,15169,9.99123e-05,132832747,0.874918
D.bunnanda,151823105,VNKE01004314.1,1,15166,9.98926e-05,132847913,0.875018
D.bunnanda,151823105,VNKE01006631.1,1,15159,9.98465e-05,132863072,0.875118
D.bunnanda,151823105,VNKE01000254.1,1,15159,9.98465e-05,132878231,0.875217
D.bunnanda,151823105,VNKE01003876.1,1,15141,9.97279e-05,132893372,0.875317
D.bunnanda,151823105,VNKE01006076.1,1,15113,9.95435e-05,132908485,0.875417
D.bunnanda,151823105,VNKE01004120.1,1,15106,9.94974e-05,132923591,0.875516
D.bunnanda,151823105,VNKE01002814.1,1,15106,9.94974e-05,132938697,0.875616
D.bunnanda,151823105,VNKE01003994.1,1,15016,9.89046e-05,132953713,0.875715
D.bunnanda,151823105,VNKE01004092.1,1,14984,9.86938e-05,132968697,0.875813
D.bunnanda,151823105,VNKE01006563.1,1,14933,9.83579e-05,132983630,0.875912
D.bunnanda,151823105,VNKE01005520.1,1,14928,9.8325e-05,132998558,0.87601
D.bunnanda,151823105,VNKE01004702.1,1,14927,9.83184e-05,133013485,0.876108
D.bunnanda,151823105,VNKE01003477.1,1,14891,9.80813e-05,133028376,0.876206
D.bunnanda,151823105,VNKE01002823.1,1,14867,9.79232e-05,133043243,0.876304
D.bunnanda,151823105,VNKE01000987.1,1,14860,9.78771e-05,133058103,0.876402
D.bunnanda,151823105,VNKE01005714.1,1,14819,9.7607e-05,133072922,0.8765
D.bunnanda,151823105,VNKE01000434.1,1,14802,9.7495e-05,133087724,0.876597
D.bunnanda,151823105,VNKE01001987.1,1,14798,9.74687e-05,133102522,0.876695
D.bunnanda,151823105,VNKE01001173.1,1,14788,9.74028e-05,133117310,0.876792
D.bunnanda,151823105,VNKE01006264.1,1,14771,9.72909e-05,133132081,0.876889
D.bunnanda,151823105,VNKE01000020.1,1,14757,9.71986e-05,133146838,0.876987
D.bunnanda,151823105,VNKE01002199.1,1,14736,9.70603e-05,133161574,0.877084
D.bunnanda,151823105,VNKE01001172.1,1,14703,9.6843e-05,133176277,0.877181
D.bunnanda,151823105,VNKE01004771.1,1,14696,9.67969e-05,133190973,0.877277
D.bunnanda,151823105,VNKE01002385.1,1,14689,9.67508e-05,133205662,0.877374
D.bunnanda,151823105,VNKE01001650.1,1,14683,9.67112e-05,133220345,0.877471
D.bunnanda,151823105,VNKE01004015.1,1,14679,9.66849e-05,133235024,0.877568
D.bunnanda,151823105,VNKE01000638.1,1,14678,9.66783e-05,133249702,0.877664
D.bunnanda,151823105,VNKE01004378.1,1,14676,9.66651e-05,133264378,0.877761
D.bunnanda,151823105,VNKE01002775.1,1,14652,9.65071e-05,133279030,0.877857
D.bunnanda,151823105,VNKE01005005.1,1,14649,9.64873e-05,133293679,0.877954
D.bunnanda,151823105,VNKE01004239.1,1,14642,9.64412e-05,133308321,0.87805
D.bunnanda,151823105,VNKE01001965.1,1,14632,9.63753e-05,133322953,0.878147
D.bunnanda,151823105,VNKE01002774.1,1,14621,9.63029e-05,133337574,0.878243
D.bunnanda,151823105,VNKE01005824.1,1,14583,9.60526e-05,133352157,0.878339
D.bunnanda,151823105,VNKE01003066.1,1,14578,9.60196e-05,133366735,0.878435
D.bunnanda,151823105,VNKE01001742.1,1,14550,9.58352e-05,133381285,0.878531
D.bunnanda,151823105,VNKE01003323.1,1,14517,9.56179e-05,133395802,0.878626
D.bunnanda,151823105,VNKE01002360.1,1,14512,9.55849e-05,133410314,0.878722
D.bunnanda,151823105,VNKE01003629.1,1,14498,9.54927e-05,133424812,0.878818
D.bunnanda,151823105,VNKE01005403.1,1,14489,9.54334e-05,133439301,0.878913
D.bunnanda,151823105,VNKE01004714.1,1,14489,9.54334e-05,133453790,0.879008
D.bunnanda,151823105,VNKE01005611.1,1,14482,9.53873e-05,133468272,0.879104
D.bunnanda,151823105,VNKE01004133.1,1,14446,9.51502e-05,133482718,0.879199
D.bunnanda,151823105,VNKE01003285.1,1,14435,9.50778e-05,133497153,0.879294
D.bunnanda,151823105,VNKE01005869.1,1,14429,9.50382e-05,133511582,0.879389
D.bunnanda,151823105,VNKE01005765.1,1,14397,9.48275e-05,133525979,0.879484
D.bunnanda,151823105,VNKE01001243.1,1,14389,9.47748e-05,133540368,0.879579
D.bunnanda,151823105,VNKE01005083.1,1,14362,9.45969e-05,133554730,0.879673
D.bunnanda,151823105,VNKE01003627.1,1,14359,9.45772e-05,133569089,0.879768
D.bunnanda,151823105,VNKE01001546.1,1,14359,9.45772e-05,133583448,0.879862
D.bunnanda,151823105,VNKE01005619.1,1,14343,9.44718e-05,133597791,0.879957
D.bunnanda,151823105,VNKE01005119.1,1,14342,9.44652e-05,133612133,0.880051
D.bunnanda,151823105,VNKE01004586.1,1,14342,9.44652e-05,133626475,0.880146
D.bunnanda,151823105,VNKE01004341.1,1,14342,9.44652e-05,133640817,0.88024
D.bunnanda,151823105,VNKE01001501.1,1,14296,9.41622e-05,133655113,0.880334
D.bunnanda,151823105,VNKE01005694.1,1,14292,9.41359e-05,133669405,0.880429
D.bunnanda,151823105,VNKE01000123.1,1,14289,9.41161e-05,133683694,0.880523
D.bunnanda,151823105,VNKE01003920.1,1,14284,9.40832e-05,133697978,0.880617
D.bunnanda,151823105,VNKE01005066.1,1,14280,9.40568e-05,133712258,0.880711
D.bunnanda,151823105,VNKE01005148.1,1,14257,9.39053e-05,133726515,0.880805
D.bunnanda,151823105,VNKE01004453.1,1,14239,9.37868e-05,133740754,0.880899
D.bunnanda,151823105,VNKE01006598.1,1,14235,9.37604e-05,133754989,0.880992
D.bunnanda,151823105,VNKE01000984.1,1,14228,9.37143e-05,133769217,0.881086
D.bunnanda,151823105,VNKE01003969.1,1,14210,9.35958e-05,133783427,0.88118
D.bunnanda,151823105,VNKE01002813.1,1,14193,9.34838e-05,133797620,0.881273
D.bunnanda,151823105,VNKE01003180.1,1,14192,9.34772e-05,133811812,0.881367
D.bunnanda,151823105,VNKE01004424.1,1,14189,9.34574e-05,133826001,0.88146
D.bunnanda,151823105,VNKE01001690.1,1,14187,9.34443e-05,133840188,0.881553
D.bunnanda,151823105,VNKE01002946.1,1,14165,9.32994e-05,133854353,0.881647
D.bunnanda,151823105,VNKE01006051.1,1,14164,9.32928e-05,133868517,0.88174
D.bunnanda,151823105,VNKE01002375.1,1,14160,9.32664e-05,133882677,0.881833
D.bunnanda,151823105,VNKE01004794.1,1,14138,9.31215e-05,133896815,0.881926
D.bunnanda,151823105,VNKE01005385.1,1,14137,9.31149e-05,133910952,0.88202
D.bunnanda,151823105,VNKE01004937.1,1,14137,9.31149e-05,133925089,0.882113
D.bunnanda,151823105,VNKE01002392.1,1,14120,9.3003e-05,133939209,0.882206
D.bunnanda,151823105,VNKE01001513.1,1,14107,9.29173e-05,133953316,0.882299
D.bunnanda,151823105,VNKE01005658.1,1,14070,9.26736e-05,133967386,0.882391
D.bunnanda,151823105,VNKE01005861.1,1,14067,9.26539e-05,133981453,0.882484
D.bunnanda,151823105,VNKE01004235.1,1,14039,9.24695e-05,133995492,0.882576
D.bunnanda,151823105,VNKE01004799.1,1,14017,9.23246e-05,134009509,0.882669
D.bunnanda,151823105,VNKE01006126.1,1,14015,9.23114e-05,134023524,0.882761
D.bunnanda,151823105,VNKE01002867.1,1,14015,9.23114e-05,134037539,0.882853
D.bunnanda,151823105,VNKE01005223.1,1,14010,9.22784e-05,134051549,0.882946
D.bunnanda,151823105,VNKE01003810.1,1,14003,9.22323e-05,134065552,0.883038
D.bunnanda,151823105,VNKE01005514.1,1,13994,9.21731e-05,134079546,0.88313
D.bunnanda,151823105,VNKE01001970.1,1,13976,9.20545e-05,134093522,0.883222
D.bunnanda,151823105,VNKE01000219.1,1,13969,9.20084e-05,134107491,0.883314
D.bunnanda,151823105,VNKE01006556.1,1,13963,9.19689e-05,134121454,0.883406
D.bunnanda,151823105,VNKE01002330.1,1,13958,9.19359e-05,134135412,0.883498
D.bunnanda,151823105,VNKE01004196.1,1,13954,9.19096e-05,134149366,0.88359
D.bunnanda,151823105,VNKE01003137.1,1,13927,9.17318e-05,134163293,0.883682
D.bunnanda,151823105,VNKE01001830.1,1,13904,9.15803e-05,134177197,0.883773
D.bunnanda,151823105,VNKE01000951.1,1,13882,9.14354e-05,134191079,0.883865
D.bunnanda,151823105,VNKE01003224.1,1,13880,9.14222e-05,134204959,0.883956
D.bunnanda,151823105,VNKE01000358.1,1,13863,9.13102e-05,134218822,0.884047
D.bunnanda,151823105,VNKE01002886.1,1,13857,9.12707e-05,134232679,0.884139
D.bunnanda,151823105,VNKE01002758.1,1,13856,9.12641e-05,134246535,0.88423
D.bunnanda,151823105,VNKE01001874.1,1,13848,9.12114e-05,134260383,0.884321
D.bunnanda,151823105,VNKE01001591.1,1,13830,9.10929e-05,134274213,0.884412
D.bunnanda,151823105,VNKE01003720.1,1,13805,9.09282e-05,134288018,0.884503
D.bunnanda,151823105,VNKE01006083.1,1,13799,9.08887e-05,134301817,0.884594
D.bunnanda,151823105,VNKE01000321.1,1,13783,9.07833e-05,134315600,0.884685
D.bunnanda,151823105,VNKE01003435.1,1,13776,9.07372e-05,134329376,0.884776
D.bunnanda,151823105,VNKE01001175.1,1,13767,9.06779e-05,134343143,0.884866
D.bunnanda,151823105,VNKE01002930.1,1,13751,9.05725e-05,134356894,0.884957
D.bunnanda,151823105,VNKE01004767.1,1,13722,9.03815e-05,134370616,0.885047
D.bunnanda,151823105,VNKE01006562.1,1,13718,9.03552e-05,134384334,0.885138
D.bunnanda,151823105,VNKE01005256.1,1,13697,9.02168e-05,134398031,0.885228
D.bunnanda,151823105,VNKE01004966.1,1,13693,9.01905e-05,134411724,0.885318
D.bunnanda,151823105,VNKE01002787.1,1,13686,9.01444e-05,134425410,0.885408
D.bunnanda,151823105,VNKE01002475.1,1,13682,9.0118e-05,134439092,0.885498
D.bunnanda,151823105,VNKE01000002.1,1,13682,9.0118e-05,134452774,0.885588
D.bunnanda,151823105,VNKE01002861.1,1,13659,8.99665e-05,134466433,0.885678
D.bunnanda,151823105,VNKE01005862.1,1,13656,8.99468e-05,134480089,0.885768
D.bunnanda,151823105,VNKE01000095.1,1,13656,8.99468e-05,134493745,0.885858
D.bunnanda,151823105,VNKE01002858.1,1,13652,8.99204e-05,134507397,0.885948
D.bunnanda,151823105,VNKE01004153.1,1,13612,8.9657e-05,134521009,0.886038
D.bunnanda,151823105,VNKE01003362.1,1,13597,8.95582e-05,134534606,0.886127
D.bunnanda,151823105,VNKE01001537.1,1,13568,8.93672e-05,134548174,0.886217
D.bunnanda,151823105,VNKE01000730.1,1,13544,8.92091e-05,134561718,0.886306
D.bunnanda,151823105,VNKE01003887.1,1,13528,8.91037e-05,134575246,0.886395
D.bunnanda,151823105,VNKE01000549.1,1,13490,8.88534e-05,134588736,0.886484
D.bunnanda,151823105,VNKE01006164.1,1,13489,8.88468e-05,134602225,0.886573
D.bunnanda,151823105,VNKE01005700.1,1,13470,8.87217e-05,134615695,0.886661
D.bunnanda,151823105,VNKE01006455.1,1,13465,8.86887e-05,134629160,0.88675
D.bunnanda,151823105,VNKE01004228.1,1,13465,8.86887e-05,134642625,0.886839
D.bunnanda,151823105,VNKE01002456.1,1,13461,8.86624e-05,134656086,0.886927
D.bunnanda,151823105,VNKE01005337.1,1,13450,8.85899e-05,134669536,0.887016
D.bunnanda,151823105,VNKE01003788.1,1,13436,8.84977e-05,134682972,0.887105
D.bunnanda,151823105,VNKE01004977.1,1,13426,8.84319e-05,134696398,0.887193
D.bunnanda,151823105,VNKE01001875.1,1,13426,8.84319e-05,134709824,0.887281
D.bunnanda,151823105,VNKE01002855.1,1,13424,8.84187e-05,134723248,0.88737
D.bunnanda,151823105,VNKE01002985.1,1,13416,8.8366e-05,134736664,0.887458
D.bunnanda,151823105,VNKE01006153.1,1,13388,8.81816e-05,134750052,0.887546
D.bunnanda,151823105,VNKE01005939.1,1,13363,8.80169e-05,134763415,0.887634
D.bunnanda,151823105,VNKE01002597.1,1,13352,8.79445e-05,134776767,0.887722
D.bunnanda,151823105,VNKE01000069.1,1,13344,8.78918e-05,134790111,0.88781
D.bunnanda,151823105,VNKE01004343.1,1,13343,8.78852e-05,134803454,0.887898
D.bunnanda,151823105,VNKE01001518.1,1,13330,8.77995e-05,134816784,0.887986
D.bunnanda,151823105,VNKE01000387.1,1,13311,8.76744e-05,134830095,0.888074
D.bunnanda,151823105,VNKE01005134.1,1,13308,8.76546e-05,134843403,0.888161
D.bunnanda,151823105,VNKE01002198.1,1,13306,8.76415e-05,134856709,0.888249
D.bunnanda,151823105,VNKE01006252.1,1,13301,8.76085e-05,134870010,0.888337
D.bunnanda,151823105,VNKE01001771.1,1,13296,8.75756e-05,134883306,0.888424
D.bunnanda,151823105,VNKE01004199.1,1,13279,8.74636e-05,134896585,0.888512
D.bunnanda,151823105,VNKE01005779.1,1,13278,8.7457e-05,134909863,0.888599
D.bunnanda,151823105,VNKE01006259.1,1,13268,8.73912e-05,134923131,0.888686
D.bunnanda,151823105,VNKE01003351.1,1,13221,8.70816e-05,134936352,0.888773
D.bunnanda,151823105,VNKE01000377.1,1,13212,8.70223e-05,134949564,0.888861
D.bunnanda,151823105,VNKE01006218.1,1,13182,8.68247e-05,134962746,0.888947
D.bunnanda,151823105,VNKE01005697.1,1,13178,8.67984e-05,134975924,0.889034
D.bunnanda,151823105,VNKE01001391.1,1,13173,8.67654e-05,134989097,0.889121
D.bunnanda,151823105,VNKE01000601.1,1,13160,8.66798e-05,135002257,0.889208
D.bunnanda,151823105,VNKE01004901.1,1,13145,8.6581e-05,135015402,0.889294
D.bunnanda,151823105,VNKE01006168.1,1,13143,8.65679e-05,135028545,0.889381
D.bunnanda,151823105,VNKE01005182.1,1,13136,8.65217e-05,135041681,0.889467
D.bunnanda,151823105,VNKE01005696.1,1,13129,8.64756e-05,135054810,0.889554
D.bunnanda,151823105,VNKE01002863.1,1,13129,8.64756e-05,135067939,0.88964
D.bunnanda,151823105,VNKE01006109.1,1,13087,8.6199e-05,135081026,0.889726
D.bunnanda,151823105,VNKE01003794.1,1,13059,8.60146e-05,135094085,0.889812
D.bunnanda,151823105,VNKE01002467.1,1,13051,8.59619e-05,135107136,0.889898
D.bunnanda,151823105,VNKE01002836.1,1,13033,8.58433e-05,135120169,0.889984
D.bunnanda,151823105,VNKE01005441.1,1,13029,8.5817e-05,135133198,0.89007
D.bunnanda,151823105,VNKE01000535.1,1,13028,8.58104e-05,135146226,0.890156
D.bunnanda,151823105,VNKE01002780.1,1,13019,8.57511e-05,135159245,0.890242
D.bunnanda,151823105,VNKE01001847.1,1,13002,8.56391e-05,135172247,0.890327
D.bunnanda,151823105,VNKE01001099.1,1,12996,8.55996e-05,135185243,0.890413
D.bunnanda,151823105,VNKE01004485.1,1,12995,8.5593e-05,135198238,0.890498
D.bunnanda,151823105,VNKE01003786.1,1,12993,8.55799e-05,135211231,0.890584
D.bunnanda,151823105,VNKE01003870.1,1,12973,8.54481e-05,135224204,0.890669
D.bunnanda,151823105,VNKE01002413.1,1,12966,8.5402e-05,135237170,0.890755
D.bunnanda,151823105,VNKE01006154.1,1,12958,8.53493e-05,135250128,0.89084
D.bunnanda,151823105,VNKE01002267.1,1,12945,8.52637e-05,135263073,0.890925
D.bunnanda,151823105,VNKE01005466.1,1,12939,8.52242e-05,135276012,0.891011
D.bunnanda,151823105,VNKE01002779.1,1,12921,8.51056e-05,135288933,0.891096
D.bunnanda,151823105,VNKE01002747.1,1,12915,8.50661e-05,135301848,0.891181
D.bunnanda,151823105,VNKE01000405.1,1,12915,8.50661e-05,135314763,0.891266
D.bunnanda,151823105,VNKE01004535.1,1,12890,8.49014e-05,135327653,0.891351
D.bunnanda,151823105,VNKE01002824.1,1,12886,8.48751e-05,135340539,0.891436
D.bunnanda,151823105,VNKE01001174.1,1,12886,8.48751e-05,135353425,0.891521
D.bunnanda,151823105,VNKE01001193.1,1,12884,8.48619e-05,135366309,0.891605
D.bunnanda,151823105,VNKE01000569.1,1,12860,8.47038e-05,135379169,0.89169
D.bunnanda,151823105,VNKE01003894.1,1,12825,8.44733e-05,135391994,0.891775
D.bunnanda,151823105,VNKE01003844.1,1,12809,8.43679e-05,135404803,0.891859
D.bunnanda,151823105,VNKE01004422.1,1,12805,8.43416e-05,135417608,0.891943
D.bunnanda,151823105,VNKE01002705.1,1,12780,8.41769e-05,135430388,0.892028
D.bunnanda,151823105,VNKE01002452.1,1,12764,8.40715e-05,135443152,0.892112
D.bunnanda,151823105,VNKE01001127.1,1,12757,8.40254e-05,135455909,0.892196
D.bunnanda,151823105,VNKE01001593.1,1,12748,8.39661e-05,135468657,0.89228
D.bunnanda,151823105,VNKE01001588.1,1,12723,8.38015e-05,135481380,0.892363
D.bunnanda,151823105,VNKE01003325.1,1,12719,8.37751e-05,135494099,0.892447
D.bunnanda,151823105,VNKE01002158.1,1,12703,8.36697e-05,135506802,0.892531
D.bunnanda,151823105,VNKE01000825.1,1,12694,8.36105e-05,135519496,0.892614
D.bunnanda,151823105,VNKE01001249.1,1,12683,8.3538e-05,135532179,0.892698
D.bunnanda,151823105,VNKE01000151.1,1,12683,8.3538e-05,135544862,0.892782
D.bunnanda,151823105,VNKE01000416.1,1,12642,8.3268e-05,135557504,0.892865
D.bunnanda,151823105,VNKE01002451.1,1,12595,8.29584e-05,135570099,0.892948
D.bunnanda,151823105,VNKE01006346.1,1,12574,8.28201e-05,135582673,0.893031
D.bunnanda,151823105,VNKE01006156.1,1,12573,8.28135e-05,135595246,0.893113
D.bunnanda,151823105,VNKE01004229.1,1,12572,8.28069e-05,135607818,0.893196
D.bunnanda,151823105,VNKE01004777.1,1,12539,8.25895e-05,135620357,0.893279
D.bunnanda,151823105,VNKE01006130.1,1,12523,8.24842e-05,135632880,0.893361
D.bunnanda,151823105,VNKE01006594.1,1,12495,8.22997e-05,135645375,0.893444
D.bunnanda,151823105,VNKE01004710.1,1,12410,8.17399e-05,135657785,0.893525
D.bunnanda,151823105,VNKE01002777.1,1,12391,8.16147e-05,135670176,0.893607
D.bunnanda,151823105,VNKE01004972.1,1,12374,8.15027e-05,135682550,0.893688
D.bunnanda,151823105,VNKE01003577.1,1,12347,8.13249e-05,135694897,0.89377
D.bunnanda,151823105,VNKE01001384.1,1,12329,8.12063e-05,135707226,0.893851
D.bunnanda,151823105,VNKE01000551.1,1,12327,8.11932e-05,135719553,0.893932
D.bunnanda,151823105,VNKE01005232.1,1,12301,8.10219e-05,135731854,0.894013
D.bunnanda,151823105,VNKE01001519.1,1,12301,8.10219e-05,135744155,0.894094
D.bunnanda,151823105,VNKE01002030.1,1,12289,8.09429e-05,135756444,0.894175
D.bunnanda,151823105,VNKE01003807.1,1,12285,8.09165e-05,135768729,0.894256
D.bunnanda,151823105,VNKE01000905.1,1,12282,8.08968e-05,135781011,0.894337
D.bunnanda,151823105,VNKE01006568.1,1,12270,8.08177e-05,135793281,0.894418
D.bunnanda,151823105,VNKE01000468.1,1,12263,8.07716e-05,135805544,0.894499
D.bunnanda,151823105,VNKE01001600.1,1,12247,8.06662e-05,135817791,0.894579
D.bunnanda,151823105,VNKE01004548.1,1,12240,8.06201e-05,135830031,0.89466
D.bunnanda,151823105,VNKE01003311.1,1,12234,8.05806e-05,135842265,0.89474
D.bunnanda,151823105,VNKE01002005.1,1,12220,8.04884e-05,135854485,0.894821
D.bunnanda,151823105,VNKE01000536.1,1,12220,8.04884e-05,135866705,0.894901
D.bunnanda,151823105,VNKE01003104.1,1,12219,8.04818e-05,135878924,0.894982
D.bunnanda,151823105,VNKE01002611.1,1,12219,8.04818e-05,135891143,0.895062
D.bunnanda,151823105,VNKE01006608.1,1,12199,8.03501e-05,135903342,0.895143
D.bunnanda,151823105,VNKE01006411.1,1,12190,8.02908e-05,135915532,0.895223
D.bunnanda,151823105,VNKE01006339.1,1,12187,8.0271e-05,135927719,0.895303
D.bunnanda,151823105,VNKE01001335.1,1,12187,8.0271e-05,135939906,0.895384
D.bunnanda,151823105,VNKE01003486.1,1,12177,8.02052e-05,135952083,0.895464
D.bunnanda,151823105,VNKE01000226.1,1,12175,8.0192e-05,135964258,0.895544
D.bunnanda,151823105,VNKE01000406.1,1,12168,8.01459e-05,135976426,0.895624
D.bunnanda,151823105,VNKE01003118.1,1,12167,8.01393e-05,135988593,0.895704
D.bunnanda,151823105,VNKE01003090.1,1,12147,8.00076e-05,136000740,0.895784
D.bunnanda,151823105,VNKE01002292.1,1,12131,7.99022e-05,136012871,0.895864
D.bunnanda,151823105,VNKE01005568.1,1,12103,7.97178e-05,136024974,0.895944
D.bunnanda,151823105,VNKE01001408.1,1,12083,7.9586e-05,136037057,0.896023
D.bunnanda,151823105,VNKE01000887.1,1,12073,7.95202e-05,136049130,0.896103
D.bunnanda,151823105,VNKE01001401.1,1,12065,7.94675e-05,136061195,0.896182
D.bunnanda,151823105,VNKE01004376.1,1,12045,7.93358e-05,136073240,0.896262
D.bunnanda,151823105,VNKE01003582.1,1,12033,7.92567e-05,136085273,0.896341
D.bunnanda,151823105,VNKE01005703.1,1,12032,7.92501e-05,136097305,0.89642
D.bunnanda,151823105,VNKE01000366.1,1,12010,7.91052e-05,136109315,0.896499
D.bunnanda,151823105,VNKE01003873.1,1,12009,7.90986e-05,136121324,0.896578
D.bunnanda,151823105,VNKE01004742.1,1,12008,7.9092e-05,136133332,0.896658
D.bunnanda,151823105,VNKE01005537.1,1,12005,7.90723e-05,136145337,0.896737
D.bunnanda,151823105,VNKE01005830.1,1,12003,7.90591e-05,136157340,0.896816
D.bunnanda,151823105,VNKE01002866.1,1,11994,7.89998e-05,136169334,0.896895
D.bunnanda,151823105,VNKE01000171.1,1,11980,7.89076e-05,136181314,0.896974
D.bunnanda,151823105,VNKE01006147.1,1,11975,7.88747e-05,136193289,0.897052
D.bunnanda,151823105,VNKE01006348.1,1,11959,7.87693e-05,136205248,0.897131
D.bunnanda,151823105,VNKE01001065.1,1,11952,7.87232e-05,136217200,0.89721
D.bunnanda,151823105,VNKE01000788.1,1,11936,7.86178e-05,136229136,0.897289
D.bunnanda,151823105,VNKE01003100.1,1,11922,7.85256e-05,136241058,0.897367
D.bunnanda,151823105,VNKE01005419.1,1,11917,7.84927e-05,136252975,0.897446
D.bunnanda,151823105,VNKE01002067.1,1,11904,7.8407e-05,136264879,0.897524
D.bunnanda,151823105,VNKE01002676.1,1,11867,7.81633e-05,136276746,0.897602
D.bunnanda,151823105,VNKE01001389.1,1,11861,7.81238e-05,136288607,0.89768
D.bunnanda,151823105,VNKE01003078.1,1,11855,7.80843e-05,136300462,0.897758
D.bunnanda,151823105,VNKE01000732.1,1,11824,7.78801e-05,136312286,0.897836
D.bunnanda,151823105,VNKE01002273.1,1,11813,7.78077e-05,136324099,0.897914
D.bunnanda,151823105,VNKE01003240.1,1,11802,7.77352e-05,136335901,0.897992
D.bunnanda,151823105,VNKE01006298.1,1,11792,7.76693e-05,136347693,0.898069
D.bunnanda,151823105,VNKE01002938.1,1,11771,7.7531e-05,136359464,0.898147
D.bunnanda,151823105,VNKE01000441.1,1,11745,7.73598e-05,136371209,0.898224
D.bunnanda,151823105,VNKE01001117.1,1,11728,7.72478e-05,136382937,0.898302
D.bunnanda,151823105,VNKE01004330.1,1,11724,7.72214e-05,136394661,0.898379
D.bunnanda,151823105,VNKE01002457.1,1,11719,7.71885e-05,136406380,0.898456
D.bunnanda,151823105,VNKE01002629.1,1,11710,7.71292e-05,136418090,0.898533
D.bunnanda,151823105,VNKE01001955.1,1,11702,7.70765e-05,136429792,0.89861
D.bunnanda,151823105,VNKE01004264.1,1,11684,7.6958e-05,136441476,0.898687
D.bunnanda,151823105,VNKE01002270.1,1,11677,7.69119e-05,136453153,0.898764
D.bunnanda,151823105,VNKE01004528.1,1,11672,7.68789e-05,136464825,0.898841
D.bunnanda,151823105,VNKE01000386.1,1,11667,7.6846e-05,136476492,0.898918
D.bunnanda,151823105,VNKE01003487.1,1,11665,7.68328e-05,136488157,0.898995
D.bunnanda,151823105,VNKE01004109.1,1,11655,7.6767e-05,136499812,0.899071
D.bunnanda,151823105,VNKE01002936.1,1,11618,7.65233e-05,136511430,0.899148
D.bunnanda,151823105,VNKE01000086.1,1,11615,7.65035e-05,136523045,0.899224
D.bunnanda,151823105,VNKE01004258.1,1,11602,7.64179e-05,136534647,0.899301
D.bunnanda,151823105,VNKE01006400.1,1,11585,7.63059e-05,136546232,0.899377
D.bunnanda,151823105,VNKE01006212.1,1,11567,7.61873e-05,136557799,0.899453
D.bunnanda,151823105,VNKE01001096.1,1,11556,7.61149e-05,136569355,0.899529
D.bunnanda,151823105,VNKE01005702.1,1,11546,7.6049e-05,136580901,0.899606
D.bunnanda,151823105,VNKE01002698.1,1,11541,7.60161e-05,136592442,0.899682
D.bunnanda,151823105,VNKE01000894.1,1,11531,7.59502e-05,136603973,0.899757
D.bunnanda,151823105,VNKE01002381.1,1,11519,7.58712e-05,136615492,0.899833
D.bunnanda,151823105,VNKE01001586.1,1,11508,7.57987e-05,136627000,0.899909
D.bunnanda,151823105,VNKE01000554.1,1,11508,7.57987e-05,136638508,0.899985
D.bunnanda,151823105,VNKE01003057.1,1,11492,7.56934e-05,136650000,0.900061
D.bunnanda,151823105,VNKE01003322.1,1,11491,7.56868e-05,136661491,0.900136
D.bunnanda,151823105,VNKE01003881.1,1,11476,7.5588e-05,136672967,0.900212
D.bunnanda,151823105,VNKE01000094.1,1,11473,7.55682e-05,136684440,0.900287
D.bunnanda,151823105,VNKE01000941.1,1,11472,7.55616e-05,136695912,0.900363
D.bunnanda,151823105,VNKE01005996.1,1,11468,7.55353e-05,136707380,0.900439
D.bunnanda,151823105,VNKE01002837.1,1,11459,7.5476e-05,136718839,0.900514
D.bunnanda,151823105,VNKE01005221.1,1,11454,7.54431e-05,136730293,0.900589
D.bunnanda,151823105,VNKE01004856.1,1,11437,7.53311e-05,136741730,0.900665
D.bunnanda,151823105,VNKE01004430.1,1,11437,7.53311e-05,136753167,0.90074
D.bunnanda,151823105,VNKE01001244.1,1,11423,7.52389e-05,136764590,0.900815
D.bunnanda,151823105,VNKE01004024.1,1,11415,7.51862e-05,136776005,0.900891
D.bunnanda,151823105,VNKE01002507.1,1,11396,7.5061e-05,136787401,0.900966
D.bunnanda,151823105,VNKE01003651.1,1,11392,7.50347e-05,136798793,0.901041
D.bunnanda,151823105,VNKE01004850.1,1,11384,7.4982e-05,136810177,0.901116
D.bunnanda,151823105,VNKE01006169.1,1,11373,7.49095e-05,136821550,0.901191
D.bunnanda,151823105,VNKE01002631.1,1,11356,7.47976e-05,136832906,0.901265
D.bunnanda,151823105,VNKE01002634.1,1,11346,7.47317e-05,136844252,0.90134
D.bunnanda,151823105,VNKE01003890.1,1,11329,7.46197e-05,136855581,0.901415
D.bunnanda,151823105,VNKE01004339.1,1,11327,7.46066e-05,136866908,0.901489
D.bunnanda,151823105,VNKE01000611.1,1,11321,7.4567e-05,136878229,0.901564
D.bunnanda,151823105,VNKE01000006.1,1,11318,7.45473e-05,136889547,0.901638
D.bunnanda,151823105,VNKE01004786.1,1,11317,7.45407e-05,136900864,0.901713
D.bunnanda,151823105,VNKE01005522.1,1,11311,7.45012e-05,136912175,0.901787
D.bunnanda,151823105,VNKE01001603.1,1,11299,7.44221e-05,136923474,0.901862
D.bunnanda,151823105,VNKE01003889.1,1,11295,7.43958e-05,136934769,0.901936
D.bunnanda,151823105,VNKE01000789.1,1,11293,7.43826e-05,136946062,0.902011
D.bunnanda,151823105,VNKE01006158.1,1,11280,7.4297e-05,136957342,0.902085
D.bunnanda,151823105,VNKE01006214.1,1,11271,7.42377e-05,136968613,0.902159
D.bunnanda,151823105,VNKE01006183.1,1,11266,7.42048e-05,136979879,0.902233
D.bunnanda,151823105,VNKE01006011.1,1,11239,7.40269e-05,136991118,0.902307
D.bunnanda,151823105,VNKE01006620.1,1,11225,7.39347e-05,137002343,0.902381
D.bunnanda,151823105,VNKE01001838.1,1,11220,7.39018e-05,137013563,0.902455
D.bunnanda,151823105,VNKE01005404.1,1,11217,7.3882e-05,137024780,0.902529
D.bunnanda,151823105,VNKE01004283.1,1,11211,7.38425e-05,137035991,0.902603
D.bunnanda,151823105,VNKE01000644.1,1,11208,7.38228e-05,137047199,0.902677
D.bunnanda,151823105,VNKE01005340.1,1,11181,7.36449e-05,137058380,0.90275
D.bunnanda,151823105,VNKE01001251.1,1,11179,7.36317e-05,137069559,0.902824
D.bunnanda,151823105,VNKE01006554.1,1,11165,7.35395e-05,137080724,0.902898
D.bunnanda,151823105,VNKE01001933.1,1,11161,7.35132e-05,137091885,0.902971
D.bunnanda,151823105,VNKE01005601.1,1,11156,7.34803e-05,137103041,0.903045
D.bunnanda,151823105,VNKE01006121.1,1,11152,7.34539e-05,137114193,0.903118
D.bunnanda,151823105,VNKE01004908.1,1,11142,7.3388e-05,137125335,0.903191
D.bunnanda,151823105,VNKE01004892.1,1,11111,7.31839e-05,137136446,0.903265
D.bunnanda,151823105,VNKE01002598.1,1,11111,7.31839e-05,137147557,0.903338
D.bunnanda,151823105,VNKE01004100.1,1,11109,7.31707e-05,137158666,0.903411
D.bunnanda,151823105,VNKE01005454.1,1,11092,7.30587e-05,137169758,0.903484
D.bunnanda,151823105,VNKE01004518.1,1,11085,7.30126e-05,137180843,0.903557
D.bunnanda,151823105,VNKE01003463.1,1,11079,7.29731e-05,137191922,0.90363
D.bunnanda,151823105,VNKE01001743.1,1,11070,7.29138e-05,137202992,0.903703
D.bunnanda,151823105,VNKE01003490.1,1,11047,7.27623e-05,137214039,0.903776
D.bunnanda,151823105,VNKE01006057.1,1,11000,7.24527e-05,137225039,0.903848
D.bunnanda,151823105,VNKE01005699.1,1,10987,7.23671e-05,137236026,0.903921
D.bunnanda,151823105,VNKE01000456.1,1,10983,7.23408e-05,137247009,0.903993
D.bunnanda,151823105,VNKE01001645.1,1,10977,7.23012e-05,137257986,0.904065
D.bunnanda,151823105,VNKE01000428.1,1,10946,7.20971e-05,137268932,0.904137
D.bunnanda,151823105,VNKE01003959.1,1,10927,7.19719e-05,137279859,0.904209
D.bunnanda,151823105,VNKE01006299.1,1,10926,7.19653e-05,137290785,0.904281
D.bunnanda,151823105,VNKE01003865.1,1,10920,7.19258e-05,137301705,0.904353
D.bunnanda,151823105,VNKE01001040.1,1,10918,7.19126e-05,137312623,0.904425
D.bunnanda,151823105,VNKE01002449.1,1,10914,7.18863e-05,137323537,0.904497
D.bunnanda,151823105,VNKE01005841.1,1,10904,7.18204e-05,137334441,0.904569
D.bunnanda,151823105,VNKE01003121.1,1,10894,7.17546e-05,137345335,0.904641
D.bunnanda,151823105,VNKE01003842.1,1,10877,7.16426e-05,137356212,0.904712
D.bunnanda,151823105,VNKE01004947.1,1,10875,7.16294e-05,137367087,0.904784
D.bunnanda,151823105,VNKE01006375.1,1,10874,7.16228e-05,137377961,0.904855
D.bunnanda,151823105,VNKE01004734.1,1,10873,7.16162e-05,137388834,0.904927
D.bunnanda,151823105,VNKE01000952.1,1,10858,7.15174e-05,137399692,0.904999
D.bunnanda,151823105,VNKE01006553.1,1,10850,7.14647e-05,137410542,0.90507
D.bunnanda,151823105,VNKE01001606.1,1,10823,7.12869e-05,137421365,0.905141
D.bunnanda,151823105,VNKE01004496.1,1,10819,7.12606e-05,137432184,0.905213
D.bunnanda,151823105,VNKE01004265.1,1,10819,7.12606e-05,137443003,0.905284
D.bunnanda,151823105,VNKE01005936.1,1,10817,7.12474e-05,137453820,0.905355
D.bunnanda,151823105,VNKE01004857.1,1,10788,7.10564e-05,137464608,0.905426
D.bunnanda,151823105,VNKE01003148.1,1,10787,7.10498e-05,137475395,0.905497
D.bunnanda,151823105,VNKE01001385.1,1,10781,7.10103e-05,137486176,0.905568
D.bunnanda,151823105,VNKE01006510.1,1,10757,7.08522e-05,137496933,0.905639
D.bunnanda,151823105,VNKE01000135.1,1,10725,7.06414e-05,137507658,0.90571
D.bunnanda,151823105,VNKE01001619.1,1,10722,7.06217e-05,137518380,0.90578
D.bunnanda,151823105,VNKE01005226.1,1,10717,7.05887e-05,137529097,0.905851
D.bunnanda,151823105,VNKE01004099.1,1,10712,7.05558e-05,137539809,0.905921
D.bunnanda,151823105,VNKE01001587.1,1,10703,7.04965e-05,137550512,0.905992
D.bunnanda,151823105,VNKE01006342.1,1,10697,7.0457e-05,137561209,0.906062
D.bunnanda,151823105,VNKE01003845.1,1,10682,7.03582e-05,137571891,0.906133
D.bunnanda,151823105,VNKE01004998.1,1,10677,7.03253e-05,137582568,0.906203
D.bunnanda,151823105,VNKE01005239.1,1,10675,7.03121e-05,137593243,0.906273
D.bunnanda,151823105,VNKE01003393.1,1,10673,7.02989e-05,137603916,0.906344
D.bunnanda,151823105,VNKE01004394.1,1,10661,7.02199e-05,137614577,0.906414
D.bunnanda,151823105,VNKE01000143.1,1,10655,7.01804e-05,137625232,0.906484
D.bunnanda,151823105,VNKE01003921.1,1,10653,7.01672e-05,137635885,0.906554
D.bunnanda,151823105,VNKE01006053.1,1,10644,7.01079e-05,137646529,0.906624
D.bunnanda,151823105,VNKE01001488.1,1,10634,7.0042e-05,137657163,0.906694
D.bunnanda,151823105,VNKE01005932.1,1,10624,6.99762e-05,137667787,0.906764
D.bunnanda,151823105,VNKE01001319.1,1,10619,6.99432e-05,137678406,0.906834
D.bunnanda,151823105,VNKE01005735.1,1,10618,6.99367e-05,137689024,0.906904
D.bunnanda,151823105,VNKE01004992.1,1,10615,6.99169e-05,137699639,0.906974
D.bunnanda,151823105,VNKE01002368.1,1,10614,6.99103e-05,137710253,0.907044
D.bunnanda,151823105,VNKE01002128.1,1,10602,6.98313e-05,137720855,0.907114
D.bunnanda,151823105,VNKE01004770.1,1,10598,6.98049e-05,137731453,0.907184
D.bunnanda,151823105,VNKE01000283.1,1,10595,6.97852e-05,137742048,0.907254
D.bunnanda,151823105,VNKE01002673.1,1,10590,6.97522e-05,137752638,0.907323
D.bunnanda,151823105,VNKE01006059.1,1,10583,6.97061e-05,137763221,0.907393
D.bunnanda,151823105,VNKE01004664.1,1,10570,6.96205e-05,137773791,0.907463
D.bunnanda,151823105,VNKE01000454.1,1,10557,6.95349e-05,137784348,0.907532
D.bunnanda,151823105,VNKE01002133.1,1,10554,6.95151e-05,137794902,0.907602
D.bunnanda,151823105,VNKE01002023.1,1,10549,6.94822e-05,137805451,0.907671
D.bunnanda,151823105,VNKE01000674.1,1,10545,6.94558e-05,137815996,0.907741
D.bunnanda,151823105,VNKE01004411.1,1,10526,6.93307e-05,137826522,0.90781
D.bunnanda,151823105,VNKE01002113.1,1,10509,6.92187e-05,137837031,0.907879
D.bunnanda,151823105,VNKE01005024.1,1,10478,6.90145e-05,137847509,0.907948
D.bunnanda,151823105,VNKE01003526.1,1,10467,6.89421e-05,137857976,0.908017
D.bunnanda,151823105,VNKE01006461.1,1,10466,6.89355e-05,137868442,0.908086
D.bunnanda,151823105,VNKE01001265.1,1,10459,6.88894e-05,137878901,0.908155
D.bunnanda,151823105,VNKE01003120.1,1,10457,6.88762e-05,137889358,0.908224
D.bunnanda,151823105,VNKE01002901.1,1,10453,6.88499e-05,137899811,0.908293
D.bunnanda,151823105,VNKE01005586.1,1,10451,6.88367e-05,137910262,0.908361
D.bunnanda,151823105,VNKE01001141.1,1,10446,6.88038e-05,137920708,0.90843
D.bunnanda,151823105,VNKE01004707.1,1,10444,6.87906e-05,137931152,0.908499
D.bunnanda,151823105,VNKE01002933.1,1,10441,6.87708e-05,137941593,0.908568
D.bunnanda,151823105,VNKE01002342.1,1,10437,6.87445e-05,137952030,0.908637
D.bunnanda,151823105,VNKE01005600.1,1,10410,6.85666e-05,137962440,0.908705
D.bunnanda,151823105,VNKE01003687.1,1,10402,6.85139e-05,137972842,0.908774
D.bunnanda,151823105,VNKE01004492.1,1,10393,6.84547e-05,137983235,0.908842
D.bunnanda,151823105,VNKE01000725.1,1,10380,6.8369e-05,137993615,0.908911
D.bunnanda,151823105,VNKE01005495.1,1,10377,6.83493e-05,138003992,0.908979
D.bunnanda,151823105,VNKE01003161.1,1,10356,6.8211e-05,138014348,0.909047
D.bunnanda,151823105,VNKE01001843.1,1,10356,6.8211e-05,138024704,0.909115
D.bunnanda,151823105,VNKE01000623.1,1,10346,6.81451e-05,138035050,0.909183
D.bunnanda,151823105,VNKE01001598.1,1,10324,6.80002e-05,138045374,0.909251
D.bunnanda,151823105,VNKE01005899.1,1,10283,6.77301e-05,138055657,0.909319
D.bunnanda,151823105,VNKE01004261.1,1,10264,6.7605e-05,138065921,0.909387
D.bunnanda,151823105,VNKE01004263.1,1,10256,6.75523e-05,138076177,0.909454
D.bunnanda,151823105,VNKE01004043.1,1,10250,6.75128e-05,138086427,0.909522
D.bunnanda,151823105,VNKE01004025.1,1,10234,6.74074e-05,138096661,0.909589
D.bunnanda,151823105,VNKE01005273.1,1,10208,6.72361e-05,138106869,0.909656
D.bunnanda,151823105,VNKE01006088.1,1,10203,6.72032e-05,138117072,0.909724
D.bunnanda,151823105,VNKE01004426.1,1,10200,6.71835e-05,138127272,0.909791
D.bunnanda,151823105,VNKE01000465.1,1,10180,6.70517e-05,138137452,0.909858
D.bunnanda,151823105,VNKE01001732.1,1,10176,6.70254e-05,138147628,0.909925
D.bunnanda,151823105,VNKE01005609.1,1,10148,6.68409e-05,138157776,0.909992
D.bunnanda,151823105,VNKE01001340.1,1,10143,6.6808e-05,138167919,0.910059
D.bunnanda,151823105,VNKE01000811.1,1,10138,6.67751e-05,138178057,0.910125
D.bunnanda,151823105,VNKE01003063.1,1,10129,6.67158e-05,138188186,0.910192
D.bunnanda,151823105,VNKE01001599.1,1,10124,6.66829e-05,138198310,0.910259
D.bunnanda,151823105,VNKE01001592.1,1,10118,6.66433e-05,138208428,0.910325
D.bunnanda,151823105,VNKE01000137.1,1,10117,6.66368e-05,138218545,0.910392
D.bunnanda,151823105,VNKE01004262.1,1,10114,6.6617e-05,138228659,0.910459
D.bunnanda,151823105,VNKE01000628.1,1,10100,6.65248e-05,138238759,0.910525
D.bunnanda,151823105,VNKE01004775.1,1,10071,6.63338e-05,138248830,0.910592
D.bunnanda,151823105,VNKE01006404.1,1,10064,6.62877e-05,138258894,0.910658
D.bunnanda,151823105,VNKE01005704.1,1,10049,6.61889e-05,138268943,0.910724
D.bunnanda,151823105,VNKE01002660.1,1,10046,6.61691e-05,138278989,0.91079
D.bunnanda,151823105,VNKE01005742.1,1,10040,6.61296e-05,138289029,0.910856
D.bunnanda,151823105,VNKE01006405.1,1,10034,6.60901e-05,138299063,0.910922
D.bunnanda,151823105,VNKE01001594.1,1,10019,6.59913e-05,138309082,0.910988
D.bunnanda,151823105,VNKE01000650.1,1,10013,6.59518e-05,138319095,0.911054
D.bunnanda,151823105,VNKE01000064.1,1,10000,6.58661e-05,138329095,0.91112
D.bunnanda,151823105,VNKE01001652.1,1,9997,6.58464e-05,138339092,0.911186
D.bunnanda,151823105,VNKE01003221.1,1,9987,6.57805e-05,138349079,0.911252
D.bunnanda,151823105,VNKE01005825.1,1,9984,6.57607e-05,138359063,0.911318
D.bunnanda,151823105,VNKE01002675.1,1,9983,6.57542e-05,138369046,0.911383
D.bunnanda,151823105,VNKE01002165.1,1,9983,6.57542e-05,138379029,0.911449
D.bunnanda,151823105,VNKE01002891.1,1,9973,6.56883e-05,138389002,0.911515
D.bunnanda,151823105,VNKE01006119.1,1,9968,6.56554e-05,138398970,0.91158
D.bunnanda,151823105,VNKE01003617.1,1,9948,6.55236e-05,138408918,0.911646
D.bunnanda,151823105,VNKE01003246.1,1,9947,6.5517e-05,138418865,0.911711
D.bunnanda,151823105,VNKE01001393.1,1,9904,6.52338e-05,138428769,0.911777
D.bunnanda,151823105,VNKE01006340.1,1,9900,6.52075e-05,138438669,0.911842
D.bunnanda,151823105,VNKE01004267.1,1,9899,6.52009e-05,138448568,0.911907
D.bunnanda,151823105,VNKE01000892.1,1,9877,6.5056e-05,138458445,0.911972
D.bunnanda,151823105,VNKE01006020.1,1,9871,6.50165e-05,138468316,0.912037
D.bunnanda,151823105,VNKE01006504.1,1,9861,6.49506e-05,138478177,0.912102
D.bunnanda,151823105,VNKE01002482.1,1,9859,6.49374e-05,138488036,0.912167
D.bunnanda,151823105,VNKE01005706.1,1,9858,6.49308e-05,138497894,0.912232
D.bunnanda,151823105,VNKE01004900.1,1,9841,6.48189e-05,138507735,0.912297
D.bunnanda,151823105,VNKE01003128.1,1,9832,6.47596e-05,138517567,0.912362
D.bunnanda,151823105,VNKE01003013.1,1,9830,6.47464e-05,138527397,0.912426
D.bunnanda,151823105,VNKE01004647.1,1,9819,6.4674e-05,138537216,0.912491
D.bunnanda,151823105,VNKE01004534.1,1,9811,6.46213e-05,138547027,0.912556
D.bunnanda,151823105,VNKE01000121.1,1,9809,6.46081e-05,138556836,0.91262
D.bunnanda,151823105,VNKE01004934.1,1,9807,6.45949e-05,138566643,0.912685
D.bunnanda,151823105,VNKE01002391.1,1,9799,6.45422e-05,138576442,0.912749
D.bunnanda,151823105,VNKE01001205.1,1,9776,6.43907e-05,138586218,0.912814
D.bunnanda,151823105,VNKE01006408.1,1,9774,6.43776e-05,138595992,0.912878
D.bunnanda,151823105,VNKE01004040.1,1,9773,6.4371e-05,138605765,0.912942
D.bunnanda,151823105,VNKE01000003.1,1,9770,6.43512e-05,138615535,0.913007
D.bunnanda,151823105,VNKE01004268.1,1,9768,6.4338e-05,138625303,0.913071
D.bunnanda,151823105,VNKE01003392.1,1,9767,6.43314e-05,138635070,0.913136
D.bunnanda,151823105,VNKE01005103.1,1,9766,6.43249e-05,138644836,0.9132
D.bunnanda,151823105,VNKE01002973.1,1,9758,6.42722e-05,138654594,0.913264
D.bunnanda,151823105,VNKE01003570.1,1,9751,6.42261e-05,138664345,0.913328
D.bunnanda,151823105,VNKE01006372.1,1,9742,6.41668e-05,138674087,0.913393
D.bunnanda,151823105,VNKE01004421.1,1,9729,6.40812e-05,138683816,0.913457
D.bunnanda,151823105,VNKE01004661.1,1,9722,6.4035e-05,138693538,0.913521
D.bunnanda,151823105,VNKE01000548.1,1,9714,6.39824e-05,138703252,0.913585
D.bunnanda,151823105,VNKE01005010.1,1,9704,6.39165e-05,138712956,0.913649
D.bunnanda,151823105,VNKE01000540.1,1,9703,6.39099e-05,138722659,0.913712
D.bunnanda,151823105,VNKE01006545.1,1,9702,6.39033e-05,138732361,0.913776
D.bunnanda,151823105,VNKE01001388.1,1,9674,6.37189e-05,138742035,0.91384
D.bunnanda,151823105,VNKE01004810.1,1,9670,6.36925e-05,138751705,0.913904
D.bunnanda,151823105,VNKE01004680.1,1,9657,6.36069e-05,138761362,0.913967
D.bunnanda,151823105,VNKE01006196.1,1,9652,6.3574e-05,138771014,0.914031
D.bunnanda,151823105,VNKE01001140.1,1,9650,6.35608e-05,138780664,0.914094
D.bunnanda,151823105,VNKE01002091.1,1,9641,6.35015e-05,138790305,0.914158
D.bunnanda,151823105,VNKE01002007.1,1,9616,6.33369e-05,138799921,0.914221
D.bunnanda,151823105,VNKE01005279.1,1,9608,6.32842e-05,138809529,0.914285
D.bunnanda,151823105,VNKE01005212.1,1,9602,6.32447e-05,138819131,0.914348
D.bunnanda,151823105,VNKE01001585.1,1,9602,6.32447e-05,138828733,0.914411
D.bunnanda,151823105,VNKE01001045.1,1,9586,6.31393e-05,138838319,0.914474
D.bunnanda,151823105,VNKE01002318.1,1,9581,6.31063e-05,138847900,0.914537
D.bunnanda,151823105,VNKE01003473.1,1,9576,6.30734e-05,138857476,0.9146
D.bunnanda,151823105,VNKE01003394.1,1,9574,6.30602e-05,138867050,0.914663
D.bunnanda,151823105,VNKE01002716.1,1,9561,6.29746e-05,138876611,0.914726
D.bunnanda,151823105,VNKE01003743.1,1,9554,6.29285e-05,138886165,0.914789
D.bunnanda,151823105,VNKE01001654.1,1,9545,6.28692e-05,138895710,0.914852
D.bunnanda,151823105,VNKE01002667.1,1,9542,6.28495e-05,138905252,0.914915
D.bunnanda,151823105,VNKE01005708.1,1,9536,6.28099e-05,138914788,0.914978
D.bunnanda,151823105,VNKE01006079.1,1,9515,6.26716e-05,138924303,0.915041
D.bunnanda,151823105,VNKE01000791.1,1,9485,6.2474e-05,138933788,0.915103
D.bunnanda,151823105,VNKE01002555.1,1,9467,6.23555e-05,138943255,0.915165
D.bunnanda,151823105,VNKE01002145.1,1,9460,6.23094e-05,138952715,0.915228
D.bunnanda,151823105,VNKE01003476.1,1,9455,6.22764e-05,138962170,0.91529
D.bunnanda,151823105,VNKE01003407.1,1,9445,6.22106e-05,138971615,0.915352
D.bunnanda,151823105,VNKE01000142.1,1,9445,6.22106e-05,138981060,0.915414
D.bunnanda,151823105,VNKE01005415.1,1,9443,6.21974e-05,138990503,0.915477
D.bunnanda,151823105,VNKE01005293.1,1,9416,6.20195e-05,138999919,0.915539
D.bunnanda,151823105,VNKE01006566.1,1,9404,6.19405e-05,139009323,0.915601
D.bunnanda,151823105,VNKE01002143.1,1,9399,6.19076e-05,139018722,0.915662
D.bunnanda,151823105,VNKE01001426.1,1,9383,6.18022e-05,139028105,0.915724
D.bunnanda,151823105,VNKE01000288.1,1,9382,6.17956e-05,139037487,0.915786
D.bunnanda,151823105,VNKE01006161.1,1,9363,6.16705e-05,139046850,0.915848
D.bunnanda,151823105,VNKE01002465.1,1,9357,6.16309e-05,139056207,0.915909
D.bunnanda,151823105,VNKE01004740.1,1,9348,6.15717e-05,139065555,0.915971
D.bunnanda,151823105,VNKE01004980.1,1,9341,6.15255e-05,139074896,0.916032
D.bunnanda,151823105,VNKE01005179.1,1,9332,6.14663e-05,139084228,0.916094
D.bunnanda,151823105,VNKE01003729.1,1,9332,6.14663e-05,139093560,0.916155
D.bunnanda,151823105,VNKE01001001.1,1,9328,6.14399e-05,139102888,0.916217
D.bunnanda,151823105,VNKE01002072.1,1,9321,6.13938e-05,139112209,0.916278
D.bunnanda,151823105,VNKE01002655.1,1,9320,6.13872e-05,139121529,0.91634
D.bunnanda,151823105,VNKE01002153.1,1,9317,6.13675e-05,139130846,0.916401
D.bunnanda,151823105,VNKE01001651.1,1,9312,6.13345e-05,139140158,0.916462
D.bunnanda,151823105,VNKE01003543.1,1,9311,6.1328e-05,139149469,0.916524
D.bunnanda,151823105,VNKE01001120.1,1,9310,6.13214e-05,139158779,0.916585
D.bunnanda,151823105,VNKE01005352.1,1,9288,6.11765e-05,139168067,0.916646
D.bunnanda,151823105,VNKE01004688.1,1,9288,6.11765e-05,139177355,0.916707
D.bunnanda,151823105,VNKE01000091.1,1,9284,6.11501e-05,139186639,0.916768
D.bunnanda,151823105,VNKE01001466.1,1,9277,6.1104e-05,139195916,0.91683
D.bunnanda,151823105,VNKE01002690.1,1,9272,6.10711e-05,139205188,0.916891
D.bunnanda,151823105,VNKE01000722.1,1,9264,6.10184e-05,139214452,0.916952
D.bunnanda,151823105,VNKE01001816.1,1,9258,6.09789e-05,139223710,0.917013
D.bunnanda,151823105,VNKE01000648.1,1,9256,6.09657e-05,139232966,0.917074
D.bunnanda,151823105,VNKE01001543.1,1,9242,6.08735e-05,139242208,0.917135
D.bunnanda,151823105,VNKE01000307.1,1,9234,6.08208e-05,139251442,0.917195
D.bunnanda,151823105,VNKE01001772.1,1,9224,6.07549e-05,139260666,0.917256
D.bunnanda,151823105,VNKE01005692.1,1,9215,6.06956e-05,139269881,0.917317
D.bunnanda,151823105,VNKE01001491.1,1,9214,6.0689e-05,139279095,0.917377
D.bunnanda,151823105,VNKE01003668.1,1,9202,6.061e-05,139288297,0.917438
D.bunnanda,151823105,VNKE01002096.1,1,9199,6.05903e-05,139297496,0.917499
D.bunnanda,151823105,VNKE01004260.1,1,9198,6.05837e-05,139306694,0.917559
D.bunnanda,151823105,VNKE01001904.1,1,9197,6.05771e-05,139315891,0.91762
D.bunnanda,151823105,VNKE01004640.1,1,9190,6.0531e-05,139325081,0.91768
D.bunnanda,151823105,VNKE01004266.1,1,9176,6.04388e-05,139334257,0.917741
D.bunnanda,151823105,VNKE01004808.1,1,9167,6.03795e-05,139343424,0.917801
D.bunnanda,151823105,VNKE01000792.1,1,9163,6.03531e-05,139352587,0.917862
D.bunnanda,151823105,VNKE01001850.1,1,9156,6.0307e-05,139361743,0.917922
D.bunnanda,151823105,VNKE01002661.1,1,9144,6.0228e-05,139370887,0.917982
D.bunnanda,151823105,VNKE01000231.1,1,9138,6.01885e-05,139380025,0.918042
D.bunnanda,151823105,VNKE01002919.1,1,9122,6.00831e-05,139389147,0.918102
D.bunnanda,151823105,VNKE01001217.1,1,9118,6.00567e-05,139398265,0.918162
D.bunnanda,151823105,VNKE01001121.1,1,9106,5.99777e-05,139407371,0.918222
D.bunnanda,151823105,VNKE01006205.1,1,9102,5.99513e-05,139416473,0.918282
D.bunnanda,151823105,VNKE01001621.1,1,9092,5.98855e-05,139425565,0.918342
D.bunnanda,151823105,VNKE01004385.1,1,9081,5.9813e-05,139434646,0.918402
D.bunnanda,151823105,VNKE01003795.1,1,9076,5.97801e-05,139443722,0.918462
D.bunnanda,151823105,VNKE01004112.1,1,9075,5.97735e-05,139452797,0.918522
D.bunnanda,151823105,VNKE01003268.1,1,9060,5.96747e-05,139461857,0.918581
D.bunnanda,151823105,VNKE01004545.1,1,9045,5.95759e-05,139470902,0.918641
D.bunnanda,151823105,VNKE01004902.1,1,9034,5.95035e-05,139479936,0.9187
D.bunnanda,151823105,VNKE01006470.1,1,9027,5.94574e-05,139488963,0.91876
D.bunnanda,151823105,VNKE01003957.1,1,9025,5.94442e-05,139497988,0.918819
D.bunnanda,151823105,VNKE01005864.1,1,9006,5.9319e-05,139506994,0.918879
D.bunnanda,151823105,VNKE01001416.1,1,9001,5.92861e-05,139515995,0.918938
D.bunnanda,151823105,VNKE01003188.1,1,8976,5.91214e-05,139524971,0.918997
D.bunnanda,151823105,VNKE01002138.1,1,8958,5.90029e-05,139533929,0.919056
D.bunnanda,151823105,VNKE01005152.1,1,8957,5.89963e-05,139542886,0.919115
D.bunnanda,151823105,VNKE01004529.1,1,8944,5.89107e-05,139551830,0.919174
D.bunnanda,151823105,VNKE01005963.1,1,8943,5.89041e-05,139560773,0.919233
D.bunnanda,151823105,VNKE01000532.1,1,8943,5.89041e-05,139569716,0.919292
D.bunnanda,151823105,VNKE01005483.1,1,8941,5.88909e-05,139578657,0.919351
D.bunnanda,151823105,VNKE01001154.1,1,8934,5.88448e-05,139587591,0.919409
D.bunnanda,151823105,VNKE01003862.1,1,8928,5.88053e-05,139596519,0.919468
D.bunnanda,151823105,VNKE01003418.1,1,8926,5.87921e-05,139605445,0.919527
D.bunnanda,151823105,VNKE01006359.1,1,8925,5.87855e-05,139614370,0.919586
D.bunnanda,151823105,VNKE01004340.1,1,8902,5.8634e-05,139623272,0.919644
D.bunnanda,151823105,VNKE01001399.1,1,8894,5.85813e-05,139632166,0.919703
D.bunnanda,151823105,VNKE01003232.1,1,8893,5.85747e-05,139641059,0.919762
D.bunnanda,151823105,VNKE01003867.1,1,8891,5.85616e-05,139649950,0.91982
D.bunnanda,151823105,VNKE01001346.1,1,8877,5.84694e-05,139658827,0.919879
D.bunnanda,151823105,VNKE01004048.1,1,8871,5.84298e-05,139667698,0.919937
D.bunnanda,151823105,VNKE01001665.1,1,8864,5.83837e-05,139676562,0.919995
D.bunnanda,151823105,VNKE01003301.1,1,8861,5.8364e-05,139685423,0.920054
D.bunnanda,151823105,VNKE01000836.1,1,8861,5.8364e-05,139694284,0.920112
D.bunnanda,151823105,VNKE01005315.1,1,8858,5.83442e-05,139703142,0.92017
D.bunnanda,151823105,VNKE01003474.1,1,8858,5.83442e-05,139712000,0.920229
D.bunnanda,151823105,VNKE01000016.1,1,8850,5.82915e-05,139720850,0.920287
D.bunnanda,151823105,VNKE01000022.1,1,8826,5.81334e-05,139729676,0.920345
D.bunnanda,151823105,VNKE01004056.1,1,8818,5.80808e-05,139738494,0.920403
D.bunnanda,151823105,VNKE01004494.1,1,8814,5.80544e-05,139747308,0.920461
D.bunnanda,151823105,VNKE01005955.1,1,8791,5.79029e-05,139756099,0.920519
D.bunnanda,151823105,VNKE01004571.1,1,8784,5.78568e-05,139764883,0.920577
D.bunnanda,151823105,VNKE01005513.1,1,8775,5.77975e-05,139773658,0.920635
D.bunnanda,151823105,VNKE01004555.1,1,8741,5.75736e-05,139782399,0.920693
D.bunnanda,151823105,VNKE01003789.1,1,8741,5.75736e-05,139791140,0.92075
D.bunnanda,151823105,VNKE01000621.1,1,8730,5.75011e-05,139799870,0.920808
D.bunnanda,151823105,VNKE01001161.1,1,8723,5.7455e-05,139808593,0.920865
D.bunnanda,151823105,VNKE01002940.1,1,8719,5.74287e-05,139817312,0.920922
D.bunnanda,151823105,VNKE01000889.1,1,8719,5.74287e-05,139826031,0.92098
D.bunnanda,151823105,VNKE01003633.1,1,8715,5.74023e-05,139834746,0.921037
D.bunnanda,151823105,VNKE01000639.1,1,8712,5.73826e-05,139843458,0.921095
D.bunnanda,151823105,VNKE01000232.1,1,8705,5.73365e-05,139852163,0.921152
D.bunnanda,151823105,VNKE01005219.1,1,8689,5.72311e-05,139860852,0.921209
D.bunnanda,151823105,VNKE01000944.1,1,8689,5.72311e-05,139869541,0.921267
D.bunnanda,151823105,VNKE01003253.1,1,8680,5.71718e-05,139878221,0.921324
D.bunnanda,151823105,VNKE01004299.1,1,8676,5.71455e-05,139886897,0.921381
D.bunnanda,151823105,VNKE01004730.1,1,8671,5.71125e-05,139895568,0.921438
D.bunnanda,151823105,VNKE01004232.1,1,8662,5.70532e-05,139904230,0.921495
D.bunnanda,151823105,VNKE01001119.1,1,8657,5.70203e-05,139912887,0.921552
D.bunnanda,151823105,VNKE01006078.1,1,8626,5.68161e-05,139921513,0.921609
D.bunnanda,151823105,VNKE01000645.1,1,8621,5.67832e-05,139930134,0.921666
D.bunnanda,151823105,VNKE01000285.1,1,8611,5.67173e-05,139938745,0.921722
D.bunnanda,151823105,VNKE01006043.1,1,8607,5.6691e-05,139947352,0.921779
D.bunnanda,151823105,VNKE01000868.1,1,8605,5.66778e-05,139955957,0.921836
D.bunnanda,151823105,VNKE01003396.1,1,8585,5.65461e-05,139964542,0.921892
D.bunnanda,151823105,VNKE01003304.1,1,8581,5.65197e-05,139973123,0.921949
D.bunnanda,151823105,VNKE01000120.1,1,8561,5.6388e-05,139981684,0.922005
D.bunnanda,151823105,VNKE01003569.1,1,8558,5.63682e-05,139990242,0.922062
D.bunnanda,151823105,VNKE01002998.1,1,8556,5.63551e-05,139998798,0.922118
D.bunnanda,151823105,VNKE01000552.1,1,8554,5.63419e-05,140007352,0.922174
D.bunnanda,151823105,VNKE01000922.1,1,8539,5.62431e-05,140015891,0.92223
D.bunnanda,151823105,VNKE01000891.1,1,8520,5.61179e-05,140024411,0.922287
D.bunnanda,151823105,VNKE01003491.1,1,8512,5.60652e-05,140032923,0.922343
D.bunnanda,151823105,VNKE01006087.1,1,8492,5.59335e-05,140041415,0.922399
D.bunnanda,151823105,VNKE01001149.1,1,8492,5.59335e-05,140049907,0.922455
D.bunnanda,151823105,VNKE01003837.1,1,8491,5.59269e-05,140058398,0.92251
D.bunnanda,151823105,VNKE01003774.1,1,8488,5.59072e-05,140066886,0.922566
D.bunnanda,151823105,VNKE01006000.1,1,8487,5.59006e-05,140075373,0.922622
D.bunnanda,151823105,VNKE01001457.1,1,8482,5.58676e-05,140083855,0.922678
D.bunnanda,151823105,VNKE01000017.1,1,8470,5.57886e-05,140092325,0.922734
D.bunnanda,151823105,VNKE01002008.1,1,8466,5.57623e-05,140100791,0.92279
D.bunnanda,151823105,VNKE01004163.1,1,8459,5.57162e-05,140109250,0.922845
D.bunnanda,151823105,VNKE01005553.1,1,8458,5.57096e-05,140117708,0.922901
D.bunnanda,151823105,VNKE01000972.1,1,8449,5.56503e-05,140126157,0.922957
D.bunnanda,151823105,VNKE01006253.1,1,8446,5.56305e-05,140134603,0.923012
D.bunnanda,151823105,VNKE01000640.1,1,8444,5.56174e-05,140143047,0.923068
D.bunnanda,151823105,VNKE01002359.1,1,8441,5.55976e-05,140151488,0.923124
D.bunnanda,151823105,VNKE01001512.1,1,8421,5.54659e-05,140159909,0.923179
D.bunnanda,151823105,VNKE01000126.1,1,8412,5.54066e-05,140168321,0.923234
D.bunnanda,151823105,VNKE01005941.1,1,8406,5.53671e-05,140176727,0.92329
D.bunnanda,151823105,VNKE01003412.1,1,8402,5.53407e-05,140185129,0.923345
D.bunnanda,151823105,VNKE01004287.1,1,8400,5.53275e-05,140193529,0.9234
D.bunnanda,151823105,VNKE01000281.1,1,8399,5.5321e-05,140201928,0.923456
D.bunnanda,151823105,VNKE01003397.1,1,8389,5.52551e-05,140210317,0.923511
D.bunnanda,151823105,VNKE01004317.1,1,8384,5.52222e-05,140218701,0.923566
D.bunnanda,151823105,VNKE01003482.1,1,8371,5.51365e-05,140227072,0.923621
D.bunnanda,151823105,VNKE01001316.1,1,8363,5.50838e-05,140235435,0.923677
D.bunnanda,151823105,VNKE01000641.1,1,8361,5.50707e-05,140243796,0.923732
D.bunnanda,151823105,VNKE01002818.1,1,8357,5.50443e-05,140252153,0.923787
D.bunnanda,151823105,VNKE01000720.1,1,8356,5.50377e-05,140260509,0.923842
D.bunnanda,151823105,VNKE01003449.1,1,8352,5.50114e-05,140268861,0.923897
D.bunnanda,151823105,VNKE01001321.1,1,8345,5.49653e-05,140277206,0.923952
D.bunnanda,151823105,VNKE01001113.1,1,8312,5.47479e-05,140285518,0.924006
D.bunnanda,151823105,VNKE01005555.1,1,8302,5.46821e-05,140293820,0.924061
D.bunnanda,151823105,VNKE01003548.1,1,8302,5.46821e-05,140302122,0.924116
D.bunnanda,151823105,VNKE01006277.1,1,8283,5.45569e-05,140310405,0.92417
D.bunnanda,151823105,VNKE01000550.1,1,8272,5.44845e-05,140318677,0.924225
D.bunnanda,151823105,VNKE01003815.1,1,8265,5.44384e-05,140326942,0.924279
D.bunnanda,151823105,VNKE01003714.1,1,8226,5.41815e-05,140335168,0.924333
D.bunnanda,151823105,VNKE01001761.1,1,8222,5.41551e-05,140343390,0.924388
D.bunnanda,151823105,VNKE01004692.1,1,8210,5.40761e-05,140351600,0.924442
D.bunnanda,151823105,VNKE01002242.1,1,8203,5.403e-05,140359803,0.924496
D.bunnanda,151823105,VNKE01004441.1,1,8201,5.40168e-05,140368004,0.92455
D.bunnanda,151823105,VNKE01001661.1,1,8200,5.40102e-05,140376204,0.924604
D.bunnanda,151823105,VNKE01001826.1,1,8199,5.40036e-05,140384403,0.924658
D.bunnanda,151823105,VNKE01005711.1,1,8198,5.39971e-05,140392601,0.924712
D.bunnanda,151823105,VNKE01001291.1,1,8197,5.39905e-05,140400798,0.924766
D.bunnanda,151823105,VNKE01001610.1,1,8194,5.39707e-05,140408992,0.92482
D.bunnanda,151823105,VNKE01003314.1,1,8183,5.38983e-05,140417175,0.924874
D.bunnanda,151823105,VNKE01005628.1,1,8168,5.37995e-05,140425343,0.924927
D.bunnanda,151823105,VNKE01004221.1,1,8168,5.37995e-05,140433511,0.924981
D.bunnanda,151823105,VNKE01003954.1,1,8168,5.37995e-05,140441679,0.925035
D.bunnanda,151823105,VNKE01002554.1,1,8168,5.37995e-05,140449847,0.925089
D.bunnanda,151823105,VNKE01005071.1,1,8167,5.37929e-05,140458014,0.925143
D.bunnanda,151823105,VNKE01004568.1,1,8148,5.36677e-05,140466162,0.925196
D.bunnanda,151823105,VNKE01006487.1,1,8146,5.36545e-05,140474308,0.92525
D.bunnanda,151823105,VNKE01000166.1,1,8144,5.36414e-05,140482452,0.925304
D.bunnanda,151823105,VNKE01005845.1,1,8137,5.35953e-05,140490589,0.925357
D.bunnanda,151823105,VNKE01000500.1,1,8136,5.35887e-05,140498725,0.925411
D.bunnanda,151823105,VNKE01002854.1,1,8131,5.35557e-05,140506856,0.925464
D.bunnanda,151823105,VNKE01000011.1,1,8125,5.35162e-05,140514981,0.925518
D.bunnanda,151823105,VNKE01005897.1,1,8121,5.34899e-05,140523102,0.925571
D.bunnanda,151823105,VNKE01000739.1,1,8110,5.34174e-05,140531212,0.925625
D.bunnanda,151823105,VNKE01000948.1,1,8094,5.3312e-05,140539306,0.925678
D.bunnanda,151823105,VNKE01001520.1,1,8091,5.32923e-05,140547397,0.925731
D.bunnanda,151823105,VNKE01006544.1,1,8084,5.32462e-05,140555481,0.925785
D.bunnanda,151823105,VNKE01001110.1,1,8080,5.32198e-05,140563561,0.925838
D.bunnanda,151823105,VNKE01000734.1,1,8078,5.32067e-05,140571639,0.925891
D.bunnanda,151823105,VNKE01000218.1,1,8075,5.31869e-05,140579714,0.925944
D.bunnanda,151823105,VNKE01004969.1,1,8062,5.31013e-05,140587776,0.925997
D.bunnanda,151823105,VNKE01005494.1,1,8058,5.30749e-05,140595834,0.92605
D.bunnanda,151823105,VNKE01001940.1,1,8058,5.30749e-05,140603892,0.926103
D.bunnanda,151823105,VNKE01004114.1,1,8051,5.30288e-05,140611943,0.926156
D.bunnanda,151823105,VNKE01005016.1,1,8019,5.2818e-05,140619962,0.926209
D.bunnanda,151823105,VNKE01001616.1,1,8018,5.28115e-05,140627980,0.926262
D.bunnanda,151823105,VNKE01005820.1,1,8003,5.27127e-05,140635983,0.926315
D.bunnanda,151823105,VNKE01001618.1,1,8001,5.26995e-05,140643984,0.926367
D.bunnanda,151823105,VNKE01004032.1,1,7999,5.26863e-05,140651983,0.92642
D.bunnanda,151823105,VNKE01002654.1,1,7999,5.26863e-05,140659982,0.926473
D.bunnanda,151823105,VNKE01000871.1,1,7993,5.26468e-05,140667975,0.926525
D.bunnanda,151823105,VNKE01000592.1,1,7990,5.2627e-05,140675965,0.926578
D.bunnanda,151823105,VNKE01004922.1,1,7985,5.25941e-05,140683950,0.926631
D.bunnanda,151823105,VNKE01004259.1,1,7971,5.25019e-05,140691921,0.926683
D.bunnanda,151823105,VNKE01000556.1,1,7957,5.24097e-05,140699878,0.926736
D.bunnanda,151823105,VNKE01004044.1,1,7955,5.23965e-05,140707833,0.926788
D.bunnanda,151823105,VNKE01005257.1,1,7953,5.23833e-05,140715786,0.92684
D.bunnanda,151823105,VNKE01004809.1,1,7936,5.22714e-05,140723722,0.926893
D.bunnanda,151823105,VNKE01000911.1,1,7932,5.2245e-05,140731654,0.926945
D.bunnanda,151823105,VNKE01005373.1,1,7920,5.2166e-05,140739574,0.926997
D.bunnanda,151823105,VNKE01001824.1,1,7901,5.20408e-05,140747475,0.927049
D.bunnanda,151823105,VNKE01002517.1,1,7896,5.20079e-05,140755371,0.927101
D.bunnanda,151823105,VNKE01005487.1,1,7892,5.19815e-05,140763263,0.927153
D.bunnanda,151823105,VNKE01004049.1,1,7892,5.19815e-05,140771155,0.927205
D.bunnanda,151823105,VNKE01000700.1,1,7892,5.19815e-05,140779047,0.927257
D.bunnanda,151823105,VNKE01001860.1,1,7884,5.19289e-05,140786931,0.927309
D.bunnanda,151823105,VNKE01000888.1,1,7881,5.19091e-05,140794812,0.927361
D.bunnanda,151823105,VNKE01006374.1,1,7880,5.19025e-05,140802692,0.927413
D.bunnanda,151823105,VNKE01004050.1,1,7877,5.18827e-05,140810569,0.927465
D.bunnanda,151823105,VNKE01005935.1,1,7874,5.1863e-05,140818443,0.927517
D.bunnanda,151823105,VNKE01000284.1,1,7861,5.17774e-05,140826304,0.927568
D.bunnanda,151823105,VNKE01003402.1,1,7849,5.16983e-05,140834153,0.92762
D.bunnanda,151823105,VNKE01006207.1,1,7843,5.16588e-05,140841996,0.927672
D.bunnanda,151823105,VNKE01003326.1,1,7840,5.1639e-05,140849836,0.927723
D.bunnanda,151823105,VNKE01003335.1,1,7836,5.16127e-05,140857672,0.927775
D.bunnanda,151823105,VNKE01003122.1,1,7819,5.15007e-05,140865491,0.927826
D.bunnanda,151823105,VNKE01005448.1,1,7804,5.14019e-05,140873295,0.927878
D.bunnanda,151823105,VNKE01002652.1,1,7792,5.13229e-05,140881087,0.927929
D.bunnanda,151823105,VNKE01003179.1,1,7789,5.13031e-05,140888876,0.92798
D.bunnanda,151823105,VNKE01003173.1,1,7788,5.12965e-05,140896664,0.928032
D.bunnanda,151823105,VNKE01004450.1,1,7786,5.12834e-05,140904450,0.928083
D.bunnanda,151823105,VNKE01003545.1,1,7784,5.12702e-05,140912234,0.928134
D.bunnanda,151823105,VNKE01006533.1,1,7774,5.12043e-05,140920008,0.928186
D.bunnanda,151823105,VNKE01006120.1,1,7717,5.08289e-05,140927725,0.928236
D.bunnanda,151823105,VNKE01004820.1,1,7710,5.07828e-05,140935435,0.928287
D.bunnanda,151823105,VNKE01003095.1,1,7702,5.07301e-05,140943137,0.928338
D.bunnanda,151823105,VNKE01004773.1,1,7698,5.07037e-05,140950835,0.928389
D.bunnanda,151823105,VNKE01001746.1,1,7694,5.06774e-05,140958529,0.928439
D.bunnanda,151823105,VNKE01001764.1,1,7681,5.05918e-05,140966210,0.92849
D.bunnanda,151823105,VNKE01000884.1,1,7681,5.05918e-05,140973891,0.92854
D.bunnanda,151823105,VNKE01004780.1,1,7674,5.05457e-05,140981565,0.928591
D.bunnanda,151823105,VNKE01005615.1,1,7662,5.04666e-05,140989227,0.928641
D.bunnanda,151823105,VNKE01001337.1,1,7650,5.03876e-05,140996877,0.928692
D.bunnanda,151823105,VNKE01004732.1,1,7638,5.03085e-05,141004515,0.928742
D.bunnanda,151823105,VNKE01001515.1,1,7631,5.02624e-05,141012146,0.928792
D.bunnanda,151823105,VNKE01004745.1,1,7624,5.02163e-05,141019770,0.928843
D.bunnanda,151823105,VNKE01004753.1,1,7610,5.01241e-05,141027380,0.928893
D.bunnanda,151823105,VNKE01006371.1,1,7591,4.9999e-05,141034971,0.928943
D.bunnanda,151823105,VNKE01005341.1,1,7585,4.99595e-05,141042556,0.928993
D.bunnanda,151823105,VNKE01006221.1,1,7583,4.99463e-05,141050139,0.929043
D.bunnanda,151823105,VNKE01000886.1,1,7563,4.98146e-05,141057702,0.929092
D.bunnanda,151823105,VNKE01002462.1,1,7558,4.97816e-05,141065260,0.929142
D.bunnanda,151823105,VNKE01003026.1,1,7545,4.9696e-05,141072805,0.929192
D.bunnanda,151823105,VNKE01000400.1,1,7524,4.95577e-05,141080329,0.929241
D.bunnanda,151823105,VNKE01004533.1,1,7521,4.95379e-05,141087850,0.929291
D.bunnanda,151823105,VNKE01000445.1,1,7516,4.9505e-05,141095366,0.929341
D.bunnanda,151823105,VNKE01004973.1,1,7515,4.94984e-05,141102881,0.92939
D.bunnanda,151823105,VNKE01002668.1,1,7504,4.94259e-05,141110385,0.929439
D.bunnanda,151823105,VNKE01000118.1,1,7485,4.93008e-05,141117870,0.929489
D.bunnanda,151823105,VNKE01004812.1,1,7483,4.92876e-05,141125353,0.929538
D.bunnanda,151823105,VNKE01002785.1,1,7481,4.92745e-05,141132834,0.929587
D.bunnanda,151823105,VNKE01000442.1,1,7476,4.92415e-05,141140310,0.929637
D.bunnanda,151823105,VNKE01000975.1,1,7470,4.9202e-05,141147780,0.929686
D.bunnanda,151823105,VNKE01003515.1,1,7469,4.91954e-05,141155249,0.929735
D.bunnanda,151823105,VNKE01005979.1,1,7452,4.90834e-05,141162701,0.929784
D.bunnanda,151823105,VNKE01006021.1,1,7450,4.90703e-05,141170151,0.929833
D.bunnanda,151823105,VNKE01001640.1,1,7433,4.89583e-05,141177584,0.929882
D.bunnanda,151823105,VNKE01005750.1,1,7432,4.89517e-05,141185016,0.929931
D.bunnanda,151823105,VNKE01002848.1,1,7417,4.88529e-05,141192433,0.92998
D.bunnanda,151823105,VNKE01002463.1,1,7414,4.88331e-05,141199847,0.930029
D.bunnanda,151823105,VNKE01005197.1,1,7410,4.88068e-05,141207257,0.930078
D.bunnanda,151823105,VNKE01002883.1,1,7407,4.8787e-05,141214664,0.930126
D.bunnanda,151823105,VNKE01005584.1,1,7406,4.87805e-05,141222070,0.930175
D.bunnanda,151823105,VNKE01004572.1,1,7399,4.87343e-05,141229469,0.930224
D.bunnanda,151823105,VNKE01005236.1,1,7397,4.87212e-05,141236866,0.930273
D.bunnanda,151823105,VNKE01001532.1,1,7392,4.86882e-05,141244258,0.930321
D.bunnanda,151823105,VNKE01006380.1,1,7380,4.86092e-05,141251638,0.93037
D.bunnanda,151823105,VNKE01005970.1,1,7375,4.85763e-05,141259013,0.930418
D.bunnanda,151823105,VNKE01004970.1,1,7362,4.84906e-05,141266375,0.930467
D.bunnanda,151823105,VNKE01005177.1,1,7357,4.84577e-05,141273732,0.930515
D.bunnanda,151823105,VNKE01003302.1,1,7354,4.8438e-05,141281086,0.930564
D.bunnanda,151823105,VNKE01001823.1,1,7350,4.84116e-05,141288436,0.930612
D.bunnanda,151823105,VNKE01005518.1,1,7346,4.83853e-05,141295782,0.930661
D.bunnanda,151823105,VNKE01002026.1,1,7346,4.83853e-05,141303128,0.930709
D.bunnanda,151823105,VNKE01000360.1,1,7338,4.83326e-05,141310466,0.930757
D.bunnanda,151823105,VNKE01003390.1,1,7328,4.82667e-05,141317794,0.930806
D.bunnanda,151823105,VNKE01005769.1,1,7326,4.82535e-05,141325120,0.930854
D.bunnanda,151823105,VNKE01004737.1,1,7323,4.82338e-05,141332443,0.930902
D.bunnanda,151823105,VNKE01006025.1,1,7320,4.8214e-05,141339763,0.93095
D.bunnanda,151823105,VNKE01005056.1,1,7311,4.81547e-05,141347074,0.930998
D.bunnanda,151823105,VNKE01003168.1,1,7300,4.80823e-05,141354374,0.931047
D.bunnanda,151823105,VNKE01003398.1,1,7298,4.80691e-05,141361672,0.931095
D.bunnanda,151823105,VNKE01000885.1,1,7295,4.80493e-05,141368967,0.931143
D.bunnanda,151823105,VNKE01006585.1,1,7288,4.80032e-05,141376255,0.931191
D.bunnanda,151823105,VNKE01001533.1,1,7288,4.80032e-05,141383543,0.931239
D.bunnanda,151823105,VNKE01005225.1,1,7279,4.7944e-05,141390822,0.931287
D.bunnanda,151823105,VNKE01004293.1,1,7277,4.79308e-05,141398099,0.931335
D.bunnanda,151823105,VNKE01002888.1,1,7244,4.77134e-05,141405343,0.931382
D.bunnanda,151823105,VNKE01001729.1,1,7244,4.77134e-05,141412587,0.93143
D.bunnanda,151823105,VNKE01004716.1,1,7236,4.76607e-05,141419823,0.931478
D.bunnanda,151823105,VNKE01006209.1,1,7230,4.76212e-05,141427053,0.931525
D.bunnanda,151823105,VNKE01002853.1,1,7218,4.75422e-05,141434271,0.931573
D.bunnanda,151823105,VNKE01000810.1,1,7218,4.75422e-05,141441489,0.93162
D.bunnanda,151823105,VNKE01000172.1,1,7213,4.75092e-05,141448702,0.931668
D.bunnanda,151823105,VNKE01000797.1,1,7205,4.74565e-05,141455907,0.931715
D.bunnanda,151823105,VNKE01004733.1,1,7203,4.74434e-05,141463110,0.931763
D.bunnanda,151823105,VNKE01004531.1,1,7200,4.74236e-05,141470310,0.93181
D.bunnanda,151823105,VNKE01005252.1,1,7195,4.73907e-05,141477505,0.931858
D.bunnanda,151823105,VNKE01005196.1,1,7183,4.73116e-05,141484688,0.931905
D.bunnanda,151823105,VNKE01005782.1,1,7177,4.72721e-05,141491865,0.931952
D.bunnanda,151823105,VNKE01003200.1,1,7172,4.72392e-05,141499037,0.931999
D.bunnanda,151823105,VNKE01004357.1,1,7156,4.71338e-05,141506193,0.932046
D.bunnanda,151823105,VNKE01002657.1,1,7150,4.70943e-05,141513343,0.932094
D.bunnanda,151823105,VNKE01004255.1,1,7149,4.70877e-05,141520492,0.932141
D.bunnanda,151823105,VNKE01005565.1,1,7137,4.70087e-05,141527629,0.932188
D.bunnanda,151823105,VNKE01000309.1,1,7135,4.69955e-05,141534764,0.932235
D.bunnanda,151823105,VNKE01004735.1,1,7134,4.69889e-05,141541898,0.932282
D.bunnanda,151823105,VNKE01005842.1,1,7133,4.69823e-05,141549031,0.932329
D.bunnanda,151823105,VNKE01005218.1,1,7131,4.69691e-05,141556162,0.932376
D.bunnanda,151823105,VNKE01002173.1,1,7129,4.6956e-05,141563291,0.932423
D.bunnanda,151823105,VNKE01006270.1,1,7128,4.69494e-05,141570419,0.93247
D.bunnanda,151823105,VNKE01004297.1,1,7118,4.68835e-05,141577537,0.932516
D.bunnanda,151823105,VNKE01002251.1,1,7117,4.68769e-05,141584654,0.932563
D.bunnanda,151823105,VNKE01001548.1,1,7101,4.67715e-05,141591755,0.93261
D.bunnanda,151823105,VNKE01000136.1,1,7099,4.67584e-05,141598854,0.932657
D.bunnanda,151823105,VNKE01001430.1,1,7097,4.67452e-05,141605951,0.932704
D.bunnanda,151823105,VNKE01001057.1,1,7093,4.67188e-05,141613044,0.93275
D.bunnanda,151823105,VNKE01004057.1,1,7090,4.66991e-05,141620134,0.932797
D.bunnanda,151823105,VNKE01005818.1,1,7088,4.66859e-05,141627222,0.932844
D.bunnanda,151823105,VNKE01000531.1,1,7081,4.66398e-05,141634303,0.93289
D.bunnanda,151823105,VNKE01003184.1,1,7074,4.65937e-05,141641377,0.932937
D.bunnanda,151823105,VNKE01004890.1,1,7070,4.65674e-05,141648447,0.932983
D.bunnanda,151823105,VNKE01006116.1,1,7069,4.65608e-05,141655516,0.93303
D.bunnanda,151823105,VNKE01000910.1,1,7067,4.65476e-05,141662583,0.933077
D.bunnanda,151823105,VNKE01003516.1,1,7065,4.65344e-05,141669648,0.933123
D.bunnanda,151823105,VNKE01002119.1,1,7059,4.64949e-05,141676707,0.93317
D.bunnanda,151823105,VNKE01004347.1,1,7044,4.63961e-05,141683751,0.933216
D.bunnanda,151823105,VNKE01003020.1,1,7043,4.63895e-05,141690794,0.933262
D.bunnanda,151823105,VNKE01005481.1,1,7037,4.635e-05,141697831,0.933309
D.bunnanda,151823105,VNKE01002781.1,1,7023,4.62578e-05,141704854,0.933355
D.bunnanda,151823105,VNKE01005780.1,1,7002,4.61195e-05,141711856,0.933401
D.bunnanda,151823105,VNKE01001072.1,1,6970,4.59087e-05,141718826,0.933447
D.bunnanda,151823105,VNKE01002285.1,1,6969,4.59021e-05,141725795,0.933493
D.bunnanda,151823105,VNKE01006376.1,1,6965,4.58758e-05,141732760,0.933539
D.bunnanda,151823105,VNKE01005266.1,1,6960,4.58428e-05,141739720,0.933585
D.bunnanda,151823105,VNKE01001227.1,1,6958,4.58297e-05,141746678,0.93363
D.bunnanda,151823105,VNKE01006412.1,1,6946,4.57506e-05,141753624,0.933676
D.bunnanda,151823105,VNKE01002949.1,1,6945,4.5744e-05,141760569,0.933722
D.bunnanda,151823105,VNKE01003214.1,1,6943,4.57309e-05,141767512,0.933768
D.bunnanda,151823105,VNKE01000895.1,1,6940,4.57111e-05,141774452,0.933813
D.bunnanda,151823105,VNKE01005846.1,1,6935,4.56782e-05,141781387,0.933859
D.bunnanda,151823105,VNKE01005034.1,1,6926,4.56189e-05,141788313,0.933905
D.bunnanda,151823105,VNKE01003116.1,1,6926,4.56189e-05,141795239,0.93395
D.bunnanda,151823105,VNKE01002082.1,1,6926,4.56189e-05,141802165,0.933996
D.bunnanda,151823105,VNKE01002365.1,1,6923,4.55991e-05,141809088,0.934042
D.bunnanda,151823105,VNKE01001601.1,1,6922,4.55925e-05,141816010,0.934087
D.bunnanda,151823105,VNKE01002346.1,1,6898,4.54345e-05,141822908,0.934133
D.bunnanda,151823105,VNKE01003755.1,1,6895,4.54147e-05,141829803,0.934178
D.bunnanda,151823105,VNKE01005408.1,1,6894,4.54081e-05,141836697,0.934223
D.bunnanda,151823105,VNKE01005216.1,1,6887,4.5362e-05,141843584,0.934269
D.bunnanda,151823105,VNKE01000979.1,1,6880,4.53159e-05,141850464,0.934314
D.bunnanda,151823105,VNKE01002534.1,1,6878,4.53027e-05,141857342,0.934359
D.bunnanda,151823105,VNKE01004161.1,1,6875,4.5283e-05,141864217,0.934405
D.bunnanda,151823105,VNKE01005933.1,1,6872,4.52632e-05,141871089,0.93445
D.bunnanda,151823105,VNKE01004298.1,1,6869,4.52434e-05,141877958,0.934495
D.bunnanda,151823105,VNKE01004927.1,1,6866,4.52237e-05,141884824,0.93454
D.bunnanda,151823105,VNKE01005425.1,1,6864,4.52105e-05,141891688,0.934586
D.bunnanda,151823105,VNKE01005276.1,1,6863,4.52039e-05,141898551,0.934631
D.bunnanda,151823105,VNKE01001825.1,1,6850,4.51183e-05,141905401,0.934676
D.bunnanda,151823105,VNKE01005517.1,1,6846,4.5092e-05,141912247,0.934721
D.bunnanda,151823105,VNKE01002503.1,1,6846,4.5092e-05,141919093,0.934766
D.bunnanda,151823105,VNKE01003542.1,1,6843,4.50722e-05,141925936,0.934811
D.bunnanda,151823105,VNKE01002125.1,1,6842,4.50656e-05,141932778,0.934856
D.bunnanda,151823105,VNKE01004468.1,1,6840,4.50524e-05,141939618,0.934901
D.bunnanda,151823105,VNKE01005709.1,1,6836,4.50261e-05,141946454,0.934946
D.bunnanda,151823105,VNKE01001228.1,1,6827,4.49668e-05,141953281,0.934991
D.bunnanda,151823105,VNKE01001111.1,1,6824,4.4947e-05,141960105,0.935036
D.bunnanda,151823105,VNKE01005088.1,1,6812,4.4868e-05,141966917,0.935081
D.bunnanda,151823105,VNKE01004965.1,1,6806,4.48285e-05,141973723,0.935126
D.bunnanda,151823105,VNKE01001167.1,1,6804,4.48153e-05,141980527,0.935171
D.bunnanda,151823105,VNKE01003050.1,1,6802,4.48021e-05,141987329,0.935216
D.bunnanda,151823105,VNKE01004351.1,1,6796,4.47626e-05,141994125,0.93526
D.bunnanda,151823105,VNKE01004476.1,1,6795,4.4756e-05,142000920,0.935305
D.bunnanda,151823105,VNKE01001078.1,1,6792,4.47363e-05,142007712,0.93535
D.bunnanda,151823105,VNKE01001622.1,1,6781,4.46638e-05,142014493,0.935394
D.bunnanda,151823105,VNKE01006148.1,1,6780,4.46572e-05,142021273,0.935439
D.bunnanda,151823105,VNKE01004654.1,1,6765,4.45584e-05,142028038,0.935484
D.bunnanda,151823105,VNKE01001609.1,1,6757,4.45057e-05,142034795,0.935528
D.bunnanda,151823105,VNKE01005446.1,1,6752,4.44728e-05,142041547,0.935573
D.bunnanda,151823105,VNKE01002649.1,1,6747,4.44399e-05,142048294,0.935617
D.bunnanda,151823105,VNKE01002757.1,1,6727,4.43081e-05,142055021,0.935661
D.bunnanda,151823105,VNKE01002120.1,1,6726,4.43016e-05,142061747,0.935706
D.bunnanda,151823105,VNKE01000787.1,1,6724,4.42884e-05,142068471,0.93575
D.bunnanda,151823105,VNKE01002850.1,1,6723,4.42818e-05,142075194,0.935794
D.bunnanda,151823105,VNKE01005906.1,1,6718,4.42489e-05,142081912,0.935839
D.bunnanda,151823105,VNKE01005858.1,1,6715,4.42291e-05,142088627,0.935883
D.bunnanda,151823105,VNKE01005295.1,1,6710,4.41962e-05,142095337,0.935927
D.bunnanda,151823105,VNKE01003117.1,1,6710,4.41962e-05,142102047,0.935971
D.bunnanda,151823105,VNKE01000893.1,1,6709,4.41896e-05,142108756,0.936015
D.bunnanda,151823105,VNKE01002156.1,1,6698,4.41171e-05,142115454,0.936059
D.bunnanda,151823105,VNKE01000165.1,1,6694,4.40908e-05,142122148,0.936104
D.bunnanda,151823105,VNKE01000572.1,1,6693,4.40842e-05,142128841,0.936148
D.bunnanda,151823105,VNKE01005667.1,1,6686,4.40381e-05,142135527,0.936192
D.bunnanda,151823105,VNKE01004237.1,1,6686,4.40381e-05,142142213,0.936236
D.bunnanda,151823105,VNKE01001279.1,1,6686,4.40381e-05,142148899,0.93628
D.bunnanda,151823105,VNKE01002538.1,1,6684,4.40249e-05,142155583,0.936324
D.bunnanda,151823105,VNKE01001162.1,1,6679,4.3992e-05,142162262,0.936368
D.bunnanda,151823105,VNKE01001402.1,1,6671,4.39393e-05,142168933,0.936412
D.bunnanda,151823105,VNKE01000820.1,1,6670,4.39327e-05,142175603,0.936456
D.bunnanda,151823105,VNKE01005366.1,1,6664,4.38932e-05,142182267,0.9365
D.bunnanda,151823105,VNKE01003697.1,1,6659,4.38603e-05,142188926,0.936543
D.bunnanda,151823105,VNKE01003676.1,1,6648,4.37878e-05,142195574,0.936587
D.bunnanda,151823105,VNKE01005220.1,1,6639,4.37285e-05,142202213,0.936631
D.bunnanda,151823105,VNKE01004431.1,1,6632,4.36824e-05,142208845,0.936675
D.bunnanda,151823105,VNKE01004273.1,1,6623,4.36231e-05,142215468,0.936718
D.bunnanda,151823105,VNKE01004982.1,1,6582,4.33531e-05,142222050,0.936762
D.bunnanda,151823105,VNKE01001624.1,1,6580,4.33399e-05,142228630,0.936805
D.bunnanda,151823105,VNKE01001834.1,1,6573,4.32938e-05,142235203,0.936848
D.bunnanda,151823105,VNKE01001414.1,1,6572,4.32872e-05,142241775,0.936891
D.bunnanda,151823105,VNKE01006586.1,1,6569,4.32675e-05,142248344,0.936935
D.bunnanda,151823105,VNKE01002851.1,1,6564,4.32345e-05,142254908,0.936978
D.bunnanda,151823105,VNKE01005546.1,1,6560,4.32082e-05,142261468,0.937021
D.bunnanda,151823105,VNKE01003996.1,1,6560,4.32082e-05,142268028,0.937064
D.bunnanda,151823105,VNKE01001186.1,1,6558,4.3195e-05,142274586,0.937108
D.bunnanda,151823105,VNKE01006564.1,1,6557,4.31884e-05,142281143,0.937151
D.bunnanda,151823105,VNKE01003082.1,1,6556,4.31818e-05,142287699,0.937194
D.bunnanda,151823105,VNKE01005942.1,1,6554,4.31687e-05,142294253,0.937237
D.bunnanda,151823105,VNKE01000167.1,1,6541,4.3083e-05,142300794,0.93728
D.bunnanda,151823105,VNKE01003861.1,1,6524,4.29711e-05,142307318,0.937323
D.bunnanda,151823105,VNKE01002678.1,1,6518,4.29315e-05,142313836,0.937366
D.bunnanda,151823105,VNKE01005369.1,1,6503,4.28327e-05,142320339,0.937409
D.bunnanda,151823105,VNKE01003866.1,1,6501,4.28196e-05,142326840,0.937452
D.bunnanda,151823105,VNKE01006370.1,1,6499,4.28064e-05,142333339,0.937495
D.bunnanda,151823105,VNKE01001076.1,1,6485,4.27142e-05,142339824,0.937537
D.bunnanda,151823105,VNKE01001190.1,1,6482,4.26944e-05,142346306,0.93758
D.bunnanda,151823105,VNKE01000657.1,1,6478,4.26681e-05,142352784,0.937623
D.bunnanda,151823105,VNKE01006260.1,1,6476,4.26549e-05,142359260,0.937665
D.bunnanda,151823105,VNKE01005058.1,1,6473,4.26351e-05,142365733,0.937708
D.bunnanda,151823105,VNKE01003475.1,1,6466,4.2589e-05,142372199,0.937751
D.bunnanda,151823105,VNKE01000908.1,1,6466,4.2589e-05,142378665,0.937793
D.bunnanda,151823105,VNKE01005388.1,1,6459,4.25429e-05,142385124,0.937836
D.bunnanda,151823105,VNKE01006494.1,1,6457,4.25298e-05,142391581,0.937878
D.bunnanda,151823105,VNKE01003313.1,1,6457,4.25298e-05,142398038,0.937921
D.bunnanda,151823105,VNKE01005162.1,1,6453,4.25034e-05,142404491,0.937963
D.bunnanda,151823105,VNKE01004758.1,1,6448,4.24705e-05,142410939,0.938006
D.bunnanda,151823105,VNKE01005174.1,1,6444,4.24441e-05,142417383,0.938048
D.bunnanda,151823105,VNKE01006422.1,1,6438,4.24046e-05,142423821,0.938091
D.bunnanda,151823105,VNKE01006373.1,1,6437,4.2398e-05,142430258,0.938133
D.bunnanda,151823105,VNKE01001007.1,1,6436,4.23914e-05,142436694,0.938175
D.bunnanda,151823105,VNKE01005000.1,1,6430,4.23519e-05,142443124,0.938218
D.bunnanda,151823105,VNKE01000510.1,1,6426,4.23256e-05,142449550,0.93826
D.bunnanda,151823105,VNKE01006144.1,1,6411,4.22268e-05,142455961,0.938302
D.bunnanda,151823105,VNKE01005666.1,1,6406,4.21938e-05,142462367,0.938344
D.bunnanda,151823105,VNKE01001980.1,1,6398,4.21411e-05,142468765,0.938387
D.bunnanda,151823105,VNKE01003300.1,1,6391,4.2095e-05,142475156,0.938429
D.bunnanda,151823105,VNKE01004876.1,1,6389,4.20819e-05,142481545,0.938471
D.bunnanda,151823105,VNKE01004282.1,1,6387,4.20687e-05,142487932,0.938513
D.bunnanda,151823105,VNKE01003485.1,1,6386,4.20621e-05,142494318,0.938555
D.bunnanda,151823105,VNKE01001623.1,1,6380,4.20226e-05,142500698,0.938597
D.bunnanda,151823105,VNKE01002031.1,1,6377,4.20028e-05,142507075,0.938639
D.bunnanda,151823105,VNKE01000906.1,1,6370,4.19567e-05,142513445,0.938681
D.bunnanda,151823105,VNKE01006202.1,1,6369,4.19501e-05,142519814,0.938723
D.bunnanda,151823105,VNKE01003728.1,1,6367,4.1937e-05,142526181,0.938765
D.bunnanda,151823105,VNKE01002378.1,1,6367,4.1937e-05,142532548,0.938807
D.bunnanda,151823105,VNKE01001844.1,1,6364,4.19172e-05,142538912,0.938849
D.bunnanda,151823105,VNKE01001241.1,1,6358,4.18777e-05,142545270,0.93889
D.bunnanda,151823105,VNKE01002121.1,1,6355,4.18579e-05,142551625,0.938932
D.bunnanda,151823105,VNKE01004168.1,1,6349,4.18184e-05,142557974,0.938974
D.bunnanda,151823105,VNKE01001128.1,1,6349,4.18184e-05,142564323,0.939016
D.bunnanda,151823105,VNKE01005969.1,1,6337,4.17394e-05,142570660,0.939058
D.bunnanda,151823105,VNKE01004988.1,1,6336,4.17328e-05,142576996,0.939099
D.bunnanda,151823105,VNKE01004292.1,1,6311,4.15681e-05,142583307,0.939141
D.bunnanda,151823105,VNKE01006282.1,1,6309,4.15549e-05,142589616,0.939183
D.bunnanda,151823105,VNKE01005987.1,1,6307,4.15418e-05,142595923,0.939224
D.bunnanda,151823105,VNKE01005004.1,1,6305,4.15286e-05,142602228,0.939266
D.bunnanda,151823105,VNKE01001448.1,1,6300,4.14957e-05,142608528,0.939307
D.bunnanda,151823105,VNKE01000159.1,1,6300,4.14957e-05,142614828,0.939349
D.bunnanda,151823105,VNKE01001415.1,1,6299,4.14891e-05,142621127,0.93939
D.bunnanda,151823105,VNKE01004080.1,1,6297,4.14759e-05,142627424,0.939432
D.bunnanda,151823105,VNKE01002468.1,1,6286,4.14034e-05,142633710,0.939473
D.bunnanda,151823105,VNKE01002002.1,1,6284,4.13903e-05,142639994,0.939514
D.bunnanda,151823105,VNKE01001949.1,1,6282,4.13771e-05,142646276,0.939556
D.bunnanda,151823105,VNKE01001602.1,1,6275,4.1331e-05,142652551,0.939597
D.bunnanda,151823105,VNKE01002208.1,1,6262,4.12454e-05,142658813,0.939638
D.bunnanda,151823105,VNKE01004736.1,1,6260,4.12322e-05,142665073,0.93968
D.bunnanda,151823105,VNKE01000512.1,1,6259,4.12256e-05,142671332,0.939721
D.bunnanda,151823105,VNKE01006149.1,1,6256,4.12058e-05,142677588,0.939762
D.bunnanda,151823105,VNKE01002367.1,1,6256,4.12058e-05,142683844,0.939803
D.bunnanda,151823105,VNKE01001306.1,1,6248,4.11532e-05,142690092,0.939844
D.bunnanda,151823105,VNKE01001996.1,1,6247,4.11466e-05,142696339,0.939886
D.bunnanda,151823105,VNKE01005551.1,1,6243,4.11202e-05,142702582,0.939927
D.bunnanda,151823105,VNKE01003573.1,1,6240,4.11005e-05,142708822,0.939968
D.bunnanda,151823105,VNKE01000920.1,1,6237,4.10807e-05,142715059,0.940009
D.bunnanda,151823105,VNKE01000958.1,1,6229,4.1028e-05,142721288,0.94005
D.bunnanda,151823105,VNKE01002889.1,1,6225,4.10017e-05,142727513,0.940091
D.bunnanda,151823105,VNKE01005367.1,1,6210,4.09029e-05,142733723,0.940132
D.bunnanda,151823105,VNKE01004738.1,1,6208,4.08897e-05,142739931,0.940173
D.bunnanda,151823105,VNKE01001060.1,1,6190,4.07711e-05,142746121,0.940213
D.bunnanda,151823105,VNKE01000351.1,1,6186,4.07448e-05,142752307,0.940254
D.bunnanda,151823105,VNKE01004903.1,1,6181,4.07119e-05,142758488,0.940295
D.bunnanda,151823105,VNKE01003955.1,1,6172,4.06526e-05,142764660,0.940336
D.bunnanda,151823105,VNKE01001129.1,1,6164,4.05999e-05,142770824,0.940376
D.bunnanda,151823105,VNKE01002201.1,1,6155,4.05406e-05,142776979,0.940417
D.bunnanda,151823105,VNKE01000790.1,1,6153,4.05274e-05,142783132,0.940457
D.bunnanda,151823105,VNKE01000014.1,1,6146,4.04813e-05,142789278,0.940498
D.bunnanda,151823105,VNKE01000667.1,1,6145,4.04747e-05,142795423,0.940538
D.bunnanda,151823105,VNKE01001334.1,1,6138,4.04286e-05,142801561,0.940579
D.bunnanda,151823105,VNKE01005784.1,1,6133,4.03957e-05,142807694,0.940619
D.bunnanda,151823105,VNKE01006195.1,1,6132,4.03891e-05,142813826,0.940659
D.bunnanda,151823105,VNKE01000534.1,1,6127,4.03562e-05,142819953,0.9407
D.bunnanda,151823105,VNKE01003562.1,1,6125,4.0343e-05,142826078,0.94074
D.bunnanda,151823105,VNKE01001145.1,1,6086,4.00861e-05,142832164,0.94078
D.bunnanda,151823105,VNKE01000996.1,1,6075,4.00137e-05,142838239,0.94082
D.bunnanda,151823105,VNKE01000490.1,1,6070,3.99807e-05,142844309,0.94086
D.bunnanda,151823105,VNKE01002915.1,1,6056,3.98885e-05,142850365,0.9409
D.bunnanda,151823105,VNKE01005857.1,1,6050,3.9849e-05,142856415,0.94094
D.bunnanda,151823105,VNKE01003365.1,1,6042,3.97963e-05,142862457,0.94098
D.bunnanda,151823105,VNKE01006420.1,1,6034,3.97436e-05,142868491,0.941019
D.bunnanda,151823105,VNKE01000907.1,1,6030,3.97173e-05,142874521,0.941059
D.bunnanda,151823105,VNKE01000125.1,1,6022,3.96646e-05,142880543,0.941099
D.bunnanda,151823105,VNKE01003124.1,1,6021,3.9658e-05,142886564,0.941138
D.bunnanda,151823105,VNKE01006114.1,1,6016,3.96251e-05,142892580,0.941178
D.bunnanda,151823105,VNKE01003151.1,1,6016,3.96251e-05,142898596,0.941218
D.bunnanda,151823105,VNKE01000286.1,1,6009,3.9579e-05,142904605,0.941257
D.bunnanda,151823105,VNKE01004029.1,1,6003,3.95394e-05,142910608,0.941297
D.bunnanda,151823105,VNKE01000921.1,1,5997,3.94999e-05,142916605,0.941336
D.bunnanda,151823105,VNKE01001939.1,1,5988,3.94406e-05,142922593,0.941376
D.bunnanda,151823105,VNKE01001910.1,1,5987,3.94341e-05,142928580,0.941415
D.bunnanda,151823105,VNKE01004912.1,1,5985,3.94209e-05,142934565,0.941455
D.bunnanda,151823105,VNKE01003965.1,1,5979,3.93814e-05,142940544,0.941494
D.bunnanda,151823105,VNKE01000019.1,1,5979,3.93814e-05,142946523,0.941533
D.bunnanda,151823105,VNKE01005588.1,1,5974,3.93484e-05,142952497,0.941573
D.bunnanda,151823105,VNKE01004289.1,1,5965,3.92891e-05,142958462,0.941612
D.bunnanda,151823105,VNKE01003125.1,1,5962,3.92694e-05,142964424,0.941651
D.bunnanda,151823105,VNKE01004320.1,1,5954,3.92167e-05,142970378,0.941691
D.bunnanda,151823105,VNKE01005003.1,1,5949,3.91838e-05,142976327,0.94173
D.bunnanda,151823105,VNKE01005132.1,1,5948,3.91772e-05,142982275,0.941769
D.bunnanda,151823105,VNKE01001053.1,1,5941,3.91311e-05,142988216,0.941808
D.bunnanda,151823105,VNKE01005810.1,1,5926,3.90323e-05,142994142,0.941847
D.bunnanda,151823105,VNKE01004295.1,1,5925,3.90257e-05,143000067,0.941886
D.bunnanda,151823105,VNKE01000702.1,1,5925,3.90257e-05,143005992,0.941925
D.bunnanda,151823105,VNKE01003771.1,1,5919,3.89862e-05,143011911,0.941964
D.bunnanda,151823105,VNKE01001163.1,1,5911,3.89335e-05,143017822,0.942003
D.bunnanda,151823105,VNKE01000133.1,1,5911,3.89335e-05,143023733,0.942042
D.bunnanda,151823105,VNKE01000684.1,1,5905,3.88939e-05,143029638,0.942081
D.bunnanda,151823105,VNKE01001147.1,1,5900,3.8861e-05,143035538,0.94212
D.bunnanda,151823105,VNKE01000096.1,1,5897,3.88413e-05,143041435,0.942159
D.bunnanda,151823105,VNKE01003863.1,1,5890,3.87951e-05,143047325,0.942197
D.bunnanda,151823105,VNKE01004214.1,1,5884,3.87556e-05,143053209,0.942236
D.bunnanda,151823105,VNKE01004429.1,1,5879,3.87227e-05,143059088,0.942275
D.bunnanda,151823105,VNKE01004541.1,1,5877,3.87095e-05,143064965,0.942314
D.bunnanda,151823105,VNKE01004975.1,1,5873,3.86832e-05,143070838,0.942352
D.bunnanda,151823105,VNKE01003458.1,1,5870,3.86634e-05,143076708,0.942391
D.bunnanda,151823105,VNKE01005255.1,1,5863,3.86173e-05,143082571,0.942429
D.bunnanda,151823105,VNKE01002844.1,1,5862,3.86107e-05,143088433,0.942468
D.bunnanda,151823105,VNKE01006208.1,1,5860,3.85976e-05,143094293,0.942507
D.bunnanda,151823105,VNKE01003521.1,1,5859,3.8591e-05,143100152,0.942545
D.bunnanda,151823105,VNKE01001964.1,1,5855,3.85646e-05,143106007,0.942584
D.bunnanda,151823105,VNKE01000912.1,1,5852,3.85449e-05,143111859,0.942622
D.bunnanda,151823105,VNKE01002022.1,1,5848,3.85185e-05,143117707,0.942661
D.bunnanda,151823105,VNKE01001417.1,1,5846,3.85053e-05,143123553,0.942699
D.bunnanda,151823105,VNKE01006458.1,1,5840,3.84658e-05,143129393,0.942738
D.bunnanda,151823105,VNKE01002094.1,1,5838,3.84526e-05,143135231,0.942776
D.bunnanda,151823105,VNKE01004256.1,1,5834,3.84263e-05,143141065,0.942815
D.bunnanda,151823105,VNKE01000562.1,1,5821,3.83407e-05,143146886,0.942853
D.bunnanda,151823105,VNKE01006273.1,1,5818,3.83209e-05,143152704,0.942891
D.bunnanda,151823105,VNKE01003493.1,1,5810,3.82682e-05,143158514,0.94293
D.bunnanda,151823105,VNKE01004949.1,1,5803,3.82221e-05,143164317,0.942968
D.bunnanda,151823105,VNKE01000731.1,1,5800,3.82024e-05,143170117,0.943006
D.bunnanda,151823105,VNKE01003380.1,1,5789,3.81299e-05,143175906,0.943044
D.bunnanda,151823105,VNKE01001152.1,1,5789,3.81299e-05,143181695,0.943082
D.bunnanda,151823105,VNKE01002980.1,1,5784,3.8097e-05,143187479,0.94312
D.bunnanda,151823105,VNKE01004490.1,1,5783,3.80904e-05,143193262,0.943159
D.bunnanda,151823105,VNKE01003813.1,1,5771,3.80113e-05,143199033,0.943197
D.bunnanda,151823105,VNKE01005290.1,1,5769,3.79982e-05,143204802,0.943235
D.bunnanda,151823105,VNKE01005876.1,1,5756,3.79125e-05,143210558,0.943272
D.bunnanda,151823105,VNKE01003578.1,1,5754,3.78994e-05,143216312,0.94331
D.bunnanda,151823105,VNKE01001412.1,1,5736,3.77808e-05,143222048,0.943348
D.bunnanda,151823105,VNKE01000946.1,1,5729,3.77347e-05,143227777,0.943386
D.bunnanda,151823105,VNKE01001124.1,1,5720,3.76754e-05,143233497,0.943424
D.bunnanda,151823105,VNKE01003662.1,1,5717,3.76557e-05,143239214,0.943461
D.bunnanda,151823105,VNKE01004920.1,1,5713,3.76293e-05,143244927,0.943499
D.bunnanda,151823105,VNKE01001369.1,1,5713,3.76293e-05,143250640,0.943536
D.bunnanda,151823105,VNKE01005632.1,1,5708,3.75964e-05,143256348,0.943574
D.bunnanda,151823105,VNKE01001429.1,1,5705,3.75766e-05,143262053,0.943612
D.bunnanda,151823105,VNKE01006377.1,1,5703,3.75635e-05,143267756,0.943649
D.bunnanda,151823105,VNKE01006090.1,1,5686,3.74515e-05,143273442,0.943687
D.bunnanda,151823105,VNKE01002772.1,1,5684,3.74383e-05,143279126,0.943724
D.bunnanda,151823105,VNKE01000229.1,1,5674,3.73724e-05,143284800,0.943761
D.bunnanda,151823105,VNKE01002379.1,1,5672,3.73593e-05,143290472,0.943799
D.bunnanda,151823105,VNKE01004855.1,1,5665,3.73132e-05,143296137,0.943836
D.bunnanda,151823105,VNKE01002068.1,1,5658,3.72671e-05,143301795,0.943873
D.bunnanda,151823105,VNKE01003216.1,1,5649,3.72078e-05,143307444,0.943911
D.bunnanda,151823105,VNKE01002316.1,1,5649,3.72078e-05,143313093,0.943948
D.bunnanda,151823105,VNKE01004227.1,1,5645,3.71814e-05,143318738,0.943985
D.bunnanda,151823105,VNKE01003730.1,1,5642,3.71617e-05,143324380,0.944022
D.bunnanda,151823105,VNKE01000899.1,1,5640,3.71485e-05,143330020,0.944059
D.bunnanda,151823105,VNKE01004186.1,1,5639,3.71419e-05,143335659,0.944096
D.bunnanda,151823105,VNKE01001469.1,1,5628,3.70695e-05,143341287,0.944134
D.bunnanda,151823105,VNKE01004634.1,1,5619,3.70102e-05,143346906,0.944171
D.bunnanda,151823105,VNKE01000576.1,1,5619,3.70102e-05,143352525,0.944208
D.bunnanda,151823105,VNKE01003553.1,1,5617,3.6997e-05,143358142,0.944245
D.bunnanda,151823105,VNKE01000925.1,1,5616,3.69904e-05,143363758,0.944282
D.bunnanda,151823105,VNKE01001267.1,1,5614,3.69772e-05,143369372,0.944319
D.bunnanda,151823105,VNKE01004826.1,1,5607,3.69311e-05,143374979,0.944355
D.bunnanda,151823105,VNKE01005614.1,1,5602,3.68982e-05,143380581,0.944392
D.bunnanda,151823105,VNKE01003653.1,1,5595,3.68521e-05,143386176,0.944429
D.bunnanda,151823105,VNKE01001553.1,1,5584,3.67796e-05,143391760,0.944466
D.bunnanda,151823105,VNKE01000225.1,1,5582,3.67665e-05,143397342,0.944503
D.bunnanda,151823105,VNKE01001317.1,1,5576,3.6727e-05,143402918,0.944539
D.bunnanda,151823105,VNKE01003244.1,1,5567,3.66677e-05,143408485,0.944576
D.bunnanda,151823105,VNKE01001935.1,1,5566,3.66611e-05,143414051,0.944613
D.bunnanda,151823105,VNKE01003964.1,1,5553,3.65755e-05,143419604,0.944649
D.bunnanda,151823105,VNKE01006433.1,1,5547,3.65359e-05,143425151,0.944686
D.bunnanda,151823105,VNKE01006300.1,1,5544,3.65162e-05,143430695,0.944722
D.bunnanda,151823105,VNKE01004847.1,1,5536,3.64635e-05,143436231,0.944759
D.bunnanda,151823105,VNKE01000913.1,1,5535,3.64569e-05,143441766,0.944795
D.bunnanda,151823105,VNKE01000435.1,1,5519,3.63515e-05,143447285,0.944832
D.bunnanda,151823105,VNKE01005713.1,1,5509,3.62856e-05,143452794,0.944868
D.bunnanda,151823105,VNKE01005617.1,1,5505,3.62593e-05,143458299,0.944904
D.bunnanda,151823105,VNKE01000961.1,1,5503,3.62461e-05,143463802,0.944941
D.bunnanda,151823105,VNKE01003265.1,1,5499,3.62198e-05,143469301,0.944977
D.bunnanda,151823105,VNKE01004618.1,1,5490,3.61605e-05,143474791,0.945013
D.bunnanda,151823105,VNKE01002439.1,1,5490,3.61605e-05,143480281,0.945049
D.bunnanda,151823105,VNKE01000724.1,1,5486,3.61342e-05,143485767,0.945085
D.bunnanda,151823105,VNKE01006151.1,1,5482,3.61078e-05,143491249,0.945121
D.bunnanda,151823105,VNKE01000382.1,1,5475,3.60617e-05,143496724,0.945157
D.bunnanda,151823105,VNKE01001360.1,1,5474,3.60551e-05,143502198,0.945193
D.bunnanda,151823105,VNKE01003953.1,1,5467,3.6009e-05,143507665,0.945229
D.bunnanda,151823105,VNKE01003571.1,1,5466,3.60024e-05,143513131,0.945265
D.bunnanda,151823105,VNKE01004001.1,1,5462,3.59761e-05,143518593,0.945301
D.bunnanda,151823105,VNKE01004448.1,1,5461,3.59695e-05,143524054,0.945337
D.bunnanda,151823105,VNKE01004182.1,1,5453,3.59168e-05,143529507,0.945373
D.bunnanda,151823105,VNKE01006578.1,1,5450,3.5897e-05,143534957,0.945409
D.bunnanda,151823105,VNKE01001668.1,1,5445,3.58641e-05,143540402,0.945445
D.bunnanda,151823105,VNKE01006520.1,1,5438,3.5818e-05,143545840,0.945481
D.bunnanda,151823105,VNKE01004795.1,1,5434,3.57917e-05,143551274,0.945517
D.bunnanda,151823105,VNKE01005800.1,1,5432,3.57785e-05,143556706,0.945552
D.bunnanda,151823105,VNKE01001583.1,1,5426,3.5739e-05,143562132,0.945588
D.bunnanda,151823105,VNKE01004616.1,1,5424,3.57258e-05,143567556,0.945624
D.bunnanda,151823105,VNKE01003146.1,1,5422,3.57126e-05,143572978,0.94566
D.bunnanda,151823105,VNKE01001208.1,1,5417,3.56797e-05,143578395,0.945695
D.bunnanda,151823105,VNKE01004990.1,1,5410,3.56336e-05,143583805,0.945731
D.bunnanda,151823105,VNKE01000826.1,1,5408,3.56204e-05,143589213,0.945767
D.bunnanda,151823105,VNKE01000180.1,1,5402,3.55809e-05,143594615,0.945802
D.bunnanda,151823105,VNKE01002064.1,1,5401,3.55743e-05,143600016,0.945838
D.bunnanda,151823105,VNKE01006525.1,1,5400,3.55677e-05,143605416,0.945873
D.bunnanda,151823105,VNKE01006559.1,1,5386,3.54755e-05,143610802,0.945909
D.bunnanda,151823105,VNKE01006506.1,1,5386,3.54755e-05,143616188,0.945944
D.bunnanda,151823105,VNKE01000804.1,1,5386,3.54755e-05,143621574,0.94598
D.bunnanda,151823105,VNKE01006145.1,1,5378,3.54228e-05,143626952,0.946015
D.bunnanda,151823105,VNKE01004178.1,1,5378,3.54228e-05,143632330,0.946051
D.bunnanda,151823105,VNKE01004070.1,1,5378,3.54228e-05,143637708,0.946086
D.bunnanda,151823105,VNKE01005012.1,1,5368,3.53569e-05,143643076,0.946121
D.bunnanda,151823105,VNKE01001020.1,1,5368,3.53569e-05,143648444,0.946157
D.bunnanda,151823105,VNKE01003479.1,1,5364,3.53306e-05,143653808,0.946192
D.bunnanda,151823105,VNKE01002916.1,1,5362,3.53174e-05,143659170,0.946227
D.bunnanda,151823105,VNKE01005545.1,1,5359,3.52977e-05,143664529,0.946263
D.bunnanda,151823105,VNKE01004553.1,1,5359,3.52977e-05,143669888,0.946298
D.bunnanda,151823105,VNKE01000555.1,1,5355,3.52713e-05,143675243,0.946333
D.bunnanda,151823105,VNKE01004852.1,1,5351,3.5245e-05,143680594,0.946368
D.bunnanda,151823105,VNKE01001144.1,1,5341,3.51791e-05,143685935,0.946404
D.bunnanda,151823105,VNKE01000863.1,1,5332,3.51198e-05,143691267,0.946439
D.bunnanda,151823105,VNKE01002193.1,1,5331,3.51132e-05,143696598,0.946474
D.bunnanda,151823105,VNKE01003666.1,1,5320,3.50408e-05,143701918,0.946509
D.bunnanda,151823105,VNKE01006418.1,1,5307,3.49552e-05,143707225,0.946544
D.bunnanda,151823105,VNKE01003254.1,1,5307,3.49552e-05,143712532,0.946579
D.bunnanda,151823105,VNKE01001056.1,1,5307,3.49552e-05,143717839,0.946614
D.bunnanda,151823105,VNKE01001169.1,1,5296,3.48827e-05,143723135,0.946649
D.bunnanda,151823105,VNKE01004059.1,1,5290,3.48432e-05,143728425,0.946683
D.bunnanda,151823105,VNKE01002272.1,1,5288,3.483e-05,143733713,0.946718
D.bunnanda,151823105,VNKE01002053.1,1,5286,3.48168e-05,143738999,0.946753
D.bunnanda,151823105,VNKE01001413.1,1,5286,3.48168e-05,143744285,0.946788
D.bunnanda,151823105,VNKE01000234.1,1,5286,3.48168e-05,143749571,0.946823
D.bunnanda,151823105,VNKE01005009.1,1,5281,3.47839e-05,143754852,0.946858
D.bunnanda,151823105,VNKE01002743.1,1,5280,3.47773e-05,143760132,0.946892
D.bunnanda,151823105,VNKE01006213.1,1,5279,3.47707e-05,143765411,0.946927
D.bunnanda,151823105,VNKE01004060.1,1,5270,3.47114e-05,143770681,0.946962
D.bunnanda,151823105,VNKE01000832.1,1,5268,3.46983e-05,143775949,0.946996
D.bunnanda,151823105,VNKE01000359.1,1,5238,3.45007e-05,143781187,0.947031
D.bunnanda,151823105,VNKE01003141.1,1,5234,3.44743e-05,143786421,0.947065
D.bunnanda,151823105,VNKE01002131.1,1,5234,3.44743e-05,143791655,0.9471
D.bunnanda,151823105,VNKE01004576.1,1,5222,3.43953e-05,143796877,0.947134
D.bunnanda,151823105,VNKE01004619.1,1,5221,3.43887e-05,143802098,0.947169
D.bunnanda,151823105,VNKE01003650.1,1,5218,3.43689e-05,143807316,0.947203
D.bunnanda,151823105,VNKE01000762.1,1,5218,3.43689e-05,143812534,0.947237
D.bunnanda,151823105,VNKE01006633.1,1,5213,3.4336e-05,143817747,0.947272
D.bunnanda,151823105,VNKE01002182.1,1,5213,3.4336e-05,143822960,0.947306
D.bunnanda,151823105,VNKE01004575.1,1,5210,3.43163e-05,143828170,0.94734
D.bunnanda,151823105,VNKE01003995.1,1,5204,3.42767e-05,143833374,0.947375
D.bunnanda,151823105,VNKE01001637.1,1,5198,3.42372e-05,143838572,0.947409
D.bunnanda,151823105,VNKE01005480.1,1,5192,3.41977e-05,143843764,0.947443
D.bunnanda,151823105,VNKE01002097.1,1,5188,3.41713e-05,143848952,0.947477
D.bunnanda,151823105,VNKE01002840.1,1,5187,3.41648e-05,143854139,0.947512
D.bunnanda,151823105,VNKE01005097.1,1,5182,3.41318e-05,143859321,0.947546
D.bunnanda,151823105,VNKE01004862.1,1,5181,3.41252e-05,143864502,0.94758
D.bunnanda,151823105,VNKE01002364.1,1,5181,3.41252e-05,143869683,0.947614
D.bunnanda,151823105,VNKE01006122.1,1,5180,3.41187e-05,143874863,0.947648
D.bunnanda,151823105,VNKE01006426.1,1,5179,3.41121e-05,143880042,0.947682
D.bunnanda,151823105,VNKE01003775.1,1,5176,3.40923e-05,143885218,0.947716
D.bunnanda,151823105,VNKE01003456.1,1,5174,3.40791e-05,143890392,0.94775
D.bunnanda,151823105,VNKE01003772.1,1,5173,3.40725e-05,143895565,0.947784
D.bunnanda,151823105,VNKE01004962.1,1,5167,3.4033e-05,143900732,0.947818
D.bunnanda,151823105,VNKE01003509.1,1,5167,3.4033e-05,143905899,0.947852
D.bunnanda,151823105,VNKE01000597.1,1,5167,3.4033e-05,143911066,0.947886
D.bunnanda,151823105,VNKE01005978.1,1,5155,3.3954e-05,143916221,0.94792
D.bunnanda,151823105,VNKE01000410.1,1,5151,3.39276e-05,143921372,0.947954
D.bunnanda,151823105,VNKE01004811.1,1,5148,3.39079e-05,143926520,0.947988
D.bunnanda,151823105,VNKE01001957.1,1,5141,3.38618e-05,143931661,0.948022
D.bunnanda,151823105,VNKE01002386.1,1,5139,3.38486e-05,143936800,0.948056
D.bunnanda,151823105,VNKE01003618.1,1,5138,3.3842e-05,143941938,0.94809
D.bunnanda,151823105,VNKE01004204.1,1,5137,3.38354e-05,143947075,0.948124
D.bunnanda,151823105,VNKE01000557.1,1,5133,3.38091e-05,143952208,0.948157
D.bunnanda,151823105,VNKE01004653.1,1,5130,3.37893e-05,143957338,0.948191
D.bunnanda,151823105,VNKE01003494.1,1,5129,3.37827e-05,143962467,0.948225
D.bunnanda,151823105,VNKE01000354.1,1,5129,3.37827e-05,143967596,0.948259
D.bunnanda,151823105,VNKE01005881.1,1,5128,3.37762e-05,143972724,0.948293
D.bunnanda,151823105,VNKE01001187.1,1,5126,3.3763e-05,143977850,0.948326
D.bunnanda,151823105,VNKE01001052.1,1,5120,3.37235e-05,143982970,0.94836
D.bunnanda,151823105,VNKE01006500.1,1,5115,3.36905e-05,143988085,0.948394
D.bunnanda,151823105,VNKE01001831.1,1,5114,3.36839e-05,143993199,0.948427
D.bunnanda,151823105,VNKE01002516.1,1,5111,3.36642e-05,143998310,0.948461
D.bunnanda,151823105,VNKE01003962.1,1,5101,3.35983e-05,144003411,0.948495
D.bunnanda,151823105,VNKE01002066.1,1,5093,3.35456e-05,144008504,0.948528
D.bunnanda,151823105,VNKE01000380.1,1,5088,3.35127e-05,144013592,0.948562
D.bunnanda,151823105,VNKE01005460.1,1,5072,3.34073e-05,144018664,0.948595
D.bunnanda,151823105,VNKE01002830.1,1,5066,3.33678e-05,144023730,0.948629
D.bunnanda,151823105,VNKE01003832.1,1,5064,3.33546e-05,144028794,0.948662
D.bunnanda,151823105,VNKE01005770.1,1,5060,3.33283e-05,144033854,0.948695
D.bunnanda,151823105,VNKE01003524.1,1,5046,3.3236e-05,144038900,0.948728
D.bunnanda,151823105,VNKE01001433.1,1,5045,3.32295e-05,144043945,0.948762
D.bunnanda,151823105,VNKE01001842.1,1,5044,3.32229e-05,144048989,0.948795
D.bunnanda,151823105,VNKE01002511.1,1,5040,3.31965e-05,144054029,0.948828
D.bunnanda,151823105,VNKE01000230.1,1,5038,3.31834e-05,144059067,0.948861
D.bunnanda,151823105,VNKE01003370.1,1,5037,3.31768e-05,144064104,0.948894
D.bunnanda,151823105,VNKE01001224.1,1,5033,3.31504e-05,144069137,0.948928
D.bunnanda,151823105,VNKE01003762.1,1,5028,3.31175e-05,144074165,0.948961
D.bunnanda,151823105,VNKE01002129.1,1,5017,3.3045e-05,144079182,0.948994
D.bunnanda,151823105,VNKE01006003.1,1,5016,3.30384e-05,144084198,0.949027
D.bunnanda,151823105,VNKE01000258.1,1,5012,3.30121e-05,144089210,0.94906
D.bunnanda,151823105,VNKE01003306.1,1,5011,3.30055e-05,144094221,0.949093
D.bunnanda,151823105,VNKE01005991.1,1,4990,3.28672e-05,144099211,0.949126
D.bunnanda,151823105,VNKE01005990.1,1,4974,3.27618e-05,144104185,0.949158
D.bunnanda,151823105,VNKE01005561.1,1,4974,3.27618e-05,144109159,0.949191
D.bunnanda,151823105,VNKE01002187.1,1,4974,3.27618e-05,144114133,0.949224
D.bunnanda,151823105,VNKE01004978.1,1,4972,3.27486e-05,144119105,0.949257
D.bunnanda,151823105,VNKE01003806.1,1,4969,3.27289e-05,144124074,0.949289
D.bunnanda,151823105,VNKE01003269.1,1,4967,3.27157e-05,144129041,0.949322
D.bunnanda,151823105,VNKE01005247.1,1,4962,3.26828e-05,144134003,0.949355
D.bunnanda,151823105,VNKE01003811.1,1,4961,3.26762e-05,144138964,0.949388
D.bunnanda,151823105,VNKE01000097.1,1,4961,3.26762e-05,144143925,0.94942
D.bunnanda,151823105,VNKE01003446.1,1,4956,3.26433e-05,144148881,0.949453
D.bunnanda,151823105,VNKE01003399.1,1,4955,3.26367e-05,144153836,0.949485
D.bunnanda,151823105,VNKE01001153.1,1,4944,3.25642e-05,144158780,0.949518
D.bunnanda,151823105,VNKE01000779.1,1,4942,3.2551e-05,144163722,0.949551
D.bunnanda,151823105,VNKE01000163.1,1,4930,3.2472e-05,144168652,0.949583
D.bunnanda,151823105,VNKE01002373.1,1,4927,3.24522e-05,144173579,0.949616
D.bunnanda,151823105,VNKE01005620.1,1,4925,3.24391e-05,144178504,0.949648
D.bunnanda,151823105,VNKE01005007.1,1,4925,3.24391e-05,144183429,0.94968
D.bunnanda,151823105,VNKE01001832.1,1,4925,3.24391e-05,144188354,0.949713
D.bunnanda,151823105,VNKE01000280.1,1,4924,3.24325e-05,144193278,0.949745
D.bunnanda,151823105,VNKE01003525.1,1,4918,3.2393e-05,144198196,0.949778
D.bunnanda,151823105,VNKE01001517.1,1,4918,3.2393e-05,144203114,0.94981
D.bunnanda,151823105,VNKE01001086.1,1,4917,3.23864e-05,144208031,0.949842
D.bunnanda,151823105,VNKE01000227.1,1,4909,3.23337e-05,144212940,0.949875
D.bunnanda,151823105,VNKE01003572.1,1,4906,3.23139e-05,144217846,0.949907
D.bunnanda,151823105,VNKE01000104.1,1,4887,3.21888e-05,144222733,0.949939
D.bunnanda,151823105,VNKE01006099.1,1,4884,3.2169e-05,144227617,0.949971
D.bunnanda,151823105,VNKE01005716.1,1,4882,3.21558e-05,144232499,0.950004
D.bunnanda,151823105,VNKE01001403.1,1,4882,3.21558e-05,144237381,0.950036
D.bunnanda,151823105,VNKE01005512.1,1,4878,3.21295e-05,144242259,0.950068
D.bunnanda,151823105,VNKE01004388.1,1,4877,3.21229e-05,144247136,0.9501
D.bunnanda,151823105,VNKE01001130.1,1,4866,3.20505e-05,144252002,0.950132
D.bunnanda,151823105,VNKE01001820.1,1,4848,3.19319e-05,144256850,0.950164
D.bunnanda,151823105,VNKE01002890.1,1,4843,3.1899e-05,144261693,0.950196
D.bunnanda,151823105,VNKE01000930.1,1,4841,3.18858e-05,144266534,0.950228
D.bunnanda,151823105,VNKE01002079.1,1,4839,3.18726e-05,144271373,0.95026
D.bunnanda,151823105,VNKE01004904.1,1,4837,3.18594e-05,144276210,0.950292
D.bunnanda,151823105,VNKE01003368.1,1,4836,3.18529e-05,144281046,0.950323
D.bunnanda,151823105,VNKE01003637.1,1,4835,3.18463e-05,144285881,0.950355
D.bunnanda,151823105,VNKE01004383.1,1,4829,3.18068e-05,144290710,0.950387
D.bunnanda,151823105,VNKE01003799.1,1,4824,3.17738e-05,144295534,0.950419
D.bunnanda,151823105,VNKE01000408.1,1,4809,3.1675e-05,144300343,0.95045
D.bunnanda,151823105,VNKE01003156.1,1,4806,3.16553e-05,144305149,0.950482
D.bunnanda,151823105,VNKE01003744.1,1,4794,3.15762e-05,144309943,0.950514
D.bunnanda,151823105,VNKE01005974.1,1,4791,3.15565e-05,144314734,0.950545
D.bunnanda,151823105,VNKE01000808.1,1,4787,3.15301e-05,144319521,0.950577
D.bunnanda,151823105,VNKE01005280.1,1,4786,3.15235e-05,144324307,0.950608
D.bunnanda,151823105,VNKE01006266.1,1,4781,3.14906e-05,144329088,0.95064
D.bunnanda,151823105,VNKE01002968.1,1,4775,3.14511e-05,144333863,0.950671
D.bunnanda,151823105,VNKE01000119.1,1,4773,3.14379e-05,144338636,0.950703
D.bunnanda,151823105,VNKE01006152.1,1,4760,3.13523e-05,144343396,0.950734
D.bunnanda,151823105,VNKE01006281.1,1,4758,3.13391e-05,144348154,0.950765
D.bunnanda,151823105,VNKE01003717.1,1,4750,3.12864e-05,144352904,0.950797
D.bunnanda,151823105,VNKE01005014.1,1,4738,3.12074e-05,144357642,0.950828
D.bunnanda,151823105,VNKE01000233.1,1,4731,3.11613e-05,144362373,0.950859
D.bunnanda,151823105,VNKE01002146.1,1,4730,3.11547e-05,144367103,0.95089
D.bunnanda,151823105,VNKE01006206.1,1,4724,3.11152e-05,144371827,0.950921
D.bunnanda,151823105,VNKE01001494.1,1,4720,3.10888e-05,144376547,0.950952
D.bunnanda,151823105,VNKE01004493.1,1,4706,3.09966e-05,144381253,0.950983
D.bunnanda,151823105,VNKE01002269.1,1,4696,3.09307e-05,144385949,0.951014
D.bunnanda,151823105,VNKE01004197.1,1,4690,3.08912e-05,144390639,0.951045
D.bunnanda,151823105,VNKE01002118.1,1,4690,3.08912e-05,144395329,0.951076
D.bunnanda,151823105,VNKE01005128.1,1,4683,3.08451e-05,144400012,0.951107
D.bunnanda,151823105,VNKE01003971.1,1,4680,3.08253e-05,144404692,0.951138
D.bunnanda,151823105,VNKE01005222.1,1,4678,3.08122e-05,144409370,0.951169
D.bunnanda,151823105,VNKE01003579.1,1,4671,3.07661e-05,144414041,0.951199
D.bunnanda,151823105,VNKE01002586.1,1,4664,3.072e-05,144418705,0.95123
D.bunnanda,151823105,VNKE01000816.1,1,4661,3.07002e-05,144423366,0.951261
D.bunnanda,151823105,VNKE01006177.1,1,4645,3.05948e-05,144428011,0.951291
D.bunnanda,151823105,VNKE01000182.1,1,4641,3.05685e-05,144432652,0.951322
D.bunnanda,151823105,VNKE01002164.1,1,4635,3.0529e-05,144437287,0.951352
D.bunnanda,151823105,VNKE01005233.1,1,4620,3.04302e-05,144441907,0.951383
D.bunnanda,151823105,VNKE01004183.1,1,4610,3.03643e-05,144446517,0.951413
D.bunnanda,151823105,VNKE01002004.1,1,4610,3.03643e-05,144451127,0.951444
D.bunnanda,151823105,VNKE01005971.1,1,4609,3.03577e-05,144455736,0.951474
D.bunnanda,151823105,VNKE01000021.1,1,4609,3.03577e-05,144460345,0.951504
D.bunnanda,151823105,VNKE01000093.1,1,4601,3.0305e-05,144464946,0.951535
D.bunnanda,151823105,VNKE01004896.1,1,4599,3.02918e-05,144469545,0.951565
D.bunnanda,151823105,VNKE01000976.1,1,4599,3.02918e-05,144474144,0.951595
D.bunnanda,151823105,VNKE01003327.1,1,4598,3.02852e-05,144478742,0.951626
D.bunnanda,151823105,VNKE01004658.1,1,4590,3.02326e-05,144483332,0.951656
D.bunnanda,151823105,VNKE01003328.1,1,4590,3.02326e-05,144487922,0.951686
D.bunnanda,151823105,VNKE01002338.1,1,4583,3.01864e-05,144492505,0.951716
D.bunnanda,151823105,VNKE01003178.1,1,4582,3.01799e-05,144497087,0.951746
D.bunnanda,151823105,VNKE01004491.1,1,4572,3.0114e-05,144501659,0.951776
D.bunnanda,151823105,VNKE01002817.1,1,4569,3.00942e-05,144506228,0.951807
D.bunnanda,151823105,VNKE01002630.1,1,4564,3.00613e-05,144510792,0.951837
D.bunnanda,151823105,VNKE01003664.1,1,4561,3.00415e-05,144515353,0.951867
D.bunnanda,151823105,VNKE01003312.1,1,4559,3.00284e-05,144519912,0.951897
D.bunnanda,151823105,VNKE01003492.1,1,4550,2.99691e-05,144524462,0.951927
D.bunnanda,151823105,VNKE01000977.1,1,4548,2.99559e-05,144529010,0.951957
D.bunnanda,151823105,VNKE01001731.1,1,4546,2.99427e-05,144533556,0.951987
D.bunnanda,151823105,VNKE01004613.1,1,4545,2.99362e-05,144538101,0.952016
D.bunnanda,151823105,VNKE01001400.1,1,4544,2.99296e-05,144542645,0.952046
D.bunnanda,151823105,VNKE01006382.1,1,4543,2.9923e-05,144547188,0.952076
D.bunnanda,151823105,VNKE01000423.1,1,4538,2.989e-05,144551726,0.952106
D.bunnanda,151823105,VNKE01004064.1,1,4527,2.98176e-05,144556253,0.952136
D.bunnanda,151823105,VNKE01003126.1,1,4527,2.98176e-05,144560780,0.952166
D.bunnanda,151823105,VNKE01006441.1,1,4525,2.98044e-05,144565305,0.952196
D.bunnanda,151823105,VNKE01002054.1,1,4517,2.97517e-05,144569822,0.952225
D.bunnanda,151823105,VNKE01003665.1,1,4508,2.96925e-05,144574330,0.952255
D.bunnanda,151823105,VNKE01001304.1,1,4501,2.96463e-05,144578831,0.952285
D.bunnanda,151823105,VNKE01003875.1,1,4500,2.96398e-05,144583331,0.952314
D.bunnanda,151823105,VNKE01001126.1,1,4498,2.96266e-05,144587829,0.952344
D.bunnanda,151823105,VNKE01004756.1,1,4496,2.96134e-05,144592325,0.952374
D.bunnanda,151823105,VNKE01002815.1,1,4480,2.9508e-05,144596805,0.952403
D.bunnanda,151823105,VNKE01006454.1,1,4471,2.94487e-05,144601276,0.952433
D.bunnanda,151823105,VNKE01004356.1,1,4467,2.94224e-05,144605743,0.952462
D.bunnanda,151823105,VNKE01000710.1,1,4463,2.93961e-05,144610206,0.952491
D.bunnanda,151823105,VNKE01002157.1,1,4458,2.93631e-05,144614664,0.952521
D.bunnanda,151823105,VNKE01005664.1,1,4456,2.93499e-05,144619120,0.95255
D.bunnanda,151823105,VNKE01002663.1,1,4456,2.93499e-05,144623576,0.952579
D.bunnanda,151823105,VNKE01004081.1,1,4453,2.93302e-05,144628029,0.952609
D.bunnanda,151823105,VNKE01006272.1,1,4444,2.92709e-05,144632473,0.952638
D.bunnanda,151823105,VNKE01000703.1,1,4443,2.92643e-05,144636916,0.952667
D.bunnanda,151823105,VNKE01001944.1,1,4439,2.9238e-05,144641355,0.952697
D.bunnanda,151823105,VNKE01002508.1,1,4438,2.92314e-05,144645793,0.952726
D.bunnanda,151823105,VNKE01003198.1,1,4430,2.91787e-05,144650223,0.952755
D.bunnanda,151823105,VNKE01001166.1,1,4426,2.91523e-05,144654649,0.952784
D.bunnanda,151823105,VNKE01005204.1,1,4424,2.91392e-05,144659073,0.952813
D.bunnanda,151823105,VNKE01003371.1,1,4423,2.91326e-05,144663496,0.952842
D.bunnanda,151823105,VNKE01004825.1,1,4422,2.9126e-05,144667918,0.952872
D.bunnanda,151823105,VNKE01003058.1,1,4420,2.91128e-05,144672338,0.952901
D.bunnanda,151823105,VNKE01006334.1,1,4410,2.9047e-05,144676748,0.95293
D.bunnanda,151823105,VNKE01003864.1,1,4409,2.90404e-05,144681157,0.952959
D.bunnanda,151823105,VNKE01002130.1,1,4403,2.90009e-05,144685560,0.952988
D.bunnanda,151823105,VNKE01001418.1,1,4395,2.89482e-05,144689955,0.953017
D.bunnanda,151823105,VNKE01001550.1,1,4389,2.89086e-05,144694344,0.953046
D.bunnanda,151823105,VNKE01001002.1,1,4384,2.88757e-05,144698728,0.953074
D.bunnanda,151823105,VNKE01001783.1,1,4381,2.8856e-05,144703109,0.953103
D.bunnanda,151823105,VNKE01003652.1,1,4378,2.88362e-05,144707487,0.953132
D.bunnanda,151823105,VNKE01005743.1,1,4373,2.88033e-05,144711860,0.953161
D.bunnanda,151823105,VNKE01000312.1,1,4369,2.87769e-05,144716229,0.95319
D.bunnanda,151823105,VNKE01000010.1,1,4369,2.87769e-05,144720598,0.953219
D.bunnanda,151823105,VNKE01004074.1,1,4354,2.86781e-05,144724952,0.953247
D.bunnanda,151823105,VNKE01005407.1,1,4353,2.86715e-05,144729305,0.953276
D.bunnanda,151823105,VNKE01004124.1,1,4352,2.86649e-05,144733657,0.953305
D.bunnanda,151823105,VNKE01000818.1,1,4348,2.86386e-05,144738005,0.953333
D.bunnanda,151823105,VNKE01001085.1,1,4346,2.86254e-05,144742351,0.953362
D.bunnanda,151823105,VNKE01001325.1,1,4345,2.86188e-05,144746696,0.95339
D.bunnanda,151823105,VNKE01001620.1,1,4339,2.85793e-05,144751035,0.953419
D.bunnanda,151823105,VNKE01006398.1,1,4338,2.85727e-05,144755373,0.953448
D.bunnanda,151823105,VNKE01001906.1,1,4326,2.84937e-05,144759699,0.953476
D.bunnanda,151823105,VNKE01005069.1,1,4321,2.84608e-05,144764020,0.953505
D.bunnanda,151823105,VNKE01000357.1,1,4314,2.84146e-05,144768334,0.953533
D.bunnanda,151823105,VNKE01001628.1,1,4303,2.83422e-05,144772637,0.953561
D.bunnanda,151823105,VNKE01003481.1,1,4298,2.83093e-05,144776935,0.95359
D.bunnanda,151823105,VNKE01004055.1,1,4293,2.82763e-05,144781228,0.953618
D.bunnanda,151823105,VNKE01006210.1,1,4289,2.825e-05,144785517,0.953646
D.bunnanda,151823105,VNKE01006503.1,1,4287,2.82368e-05,144789804,0.953674
D.bunnanda,151823105,VNKE01002207.1,1,4284,2.8217e-05,144794088,0.953703
D.bunnanda,151823105,VNKE01001194.1,1,4284,2.8217e-05,144798372,0.953731
D.bunnanda,151823105,VNKE01003615.1,1,4283,2.82105e-05,144802655,0.953759
D.bunnanda,151823105,VNKE01006575.1,1,4276,2.81644e-05,144806931,0.953787
D.bunnanda,151823105,VNKE01004250.1,1,4273,2.81446e-05,144811204,0.953815
D.bunnanda,151823105,VNKE01004190.1,1,4269,2.81182e-05,144815473,0.953843
D.bunnanda,151823105,VNKE01002847.1,1,4269,2.81182e-05,144819742,0.953872
D.bunnanda,151823105,VNKE01006184.1,1,4266,2.80985e-05,144824008,0.9539
D.bunnanda,151823105,VNKE01002159.1,1,4266,2.80985e-05,144828274,0.953928
D.bunnanda,151823105,VNKE01001482.1,1,4264,2.80853e-05,144832538,0.953956
D.bunnanda,151823105,VNKE01005502.1,1,4262,2.80721e-05,144836800,0.953984
D.bunnanda,151823105,VNKE01001444.1,1,4261,2.80656e-05,144841061,0.954012
D.bunnanda,151823105,VNKE01000260.1,1,4253,2.80129e-05,144845314,0.95404
D.bunnanda,151823105,VNKE01004897.1,1,4244,2.79536e-05,144849558,0.954068
D.bunnanda,151823105,VNKE01006194.1,1,4235,2.78943e-05,144853793,0.954096
D.bunnanda,151823105,VNKE01000197.1,1,4235,2.78943e-05,144858028,0.954124
D.bunnanda,151823105,VNKE01002619.1,1,4232,2.78745e-05,144862260,0.954152
D.bunnanda,151823105,VNKE01001841.1,1,4227,2.78416e-05,144866487,0.954179
D.bunnanda,151823105,VNKE01005428.1,1,4225,2.78284e-05,144870712,0.954207
D.bunnanda,151823105,VNKE01001759.1,1,4220,2.77955e-05,144874932,0.954235
D.bunnanda,151823105,VNKE01004296.1,1,4217,2.77757e-05,144879149,0.954263
D.bunnanda,151823105,VNKE01006627.1,1,4216,2.77692e-05,144883365,0.954291
D.bunnanda,151823105,VNKE01005687.1,1,4214,2.7756e-05,144887579,0.954318
D.bunnanda,151823105,VNKE01001328.1,1,4207,2.77099e-05,144891786,0.954346
D.bunnanda,151823105,VNKE01003511.1,1,4205,2.76967e-05,144895991,0.954374
D.bunnanda,151823105,VNKE01001336.1,1,4199,2.76572e-05,144900190,0.954401
D.bunnanda,151823105,VNKE01003583.1,1,4197,2.7644e-05,144904387,0.954429
D.bunnanda,151823105,VNKE01000546.1,1,4196,2.76374e-05,144908583,0.954457
D.bunnanda,151823105,VNKE01002967.1,1,4192,2.76111e-05,144912775,0.954484
D.bunnanda,151823105,VNKE01001394.1,1,4187,2.75781e-05,144916962,0.954512
D.bunnanda,151823105,VNKE01001046.1,1,4187,2.75781e-05,144921149,0.954539
D.bunnanda,151823105,VNKE01000362.1,1,4184,2.75584e-05,144925333,0.954567
D.bunnanda,151823105,VNKE01005603.1,1,4183,2.75518e-05,144929516,0.954595
D.bunnanda,151823105,VNKE01004938.1,1,4180,2.7532e-05,144933696,0.954622
D.bunnanda,151823105,VNKE01003722.1,1,4179,2.75255e-05,144937875,0.95465
D.bunnanda,151823105,VNKE01001767.1,1,4175,2.74991e-05,144942050,0.954677
D.bunnanda,151823105,VNKE01003758.1,1,4173,2.74859e-05,144946223,0.954705
D.bunnanda,151823105,VNKE01006629.1,1,4171,2.74728e-05,144950394,0.954732
D.bunnanda,151823105,VNKE01006171.1,1,4170,2.74662e-05,144954564,0.95476
D.bunnanda,151823105,VNKE01003279.1,1,4168,2.7453e-05,144958732,0.954787
D.bunnanda,151823105,VNKE01006006.1,1,4164,2.74267e-05,144962896,0.954814
D.bunnanda,151823105,VNKE01001806.1,1,4164,2.74267e-05,144967060,0.954842
D.bunnanda,151823105,VNKE01006632.1,1,4161,2.74069e-05,144971221,0.954869
D.bunnanda,151823105,VNKE01003916.1,1,4156,2.7374e-05,144975377,0.954897
D.bunnanda,151823105,VNKE01004208.1,1,4154,2.73608e-05,144979531,0.954924
D.bunnanda,151823105,VNKE01000455.1,1,4153,2.73542e-05,144983684,0.954951
D.bunnanda,151823105,VNKE01001409.1,1,4152,2.73476e-05,144987836,0.954979
D.bunnanda,151823105,VNKE01005435.1,1,4149,2.73279e-05,144991985,0.955006
D.bunnanda,151823105,VNKE01000775.1,1,4147,2.73147e-05,144996132,0.955033
D.bunnanda,151823105,VNKE01002369.1,1,4145,2.73015e-05,145000277,0.955061
D.bunnanda,151823105,VNKE01000579.1,1,4143,2.72883e-05,145004420,0.955088
D.bunnanda,151823105,VNKE01006532.1,1,4141,2.72752e-05,145008561,0.955115
D.bunnanda,151823105,VNKE01000890.1,1,4138,2.72554e-05,145012699,0.955142
D.bunnanda,151823105,VNKE01002127.1,1,4125,2.71698e-05,145016824,0.95517
D.bunnanda,151823105,VNKE01001295.1,1,4123,2.71566e-05,145020947,0.955197
D.bunnanda,151823105,VNKE01002410.1,1,4121,2.71434e-05,145025068,0.955224
D.bunnanda,151823105,VNKE01001206.1,1,4121,2.71434e-05,145029189,0.955251
D.bunnanda,151823105,VNKE01000812.1,1,4120,2.71368e-05,145033309,0.955278
D.bunnanda,151823105,VNKE01003765.1,1,4119,2.71303e-05,145037428,0.955305
D.bunnanda,151823105,VNKE01001798.1,1,4115,2.71039e-05,145041543,0.955332
D.bunnanda,151823105,VNKE01006309.1,1,4113,2.70907e-05,145045656,0.95536
D.bunnanda,151823105,VNKE01000356.1,1,4111,2.70776e-05,145049767,0.955387
D.bunnanda,151823105,VNKE01003133.1,1,4109,2.70644e-05,145053876,0.955414
D.bunnanda,151823105,VNKE01003356.1,1,4108,2.70578e-05,145057984,0.955441
D.bunnanda,151823105,VNKE01000235.1,1,4105,2.7038e-05,145062089,0.955468
D.bunnanda,151823105,VNKE01002896.1,1,4103,2.70249e-05,145066192,0.955495
D.bunnanda,151823105,VNKE01001762.1,1,4103,2.70249e-05,145070295,0.955522
D.bunnanda,151823105,VNKE01001059.1,1,4094,2.69656e-05,145074389,0.955549
D.bunnanda,151823105,VNKE01000815.1,1,4094,2.69656e-05,145078483,0.955576
D.bunnanda,151823105,VNKE01002227.1,1,4086,2.69129e-05,145082569,0.955603
D.bunnanda,151823105,VNKE01002058.1,1,4086,2.69129e-05,145086655,0.95563
D.bunnanda,151823105,VNKE01004249.1,1,4084,2.68997e-05,145090739,0.955657
D.bunnanda,151823105,VNKE01003228.1,1,4084,2.68997e-05,145094823,0.955683
D.bunnanda,151823105,VNKE01003574.1,1,4083,2.68931e-05,145098906,0.95571
D.bunnanda,151823105,VNKE01000363.1,1,4081,2.688e-05,145102987,0.955737
D.bunnanda,151823105,VNKE01006581.1,1,4075,2.68404e-05,145107062,0.955764
D.bunnanda,151823105,VNKE01003132.1,1,4074,2.68339e-05,145111136,0.955791
D.bunnanda,151823105,VNKE01006150.1,1,4073,2.68273e-05,145115209,0.955818
D.bunnanda,151823105,VNKE01001551.1,1,4073,2.68273e-05,145119282,0.955845
D.bunnanda,151823105,VNKE01000995.1,1,4067,2.67878e-05,145123349,0.955871
D.bunnanda,151823105,VNKE01006113.1,1,4065,2.67746e-05,145127414,0.955898
D.bunnanda,151823105,VNKE01003648.1,1,4064,2.6768e-05,145131478,0.955925
D.bunnanda,151823105,VNKE01001554.1,1,4064,2.6768e-05,145135542,0.955952
D.bunnanda,151823105,VNKE01002974.1,1,4062,2.67548e-05,145139604,0.955978
D.bunnanda,151823105,VNKE01004779.1,1,4058,2.67285e-05,145143662,0.956005
D.bunnanda,151823105,VNKE01000517.1,1,4056,2.67153e-05,145147718,0.956032
D.bunnanda,151823105,VNKE01001967.1,1,4054,2.67021e-05,145151772,0.956059
D.bunnanda,151823105,VNKE01001247.1,1,4054,2.67021e-05,145155826,0.956085
D.bunnanda,151823105,VNKE01006626.1,1,4048,2.66626e-05,145159874,0.956112
D.bunnanda,151823105,VNKE01002437.1,1,4047,2.6656e-05,145163921,0.956139
D.bunnanda,151823105,VNKE01000271.1,1,4045,2.66428e-05,145167966,0.956165
D.bunnanda,151823105,VNKE01000399.1,1,4035,2.6577e-05,145172001,0.956192
D.bunnanda,151823105,VNKE01004676.1,1,4033,2.65638e-05,145176034,0.956218
D.bunnanda,151823105,VNKE01003984.1,1,4033,2.65638e-05,145180067,0.956245
D.bunnanda,151823105,VNKE01003353.1,1,4030,2.6544e-05,145184097,0.956271
D.bunnanda,151823105,VNKE01002472.1,1,4029,2.65375e-05,145188126,0.956298
D.bunnanda,151823105,VNKE01000524.1,1,4022,2.64914e-05,145192148,0.956324
D.bunnanda,151823105,VNKE01003366.1,1,4021,2.64848e-05,145196169,0.956351
D.bunnanda,151823105,VNKE01004075.1,1,4018,2.6465e-05,145200187,0.956377
D.bunnanda,151823105,VNKE01004718.1,1,4017,2.64584e-05,145204204,0.956404
D.bunnanda,151823105,VNKE01006017.1,1,4015,2.64453e-05,145208219,0.95643
D.bunnanda,151823105,VNKE01003317.1,1,4014,2.64387e-05,145212233,0.956457
D.bunnanda,151823105,VNKE01004205.1,1,4012,2.64255e-05,145216245,0.956483
D.bunnanda,151823105,VNKE01001284.1,1,4008,2.63991e-05,145220253,0.95651
D.bunnanda,151823105,VNKE01001312.1,1,4007,2.63926e-05,145224260,0.956536
D.bunnanda,151823105,VNKE01000616.1,1,4003,2.63662e-05,145228263,0.956562
D.bunnanda,151823105,VNKE01000398.1,1,4002,2.63596e-05,145232265,0.956589
D.bunnanda,151823105,VNKE01006630.1,1,3998,2.63333e-05,145236263,0.956615
D.bunnanda,151823105,VNKE01002841.1,1,3998,2.63333e-05,145240261,0.956641
D.bunnanda,151823105,VNKE01000437.1,1,3998,2.63333e-05,145244259,0.956668
D.bunnanda,151823105,VNKE01002389.1,1,3997,2.63267e-05,145248256,0.956694
D.bunnanda,151823105,VNKE01001051.1,1,3997,2.63267e-05,145252253,0.95672
D.bunnanda,151823105,VNKE01003536.1,1,3994,2.63069e-05,145256247,0.956747
D.bunnanda,151823105,VNKE01004434.1,1,3993,2.63003e-05,145260240,0.956773
D.bunnanda,151823105,VNKE01001395.1,1,3991,2.62872e-05,145264231,0.956799
D.bunnanda,151823105,VNKE01005359.1,1,3984,2.62411e-05,145268215,0.956825
D.bunnanda,151823105,VNKE01001675.1,1,3978,2.62015e-05,145272193,0.956852
D.bunnanda,151823105,VNKE01004122.1,1,3975,2.61818e-05,145276168,0.956878
D.bunnanda,151823105,VNKE01004831.1,1,3973,2.61686e-05,145280141,0.956904
D.bunnanda,151823105,VNKE01004853.1,1,3966,2.61225e-05,145284107,0.95693
D.bunnanda,151823105,VNKE01000840.1,1,3964,2.61093e-05,145288071,0.956956
D.bunnanda,151823105,VNKE01003457.1,1,3963,2.61027e-05,145292034,0.956982
D.bunnanda,151823105,VNKE01006625.1,1,3962,2.60962e-05,145295996,0.957008
D.bunnanda,151823105,VNKE01004009.1,1,3961,2.60896e-05,145299957,0.957035
D.bunnanda,151823105,VNKE01004717.1,1,3960,2.6083e-05,145303917,0.957061
D.bunnanda,151823105,VNKE01001547.1,1,3957,2.60632e-05,145307874,0.957087
D.bunnanda,151823105,VNKE01005427.1,1,3951,2.60237e-05,145311825,0.957113
D.bunnanda,151823105,VNKE01001070.1,1,3943,2.5971e-05,145315768,0.957139
D.bunnanda,151823105,VNKE01002147.1,1,3941,2.59578e-05,145319709,0.957165
D.bunnanda,151823105,VNKE01005606.1,1,3932,2.58986e-05,145323641,0.957191
D.bunnanda,151823105,VNKE01005552.1,1,3930,2.58854e-05,145327571,0.957216
D.bunnanda,151823105,VNKE01001881.1,1,3930,2.58854e-05,145331501,0.957242
D.bunnanda,151823105,VNKE01002683.1,1,3926,2.5859e-05,145335427,0.957268
D.bunnanda,151823105,VNKE01000541.1,1,3924,2.58459e-05,145339351,0.957294
D.bunnanda,151823105,VNKE01003924.1,1,3923,2.58393e-05,145343274,0.95732
D.bunnanda,151823105,VNKE01001373.1,1,3922,2.58327e-05,145347196,0.957346
D.bunnanda,151823105,VNKE01000545.1,1,3922,2.58327e-05,145351118,0.957372
D.bunnanda,151823105,VNKE01000542.1,1,3913,2.57734e-05,145355031,0.957397
D.bunnanda,151823105,VNKE01004223.1,1,3911,2.57602e-05,145358942,0.957423
D.bunnanda,151823105,VNKE01000544.1,1,3910,2.57537e-05,145362852,0.957449
D.bunnanda,151823105,VNKE01000397.1,1,3910,2.57537e-05,145366762,0.957475
D.bunnanda,151823105,VNKE01005582.1,1,3905,2.57207e-05,145370667,0.9575
D.bunnanda,151823105,VNKE01002020.1,1,3905,2.57207e-05,145374572,0.957526
D.bunnanda,151823105,VNKE01001865.1,1,3900,2.56878e-05,145378472,0.957552
D.bunnanda,151823105,VNKE01003723.1,1,3897,2.5668e-05,145382369,0.957577
D.bunnanda,151823105,VNKE01001139.1,1,3895,2.56549e-05,145386264,0.957603
D.bunnanda,151823105,VNKE01002134.1,1,3889,2.56153e-05,145390153,0.957629
D.bunnanda,151823105,VNKE01005048.1,1,3888,2.56088e-05,145394041,0.957654
D.bunnanda,151823105,VNKE01004008.1,1,3886,2.55956e-05,145397927,0.95768
D.bunnanda,151823105,VNKE01001341.1,1,3885,2.5589e-05,145401812,0.957705
D.bunnanda,151823105,VNKE01001021.1,1,3873,2.551e-05,145405685,0.957731
D.bunnanda,151823105,VNKE01004031.1,1,3871,2.54968e-05,145409556,0.957756
D.bunnanda,151823105,VNKE01004291.1,1,3868,2.5477e-05,145413424,0.957782
D.bunnanda,151823105,VNKE01000154.1,1,3857,2.54046e-05,145417281,0.957807
D.bunnanda,151823105,VNKE01003024.1,1,3853,2.53782e-05,145421134,0.957833
D.bunnanda,151823105,VNKE01001769.1,1,3850,2.53585e-05,145424984,0.957858
D.bunnanda,151823105,VNKE01003681.1,1,3847,2.53387e-05,145428831,0.957883
D.bunnanda,151823105,VNKE01001905.1,1,3839,2.5286e-05,145432670,0.957909
D.bunnanda,151823105,VNKE01004792.1,1,3838,2.52794e-05,145436508,0.957934
D.bunnanda,151823105,VNKE01001673.1,1,3838,2.52794e-05,145440346,0.957959
D.bunnanda,151823105,VNKE01005749.1,1,3837,2.52728e-05,145444183,0.957985
D.bunnanda,151823105,VNKE01004894.1,1,3828,2.52136e-05,145448011,0.95801
D.bunnanda,151823105,VNKE01006551.1,1,3824,2.51872e-05,145451835,0.958035
D.bunnanda,151823105,VNKE01002904.1,1,3819,2.51543e-05,145455654,0.95806
D.bunnanda,151823105,VNKE01005015.1,1,3811,2.51016e-05,145459465,0.958085
D.bunnanda,151823105,VNKE01001903.1,1,3811,2.51016e-05,145463276,0.95811
D.bunnanda,151823105,VNKE01004475.1,1,3807,2.50752e-05,145467083,0.958135
D.bunnanda,151823105,VNKE01002268.1,1,3806,2.50686e-05,145470889,0.95816
D.bunnanda,151823105,VNKE01000248.1,1,3802,2.50423e-05,145474691,0.958185
D.bunnanda,151823105,VNKE01004324.1,1,3799,2.50225e-05,145478490,0.95821
D.bunnanda,151823105,VNKE01002243.1,1,3792,2.49764e-05,145482282,0.958235
D.bunnanda,151823105,VNKE01004322.1,1,3790,2.49633e-05,145486072,0.95826
D.bunnanda,151823105,VNKE01005271.1,1,3789,2.49567e-05,145489861,0.958285
D.bunnanda,151823105,VNKE01006447.1,1,3788,2.49501e-05,145493649,0.95831
D.bunnanda,151823105,VNKE01003716.1,1,3785,2.49303e-05,145497434,0.958335
D.bunnanda,151823105,VNKE01000344.1,1,3785,2.49303e-05,145501219,0.95836
D.bunnanda,151823105,VNKE01000770.1,1,3783,2.49172e-05,145505002,0.958385
D.bunnanda,151823105,VNKE01001462.1,1,3782,2.49106e-05,145508784,0.95841
D.bunnanda,151823105,VNKE01000270.1,1,3775,2.48645e-05,145512559,0.958435
D.bunnanda,151823105,VNKE01000390.1,1,3772,2.48447e-05,145516331,0.95846
D.bunnanda,151823105,VNKE01005335.1,1,3770,2.48315e-05,145520101,0.958485
D.bunnanda,151823105,VNKE01006569.1,1,3766,2.48052e-05,145523867,0.958509
D.bunnanda,151823105,VNKE01006040.1,1,3765,2.47986e-05,145527632,0.958534
D.bunnanda,151823105,VNKE01002722.1,1,3758,2.47525e-05,145531390,0.958559
D.bunnanda,151823105,VNKE01004905.1,1,3754,2.47261e-05,145535144,0.958584
D.bunnanda,151823105,VNKE01000716.1,1,3752,2.4713e-05,145538896,0.958608
D.bunnanda,151823105,VNKE01005047.1,1,3750,2.46998e-05,145542646,0.958633
D.bunnanda,151823105,VNKE01006110.1,1,3747,2.468e-05,145546393,0.958658
D.bunnanda,151823105,VNKE01000814.1,1,3746,2.46735e-05,145550139,0.958682
D.bunnanda,151823105,VNKE01006583.1,1,3745,2.46669e-05,145553884,0.958707
D.bunnanda,151823105,VNKE01004765.1,1,3744,2.46603e-05,145557628,0.958732
D.bunnanda,151823105,VNKE01001636.1,1,3744,2.46603e-05,145561372,0.958756
D.bunnanda,151823105,VNKE01000813.1,1,3744,2.46603e-05,145565116,0.958781
D.bunnanda,151823105,VNKE01006462.1,1,3740,2.46339e-05,145568856,0.958806
D.bunnanda,151823105,VNKE01000955.1,1,3740,2.46339e-05,145572596,0.95883
D.bunnanda,151823105,VNKE01001171.1,1,3736,2.46076e-05,145576332,0.958855
D.bunnanda,151823105,VNKE01003712.1,1,3732,2.45812e-05,145580064,0.95888
D.bunnanda,151823105,VNKE01001625.1,1,3730,2.45681e-05,145583794,0.958904
D.bunnanda,151823105,VNKE01000783.1,1,3728,2.45549e-05,145587522,0.958929
D.bunnanda,151823105,VNKE01002059.1,1,3725,2.45351e-05,145591247,0.958953
D.bunnanda,151823105,VNKE01005374.1,1,3709,2.44297e-05,145594956,0.958978
D.bunnanda,151823105,VNKE01000622.1,1,3708,2.44232e-05,145598664,0.959002
D.bunnanda,151823105,VNKE01000211.1,1,3708,2.44232e-05,145602372,0.959026
D.bunnanda,151823105,VNKE01001691.1,1,3706,2.441e-05,145606078,0.959051
D.bunnanda,151823105,VNKE01000553.1,1,3703,2.43902e-05,145609781,0.959075
D.bunnanda,151823105,VNKE01000332.1,1,3702,2.43836e-05,145613483,0.9591
D.bunnanda,151823105,VNKE01000924.1,1,3694,2.43309e-05,145617177,0.959124
D.bunnanda,151823105,VNKE01002680.1,1,3685,2.42717e-05,145620862,0.959148
D.bunnanda,151823105,VNKE01000841.1,1,3682,2.42519e-05,145624544,0.959172
D.bunnanda,151823105,VNKE01000253.1,1,3682,2.42519e-05,145628226,0.959197
D.bunnanda,151823105,VNKE01000256.1,1,3678,2.42256e-05,145631904,0.959221
D.bunnanda,151823105,VNKE01001322.1,1,3675,2.42058e-05,145635579,0.959245
D.bunnanda,151823105,VNKE01001108.1,1,3672,2.4186e-05,145639251,0.959269
D.bunnanda,151823105,VNKE01001195.1,1,3671,2.41795e-05,145642922,0.959294
D.bunnanda,151823105,VNKE01000508.1,1,3671,2.41795e-05,145646593,0.959318
D.bunnanda,151823105,VNKE01000199.1,1,3671,2.41795e-05,145650264,0.959342
D.bunnanda,151823105,VNKE01006310.1,1,3670,2.41729e-05,145653934,0.959366
D.bunnanda,151823105,VNKE01004252.1,1,3670,2.41729e-05,145657604,0.95939
D.bunnanda,151823105,VNKE01002069.1,1,3670,2.41729e-05,145661274,0.959414
D.bunnanda,151823105,VNKE01004405.1,1,3666,2.41465e-05,145664940,0.959439
D.bunnanda,151823105,VNKE01000766.1,1,3665,2.41399e-05,145668605,0.959463
D.bunnanda,151823105,VNKE01005665.1,1,3662,2.41202e-05,145672267,0.959487
D.bunnanda,151823105,VNKE01004449.1,1,3660,2.4107e-05,145675927,0.959511
D.bunnanda,151823105,VNKE01001765.1,1,3659,2.41004e-05,145679586,0.959535
D.bunnanda,151823105,VNKE01001215.1,1,3659,2.41004e-05,145683245,0.959559
D.bunnanda,151823105,VNKE01001286.1,1,3653,2.40609e-05,145686898,0.959583
D.bunnanda,151823105,VNKE01003338.1,1,3652,2.40543e-05,145690550,0.959607
D.bunnanda,151823105,VNKE01005660.1,1,3639,2.39687e-05,145694189,0.959631
D.bunnanda,151823105,VNKE01002248.1,1,3636,2.39489e-05,145697825,0.959655
D.bunnanda,151823105,VNKE01005278.1,1,3634,2.39358e-05,145701459,0.959679
D.bunnanda,151823105,VNKE01004206.1,1,3632,2.39226e-05,145705091,0.959703
D.bunnanda,151823105,VNKE01003853.1,1,3627,2.38896e-05,145708718,0.959727
D.bunnanda,151823105,VNKE01001562.1,1,3624,2.38699e-05,145712342,0.959751
D.bunnanda,151823105,VNKE01005997.1,1,3622,2.38567e-05,145715964,0.959775
D.bunnanda,151823105,VNKE01006573.1,1,3620,2.38435e-05,145719584,0.959798
D.bunnanda,151823105,VNKE01002923.1,1,3613,2.37974e-05,145723197,0.959822
D.bunnanda,151823105,VNKE01001449.1,1,3607,2.37579e-05,145726804,0.959846
D.bunnanda,151823105,VNKE01000496.1,1,3607,2.37579e-05,145730411,0.95987
D.bunnanda,151823105,VNKE01002682.1,1,3606,2.37513e-05,145734017,0.959894
D.bunnanda,151823105,VNKE01003830.1,1,3602,2.3725e-05,145737619,0.959917
D.bunnanda,151823105,VNKE01002244.1,1,3593,2.36657e-05,145741212,0.959941
D.bunnanda,151823105,VNKE01001155.1,1,3592,2.36591e-05,145744804,0.959965
D.bunnanda,151823105,VNKE01003086.1,1,3591,2.36525e-05,145748395,0.959988
D.bunnanda,151823105,VNKE01000117.1,1,3588,2.36328e-05,145751983,0.960012
D.bunnanda,151823105,VNKE01006628.1,1,3587,2.36262e-05,145755570,0.960035
D.bunnanda,151823105,VNKE01000604.1,1,3586,2.36196e-05,145759156,0.960059
D.bunnanda,151823105,VNKE01003339.1,1,3585,2.3613e-05,145762741,0.960083
D.bunnanda,151823105,VNKE01006313.1,1,3584,2.36064e-05,145766325,0.960106
D.bunnanda,151823105,VNKE01006390.1,1,3573,2.3534e-05,145769898,0.96013
D.bunnanda,151823105,VNKE01006246.1,1,3573,2.3534e-05,145773471,0.960153
D.bunnanda,151823105,VNKE01005473.1,1,3573,2.3534e-05,145777044,0.960177
D.bunnanda,151823105,VNKE01004202.1,1,3572,2.35274e-05,145780616,0.9602
D.bunnanda,151823105,VNKE01001184.1,1,3571,2.35208e-05,145784187,0.960224
D.bunnanda,151823105,VNKE01004083.1,1,3567,2.34944e-05,145787754,0.960247
D.bunnanda,151823105,VNKE01001058.1,1,3567,2.34944e-05,145791321,0.960271
D.bunnanda,151823105,VNKE01000052.1,1,3567,2.34944e-05,145794888,0.960294
D.bunnanda,151823105,VNKE01000004.1,1,3567,2.34944e-05,145798455,0.960318
D.bunnanda,151823105,VNKE01001516.1,1,3564,2.34747e-05,145802019,0.960341
D.bunnanda,151823105,VNKE01002021.1,1,3563,2.34681e-05,145805582,0.960365
D.bunnanda,151823105,VNKE01005264.1,1,3561,2.34549e-05,145809143,0.960388
D.bunnanda,151823105,VNKE01004953.1,1,3561,2.34549e-05,145812704,0.960412
D.bunnanda,151823105,VNKE01003590.1,1,3561,2.34549e-05,145816265,0.960435
D.bunnanda,151823105,VNKE01005414.1,1,3560,2.34483e-05,145819825,0.960459
D.bunnanda,151823105,VNKE01000293.1,1,3560,2.34483e-05,145823385,0.960482
D.bunnanda,151823105,VNKE01003345.1,1,3556,2.3422e-05,145826941,0.960506
D.bunnanda,151823105,VNKE01001663.1,1,3556,2.3422e-05,145830497,0.960529
D.bunnanda,151823105,VNKE01006413.1,1,3555,2.34154e-05,145834052,0.960552
D.bunnanda,151823105,VNKE01001756.1,1,3552,2.33956e-05,145837604,0.960576
D.bunnanda,151823105,VNKE01000433.1,1,3546,2.33561e-05,145841150,0.960599
D.bunnanda,151823105,VNKE01004096.1,1,3540,2.33166e-05,145844690,0.960622
D.bunnanda,151823105,VNKE01004201.1,1,3538,2.33034e-05,145848228,0.960646
D.bunnanda,151823105,VNKE01006224.1,1,3537,2.32968e-05,145851765,0.960669
D.bunnanda,151823105,VNKE01001703.1,1,3530,2.32507e-05,145855295,0.960692
D.bunnanda,151823105,VNKE01002714.1,1,3529,2.32442e-05,145858824,0.960716
D.bunnanda,151823105,VNKE01001749.1,1,3528,2.32376e-05,145862352,0.960739
D.bunnanda,151823105,VNKE01000670.1,1,3527,2.3231e-05,145865879,0.960762
D.bunnanda,151823105,VNKE01000457.1,1,3523,2.32046e-05,145869402,0.960785
D.bunnanda,151823105,VNKE01000759.1,1,3522,2.31981e-05,145872924,0.960808
D.bunnanda,151823105,VNKE01006460.1,1,3519,2.31783e-05,145876443,0.960832
D.bunnanda,151823105,VNKE01003534.1,1,3513,2.31388e-05,145879956,0.960855
D.bunnanda,151823105,VNKE01003822.1,1,3504,2.30795e-05,145883460,0.960878
D.bunnanda,151823105,VNKE01001191.1,1,3503,2.30729e-05,145886963,0.960901
D.bunnanda,151823105,VNKE01000714.1,1,3501,2.30597e-05,145890464,0.960924
D.bunnanda,151823105,VNKE01004832.1,1,3499,2.30466e-05,145893963,0.960947
D.bunnanda,151823105,VNKE01002057.1,1,3499,2.30466e-05,145897462,0.96097
D.bunnanda,151823105,VNKE01005734.1,1,3496,2.30268e-05,145900958,0.960993
D.bunnanda,151823105,VNKE01001348.1,1,3494,2.30136e-05,145904452,0.961016
D.bunnanda,151823105,VNKE01002712.1,1,3493,2.3007e-05,145907945,0.961039
D.bunnanda,151823105,VNKE01003006.1,1,3487,2.29675e-05,145911432,0.961062
D.bunnanda,151823105,VNKE01004240.1,1,3486,2.29609e-05,145914918,0.961085
D.bunnanda,151823105,VNKE01003510.1,1,3481,2.2928e-05,145918399,0.961108
D.bunnanda,151823105,VNKE01006478.1,1,3480,2.29214e-05,145921879,0.961131
D.bunnanda,151823105,VNKE01006552.1,1,3477,2.29017e-05,145925356,0.961154
D.bunnanda,151823105,VNKE01004211.1,1,3477,2.29017e-05,145928833,0.961177
D.bunnanda,151823105,VNKE01001066.1,1,3474,2.28819e-05,145932307,0.9612
D.bunnanda,151823105,VNKE01002827.1,1,3470,2.28555e-05,145935777,0.961222
D.bunnanda,151823105,VNKE01001475.1,1,3470,2.28555e-05,145939247,0.961245
D.bunnanda,151823105,VNKE01001995.1,1,3468,2.28424e-05,145942715,0.961268
D.bunnanda,151823105,VNKE01000963.1,1,3458,2.27765e-05,145946173,0.961291
D.bunnanda,151823105,VNKE01001882.1,1,3457,2.27699e-05,145949630,0.961314
D.bunnanda,151823105,VNKE01006389.1,1,3456,2.27633e-05,145953086,0.961336
D.bunnanda,151823105,VNKE01005829.1,1,3452,2.2737e-05,145956538,0.961359
D.bunnanda,151823105,VNKE01003616.1,1,3449,2.27172e-05,145959987,0.961382
D.bunnanda,151823105,VNKE01003452.1,1,3448,2.27106e-05,145963435,0.961405
D.bunnanda,151823105,VNKE01006502.1,1,3443,2.26777e-05,145966878,0.961427
D.bunnanda,151823105,VNKE01005785.1,1,3442,2.26711e-05,145970320,0.96145
D.bunnanda,151823105,VNKE01004601.1,1,3440,2.26579e-05,145973760,0.961473
D.bunnanda,151823105,VNKE01000440.1,1,3439,2.26514e-05,145977199,0.961495
D.bunnanda,151823105,VNKE01004148.1,1,3436,2.26316e-05,145980635,0.961518
D.bunnanda,151823105,VNKE01002071.1,1,3436,2.26316e-05,145984071,0.961541
D.bunnanda,151823105,VNKE01002025.1,1,3435,2.2625e-05,145987506,0.961563
D.bunnanda,151823105,VNKE01003812.1,1,3428,2.25789e-05,145990934,0.961586
D.bunnanda,151823105,VNKE01000882.1,1,3422,2.25394e-05,145994356,0.961608
D.bunnanda,151823105,VNKE01005788.1,1,3416,2.24999e-05,145997772,0.961631
D.bunnanda,151823105,VNKE01003764.1,1,3415,2.24933e-05,146001187,0.961653
D.bunnanda,151823105,VNKE01001958.1,1,3410,2.24603e-05,146004597,0.961676
D.bunnanda,151823105,VNKE01001042.1,1,3409,2.24538e-05,146008006,0.961698
D.bunnanda,151823105,VNKE01005013.1,1,3405,2.24274e-05,146011411,0.961721
D.bunnanda,151823105,VNKE01003763.1,1,3402,2.24077e-05,146014813,0.961743
D.bunnanda,151823105,VNKE01003699.1,1,3402,2.24077e-05,146018215,0.961765
D.bunnanda,151823105,VNKE01001911.1,1,3401,2.24011e-05,146021616,0.961788
D.bunnanda,151823105,VNKE01006446.1,1,3399,2.23879e-05,146025015,0.96181
D.bunnanda,151823105,VNKE01001549.1,1,3399,2.23879e-05,146028414,0.961833
D.bunnanda,151823105,VNKE01001952.1,1,3398,2.23813e-05,146031812,0.961855
D.bunnanda,151823105,VNKE01006219.1,1,3397,2.23747e-05,146035209,0.961877
D.bunnanda,151823105,VNKE01004078.1,1,3396,2.23681e-05,146038605,0.9619
D.bunnanda,151823105,VNKE01001490.1,1,3394,2.2355e-05,146041999,0.961922
D.bunnanda,151823105,VNKE01000853.1,1,3389,2.2322e-05,146045388,0.961944
D.bunnanda,151823105,VNKE01005557.1,1,3383,2.22825e-05,146048771,0.961967
D.bunnanda,151823105,VNKE01000482.1,1,3382,2.22759e-05,146052153,0.961989
D.bunnanda,151823105,VNKE01000507.1,1,3377,2.2243e-05,146055530,0.962011
D.bunnanda,151823105,VNKE01000964.1,1,3364,2.21574e-05,146058894,0.962033
D.bunnanda,151823105,VNKE01000161.1,1,3363,2.21508e-05,146062257,0.962056
D.bunnanda,151823105,VNKE01004459.1,1,3360,2.2131e-05,146065617,0.962078
D.bunnanda,151823105,VNKE01001362.1,1,3360,2.2131e-05,146068977,0.9621
D.bunnanda,151823105,VNKE01001779.1,1,3357,2.21113e-05,146072334,0.962122
D.bunnanda,151823105,VNKE01001555.1,1,3353,2.20849e-05,146075687,0.962144
D.bunnanda,151823105,VNKE01000957.1,1,3351,2.20717e-05,146079038,0.962166
D.bunnanda,151823105,VNKE01000228.1,1,3351,2.20717e-05,146082389,0.962188
D.bunnanda,151823105,VNKE01005390.1,1,3348,2.2052e-05,146085737,0.96221
D.bunnanda,151823105,VNKE01003560.1,1,3348,2.2052e-05,146089085,0.962232
D.bunnanda,151823105,VNKE01005676.1,1,3346,2.20388e-05,146092431,0.962254
D.bunnanda,151823105,VNKE01004946.1,1,3343,2.2019e-05,146095774,0.962276
D.bunnanda,151823105,VNKE01003655.1,1,3343,2.2019e-05,146099117,0.962298
D.bunnanda,151823105,VNKE01004368.1,1,3337,2.19795e-05,146102454,0.96232
D.bunnanda,151823105,VNKE01001109.1,1,3337,2.19795e-05,146105791,0.962342
D.bunnanda,151823105,VNKE01006042.1,1,3335,2.19664e-05,146109126,0.962364
D.bunnanda,151823105,VNKE01004931.1,1,3335,2.19664e-05,146112461,0.962386
D.bunnanda,151823105,VNKE01004960.1,1,3330,2.19334e-05,146115791,0.962408
D.bunnanda,151823105,VNKE01001648.1,1,3323,2.18873e-05,146119114,0.96243
D.bunnanda,151823105,VNKE01006038.1,1,3316,2.18412e-05,146122430,0.962452
D.bunnanda,151823105,VNKE01005358.1,1,3316,2.18412e-05,146125746,0.962474
D.bunnanda,151823105,VNKE01002019.1,1,3315,2.18346e-05,146129061,0.962496
D.bunnanda,151823105,VNKE01005662.1,1,3314,2.1828e-05,146132375,0.962517
D.bunnanda,151823105,VNKE01002151.1,1,3313,2.18214e-05,146135688,0.962539
D.bunnanda,151823105,VNKE01001886.1,1,3313,2.18214e-05,146139001,0.962561
D.bunnanda,151823105,VNKE01005269.1,1,3312,2.18149e-05,146142313,0.962583
D.bunnanda,151823105,VNKE01004469.1,1,3310,2.18017e-05,146145623,0.962605
D.bunnanda,151823105,VNKE01005125.1,1,3300,2.17358e-05,146148923,0.962626
D.bunnanda,151823105,VNKE01001827.1,1,3299,2.17292e-05,146152222,0.962648
D.bunnanda,151823105,VNKE01006019.1,1,3297,2.17161e-05,146155519,0.96267
D.bunnanda,151823105,VNKE01003404.1,1,3294,2.16963e-05,146158813,0.962692
D.bunnanda,151823105,VNKE01004525.1,1,3293,2.16897e-05,146162106,0.962713
D.bunnanda,151823105,VNKE01004425.1,1,3293,2.16897e-05,146165399,0.962735
D.bunnanda,151823105,VNKE01003514.1,1,3290,2.167e-05,146168689,0.962757
D.bunnanda,151823105,VNKE01004400.1,1,3286,2.16436e-05,146171975,0.962778
D.bunnanda,151823105,VNKE01001763.1,1,3285,2.1637e-05,146175260,0.9628
D.bunnanda,151823105,VNKE01004916.1,1,3281,2.16107e-05,146178541,0.962821
D.bunnanda,151823105,VNKE01004140.1,1,3274,2.15646e-05,146181815,0.962843
D.bunnanda,151823105,VNKE01003549.1,1,3274,2.15646e-05,146185089,0.962865
D.bunnanda,151823105,VNKE01003157.1,1,3274,2.15646e-05,146188363,0.962886
D.bunnanda,151823105,VNKE01002398.1,1,3269,2.15316e-05,146191632,0.962908
D.bunnanda,151823105,VNKE01000361.1,1,3268,2.15251e-05,146194900,0.962929
D.bunnanda,151823105,VNKE01005343.1,1,3265,2.15053e-05,146198165,0.962951
D.bunnanda,151823105,VNKE01001082.1,1,3264,2.14987e-05,146201429,0.962972
D.bunnanda,151823105,VNKE01001114.1,1,3259,2.14658e-05,146204688,0.962994
D.bunnanda,151823105,VNKE01001754.1,1,3258,2.14592e-05,146207946,0.963015
D.bunnanda,151823105,VNKE01006249.1,1,3254,2.14328e-05,146211200,0.963037
D.bunnanda,151823105,VNKE01003622.1,1,3253,2.14263e-05,146214453,0.963058
D.bunnanda,151823105,VNKE01003174.1,1,3253,2.14263e-05,146217706,0.963079
D.bunnanda,151823105,VNKE01002828.1,1,3253,2.14263e-05,146220959,0.963101
D.bunnanda,151823105,VNKE01001797.1,1,3253,2.14263e-05,146224212,0.963122
D.bunnanda,151823105,VNKE01003504.1,1,3252,2.14197e-05,146227464,0.963144
D.bunnanda,151823105,VNKE01002647.1,1,3252,2.14197e-05,146230716,0.963165
D.bunnanda,151823105,VNKE01001560.1,1,3248,2.13933e-05,146233964,0.963186
D.bunnanda,151823105,VNKE01001485.1,1,3248,2.13933e-05,146237212,0.963208
D.bunnanda,151823105,VNKE01003819.1,1,3246,2.13801e-05,146240458,0.963229
D.bunnanda,151823105,VNKE01005639.1,1,3243,2.13604e-05,146243701,0.963251
D.bunnanda,151823105,VNKE01000444.1,1,3243,2.13604e-05,146246944,0.963272
D.bunnanda,151823105,VNKE01003906.1,1,3242,2.13538e-05,146250186,0.963293
D.bunnanda,151823105,VNKE01004011.1,1,3241,2.13472e-05,146253427,0.963315
D.bunnanda,151823105,VNKE01006584.1,1,3235,2.13077e-05,146256662,0.963336
D.bunnanda,151823105,VNKE01000680.1,1,3234,2.13011e-05,146259896,0.963357
D.bunnanda,151823105,VNKE01002180.1,1,3229,2.12682e-05,146263125,0.963379
D.bunnanda,151823105,VNKE01005006.1,1,3228,2.12616e-05,146266353,0.9634
D.bunnanda,151823105,VNKE01002700.1,1,3228,2.12616e-05,146269581,0.963421
D.bunnanda,151823105,VNKE01004380.1,1,3224,2.12352e-05,146272805,0.963442
D.bunnanda,151823105,VNKE01004827.1,1,3223,2.12287e-05,146276028,0.963464
D.bunnanda,151823105,VNKE01003147.1,1,3222,2.12221e-05,146279250,0.963485
D.bunnanda,151823105,VNKE01004194.1,1,3220,2.12089e-05,146282470,0.963506
D.bunnanda,151823105,VNKE01001463.1,1,3219,2.12023e-05,146285689,0.963527
D.bunnanda,151823105,VNKE01001133.1,1,3217,2.11891e-05,146288906,0.963548
D.bunnanda,151823105,VNKE01004102.1,1,3214,2.11694e-05,146292120,0.96357
D.bunnanda,151823105,VNKE01001641.1,1,3211,2.11496e-05,146295331,0.963591
D.bunnanda,151823105,VNKE01006465.1,1,3207,2.11233e-05,146298538,0.963612
D.bunnanda,151823105,VNKE01000065.1,1,3207,2.11233e-05,146301745,0.963633
D.bunnanda,151823105,VNKE01004169.1,1,3203,2.10969e-05,146304948,0.963654
D.bunnanda,151823105,VNKE01002052.1,1,3200,2.10772e-05,146308148,0.963675
D.bunnanda,151823105,VNKE01006442.1,1,3196,2.10508e-05,146311344,0.963696
D.bunnanda,151823105,VNKE01006243.1,1,3194,2.10376e-05,146314538,0.963717
D.bunnanda,151823105,VNKE01006111.1,1,3194,2.10376e-05,146317732,0.963738
D.bunnanda,151823105,VNKE01000527.1,1,3192,2.10245e-05,146320924,0.963759
D.bunnanda,151823105,VNKE01006511.1,1,3189,2.10047e-05,146324113,0.96378
D.bunnanda,151823105,VNKE01001054.1,1,3188,2.09981e-05,146327301,0.963801
D.bunnanda,151823105,VNKE01002056.1,1,3186,2.09849e-05,146330487,0.963822
D.bunnanda,151823105,VNKE01005258.1,1,3185,2.09784e-05,146333672,0.963843
D.bunnanda,151823105,VNKE01006357.1,1,3181,2.0952e-05,146336853,0.963864
D.bunnanda,151823105,VNKE01005289.1,1,3180,2.09454e-05,146340033,0.963885
D.bunnanda,151823105,VNKE01003911.1,1,3180,2.09454e-05,146343213,0.963906
D.bunnanda,151823105,VNKE01002306.1,1,3177,2.09257e-05,146346390,0.963927
D.bunnanda,151823105,VNKE01005884.1,1,3172,2.08927e-05,146349562,0.963948
D.bunnanda,151823105,VNKE01002512.1,1,3169,2.0873e-05,146352731,0.963969
D.bunnanda,151823105,VNKE01000185.1,1,3169,2.0873e-05,146355900,0.96399
D.bunnanda,151823105,VNKE01004460.1,1,3166,2.08532e-05,146359066,0.96401
D.bunnanda,151823105,VNKE01001248.1,1,3164,2.084e-05,146362230,0.964031
D.bunnanda,151823105,VNKE01003219.1,1,3163,2.08335e-05,146365393,0.964052
D.bunnanda,151823105,VNKE01005291.1,1,3161,2.08203e-05,146368554,0.964073
D.bunnanda,151823105,VNKE01001055.1,1,3156,2.07873e-05,146371710,0.964094
D.bunnanda,151823105,VNKE01001990.1,1,3151,2.07544e-05,146374861,0.964115
D.bunnanda,151823105,VNKE01005659.1,1,3148,2.07347e-05,146378009,0.964135
D.bunnanda,151823105,VNKE01005925.1,1,3147,2.07281e-05,146381156,0.964156
D.bunnanda,151823105,VNKE01004137.1,1,3141,2.06886e-05,146384297,0.964177
D.bunnanda,151823105,VNKE01002797.1,1,3138,2.06688e-05,146387435,0.964197
D.bunnanda,151823105,VNKE01002223.1,1,3137,2.06622e-05,146390572,0.964218
D.bunnanda,151823105,VNKE01004633.1,1,3136,2.06556e-05,146393708,0.964239
D.bunnanda,151823105,VNKE01000276.1,1,3133,2.06359e-05,146396841,0.964259
D.bunnanda,151823105,VNKE01001552.1,1,3130,2.06161e-05,146399971,0.96428
D.bunnanda,151823105,VNKE01006304.1,1,3125,2.05832e-05,146403096,0.9643
D.bunnanda,151823105,VNKE01006354.1,1,3124,2.05766e-05,146406220,0.964321
D.bunnanda,151823105,VNKE01002290.1,1,3124,2.05766e-05,146409344,0.964342
D.bunnanda,151823105,VNKE01004999.1,1,3121,2.05568e-05,146412465,0.964362
D.bunnanda,151823105,VNKE01003835.1,1,3121,2.05568e-05,146415586,0.964383
D.bunnanda,151823105,VNKE01001572.1,1,3119,2.05436e-05,146418705,0.964403
D.bunnanda,151823105,VNKE01005424.1,1,3118,2.05371e-05,146421823,0.964424
D.bunnanda,151823105,VNKE01004246.1,1,3118,2.05371e-05,146424941,0.964444
D.bunnanda,151823105,VNKE01000598.1,1,3117,2.05305e-05,146428058,0.964465
D.bunnanda,151823105,VNKE01006086.1,1,3116,2.05239e-05,146431174,0.964485
D.bunnanda,151823105,VNKE01006134.1,1,3113,2.05041e-05,146434287,0.964506
D.bunnanda,151823105,VNKE01002900.1,1,3113,2.05041e-05,146437400,0.964526
D.bunnanda,151823105,VNKE01004895.1,1,3110,2.04844e-05,146440510,0.964547
D.bunnanda,151823105,VNKE01003563.1,1,3109,2.04778e-05,146443619,0.964567
D.bunnanda,151823105,VNKE01005230.1,1,3107,2.04646e-05,146446726,0.964588
D.bunnanda,151823105,VNKE01003770.1,1,3106,2.0458e-05,146449832,0.964608
D.bunnanda,151823105,VNKE01006135.1,1,3104,2.04448e-05,146452936,0.964629
D.bunnanda,151823105,VNKE01002972.1,1,3104,2.04448e-05,146456040,0.964649
D.bunnanda,151823105,VNKE01002539.1,1,3100,2.04185e-05,146459140,0.96467
D.bunnanda,151823105,VNKE01002055.1,1,3099,2.04119e-05,146462239,0.96469
D.bunnanda,151823105,VNKE01006044.1,1,3096,2.03922e-05,146465335,0.96471
D.bunnanda,151823105,VNKE01000018.1,1,3096,2.03922e-05,146468431,0.964731
D.bunnanda,151823105,VNKE01003943.1,1,3093,2.03724e-05,146471524,0.964751
D.bunnanda,151823105,VNKE01003462.1,1,3089,2.0346e-05,146474613,0.964772
D.bunnanda,151823105,VNKE01005928.1,1,3085,2.03197e-05,146477698,0.964792
D.bunnanda,151823105,VNKE01006352.1,1,3084,2.03131e-05,146480782,0.964812
D.bunnanda,151823105,VNKE01000287.1,1,3081,2.02934e-05,146483863,0.964832
D.bunnanda,151823105,VNKE01000013.1,1,3081,2.02934e-05,146486944,0.964853
D.bunnanda,151823105,VNKE01006579.1,1,3079,2.02802e-05,146490023,0.964873
D.bunnanda,151823105,VNKE01004722.1,1,3078,2.02736e-05,146493101,0.964893
D.bunnanda,151823105,VNKE01002098.1,1,3076,2.02604e-05,146496177,0.964914
D.bunnanda,151823105,VNKE01002970.1,1,3073,2.02407e-05,146499250,0.964934
D.bunnanda,151823105,VNKE01002990.1,1,3070,2.02209e-05,146502320,0.964954
D.bunnanda,151823105,VNKE01000383.1,1,3069,2.02143e-05,146505389,0.964974
D.bunnanda,151823105,VNKE01005175.1,1,3067,2.02011e-05,146508456,0.964994
D.bunnanda,151823105,VNKE01004704.1,1,3062,2.01682e-05,146511518,0.965015
D.bunnanda,151823105,VNKE01002727.1,1,3062,2.01682e-05,146514580,0.965035
D.bunnanda,151823105,VNKE01000578.1,1,3061,2.01616e-05,146517641,0.965055
D.bunnanda,151823105,VNKE01004392.1,1,3060,2.0155e-05,146520701,0.965075
D.bunnanda,151823105,VNKE01000595.1,1,3060,2.0155e-05,146523761,0.965095
D.bunnanda,151823105,VNKE01005766.1,1,3059,2.01484e-05,146526820,0.965115
D.bunnanda,151823105,VNKE01006617.1,1,3050,2.00892e-05,146529870,0.965136
D.bunnanda,151823105,VNKE01001511.1,1,3048,2.0076e-05,146532918,0.965156
D.bunnanda,151823105,VNKE01001199.1,1,3048,2.0076e-05,146535966,0.965176
D.bunnanda,151823105,VNKE01003029.1,1,3046,2.00628e-05,146539012,0.965196
D.bunnanda,151823105,VNKE01000346.1,1,3045,2.00562e-05,146542057,0.965216
D.bunnanda,151823105,VNKE01003732.1,1,3042,2.00365e-05,146545099,0.965236
D.bunnanda,151823105,VNKE01004748.1,1,3041,2.00299e-05,146548140,0.965256
D.bunnanda,151823105,VNKE01002943.1,1,3041,2.00299e-05,146551181,0.965276
D.bunnanda,151823105,VNKE01004300.1,1,3040,2.00233e-05,146554221,0.965296
D.bunnanda,151823105,VNKE01000492.1,1,3040,2.00233e-05,146557261,0.965316
D.bunnanda,151823105,VNKE01006402.1,1,3039,2.00167e-05,146560300,0.965336
D.bunnanda,151823105,VNKE01005423.1,1,3039,2.00167e-05,146563339,0.965356
D.bunnanda,151823105,VNKE01005497.1,1,3038,2.00101e-05,146566377,0.965376
D.bunnanda,151823105,VNKE01005096.1,1,3038,2.00101e-05,146569415,0.965396
D.bunnanda,151823105,VNKE01001631.1,1,3037,2.00035e-05,146572452,0.965416
D.bunnanda,151823105,VNKE01006256.1,1,3036,1.9997e-05,146575488,0.965436
D.bunnanda,151823105,VNKE01001048.1,1,3036,1.9997e-05,146578524,0.965456
D.bunnanda,151823105,VNKE01004225.1,1,3027,1.99377e-05,146581551,0.965476
D.bunnanda,151823105,VNKE01001050.1,1,3027,1.99377e-05,146584578,0.965496
D.bunnanda,151823105,VNKE01006616.1,1,3026,1.99311e-05,146587604,0.965516
D.bunnanda,151823105,VNKE01004473.1,1,3021,1.98982e-05,146590625,0.965536
D.bunnanda,151823105,VNKE01002377.1,1,3012,1.98389e-05,146593637,0.965556
D.bunnanda,151823105,VNKE01003489.1,1,3010,1.98257e-05,146596647,0.965575
D.bunnanda,151823105,VNKE01001432.1,1,3008,1.98125e-05,146599655,0.965595
D.bunnanda,151823105,VNKE01005486.1,1,3007,1.98059e-05,146602662,0.965615
D.bunnanda,151823105,VNKE01004964.1,1,3004,1.97862e-05,146605666,0.965635
D.bunnanda,151823105,VNKE01004891.1,1,3004,1.97862e-05,146608670,0.965655
D.bunnanda,151823105,VNKE01003766.1,1,3003,1.97796e-05,146611673,0.965674
D.bunnanda,151823105,VNKE01006577.1,1,3000,1.97598e-05,146614673,0.965694
D.bunnanda,151823105,VNKE01003292.1,1,2999,1.97533e-05,146617672,0.965714
D.bunnanda,151823105,VNKE01000110.1,1,2998,1.97467e-05,146620670,0.965734
D.bunnanda,151823105,VNKE01000109.1,1,2998,1.97467e-05,146623668,0.965753
D.bunnanda,151823105,VNKE01006085.1,1,2997,1.97401e-05,146626665,0.965773
D.bunnanda,151823105,VNKE01000537.1,1,2996,1.97335e-05,146629661,0.965793
D.bunnanda,151823105,VNKE01003661.1,1,2995,1.97269e-05,146632656,0.965813
D.bunnanda,151823105,VNKE01003061.1,1,2993,1.97137e-05,146635649,0.965832
D.bunnanda,151823105,VNKE01005844.1,1,2991,1.97006e-05,146638640,0.965852
D.bunnanda,151823105,VNKE01006471.1,1,2988,1.96808e-05,146641628,0.965872
D.bunnanda,151823105,VNKE01003278.1,1,2986,1.96676e-05,146644614,0.965891
D.bunnanda,151823105,VNKE01002440.1,1,2986,1.96676e-05,146647600,0.965911
D.bunnanda,151823105,VNKE01002141.1,1,2986,1.96676e-05,146650586,0.965931
D.bunnanda,151823105,VNKE01005259.1,1,2984,1.96545e-05,146653570,0.96595
D.bunnanda,151823105,VNKE01003012.1,1,2982,1.96413e-05,146656552,0.96597
D.bunnanda,151823105,VNKE01000844.1,1,2980,1.96281e-05,146659532,0.96599
D.bunnanda,151823105,VNKE01000101.1,1,2976,1.96018e-05,146662508,0.966009
D.bunnanda,151823105,VNKE01003245.1,1,2974,1.95886e-05,146665482,0.966029
D.bunnanda,151823105,VNKE01005577.1,1,2972,1.95754e-05,146668454,0.966048
D.bunnanda,151823105,VNKE01005348.1,1,2971,1.95688e-05,146671425,0.966068
D.bunnanda,151823105,VNKE01000802.1,1,2968,1.95491e-05,146674393,0.966087
D.bunnanda,151823105,VNKE01000111.1,1,2968,1.95491e-05,146677361,0.966107
D.bunnanda,151823105,VNKE01001871.1,1,2967,1.95425e-05,146680328,0.966127
D.bunnanda,151823105,VNKE01005661.1,1,2964,1.95227e-05,146683292,0.966146
D.bunnanda,151823105,VNKE01005508.1,1,2963,1.95161e-05,146686255,0.966166
D.bunnanda,151823105,VNKE01000599.1,1,2961,1.9503e-05,146689216,0.966185
D.bunnanda,151823105,VNKE01005633.1,1,2960,1.94964e-05,146692176,0.966205
D.bunnanda,151823105,VNKE01006570.1,1,2954,1.94569e-05,146695130,0.966224
D.bunnanda,151823105,VNKE01002162.1,1,2954,1.94569e-05,146698084,0.966243
D.bunnanda,151823105,VNKE01000686.1,1,2954,1.94569e-05,146701038,0.966263
D.bunnanda,151823105,VNKE01000664.1,1,2954,1.94569e-05,146703992,0.966282
D.bunnanda,151823105,VNKE01005977.1,1,2946,1.94042e-05,146706938,0.966302
D.bunnanda,151823105,VNKE01004461.1,1,2944,1.9391e-05,146709882,0.966321
D.bunnanda,151823105,VNKE01003171.1,1,2941,1.93712e-05,146712823,0.966341
D.bunnanda,151823105,VNKE01005999.1,1,2940,1.93646e-05,146715763,0.96636
D.bunnanda,151823105,VNKE01001468.1,1,2940,1.93646e-05,146718703,0.966379
D.bunnanda,151823105,VNKE01001751.1,1,2938,1.93515e-05,146721641,0.966399
D.bunnanda,151823105,VNKE01001450.1,1,2933,1.93185e-05,146724574,0.966418
D.bunnanda,151823105,VNKE01000872.1,1,2932,1.93119e-05,146727506,0.966437
D.bunnanda,151823105,VNKE01000213.1,1,2932,1.93119e-05,146730438,0.966457
D.bunnanda,151823105,VNKE01004236.1,1,2930,1.92988e-05,146733368,0.966476
D.bunnanda,151823105,VNKE01004520.1,1,2929,1.92922e-05,146736297,0.966495
D.bunnanda,151823105,VNKE01004253.1,1,2927,1.9279e-05,146739224,0.966514
D.bunnanda,151823105,VNKE01002490.1,1,2924,1.92593e-05,146742148,0.966534
D.bunnanda,151823105,VNKE01005126.1,1,2922,1.92461e-05,146745070,0.966553
D.bunnanda,151823105,VNKE01004675.1,1,2922,1.92461e-05,146747992,0.966572
D.bunnanda,151823105,VNKE01005558.1,1,2921,1.92395e-05,146750913,0.966591
D.bunnanda,151823105,VNKE01002084.1,1,2921,1.92395e-05,146753834,0.966611
D.bunnanda,151823105,VNKE01006013.1,1,2916,1.92066e-05,146756750,0.96663
D.bunnanda,151823105,VNKE01001982.1,1,2916,1.92066e-05,146759666,0.966649
D.bunnanda,151823105,VNKE01005927.1,1,2915,1.92e-05,146762581,0.966668
D.bunnanda,151823105,VNKE01005129.1,1,2915,1.92e-05,146765496,0.966687
D.bunnanda,151823105,VNKE01002852.1,1,2912,1.91802e-05,146768408,0.966707
D.bunnanda,151823105,VNKE01006445.1,1,2911,1.91736e-05,146771319,0.966726
D.bunnanda,151823105,VNKE01000750.1,1,2911,1.91736e-05,146774230,0.966745
D.bunnanda,151823105,VNKE01001563.1,1,2910,1.9167e-05,146777140,0.966764
D.bunnanda,151823105,VNKE01000005.1,1,2909,1.91605e-05,146780049,0.966783
D.bunnanda,151823105,VNKE01005505.1,1,2903,1.91209e-05,146782952,0.966802
D.bunnanda,151823105,VNKE01003721.1,1,2903,1.91209e-05,146785855,0.966822
D.bunnanda,151823105,VNKE01002860.1,1,2897,1.90814e-05,146788752,0.966841
D.bunnanda,151823105,VNKE01004166.1,1,2895,1.90682e-05,146791647,0.96686
D.bunnanda,151823105,VNKE01002394.1,1,2894,1.90617e-05,146794541,0.966879
D.bunnanda,151823105,VNKE01006015.1,1,2892,1.90485e-05,146797433,0.966898
D.bunnanda,151823105,VNKE01002905.1,1,2891,1.90419e-05,146800324,0.966917
D.bunnanda,151823105,VNKE01003602.1,1,2890,1.90353e-05,146803214,0.966936
D.bunnanda,151823105,VNKE01002303.1,1,2890,1.90353e-05,146806104,0.966955
D.bunnanda,151823105,VNKE01003692.1,1,2888,1.90221e-05,146808992,0.966974
D.bunnanda,151823105,VNKE01000971.1,1,2887,1.90156e-05,146811879,0.966993
D.bunnanda,151823105,VNKE01002549.1,1,2885,1.90024e-05,146814764,0.967012
D.bunnanda,151823105,VNKE01002287.1,1,2884,1.89958e-05,146817648,0.967031
D.bunnanda,151823105,VNKE01006391.1,1,2880,1.89694e-05,146820528,0.96705
D.bunnanda,151823105,VNKE01005994.1,1,2879,1.89629e-05,146823407,0.967069
D.bunnanda,151823105,VNKE01001793.1,1,2878,1.89563e-05,146826285,0.967088
D.bunnanda,151823105,VNKE01000823.1,1,2878,1.89563e-05,146829163,0.967107
D.bunnanda,151823105,VNKE01000681.1,1,2878,1.89563e-05,146832041,0.967126
D.bunnanda,151823105,VNKE01002447.1,1,2876,1.89431e-05,146834917,0.967145
D.bunnanda,151823105,VNKE01006234.1,1,2874,1.89299e-05,146837791,0.967164
D.bunnanda,151823105,VNKE01004210.1,1,2874,1.89299e-05,146840665,0.967183
D.bunnanda,151823105,VNKE01003718.1,1,2870,1.89036e-05,146843535,0.967202
D.bunnanda,151823105,VNKE01003028.1,1,2867,1.88838e-05,146846402,0.96722
D.bunnanda,151823105,VNKE01001452.1,1,2865,1.88706e-05,146849267,0.967239
D.bunnanda,151823105,VNKE01001584.1,1,2863,1.88575e-05,146852130,0.967258
D.bunnanda,151823105,VNKE01002711.1,1,2860,1.88377e-05,146854990,0.967277
D.bunnanda,151823105,VNKE01001036.1,1,2860,1.88377e-05,146857850,0.967296
D.bunnanda,151823105,VNKE01005156.1,1,2858,1.88245e-05,146860708,0.967315
D.bunnanda,151823105,VNKE01001285.1,1,2857,1.8818e-05,146863565,0.967333
D.bunnanda,151823105,VNKE01003859.1,1,2855,1.88048e-05,146866420,0.967352
D.bunnanda,151823105,VNKE01000112.1,1,2854,1.87982e-05,146869274,0.967371
D.bunnanda,151823105,VNKE01003009.1,1,2853,1.87916e-05,146872127,0.96739
D.bunnanda,151823105,VNKE01002035.1,1,2852,1.8785e-05,146874979,0.967409
D.bunnanda,151823105,VNKE01004609.1,1,2851,1.87784e-05,146877830,0.967427
D.bunnanda,151823105,VNKE01000547.1,1,2850,1.87718e-05,146880680,0.967446
D.bunnanda,151823105,VNKE01000116.1,1,2849,1.87653e-05,146883529,0.967465
D.bunnanda,151823105,VNKE01005602.1,1,2848,1.87587e-05,146886377,0.967484
D.bunnanda,151823105,VNKE01001885.1,1,2847,1.87521e-05,146889224,0.967502
D.bunnanda,151823105,VNKE01002642.1,1,2845,1.87389e-05,146892069,0.967521
D.bunnanda,151823105,VNKE01000687.1,1,2845,1.87389e-05,146894914,0.96754
D.bunnanda,151823105,VNKE01003381.1,1,2844,1.87323e-05,146897758,0.967559
D.bunnanda,151823105,VNKE01000561.1,1,2841,1.87126e-05,146900599,0.967577
D.bunnanda,151823105,VNKE01002253.1,1,2836,1.86796e-05,146903435,0.967596
D.bunnanda,151823105,VNKE01003589.1,1,2832,1.86533e-05,146906267,0.967615
D.bunnanda,151823105,VNKE01002948.1,1,2832,1.86533e-05,146909099,0.967633
D.bunnanda,151823105,VNKE01002764.1,1,2830,1.86401e-05,146911929,0.967652
D.bunnanda,151823105,VNKE01002646.1,1,2829,1.86335e-05,146914758,0.967671
D.bunnanda,151823105,VNKE01000678.1,1,2826,1.86138e-05,146917584,0.967689
D.bunnanda,151823105,VNKE01000615.1,1,2826,1.86138e-05,146920410,0.967708
D.bunnanda,151823105,VNKE01005167.1,1,2825,1.86072e-05,146923235,0.967726
D.bunnanda,151823105,VNKE01005469.1,1,2819,1.85677e-05,146926054,0.967745
D.bunnanda,151823105,VNKE01000821.1,1,2817,1.85545e-05,146928871,0.967764
D.bunnanda,151823105,VNKE01000352.1,1,2817,1.85545e-05,146931688,0.967782
D.bunnanda,151823105,VNKE01005900.1,1,2815,1.85413e-05,146934503,0.967801
D.bunnanda,151823105,VNKE01003461.1,1,2814,1.85347e-05,146937317,0.967819
D.bunnanda,151823105,VNKE01000937.1,1,2812,1.85216e-05,146940129,0.967838
D.bunnanda,151823105,VNKE01004165.1,1,2811,1.8515e-05,146942940,0.967856
D.bunnanda,151823105,VNKE01000084.1,1,2811,1.8515e-05,146945751,0.967875
D.bunnanda,151823105,VNKE01005023.1,1,2810,1.85084e-05,146948561,0.967893
D.bunnanda,151823105,VNKE01001095.1,1,2809,1.85018e-05,146951370,0.967912
D.bunnanda,151823105,VNKE01002768.1,1,2807,1.84886e-05,146954177,0.96793
D.bunnanda,151823105,VNKE01003383.1,1,2806,1.8482e-05,146956983,0.967949
D.bunnanda,151823105,VNKE01002632.1,1,2804,1.84689e-05,146959787,0.967967
D.bunnanda,151823105,VNKE01000794.1,1,2802,1.84557e-05,146962589,0.967986
D.bunnanda,151823105,VNKE01004712.1,1,2801,1.84491e-05,146965390,0.968004
D.bunnanda,151823105,VNKE01004909.1,1,2800,1.84425e-05,146968190,0.968023
D.bunnanda,151823105,VNKE01006489.1,1,2797,1.84228e-05,146970987,0.968041
D.bunnanda,151823105,VNKE01003295.1,1,2797,1.84228e-05,146973784,0.968059
D.bunnanda,151823105,VNKE01003139.1,1,2792,1.83898e-05,146976576,0.968078
D.bunnanda,151823105,VNKE01003670.1,1,2791,1.83832e-05,146979367,0.968096
D.bunnanda,151823105,VNKE01003530.1,1,2791,1.83832e-05,146982158,0.968115
D.bunnanda,151823105,VNKE01001766.1,1,2790,1.83766e-05,146984948,0.968133
D.bunnanda,151823105,VNKE01005079.1,1,2788,1.83635e-05,146987736,0.968151
D.bunnanda,151823105,VNKE01003454.1,1,2788,1.83635e-05,146990524,0.96817
D.bunnanda,151823105,VNKE01004414.1,1,2785,1.83437e-05,146993309,0.968188
D.bunnanda,151823105,VNKE01001080.1,1,2785,1.83437e-05,146996094,0.968206
D.bunnanda,151823105,VNKE01003296.1,1,2784,1.83371e-05,146998878,0.968225
D.bunnanda,151823105,VNKE01006434.1,1,2783,1.83305e-05,147001661,0.968243
D.bunnanda,151823105,VNKE01004427.1,1,2782,1.8324e-05,147004443,0.968261
D.bunnanda,151823105,VNKE01003858.1,1,2781,1.83174e-05,147007224,0.96828
D.bunnanda,151823105,VNKE01002018.1,1,2779,1.83042e-05,147010003,0.968298
D.bunnanda,151823105,VNKE01003910.1,1,2778,1.82976e-05,147012781,0.968316
D.bunnanda,151823105,VNKE01002616.1,1,2775,1.82779e-05,147015556,0.968335
D.bunnanda,151823105,VNKE01004241.1,1,2772,1.82581e-05,147018328,0.968353
D.bunnanda,151823105,VNKE01004042.1,1,2772,1.82581e-05,147021100,0.968371
D.bunnanda,151823105,VNKE01004955.1,1,2770,1.82449e-05,147023870,0.968389
D.bunnanda,151823105,VNKE01003021.1,1,2770,1.82449e-05,147026640,0.968408
D.bunnanda,151823105,VNKE01003654.1,1,2769,1.82383e-05,147029409,0.968426
D.bunnanda,151823105,VNKE01001760.1,1,2768,1.82317e-05,147032177,0.968444
D.bunnanda,151823105,VNKE01005475.1,1,2767,1.82252e-05,147034944,0.968462
D.bunnanda,151823105,VNKE01003986.1,1,2766,1.82186e-05,147037710,0.96848
D.bunnanda,151823105,VNKE01003305.1,1,2766,1.82186e-05,147040476,0.968499
D.bunnanda,151823105,VNKE01000207.1,1,2766,1.82186e-05,147043242,0.968517
D.bunnanda,151823105,VNKE01002580.1,1,2762,1.81922e-05,147046004,0.968535
D.bunnanda,151823105,VNKE01002247.1,1,2761,1.81856e-05,147048765,0.968553
D.bunnanda,151823105,VNKE01006146.1,1,2758,1.81659e-05,147051523,0.968571
D.bunnanda,151823105,VNKE01002343.1,1,2758,1.81659e-05,147054281,0.96859
D.bunnanda,151823105,VNKE01000290.1,1,2757,1.81593e-05,147057038,0.968608
D.bunnanda,151823105,VNKE01001366.1,1,2756,1.81527e-05,147059794,0.968626
D.bunnanda,151823105,VNKE01001363.1,1,2752,1.81264e-05,147062546,0.968644
D.bunnanda,151823105,VNKE01006523.1,1,2749,1.81066e-05,147065295,0.968662
D.bunnanda,151823105,VNKE01002699.1,1,2748,1.81e-05,147068043,0.96868
D.bunnanda,151823105,VNKE01005380.1,1,2746,1.80868e-05,147070789,0.968698
D.bunnanda,151823105,VNKE01002924.1,1,2745,1.80803e-05,147073534,0.968716
D.bunnanda,151823105,VNKE01003001.1,1,2744,1.80737e-05,147076278,0.968734
D.bunnanda,151823105,VNKE01001379.1,1,2744,1.80737e-05,147079022,0.968753
D.bunnanda,151823105,VNKE01004159.1,1,2743,1.80671e-05,147081765,0.968771
D.bunnanda,151823105,VNKE01002245.1,1,2740,1.80473e-05,147084505,0.968789
D.bunnanda,151823105,VNKE01002238.1,1,2739,1.80407e-05,147087244,0.968807
D.bunnanda,151823105,VNKE01003372.1,1,2738,1.80341e-05,147089982,0.968825
D.bunnanda,151823105,VNKE01001434.1,1,2738,1.80341e-05,147092720,0.968843
D.bunnanda,151823105,VNKE01003230.1,1,2736,1.8021e-05,147095456,0.968861
D.bunnanda,151823105,VNKE01003834.1,1,2735,1.80144e-05,147098191,0.968879
D.bunnanda,151823105,VNKE01001318.1,1,2735,1.80144e-05,147100926,0.968897
D.bunnanda,151823105,VNKE01005472.1,1,2734,1.80078e-05,147103660,0.968915
D.bunnanda,151823105,VNKE01004401.1,1,2731,1.7988e-05,147106391,0.968933
D.bunnanda,151823105,VNKE01000673.1,1,2730,1.79815e-05,147109121,0.968951
D.bunnanda,151823105,VNKE01005883.1,1,2729,1.79749e-05,147111850,0.968969
D.bunnanda,151823105,VNKE01002231.1,1,2729,1.79749e-05,147114579,0.968987
D.bunnanda,151823105,VNKE01001770.1,1,2728,1.79683e-05,147117307,0.969005
D.bunnanda,151823105,VNKE01000568.1,1,2727,1.79617e-05,147120034,0.969023
D.bunnanda,151823105,VNKE01002010.1,1,2725,1.79485e-05,147122759,0.969041
D.bunnanda,151823105,VNKE01003182.1,1,2724,1.79419e-05,147125483,0.969059
D.bunnanda,151823105,VNKE01000200.1,1,2724,1.79419e-05,147128207,0.969077
D.bunnanda,151823105,VNKE01006101.1,1,2722,1.79288e-05,147130929,0.969094
D.bunnanda,151823105,VNKE01002015.1,1,2717,1.78958e-05,147133646,0.969112
D.bunnanda,151823105,VNKE01003501.1,1,2716,1.78892e-05,147136362,0.96913
D.bunnanda,151823105,VNKE01003154.1,1,2716,1.78892e-05,147139078,0.969148
D.bunnanda,151823105,VNKE01001039.1,1,2713,1.78695e-05,147141791,0.969166
D.bunnanda,151823105,VNKE01004514.1,1,2711,1.78563e-05,147144502,0.969184
D.bunnanda,151823105,VNKE01003495.1,1,2711,1.78563e-05,147147213,0.969202
D.bunnanda,151823105,VNKE01001647.1,1,2711,1.78563e-05,147149924,0.96922
D.bunnanda,151823105,VNKE01006593.1,1,2710,1.78497e-05,147152634,0.969237
D.bunnanda,151823105,VNKE01002470.1,1,2706,1.78234e-05,147155340,0.969255
D.bunnanda,151823105,VNKE01006524.1,1,2703,1.78036e-05,147158043,0.969273
D.bunnanda,151823105,VNKE01004583.1,1,2699,1.77773e-05,147160742,0.969291
D.bunnanda,151823105,VNKE01001752.1,1,2697,1.77641e-05,147163439,0.969309
D.bunnanda,151823105,VNKE01004174.1,1,2696,1.77575e-05,147166135,0.969326
D.bunnanda,151823105,VNKE01003484.1,1,2695,1.77509e-05,147168830,0.969344
D.bunnanda,151823105,VNKE01000502.1,1,2694,1.77443e-05,147171524,0.969362
D.bunnanda,151823105,VNKE01003499.1,1,2692,1.77312e-05,147174216,0.96938
D.bunnanda,151823105,VNKE01006245.1,1,2691,1.77246e-05,147176907,0.969397
D.bunnanda,151823105,VNKE01001405.1,1,2691,1.77246e-05,147179598,0.969415
D.bunnanda,151823105,VNKE01004729.1,1,2688,1.77048e-05,147182286,0.969433
D.bunnanda,151823105,VNKE01003483.1,1,2687,1.76982e-05,147184973,0.96945
D.bunnanda,151823105,VNKE01003498.1,1,2686,1.76916e-05,147187659,0.969468
D.bunnanda,151823105,VNKE01005070.1,1,2684,1.76785e-05,147190343,0.969486
D.bunnanda,151823105,VNKE01003497.1,1,2684,1.76785e-05,147193027,0.969503
D.bunnanda,151823105,VNKE01002975.1,1,2684,1.76785e-05,147195711,0.969521
D.bunnanda,151823105,VNKE01002834.1,1,2684,1.76785e-05,147198395,0.969539
D.bunnanda,151823105,VNKE01000518.1,1,2684,1.76785e-05,147201079,0.969557
D.bunnanda,151823105,VNKE01006622.1,1,2683,1.76719e-05,147203762,0.969574
D.bunnanda,151823105,VNKE01004858.1,1,2682,1.76653e-05,147206444,0.969592
D.bunnanda,151823105,VNKE01006222.1,1,2681,1.76587e-05,147209125,0.96961
D.bunnanda,151823105,VNKE01005570.1,1,2681,1.76587e-05,147211806,0.969627
D.bunnanda,151823105,VNKE01001755.1,1,2681,1.76587e-05,147214487,0.969645
D.bunnanda,151823105,VNKE01003804.1,1,2680,1.76521e-05,147217167,0.969662
D.bunnanda,151823105,VNKE01002548.1,1,2680,1.76521e-05,147219847,0.96968
D.bunnanda,151823105,VNKE01002411.1,1,2680,1.76521e-05,147222527,0.969698
D.bunnanda,151823105,VNKE01001988.1,1,2679,1.76455e-05,147225206,0.969715
D.bunnanda,151823105,VNKE01001458.1,1,2678,1.76389e-05,147227884,0.969733
D.bunnanda,151823105,VNKE01000856.1,1,2672,1.75994e-05,147230556,0.969751
D.bunnanda,151823105,VNKE01005571.1,1,2669,1.75797e-05,147233225,0.969768
D.bunnanda,151823105,VNKE01005068.1,1,2669,1.75797e-05,147235894,0.969786
D.bunnanda,151823105,VNKE01006492.1,1,2668,1.75731e-05,147238562,0.969803
D.bunnanda,151823105,VNKE01005432.1,1,2668,1.75731e-05,147241230,0.969821
D.bunnanda,151823105,VNKE01004328.1,1,2666,1.75599e-05,147243896,0.969839
D.bunnanda,151823105,VNKE01003506.1,1,2665,1.75533e-05,147246561,0.969856
D.bunnanda,151823105,VNKE01003023.1,1,2665,1.75533e-05,147249226,0.969874
D.bunnanda,151823105,VNKE01000349.1,1,2664,1.75467e-05,147251890,0.969891
D.bunnanda,151823105,VNKE01005573.1,1,2662,1.75336e-05,147254552,0.969909
D.bunnanda,151823105,VNKE01002135.1,1,2661,1.7527e-05,147257213,0.969926
D.bunnanda,151823105,VNKE01000279.1,1,2660,1.75204e-05,147259873,0.969944
D.bunnanda,151823105,VNKE01002918.1,1,2656,1.7494e-05,147262529,0.969961
D.bunnanda,151823105,VNKE01001192.1,1,2653,1.74743e-05,147265182,0.969979
D.bunnanda,151823105,VNKE01000539.1,1,2653,1.74743e-05,147267835,0.969996
D.bunnanda,151823105,VNKE01003008.1,1,2651,1.74611e-05,147270486,0.970014
D.bunnanda,151823105,VNKE01002881.1,1,2651,1.74611e-05,147273137,0.970031
D.bunnanda,151823105,VNKE01002332.1,1,2650,1.74545e-05,147275787,0.970049
D.bunnanda,151823105,VNKE01001371.1,1,2649,1.74479e-05,147278436,0.970066
D.bunnanda,151823105,VNKE01002648.1,1,2639,1.73821e-05,147281075,0.970083
D.bunnanda,151823105,VNKE01002189.1,1,2639,1.73821e-05,147283714,0.970101
D.bunnanda,151823105,VNKE01005886.1,1,2637,1.73689e-05,147286351,0.970118
D.bunnanda,151823105,VNKE01003025.1,1,2635,1.73557e-05,147288986,0.970136
D.bunnanda,151823105,VNKE01006490.1,1,2629,1.73162e-05,147291615,0.970153
D.bunnanda,151823105,VNKE01004867.1,1,2629,1.73162e-05,147294244,0.97017
D.bunnanda,151823105,VNKE01004231.1,1,2624,1.72833e-05,147296868,0.970187
D.bunnanda,151823105,VNKE01001997.1,1,2624,1.72833e-05,147299492,0.970205
D.bunnanda,151823105,VNKE01004172.1,1,2623,1.72767e-05,147302115,0.970222
D.bunnanda,151823105,VNKE01003643.1,1,2623,1.72767e-05,147304738,0.970239
D.bunnanda,151823105,VNKE01005161.1,1,2622,1.72701e-05,147307360,0.970257
D.bunnanda,151823105,VNKE01003999.1,1,2622,1.72701e-05,147309982,0.970274
D.bunnanda,151823105,VNKE01003503.1,1,2621,1.72635e-05,147312603,0.970291
D.bunnanda,151823105,VNKE01004523.1,1,2620,1.72569e-05,147315223,0.970308
D.bunnanda,151823105,VNKE01006361.1,1,2618,1.72438e-05,147317841,0.970326
D.bunnanda,151823105,VNKE01001305.1,1,2617,1.72372e-05,147320458,0.970343
D.bunnanda,151823105,VNKE01001992.1,1,2615,1.7224e-05,147323073,0.97036
D.bunnanda,151823105,VNKE01000113.1,1,2613,1.72108e-05,147325686,0.970377
D.bunnanda,151823105,VNKE01001959.1,1,2611,1.71976e-05,147328297,0.970394
D.bunnanda,151823105,VNKE01005622.1,1,2609,1.71845e-05,147330906,0.970412
D.bunnanda,151823105,VNKE01003556.1,1,2608,1.71779e-05,147333514,0.970429
D.bunnanda,151823105,VNKE01001608.1,1,2608,1.71779e-05,147336122,0.970446
D.bunnanda,151823105,VNKE01003259.1,1,2607,1.71713e-05,147338729,0.970463
D.bunnanda,151823105,VNKE01003106.1,1,2606,1.71647e-05,147341335,0.97048
D.bunnanda,151823105,VNKE01004761.1,1,2605,1.71581e-05,147343940,0.970497
D.bunnanda,151823105,VNKE01003781.1,1,2605,1.71581e-05,147346545,0.970515
D.bunnanda,151823105,VNKE01004406.1,1,2604,1.71515e-05,147349149,0.970532
D.bunnanda,151823105,VNKE01003905.1,1,2603,1.7145e-05,147351752,0.970549
D.bunnanda,151823105,VNKE01002625.1,1,2601,1.71318e-05,147354353,0.970566
D.bunnanda,151823105,VNKE01003092.1,1,2598,1.7112e-05,147356951,0.970583
D.bunnanda,151823105,VNKE01001006.1,1,2597,1.71054e-05,147359548,0.9706
D.bunnanda,151823105,VNKE01003196.1,1,2596,1.70988e-05,147362144,0.970617
D.bunnanda,151823105,VNKE01005772.1,1,2595,1.70923e-05,147364739,0.970634
D.bunnanda,151823105,VNKE01001887.1,1,2595,1.70923e-05,147367334,0.970652
D.bunnanda,151823105,VNKE01004270.1,1,2593,1.70791e-05,147369927,0.970669
D.bunnanda,151823105,VNKE01001617.1,1,2591,1.70659e-05,147372518,0.970686
D.bunnanda,151823105,VNKE01004713.1,1,2590,1.70593e-05,147375108,0.970703
D.bunnanda,151823105,VNKE01003649.1,1,2590,1.70593e-05,147377698,0.97072
D.bunnanda,151823105,VNKE01005837.1,1,2587,1.70396e-05,147380285,0.970737
D.bunnanda,151823105,VNKE01005657.1,1,2584,1.70198e-05,147382869,0.970754
D.bunnanda,151823105,VNKE01005778.1,1,2581,1.7e-05,147385450,0.970771
D.bunnanda,151823105,VNKE01003833.1,1,2581,1.7e-05,147388031,0.970788
D.bunnanda,151823105,VNKE01006004.1,1,2575,1.69605e-05,147390606,0.970805
D.bunnanda,151823105,VNKE01005429.1,1,2570,1.69276e-05,147393176,0.970822
D.bunnanda,151823105,VNKE01003140.1,1,2570,1.69276e-05,147395746,0.970839
D.bunnanda,151823105,VNKE01002249.1,1,2570,1.69276e-05,147398316,0.970856
D.bunnanda,151823105,VNKE01005740.1,1,2569,1.6921e-05,147400885,0.970873
D.bunnanda,151823105,VNKE01004994.1,1,2567,1.69078e-05,147403452,0.970889
D.bunnanda,151823105,VNKE01004404.1,1,2567,1.69078e-05,147406019,0.970906
D.bunnanda,151823105,VNKE01003480.1,1,2566,1.69012e-05,147408585,0.970923
D.bunnanda,151823105,VNKE01003680.1,1,2565,1.68947e-05,147411150,0.97094
D.bunnanda,151823105,VNKE01003217.1,1,2565,1.68947e-05,147413715,0.970957
D.bunnanda,151823105,VNKE01002412.1,1,2565,1.68947e-05,147416280,0.970974
D.bunnanda,151823105,VNKE01003316.1,1,2564,1.68881e-05,147418844,0.970991
D.bunnanda,151823105,VNKE01003170.1,1,2564,1.68881e-05,147421408,0.971008
D.bunnanda,151823105,VNKE01002328.1,1,2564,1.68881e-05,147423972,0.971025
D.bunnanda,151823105,VNKE01000867.1,1,2563,1.68815e-05,147426535,0.971041
D.bunnanda,151823105,VNKE01000262.1,1,2563,1.68815e-05,147429098,0.971058
D.bunnanda,151823105,VNKE01000723.1,1,2562,1.68749e-05,147431660,0.971075
D.bunnanda,151823105,VNKE01006203.1,1,2561,1.68683e-05,147434221,0.971092
D.bunnanda,151823105,VNKE01004230.1,1,2561,1.68683e-05,147436782,0.971109
D.bunnanda,151823105,VNKE01006456.1,1,2558,1.68486e-05,147439340,0.971126
D.bunnanda,151823105,VNKE01003017.1,1,2558,1.68486e-05,147441898,0.971143
D.bunnanda,151823105,VNKE01005761.1,1,2556,1.68354e-05,147444454,0.97116
D.bunnanda,151823105,VNKE01002336.1,1,2555,1.68288e-05,147447009,0.971176
D.bunnanda,151823105,VNKE01006399.1,1,2553,1.68156e-05,147449562,0.971193
D.bunnanda,151823105,VNKE01004382.1,1,2553,1.68156e-05,147452115,0.97121
D.bunnanda,151823105,VNKE01002060.1,1,2553,1.68156e-05,147454668,0.971227
D.bunnanda,151823105,VNKE01003247.1,1,2552,1.6809e-05,147457220,0.971244
D.bunnanda,151823105,VNKE01004244.1,1,2550,1.67959e-05,147459770,0.97126
D.bunnanda,151823105,VNKE01004759.1,1,2549,1.67893e-05,147462319,0.971277
D.bunnanda,151823105,VNKE01004408.1,1,2549,1.67893e-05,147464868,0.971294
D.bunnanda,151823105,VNKE01003276.1,1,2549,1.67893e-05,147467417,0.971311
D.bunnanda,151823105,VNKE01006535.1,1,2545,1.67629e-05,147469962,0.971328
D.bunnanda,151823105,VNKE01004428.1,1,2542,1.67432e-05,147472504,0.971344
D.bunnanda,151823105,VNKE01005585.1,1,2539,1.67234e-05,147475043,0.971361
D.bunnanda,151823105,VNKE01005623.1,1,2538,1.67168e-05,147477581,0.971378
D.bunnanda,151823105,VNKE01002644.1,1,2538,1.67168e-05,147480119,0.971394
D.bunnanda,151823105,VNKE01002541.1,1,2538,1.67168e-05,147482657,0.971411
D.bunnanda,151823105,VNKE01006139.1,1,2534,1.66905e-05,147485191,0.971428
D.bunnanda,151823105,VNKE01000273.1,1,2534,1.66905e-05,147487725,0.971445
D.bunnanda,151823105,VNKE01006527.1,1,2533,1.66839e-05,147490258,0.971461
D.bunnanda,151823105,VNKE01004889.1,1,2532,1.66773e-05,147492790,0.971478
D.bunnanda,151823105,VNKE01002628.1,1,2532,1.66773e-05,147495322,0.971495
D.bunnanda,151823105,VNKE01005447.1,1,2531,1.66707e-05,147497853,0.971511
D.bunnanda,151823105,VNKE01004180.1,1,2531,1.66707e-05,147500384,0.971528
D.bunnanda,151823105,VNKE01003460.1,1,2531,1.66707e-05,147502915,0.971545
D.bunnanda,151823105,VNKE01004841.1,1,2530,1.66641e-05,147505445,0.971561
D.bunnanda,151823105,VNKE01004956.1,1,2529,1.66575e-05,147507974,0.971578
D.bunnanda,151823105,VNKE01003500.1,1,2529,1.66575e-05,147510503,0.971595
D.bunnanda,151823105,VNKE01003298.1,1,2529,1.66575e-05,147513032,0.971611
D.bunnanda,151823105,VNKE01005055.1,1,2528,1.6651e-05,147515560,0.971628
D.bunnanda,151823105,VNKE01004746.1,1,2527,1.66444e-05,147518087,0.971645
D.bunnanda,151823105,VNKE01004013.1,1,2526,1.66378e-05,147520613,0.971661
D.bunnanda,151823105,VNKE01006403.1,1,2521,1.66049e-05,147523134,0.971678
D.bunnanda,151823105,VNKE01003769.1,1,2520,1.65983e-05,147525654,0.971694
D.bunnanda,151823105,VNKE01002353.1,1,2518,1.65851e-05,147528172,0.971711
D.bunnanda,151823105,VNKE01006397.1,1,2516,1.65719e-05,147530688,0.971728
D.bunnanda,151823105,VNKE01003846.1,1,2516,1.65719e-05,147533204,0.971744
D.bunnanda,151823105,VNKE01006295.1,1,2513,1.65522e-05,147535717,0.971761
D.bunnanda,151823105,VNKE01004238.1,1,2510,1.65324e-05,147538227,0.971777
D.bunnanda,151823105,VNKE01002246.1,1,2510,1.65324e-05,147540737,0.971794
D.bunnanda,151823105,VNKE01004150.1,1,2509,1.65258e-05,147543246,0.97181
D.bunnanda,151823105,VNKE01000857.1,1,2509,1.65258e-05,147545755,0.971827
D.bunnanda,151823105,VNKE01002481.1,1,2506,1.65061e-05,147548261,0.971843
D.bunnanda,151823105,VNKE01003960.1,1,2505,1.64995e-05,147550766,0.97186
D.bunnanda,151823105,VNKE01000443.1,1,2503,1.64863e-05,147553269,0.971876
D.bunnanda,151823105,VNKE01002707.1,1,2502,1.64797e-05,147555771,0.971893
D.bunnanda,151823105,VNKE01001333.1,1,2500,1.64665e-05,147558271,0.971909
D.bunnanda,151823105,VNKE01001682.1,1,2499,1.64599e-05,147560770,0.971926
D.bunnanda,151823105,VNKE01004637.1,1,2498,1.64534e-05,147563268,0.971942
D.bunnanda,151823105,VNKE01005652.1,1,2497,1.64468e-05,147565765,0.971959
D.bunnanda,151823105,VNKE01005649.1,1,2496,1.64402e-05,147568261,0.971975
D.bunnanda,151823105,VNKE01005270.1,1,2496,1.64402e-05,147570757,0.971991
D.bunnanda,151823105,VNKE01003754.1,1,2496,1.64402e-05,147573253,0.972008
D.bunnanda,151823105,VNKE01003059.1,1,2495,1.64336e-05,147575748,0.972024
D.bunnanda,151823105,VNKE01002856.1,1,2495,1.64336e-05,147578243,0.972041
D.bunnanda,151823105,VNKE01003051.1,1,2493,1.64204e-05,147580736,0.972057
D.bunnanda,151823105,VNKE01001866.1,1,2493,1.64204e-05,147583229,0.972074
D.bunnanda,151823105,VNKE01003084.1,1,2492,1.64138e-05,147585721,0.97209
D.bunnanda,151823105,VNKE01005253.1,1,2490,1.64007e-05,147588211,0.972106
D.bunnanda,151823105,VNKE01004806.1,1,2489,1.63941e-05,147590700,0.972123
D.bunnanda,151823105,VNKE01000392.1,1,2489,1.63941e-05,147593189,0.972139
D.bunnanda,151823105,VNKE01006522.1,1,2488,1.63875e-05,147595677,0.972156
D.bunnanda,151823105,VNKE01005267.1,1,2488,1.63875e-05,147598165,0.972172
D.bunnanda,151823105,VNKE01001000.1,1,2488,1.63875e-05,147600653,0.972188
D.bunnanda,151823105,VNKE01005569.1,1,2487,1.63809e-05,147603140,0.972205
D.bunnanda,151823105,VNKE01000115.1,1,2487,1.63809e-05,147605627,0.972221
D.bunnanda,151823105,VNKE01003690.1,1,2486,1.63743e-05,147608113,0.972237
D.bunnanda,151823105,VNKE01003022.1,1,2486,1.63743e-05,147610599,0.972254
D.bunnanda,151823105,VNKE01000324.1,1,2485,1.63677e-05,147613084,0.97227
D.bunnanda,151823105,VNKE01004035.1,1,2484,1.63611e-05,147615568,0.972287
D.bunnanda,151823105,VNKE01003274.1,1,2484,1.63611e-05,147618052,0.972303
D.bunnanda,151823105,VNKE01000778.1,1,2483,1.63546e-05,147620535,0.972319
D.bunnanda,151823105,VNKE01003181.1,1,2482,1.6348e-05,147623017,0.972336
D.bunnanda,151823105,VNKE01002003.1,1,2477,1.6315e-05,147625494,0.972352
D.bunnanda,151823105,VNKE01000771.1,1,2477,1.6315e-05,147627971,0.972368
D.bunnanda,151823105,VNKE01005807.1,1,2476,1.63085e-05,147630447,0.972385
D.bunnanda,151823105,VNKE01005142.1,1,2476,1.63085e-05,147632923,0.972401
D.bunnanda,151823105,VNKE01002334.1,1,2476,1.63085e-05,147635399,0.972417
D.bunnanda,151823105,VNKE01004859.1,1,2474,1.62953e-05,147637873,0.972433
D.bunnanda,151823105,VNKE01002256.1,1,2474,1.62953e-05,147640347,0.97245
D.bunnanda,151823105,VNKE01005470.1,1,2472,1.62821e-05,147642819,0.972466
D.bunnanda,151823105,VNKE01001757.1,1,2472,1.62821e-05,147645291,0.972482
D.bunnanda,151823105,VNKE01003303.1,1,2471,1.62755e-05,147647762,0.972499
D.bunnanda,151823105,VNKE01000513.1,1,2471,1.62755e-05,147650233,0.972515
D.bunnanda,151823105,VNKE01001470.1,1,2470,1.62689e-05,147652703,0.972531
D.bunnanda,151823105,VNKE01000202.1,1,2469,1.62623e-05,147655172,0.972547
D.bunnanda,151823105,VNKE01004136.1,1,2468,1.62558e-05,147657640,0.972564
D.bunnanda,151823105,VNKE01002626.1,1,2466,1.62426e-05,147660106,0.97258
D.bunnanda,151823105,VNKE01006484.1,1,2464,1.62294e-05,147662570,0.972596
D.bunnanda,151823105,VNKE01000846.1,1,2462,1.62162e-05,147665032,0.972612
D.bunnanda,151823105,VNKE01003877.1,1,2458,1.61899e-05,147667490,0.972629
D.bunnanda,151823105,VNKE01005892.1,1,2457,1.61833e-05,147669947,0.972645
D.bunnanda,151823105,VNKE01002531.1,1,2455,1.61701e-05,147672402,0.972661
D.bunnanda,151823105,VNKE01003710.1,1,2454,1.61635e-05,147674856,0.972677
D.bunnanda,151823105,VNKE01006327.1,1,2453,1.6157e-05,147677309,0.972693
D.bunnanda,151823105,VNKE01005370.1,1,2450,1.61372e-05,147679759,0.972709
D.bunnanda,151823105,VNKE01002090.1,1,2450,1.61372e-05,147682209,0.972726
D.bunnanda,151823105,VNKE01002266.1,1,2448,1.6124e-05,147684657,0.972742
D.bunnanda,151823105,VNKE01005781.1,1,2446,1.61109e-05,147687103,0.972758
D.bunnanda,151823105,VNKE01000782.1,1,2446,1.61109e-05,147689549,0.972774
D.bunnanda,151823105,VNKE01003554.1,1,2444,1.60977e-05,147691993,0.97279
D.bunnanda,151823105,VNKE01003933.1,1,2443,1.60911e-05,147694436,0.972806
D.bunnanda,151823105,VNKE01005229.1,1,2439,1.60647e-05,147696875,0.972822
D.bunnanda,151823105,VNKE01004791.1,1,2439,1.60647e-05,147699314,0.972838
D.bunnanda,151823105,VNKE01006137.1,1,2438,1.60582e-05,147701752,0.972854
D.bunnanda,151823105,VNKE01000422.1,1,2438,1.60582e-05,147704190,0.97287
D.bunnanda,151823105,VNKE01000237.1,1,2438,1.60582e-05,147706628,0.972886
D.bunnanda,151823105,VNKE01006023.1,1,2437,1.60516e-05,147709065,0.972902
D.bunnanda,151823105,VNKE01002078.1,1,2436,1.6045e-05,147711501,0.972918
D.bunnanda,151823105,VNKE01006576.1,1,2435,1.60384e-05,147713936,0.972934
D.bunnanda,151823105,VNKE01005063.1,1,2434,1.60318e-05,147716370,0.972951
D.bunnanda,151823105,VNKE01005896.1,1,2432,1.60186e-05,147718802,0.972967
D.bunnanda,151823105,VNKE01004557.1,1,2432,1.60186e-05,147721234,0.972983
D.bunnanda,151823105,VNKE01006574.1,1,2429,1.59989e-05,147723663,0.972999
D.bunnanda,151823105,VNKE01005903.1,1,2429,1.59989e-05,147726092,0.973015
D.bunnanda,151823105,VNKE01003271.1,1,2429,1.59989e-05,147728521,0.973031
D.bunnanda,151823105,VNKE01002441.1,1,2427,1.59857e-05,147730948,0.973047
D.bunnanda,151823105,VNKE01003826.1,1,2426,1.59791e-05,147733374,0.973063
D.bunnanda,151823105,VNKE01002640.1,1,2425,1.59725e-05,147735799,0.973078
D.bunnanda,151823105,VNKE01002425.1,1,2425,1.59725e-05,147738224,0.973094
D.bunnanda,151823105,VNKE01001382.1,1,2425,1.59725e-05,147740649,0.97311
D.bunnanda,151823105,VNKE01002405.1,1,2423,1.59594e-05,147743072,0.973126
D.bunnanda,151823105,VNKE01005036.1,1,2422,1.59528e-05,147745494,0.973142
D.bunnanda,151823105,VNKE01001693.1,1,2420,1.59396e-05,147747914,0.973158
D.bunnanda,151823105,VNKE01002093.1,1,2419,1.5933e-05,147750333,0.973174
D.bunnanda,151823105,VNKE01000637.1,1,2419,1.5933e-05,147752752,0.97319
D.bunnanda,151823105,VNKE01000340.1,1,2419,1.5933e-05,147755171,0.973206
D.bunnanda,151823105,VNKE01006448.1,1,2417,1.59198e-05,147757588,0.973222
D.bunnanda,151823105,VNKE01003379.1,1,2417,1.59198e-05,147760005,0.973238
D.bunnanda,151823105,VNKE01003517.1,1,2415,1.59067e-05,147762420,0.973254
D.bunnanda,151823105,VNKE01001464.1,1,2415,1.59067e-05,147764835,0.97327
D.bunnanda,151823105,VNKE01001298.1,1,2415,1.59067e-05,147767250,0.973286
D.bunnanda,151823105,VNKE01006463.1,1,2414,1.59001e-05,147769664,0.973302
D.bunnanda,151823105,VNKE01004703.1,1,2414,1.59001e-05,147772078,0.973317
D.bunnanda,151823105,VNKE01000461.1,1,2408,1.58606e-05,147774486,0.973333
D.bunnanda,151823105,VNKE01000071.1,1,2408,1.58606e-05,147776894,0.973349
D.bunnanda,151823105,VNKE01004677.1,1,2407,1.5854e-05,147779301,0.973365
D.bunnanda,151823105,VNKE01003512.1,1,2407,1.5854e-05,147781708,0.973381
D.bunnanda,151823105,VNKE01003222.1,1,2404,1.58342e-05,147784112,0.973397
D.bunnanda,151823105,VNKE01001613.1,1,2404,1.58342e-05,147786516,0.973413
D.bunnanda,151823105,VNKE01004967.1,1,2403,1.58276e-05,147788919,0.973428
D.bunnanda,151823105,VNKE01001288.1,1,2402,1.5821e-05,147791321,0.973444
D.bunnanda,151823105,VNKE01005183.1,1,2400,1.58079e-05,147793721,0.97346
D.bunnanda,151823105,VNKE01004051.1,1,2394,1.57684e-05,147796115,0.973476
D.bunnanda,151823105,VNKE01000347.1,1,2393,1.57618e-05,147798508,0.973492
D.bunnanda,151823105,VNKE01002085.1,1,2392,1.57552e-05,147800900,0.973507
D.bunnanda,151823105,VNKE01006091.1,1,2391,1.57486e-05,147803291,0.973523
D.bunnanda,151823105,VNKE01004433.1,1,2390,1.5742e-05,147805681,0.973539
D.bunnanda,151823105,VNKE01004101.1,1,2389,1.57354e-05,147808070,0.973555
D.bunnanda,151823105,VNKE01005468.1,1,2388,1.57288e-05,147810458,0.97357
D.bunnanda,151823105,VNKE01003003.1,1,2387,1.57222e-05,147812845,0.973586
D.bunnanda,151823105,VNKE01002545.1,1,2387,1.57222e-05,147815232,0.973602
D.bunnanda,151823105,VNKE01002899.1,1,2385,1.57091e-05,147817617,0.973617
D.bunnanda,151823105,VNKE01004521.1,1,2384,1.57025e-05,147820001,0.973633
D.bunnanda,151823105,VNKE01005394.1,1,2383,1.56959e-05,147822384,0.973649
D.bunnanda,151823105,VNKE01004167.1,1,2383,1.56959e-05,147824767,0.973664
D.bunnanda,151823105,VNKE01003162.1,1,2383,1.56959e-05,147827150,0.97368
D.bunnanda,151823105,VNKE01001985.1,1,2383,1.56959e-05,147829533,0.973696
D.bunnanda,151823105,VNKE01005691.1,1,2380,1.56761e-05,147831913,0.973712
D.bunnanda,151823105,VNKE01003709.1,1,2380,1.56761e-05,147834293,0.973727
D.bunnanda,151823105,VNKE01003415.1,1,2380,1.56761e-05,147836673,0.973743
D.bunnanda,151823105,VNKE01005345.1,1,2377,1.56564e-05,147839050,0.973759
D.bunnanda,151823105,VNKE01003638.1,1,2377,1.56564e-05,147841427,0.973774
D.bunnanda,151823105,VNKE01006485.1,1,2370,1.56103e-05,147843797,0.97379
D.bunnanda,151823105,VNKE01004845.1,1,2368,1.55971e-05,147846165,0.973805
D.bunnanda,151823105,VNKE01002643.1,1,2368,1.55971e-05,147848533,0.973821
D.bunnanda,151823105,VNKE01002446.1,1,2368,1.55971e-05,147850901,0.973837
D.bunnanda,151823105,VNKE01001758.1,1,2366,1.55839e-05,147853267,0.973852
D.bunnanda,151823105,VNKE01001431.1,1,2366,1.55839e-05,147855633,0.973868
D.bunnanda,151823105,VNKE01001168.1,1,2366,1.55839e-05,147857999,0.973883
D.bunnanda,151823105,VNKE01001157.1,1,2366,1.55839e-05,147860365,0.973899
D.bunnanda,151823105,VNKE01002409.1,1,2365,1.55773e-05,147862730,0.973915
D.bunnanda,151823105,VNKE01005143.1,1,2364,1.55708e-05,147865094,0.97393
D.bunnanda,151823105,VNKE01002259.1,1,2363,1.55642e-05,147867457,0.973946
D.bunnanda,151823105,VNKE01006172.1,1,2361,1.5551e-05,147869818,0.973961
D.bunnanda,151823105,VNKE01000329.1,1,2360,1.55444e-05,147872178,0.973977
D.bunnanda,151823105,VNKE01001074.1,1,2359,1.55378e-05,147874537,0.973992
D.bunnanda,151823105,VNKE01005721.1,1,2358,1.55312e-05,147876895,0.974008
D.bunnanda,151823105,VNKE01002361.1,1,2357,1.55246e-05,147879252,0.974023
D.bunnanda,151823105,VNKE01006486.1,1,2356,1.55181e-05,147881608,0.974039
D.bunnanda,151823105,VNKE01006392.1,1,2354,1.55049e-05,147883962,0.974054
D.bunnanda,151823105,VNKE01003872.1,1,2354,1.55049e-05,147886316,0.97407
D.bunnanda,151823105,VNKE01003532.1,1,2350,1.54785e-05,147888666,0.974085
D.bunnanda,151823105,VNKE01002204.1,1,2350,1.54785e-05,147891016,0.974101
D.bunnanda,151823105,VNKE01005733.1,1,2349,1.5472e-05,147893365,0.974116
D.bunnanda,151823105,VNKE01003087.1,1,2349,1.5472e-05,147895714,0.974132
D.bunnanda,151823105,VNKE01001662.1,1,2349,1.5472e-05,147898063,0.974147
D.bunnanda,151823105,VNKE01002994.1,1,2348,1.54654e-05,147900411,0.974163
D.bunnanda,151823105,VNKE01004579.1,1,2347,1.54588e-05,147902758,0.974178
D.bunnanda,151823105,VNKE01003824.1,1,2347,1.54588e-05,147905105,0.974194
D.bunnanda,151823105,VNKE01003531.1,1,2347,1.54588e-05,147907452,0.974209
D.bunnanda,151823105,VNKE01001010.1,1,2347,1.54588e-05,147909799,0.974225
D.bunnanda,151823105,VNKE01003567.1,1,2346,1.54522e-05,147912145,0.97424
D.bunnanda,151823105,VNKE01000965.1,1,2345,1.54456e-05,147914490,0.974255
D.bunnanda,151823105,VNKE01004943.1,1,2342,1.54258e-05,147916832,0.974271
D.bunnanda,151823105,VNKE01002581.1,1,2341,1.54193e-05,147919173,0.974286
D.bunnanda,151823105,VNKE01004797.1,1,2340,1.54127e-05,147921513,0.974302
D.bunnanda,151823105,VNKE01003257.1,1,2340,1.54127e-05,147923853,0.974317
D.bunnanda,151823105,VNKE01005983.1,1,2339,1.54061e-05,147926192,0.974333
D.bunnanda,151823105,VNKE01003856.1,1,2339,1.54061e-05,147928531,0.974348
D.bunnanda,151823105,VNKE01003453.1,1,2339,1.54061e-05,147930870,0.974363
D.bunnanda,151823105,VNKE01006512.1,1,2338,1.53995e-05,147933208,0.974379
D.bunnanda,151823105,VNKE01000850.1,1,2338,1.53995e-05,147935546,0.974394
D.bunnanda,151823105,VNKE01004669.1,1,2337,1.53929e-05,147937883,0.97441
D.bunnanda,151823105,VNKE01006315.1,1,2335,1.53797e-05,147940218,0.974425
D.bunnanda,151823105,VNKE01005420.1,1,2335,1.53797e-05,147942553,0.97444
D.bunnanda,151823105,VNKE01002921.1,1,2333,1.53666e-05,147944886,0.974456
D.bunnanda,151823105,VNKE01005346.1,1,2331,1.53534e-05,147947217,0.974471
D.bunnanda,151823105,VNKE01003513.1,1,2330,1.53468e-05,147949547,0.974486
D.bunnanda,151823105,VNKE01004561.1,1,2328,1.53336e-05,147951875,0.974502
D.bunnanda,151823105,VNKE01002448.1,1,2327,1.5327e-05,147954202,0.974517
D.bunnanda,151823105,VNKE01002993.1,1,2326,1.53205e-05,147956528,0.974532
D.bunnanda,151823105,VNKE01000786.1,1,2325,1.53139e-05,147958853,0.974548
D.bunnanda,151823105,VNKE01002913.1,1,2324,1.53073e-05,147961177,0.974563
D.bunnanda,151823105,VNKE01001880.1,1,2322,1.52941e-05,147963499,0.974578
D.bunnanda,151823105,VNKE01004951.1,1,2318,1.52678e-05,147965817,0.974594
D.bunnanda,151823105,VNKE01006432.1,1,2316,1.52546e-05,147968133,0.974609
D.bunnanda,151823105,VNKE01001612.1,1,2315,1.5248e-05,147970448,0.974624
D.bunnanda,151823105,VNKE01006358.1,1,2314,1.52414e-05,147972762,0.974639
D.bunnanda,151823105,VNKE01004641.1,1,2312,1.52282e-05,147975074,0.974655
D.bunnanda,151823105,VNKE01000424.1,1,2312,1.52282e-05,147977386,0.97467
D.bunnanda,151823105,VNKE01000842.1,1,2311,1.52217e-05,147979697,0.974685
D.bunnanda,151823105,VNKE01000261.1,1,2310,1.52151e-05,147982007,0.9747
D.bunnanda,151823105,VNKE01004103.1,1,2308,1.52019e-05,147984315,0.974715
D.bunnanda,151823105,VNKE01003252.1,1,2308,1.52019e-05,147986623,0.974731
D.bunnanda,151823105,VNKE01006220.1,1,2306,1.51887e-05,147988929,0.974746
D.bunnanda,151823105,VNKE01000039.1,1,2306,1.51887e-05,147991235,0.974761
D.bunnanda,151823105,VNKE01005093.1,1,2302,1.51624e-05,147993537,0.974776
D.bunnanda,151823105,VNKE01001067.1,1,2302,1.51624e-05,147995839,0.974791
D.bunnanda,151823105,VNKE01003081.1,1,2300,1.51492e-05,147998139,0.974806
D.bunnanda,151823105,VNKE01002202.1,1,2300,1.51492e-05,148000439,0.974822
D.bunnanda,151823105,VNKE01006070.1,1,2299,1.51426e-05,148002738,0.974837
D.bunnanda,151823105,VNKE01004574.1,1,2299,1.51426e-05,148005037,0.974852
D.bunnanda,151823105,VNKE01001189.1,1,2298,1.5136e-05,148007335,0.974867
D.bunnanda,151823105,VNKE01004752.1,1,2296,1.51229e-05,148009631,0.974882
D.bunnanda,151823105,VNKE01001290.1,1,2296,1.51229e-05,148011927,0.974897
D.bunnanda,151823105,VNKE01000635.1,1,2296,1.51229e-05,148014223,0.974912
D.bunnanda,151823105,VNKE01004836.1,1,2295,1.51163e-05,148016518,0.974927
D.bunnanda,151823105,VNKE01001861.1,1,2295,1.51163e-05,148018813,0.974943
D.bunnanda,151823105,VNKE01003079.1,1,2294,1.51097e-05,148021107,0.974958
D.bunnanda,151823105,VNKE01004760.1,1,2291,1.50899e-05,148023398,0.974973
D.bunnanda,151823105,VNKE01001368.1,1,2291,1.50899e-05,148025689,0.974988
D.bunnanda,151823105,VNKE01003700.1,1,2288,1.50702e-05,148027977,0.975003
D.bunnanda,151823105,VNKE01003215.1,1,2288,1.50702e-05,148030265,0.975018
D.bunnanda,151823105,VNKE01004125.1,1,2283,1.50372e-05,148032548,0.975033
D.bunnanda,151823105,VNKE01000160.1,1,2283,1.50372e-05,148034831,0.975048
D.bunnanda,151823105,VNKE01006497.1,1,2282,1.50307e-05,148037113,0.975063
D.bunnanda,151823105,VNKE01005474.1,1,2282,1.50307e-05,148039395,0.975078
D.bunnanda,151823105,VNKE01000525.1,1,2282,1.50307e-05,148041677,0.975093
D.bunnanda,151823105,VNKE01005153.1,1,2280,1.50175e-05,148043957,0.975108
D.bunnanda,151823105,VNKE01004370.1,1,2276,1.49911e-05,148046233,0.975123
D.bunnanda,151823105,VNKE01002843.1,1,2276,1.49911e-05,148048509,0.975138
D.bunnanda,151823105,VNKE01006479.1,1,2274,1.4978e-05,148050783,0.975153
D.bunnanda,151823105,VNKE01003641.1,1,2273,1.49714e-05,148053056,0.975168
D.bunnanda,151823105,VNKE01005608.1,1,2269,1.4945e-05,148055325,0.975183
D.bunnanda,151823105,VNKE01004379.1,1,2269,1.4945e-05,148057594,0.975198
D.bunnanda,151823105,VNKE01002784.1,1,2269,1.4945e-05,148059863,0.975213
D.bunnanda,151823105,VNKE01003644.1,1,2268,1.49384e-05,148062131,0.975228
D.bunnanda,151823105,VNKE01001557.1,1,2265,1.49187e-05,148064396,0.975243
D.bunnanda,151823105,VNKE01003329.1,1,2263,1.49055e-05,148066659,0.975258
D.bunnanda,151823105,VNKE01002509.1,1,2262,1.48989e-05,148068921,0.975273
D.bunnanda,151823105,VNKE01001043.1,1,2261,1.48923e-05,148071182,0.975288
D.bunnanda,151823105,VNKE01003505.1,1,2258,1.48726e-05,148073440,0.975302
D.bunnanda,151823105,VNKE01003143.1,1,2258,1.48726e-05,148075698,0.975317
D.bunnanda,151823105,VNKE01002095.1,1,2255,1.48528e-05,148077953,0.975332
D.bunnanda,151823105,VNKE01001324.1,1,2255,1.48528e-05,148080208,0.975347
D.bunnanda,151823105,VNKE01004610.1,1,2254,1.48462e-05,148082462,0.975362
D.bunnanda,151823105,VNKE01003062.1,1,2254,1.48462e-05,148084716,0.975377
D.bunnanda,151823105,VNKE01004097.1,1,2253,1.48396e-05,148086969,0.975392
D.bunnanda,151823105,VNKE01005956.1,1,2252,1.48331e-05,148089221,0.975406
D.bunnanda,151823105,VNKE01003939.1,1,2252,1.48331e-05,148091473,0.975421
D.bunnanda,151823105,VNKE01006415.1,1,2251,1.48265e-05,148093724,0.975436
D.bunnanda,151823105,VNKE01000246.1,1,2251,1.48265e-05,148095975,0.975451
D.bunnanda,151823105,VNKE01004581.1,1,2249,1.48133e-05,148098224,0.975466
D.bunnanda,151823105,VNKE01005832.1,1,2248,1.48067e-05,148100472,0.97548
D.bunnanda,151823105,VNKE01001753.1,1,2247,1.48001e-05,148102719,0.975495
D.bunnanda,151823105,VNKE01004198.1,1,2245,1.47869e-05,148104964,0.97551
D.bunnanda,151823105,VNKE01002679.1,1,2245,1.47869e-05,148107209,0.975525
D.bunnanda,151823105,VNKE01000610.1,1,2244,1.47804e-05,148109453,0.97554
D.bunnanda,151823105,VNKE01003144.1,1,2243,1.47738e-05,148111696,0.975554
D.bunnanda,151823105,VNKE01003076.1,1,2243,1.47738e-05,148113939,0.975569
D.bunnanda,151823105,VNKE01005065.1,1,2242,1.47672e-05,148116181,0.975584
D.bunnanda,151823105,VNKE01006123.1,1,2241,1.47606e-05,148118422,0.975599
D.bunnanda,151823105,VNKE01002910.1,1,2239,1.47474e-05,148120661,0.975613
D.bunnanda,151823105,VNKE01002351.1,1,2238,1.47408e-05,148122899,0.975628
D.bunnanda,151823105,VNKE01000603.1,1,2236,1.47277e-05,148125135,0.975643
D.bunnanda,151823105,VNKE01004824.1,1,2235,1.47211e-05,148127370,0.975658
D.bunnanda,151823105,VNKE01001632.1,1,2231,1.46947e-05,148129601,0.975672
D.bunnanda,151823105,VNKE01004961.1,1,2230,1.46881e-05,148131831,0.975687
D.bunnanda,151823105,VNKE01003529.1,1,2230,1.46881e-05,148134061,0.975702
D.bunnanda,151823105,VNKE01003369.1,1,2230,1.46881e-05,148136291,0.975716
D.bunnanda,151823105,VNKE01006580.1,1,2229,1.46816e-05,148138520,0.975731
D.bunnanda,151823105,VNKE01002585.1,1,2229,1.46816e-05,148140749,0.975746
D.bunnanda,151823105,VNKE01005158.1,1,2228,1.4675e-05,148142977,0.97576
D.bunnanda,151823105,VNKE01001667.1,1,2226,1.46618e-05,148145203,0.975775
D.bunnanda,151823105,VNKE01005950.1,1,2225,1.46552e-05,148147428,0.97579
D.bunnanda,151823105,VNKE01005911.1,1,2225,1.46552e-05,148149653,0.975804
D.bunnanda,151823105,VNKE01006141.1,1,2219,1.46157e-05,148151872,0.975819
D.bunnanda,151823105,VNKE01003988.1,1,2219,1.46157e-05,148154091,0.975834
D.bunnanda,151823105,VNKE01001483.1,1,2218,1.46091e-05,148156309,0.975848
D.bunnanda,151823105,VNKE01000447.1,1,2218,1.46091e-05,148158527,0.975863
D.bunnanda,151823105,VNKE01004358.1,1,2217,1.46025e-05,148160744,0.975877
D.bunnanda,151823105,VNKE01006140.1,1,2216,1.45959e-05,148162960,0.975892
D.bunnanda,151823105,VNKE01003818.1,1,2214,1.45828e-05,148165174,0.975907
D.bunnanda,151823105,VNKE01003657.1,1,2214,1.45828e-05,148167388,0.975921
D.bunnanda,151823105,VNKE01005406.1,1,2212,1.45696e-05,148169600,0.975936
D.bunnanda,151823105,VNKE01003309.1,1,2212,1.45696e-05,148171812,0.97595
D.bunnanda,151823105,VNKE01002838.1,1,2211,1.4563e-05,148174023,0.975965
D.bunnanda,151823105,VNKE01003255.1,1,2210,1.45564e-05,148176233,0.975979
D.bunnanda,151823105,VNKE01006236.1,1,2208,1.45432e-05,148178441,0.975994
D.bunnanda,151823105,VNKE01003414.1,1,2208,1.45432e-05,148180649,0.976009
D.bunnanda,151823105,VNKE01003849.1,1,2205,1.45235e-05,148182854,0.976023
D.bunnanda,151823105,VNKE01002081.1,1,2203,1.45103e-05,148185057,0.976038
D.bunnanda,151823105,VNKE01005918.1,1,2202,1.45037e-05,148187259,0.976052
D.bunnanda,151823105,VNKE01005074.1,1,2202,1.45037e-05,148189461,0.976067
D.bunnanda,151823105,VNKE01003719.1,1,2202,1.45037e-05,148191663,0.976081
D.bunnanda,151823105,VNKE01001854.1,1,2200,1.44905e-05,148193863,0.976096
D.bunnanda,151823105,VNKE01001656.1,1,2200,1.44905e-05,148196063,0.97611
D.bunnanda,151823105,VNKE01000614.1,1,2200,1.44905e-05,148198263,0.976125
D.bunnanda,151823105,VNKE01006142.1,1,2198,1.44774e-05,148200461,0.976139
D.bunnanda,151823105,VNKE01004039.1,1,2197,1.44708e-05,148202658,0.976154
D.bunnanda,151823105,VNKE01004348.1,1,2195,1.44576e-05,148204853,0.976168
D.bunnanda,151823105,VNKE01001659.1,1,2192,1.44379e-05,148207045,0.976182
D.bunnanda,151823105,VNKE01000128.1,1,2192,1.44379e-05,148209237,0.976197
D.bunnanda,151823105,VNKE01001923.1,1,2191,1.44313e-05,148211428,0.976211
D.bunnanda,151823105,VNKE01000175.1,1,2189,1.44181e-05,148213617,0.976226
D.bunnanda,151823105,VNKE01006529.1,1,2188,1.44115e-05,148215805,0.97624
D.bunnanda,151823105,VNKE01005863.1,1,2188,1.44115e-05,148217993,0.976255
D.bunnanda,151823105,VNKE01004929.1,1,2188,1.44115e-05,148220181,0.976269
D.bunnanda,151823105,VNKE01001026.1,1,2184,1.43852e-05,148222365,0.976283
D.bunnanda,151823105,VNKE01004981.1,1,2183,1.43786e-05,148224548,0.976298
D.bunnanda,151823105,VNKE01005683.1,1,2182,1.4372e-05,148226730,0.976312
D.bunnanda,151823105,VNKE01004014.1,1,2182,1.4372e-05,148228912,0.976326
D.bunnanda,151823105,VNKE01000761.1,1,2182,1.4372e-05,148231094,0.976341
D.bunnanda,151823105,VNKE01002688.1,1,2181,1.43654e-05,148233275,0.976355
D.bunnanda,151823105,VNKE01002433.1,1,2181,1.43654e-05,148235456,0.97637
D.bunnanda,151823105,VNKE01004840.1,1,2180,1.43588e-05,148237636,0.976384
D.bunnanda,151823105,VNKE01004705.1,1,2180,1.43588e-05,148239816,0.976398
D.bunnanda,151823105,VNKE01002546.1,1,2178,1.43456e-05,148241994,0.976413
D.bunnanda,151823105,VNKE01000865.1,1,2178,1.43456e-05,148244172,0.976427
D.bunnanda,151823105,VNKE01005943.1,1,2177,1.43391e-05,148246349,0.976441
D.bunnanda,151823105,VNKE01000831.1,1,2177,1.43391e-05,148248526,0.976456
D.bunnanda,151823105,VNKE01006257.1,1,2176,1.43325e-05,148250702,0.97647
D.bunnanda,151823105,VNKE01003444.1,1,2176,1.43325e-05,148252878,0.976484
D.bunnanda,151823105,VNKE01000462.1,1,2176,1.43325e-05,148255054,0.976499
D.bunnanda,151823105,VNKE01001989.1,1,2175,1.43259e-05,148257229,0.976513
D.bunnanda,151823105,VNKE01004744.1,1,2174,1.43193e-05,148259403,0.976527
D.bunnanda,151823105,VNKE01000331.1,1,2173,1.43127e-05,148261576,0.976542
D.bunnanda,151823105,VNKE01004403.1,1,2172,1.43061e-05,148263748,0.976556
D.bunnanda,151823105,VNKE01004706.1,1,2171,1.42995e-05,148265919,0.97657
D.bunnanda,151823105,VNKE01000393.1,1,2171,1.42995e-05,148268090,0.976584
D.bunnanda,151823105,VNKE01004247.1,1,2168,1.42798e-05,148270258,0.976599
D.bunnanda,151823105,VNKE01003109.1,1,2168,1.42798e-05,148272426,0.976613
D.bunnanda,151823105,VNKE01002366.1,1,2168,1.42798e-05,148274594,0.976627
D.bunnanda,151823105,VNKE01001202.1,1,2168,1.42798e-05,148276762,0.976642
D.bunnanda,151823105,VNKE01002730.1,1,2166,1.42666e-05,148278928,0.976656
D.bunnanda,151823105,VNKE01000682.1,1,2165,1.426e-05,148281093,0.97667
D.bunnanda,151823105,VNKE01006026.1,1,2164,1.42534e-05,148283257,0.976684
D.bunnanda,151823105,VNKE01004444.1,1,2164,1.42534e-05,148285421,0.976699
D.bunnanda,151823105,VNKE01002893.1,1,2164,1.42534e-05,148287585,0.976713
D.bunnanda,151823105,VNKE01003416.1,1,2163,1.42468e-05,148289748,0.976727
D.bunnanda,151823105,VNKE01005686.1,1,2158,1.42139e-05,148291906,0.976741
D.bunnanda,151823105,VNKE01002123.1,1,2158,1.42139e-05,148294064,0.976756
D.bunnanda,151823105,VNKE01002752.1,1,2157,1.42073e-05,148296221,0.97677
D.bunnanda,151823105,VNKE01002154.1,1,2156,1.42007e-05,148298377,0.976784
D.bunnanda,151823105,VNKE01001351.1,1,2155,1.41942e-05,148300532,0.976798
D.bunnanda,151823105,VNKE01001151.1,1,2154,1.41876e-05,148302686,0.976812
D.bunnanda,151823105,VNKE01006182.1,1,2153,1.4181e-05,148304839,0.976827
D.bunnanda,151823105,VNKE01000487.1,1,2151,1.41678e-05,148306990,0.976841
D.bunnanda,151823105,VNKE01002821.1,1,2149,1.41546e-05,148309139,0.976855
D.bunnanda,151823105,VNKE01004395.1,1,2148,1.4148e-05,148311287,0.976869
D.bunnanda,151823105,VNKE01002869.1,1,2147,1.41415e-05,148313434,0.976883
D.bunnanda,151823105,VNKE01006528.1,1,2146,1.41349e-05,148315580,0.976897
D.bunnanda,151823105,VNKE01004556.1,1,2146,1.41349e-05,148317726,0.976911
D.bunnanda,151823105,VNKE01005471.1,1,2145,1.41283e-05,148319871,0.976926
D.bunnanda,151823105,VNKE01004477.1,1,2143,1.41151e-05,148322014,0.97694
D.bunnanda,151823105,VNKE01004793.1,1,2141,1.41019e-05,148324155,0.976954
D.bunnanda,151823105,VNKE01003981.1,1,2141,1.41019e-05,148326296,0.976968
D.bunnanda,151823105,VNKE01000733.1,1,2141,1.41019e-05,148328437,0.976982
D.bunnanda,151823105,VNKE01001347.1,1,2139,1.40888e-05,148330576,0.976996
D.bunnanda,151823105,VNKE01001049.1,1,2139,1.40888e-05,148332715,0.97701
D.bunnanda,151823105,VNKE01003387.1,1,2137,1.40756e-05,148334852,0.977024
D.bunnanda,151823105,VNKE01001670.1,1,2137,1.40756e-05,148336989,0.977038
D.bunnanda,151823105,VNKE01001509.1,1,2137,1.40756e-05,148339126,0.977052
D.bunnanda,151823105,VNKE01004763.1,1,2136,1.4069e-05,148341262,0.977066
D.bunnanda,151823105,VNKE01002988.1,1,2136,1.4069e-05,148343398,0.977081
D.bunnanda,151823105,VNKE01000970.1,1,2136,1.4069e-05,148345534,0.977095
D.bunnanda,151823105,VNKE01006136.1,1,2135,1.40624e-05,148347669,0.977109
D.bunnanda,151823105,VNKE01000936.1,1,2134,1.40558e-05,148349803,0.977123
D.bunnanda,151823105,VNKE01000685.1,1,2134,1.40558e-05,148351937,0.977137
D.bunnanda,151823105,VNKE01004623.1,1,2133,1.40492e-05,148354070,0.977151
D.bunnanda,151823105,VNKE01001365.1,1,2133,1.40492e-05,148356203,0.977165
D.bunnanda,151823105,VNKE01005038.1,1,2130,1.40295e-05,148358333,0.977179
D.bunnanda,151823105,VNKE01002569.1,1,2130,1.40295e-05,148360463,0.977193
D.bunnanda,151823105,VNKE01006451.1,1,2127,1.40097e-05,148362590,0.977207
D.bunnanda,151823105,VNKE01005572.1,1,2126,1.40031e-05,148364716,0.977221
D.bunnanda,151823105,VNKE01005033.1,1,2126,1.40031e-05,148366842,0.977235
D.bunnanda,151823105,VNKE01001297.1,1,2125,1.39966e-05,148368967,0.977249
D.bunnanda,151823105,VNKE01006437.1,1,2124,1.399e-05,148371091,0.977263
D.bunnanda,151823105,VNKE01002582.1,1,2124,1.399e-05,148373215,0.977277
D.bunnanda,151823105,VNKE01001909.1,1,2124,1.399e-05,148375339,0.977291
D.bunnanda,151823105,VNKE01004111.1,1,2123,1.39834e-05,148377462,0.977305
D.bunnanda,151823105,VNKE01004915.1,1,2122,1.39768e-05,148379584,0.977319
D.bunnanda,151823105,VNKE01000275.1,1,2122,1.39768e-05,148381706,0.977333
D.bunnanda,151823105,VNKE01002312.1,1,2120,1.39636e-05,148383826,0.977347
D.bunnanda,151823105,VNKE01002571.1,1,2117,1.39439e-05,148385943,0.977361
D.bunnanda,151823105,VNKE01003855.1,1,2116,1.39373e-05,148388059,0.977375
D.bunnanda,151823105,VNKE01002895.1,1,2116,1.39373e-05,148390175,0.977389
D.bunnanda,151823105,VNKE01000602.1,1,2116,1.39373e-05,148392291,0.977403
D.bunnanda,151823105,VNKE01006197.1,1,2113,1.39175e-05,148394404,0.977416
D.bunnanda,151823105,VNKE01001398.1,1,2113,1.39175e-05,148396517,0.97743
D.bunnanda,151823105,VNKE01000306.1,1,2113,1.39175e-05,148398630,0.977444
D.bunnanda,151823105,VNKE01003272.1,1,2112,1.39109e-05,148400742,0.977458
D.bunnanda,151823105,VNKE01002499.1,1,2112,1.39109e-05,148402854,0.977472
D.bunnanda,151823105,VNKE01001849.1,1,2111,1.39043e-05,148404965,0.977486
D.bunnanda,151823105,VNKE01000373.1,1,2105,1.38648e-05,148407070,0.9775
D.bunnanda,151823105,VNKE01006027.1,1,2104,1.38582e-05,148409174,0.977514
D.bunnanda,151823105,VNKE01002966.1,1,2104,1.38582e-05,148411278,0.977528
D.bunnanda,151823105,VNKE01002228.1,1,2104,1.38582e-05,148413382,0.977541
D.bunnanda,151823105,VNKE01004788.1,1,2103,1.38516e-05,148415485,0.977555
D.bunnanda,151823105,VNKE01002203.1,1,2103,1.38516e-05,148417588,0.977569
D.bunnanda,151823105,VNKE01001689.1,1,2103,1.38516e-05,148419691,0.977583
D.bunnanda,151823105,VNKE01002909.1,1,2102,1.38451e-05,148421793,0.977597
D.bunnanda,151823105,VNKE01001597.1,1,2101,1.38385e-05,148423894,0.977611
D.bunnanda,151823105,VNKE01003912.1,1,2100,1.38319e-05,148425994,0.977625
D.bunnanda,151823105,VNKE01002277.1,1,2100,1.38319e-05,148428094,0.977638
D.bunnanda,151823105,VNKE01000389.1,1,2100,1.38319e-05,148430194,0.977652
D.bunnanda,151823105,VNKE01003675.1,1,2099,1.38253e-05,148432293,0.977666
D.bunnanda,151823105,VNKE01003015.1,1,2099,1.38253e-05,148434392,0.97768
D.bunnanda,151823105,VNKE01002842.1,1,2099,1.38253e-05,148436491,0.977694
D.bunnanda,151823105,VNKE01005372.1,1,2097,1.38121e-05,148438588,0.977707
D.bunnanda,151823105,VNKE01001425.1,1,2097,1.38121e-05,148440685,0.977721
D.bunnanda,151823105,VNKE01001022.1,1,2096,1.38055e-05,148442781,0.977735
D.bunnanda,151823105,VNKE01004564.1,1,2094,1.37924e-05,148444875,0.977749
D.bunnanda,151823105,VNKE01005254.1,1,2093,1.37858e-05,148446968,0.977763
D.bunnanda,151823105,VNKE01004643.1,1,2093,1.37858e-05,148449061,0.977776
D.bunnanda,151823105,VNKE01006543.1,1,2092,1.37792e-05,148451153,0.97779
D.bunnanda,151823105,VNKE01005904.1,1,2090,1.3766e-05,148453243,0.977804
D.bunnanda,151823105,VNKE01005953.1,1,2089,1.37594e-05,148455332,0.977818
D.bunnanda,151823105,VNKE01005523.1,1,2089,1.37594e-05,148457421,0.977832
D.bunnanda,151823105,VNKE01005828.1,1,2088,1.37528e-05,148459509,0.977845
D.bunnanda,151823105,VNKE01001705.1,1,2087,1.37463e-05,148461596,0.977859
D.bunnanda,151823105,VNKE01003551.1,1,2086,1.37397e-05,148463682,0.977873
D.bunnanda,151823105,VNKE01001633.1,1,2085,1.37331e-05,148465767,0.977887
D.bunnanda,151823105,VNKE01004636.1,1,2084,1.37265e-05,148467851,0.9779
D.bunnanda,151823105,VNKE01003691.1,1,2084,1.37265e-05,148469935,0.977914
D.bunnanda,151823105,VNKE01000851.1,1,2084,1.37265e-05,148472019,0.977928
D.bunnanda,151823105,VNKE01002477.1,1,2082,1.37133e-05,148474101,0.977941
D.bunnanda,151823105,VNKE01006060.1,1,2080,1.37002e-05,148476181,0.977955
D.bunnanda,151823105,VNKE01005098.1,1,2079,1.36936e-05,148478260,0.977969
D.bunnanda,151823105,VNKE01003096.1,1,2079,1.36936e-05,148480339,0.977982
D.bunnanda,151823105,VNKE01004614.1,1,2074,1.36606e-05,148482413,0.977996
D.bunnanda,151823105,VNKE01001229.1,1,2074,1.36606e-05,148484487,0.97801
D.bunnanda,151823105,VNKE01006483.1,1,2072,1.36475e-05,148486559,0.978023
D.bunnanda,151823105,VNKE01005409.1,1,2072,1.36475e-05,148488631,0.978037
D.bunnanda,151823105,VNKE01006582.1,1,2071,1.36409e-05,148490702,0.978051
D.bunnanda,151823105,VNKE01003683.1,1,2069,1.36277e-05,148492771,0.978064
D.bunnanda,151823105,VNKE01003114.1,1,2069,1.36277e-05,148494840,0.978078
D.bunnanda,151823105,VNKE01000025.1,1,2069,1.36277e-05,148496909,0.978092
D.bunnanda,151823105,VNKE01003796.1,1,2067,1.36145e-05,148498976,0.978105
D.bunnanda,151823105,VNKE01001282.1,1,2067,1.36145e-05,148501043,0.978119
D.bunnanda,151823105,VNKE01005350.1,1,2065,1.36014e-05,148503108,0.978132
D.bunnanda,151823105,VNKE01006022.1,1,2063,1.35882e-05,148505171,0.978146
D.bunnanda,151823105,VNKE01006028.1,1,2062,1.35816e-05,148507233,0.97816
D.bunnanda,151823105,VNKE01005954.1,1,2062,1.35816e-05,148509295,0.978173
D.bunnanda,151823105,VNKE01001634.1,1,2062,1.35816e-05,148511357,0.978187
D.bunnanda,151823105,VNKE01004608.1,1,2060,1.35684e-05,148513417,0.9782
D.bunnanda,151823105,VNKE01003459.1,1,2060,1.35684e-05,148515477,0.978214
D.bunnanda,151823105,VNKE01002989.1,1,2060,1.35684e-05,148517537,0.978228
D.bunnanda,151823105,VNKE01002751.1,1,2060,1.35684e-05,148519597,0.978241
D.bunnanda,151823105,VNKE01000613.1,1,2060,1.35684e-05,148521657,0.978255
D.bunnanda,151823105,VNKE01000833.1,1,2059,1.35618e-05,148523716,0.978268
D.bunnanda,151823105,VNKE01001356.1,1,2058,1.35552e-05,148525774,0.978282
D.bunnanda,151823105,VNKE01006537.1,1,2057,1.35487e-05,148527831,0.978295
D.bunnanda,151823105,VNKE01005720.1,1,2054,1.35289e-05,148529885,0.978309
D.bunnanda,151823105,VNKE01003277.1,1,2054,1.35289e-05,148531939,0.978322
D.bunnanda,151823105,VNKE01002931.1,1,2054,1.35289e-05,148533993,0.978336
D.bunnanda,151823105,VNKE01005242.1,1,2053,1.35223e-05,148536046,0.978349
D.bunnanda,151823105,VNKE01005122.1,1,2053,1.35223e-05,148538099,0.978363
D.bunnanda,151823105,VNKE01000927.1,1,2053,1.35223e-05,148540152,0.978376
D.bunnanda,151823105,VNKE01005208.1,1,2052,1.35157e-05,148542204,0.97839
D.bunnanda,151823105,VNKE01001303.1,1,2052,1.35157e-05,148544256,0.978403
D.bunnanda,151823105,VNKE01005490.1,1,2051,1.35091e-05,148546307,0.978417
D.bunnanda,151823105,VNKE01000515.1,1,2051,1.35091e-05,148548358,0.978431
D.bunnanda,151823105,VNKE01006024.1,1,2050,1.35026e-05,148550408,0.978444
D.bunnanda,151823105,VNKE01005434.1,1,2042,1.34499e-05,148552450,0.978457
D.bunnanda,151823105,VNKE01003112.1,1,2042,1.34499e-05,148554492,0.978471
D.bunnanda,151823105,VNKE01000526.1,1,2041,1.34433e-05,148556533,0.978484
D.bunnanda,151823105,VNKE01001300.1,1,2040,1.34367e-05,148558573,0.978498
D.bunnanda,151823105,VNKE01005678.1,1,2039,1.34301e-05,148560612,0.978511
D.bunnanda,151823105,VNKE01005353.1,1,2039,1.34301e-05,148562651,0.978525
D.bunnanda,151823105,VNKE01006223.1,1,2035,1.34038e-05,148564686,0.978538
D.bunnanda,151823105,VNKE01006624.1,1,2034,1.33972e-05,148566720,0.978551
D.bunnanda,151823105,VNKE01000452.1,1,2034,1.33972e-05,148568754,0.978565
D.bunnanda,151823105,VNKE01005020.1,1,2032,1.3384e-05,148570786,0.978578
D.bunnanda,151823105,VNKE01003134.1,1,2032,1.3384e-05,148572818,0.978592
D.bunnanda,151823105,VNKE01003080.1,1,2032,1.3384e-05,148574850,0.978605
D.bunnanda,151823105,VNKE01002912.1,1,2032,1.3384e-05,148576882,0.978618
D.bunnanda,151823105,VNKE01000009.1,1,2029,1.33642e-05,148578911,0.978632
D.bunnanda,151823105,VNKE01004465.1,1,2028,1.33577e-05,148580939,0.978645
D.bunnanda,151823105,VNKE01002339.1,1,2028,1.33577e-05,148582967,0.978658
D.bunnanda,151823105,VNKE01000205.1,1,2028,1.33577e-05,148584995,0.978672
D.bunnanda,151823105,VNKE01003760.1,1,2027,1.33511e-05,148587022,0.978685
D.bunnanda,151823105,VNKE01001302.1,1,2026,1.33445e-05,148589048,0.978699
D.bunnanda,151823105,VNKE01006093.1,1,2024,1.33313e-05,148591072,0.978712
D.bunnanda,151823105,VNKE01003307.1,1,2023,1.33247e-05,148593095,0.978725
D.bunnanda,151823105,VNKE01002363.1,1,2023,1.33247e-05,148595118,0.978738
D.bunnanda,151823105,VNKE01001349.1,1,2023,1.33247e-05,148597141,0.978752
D.bunnanda,151823105,VNKE01005286.1,1,2022,1.33181e-05,148599163,0.978765
D.bunnanda,151823105,VNKE01004446.1,1,2021,1.33115e-05,148601184,0.978778
D.bunnanda,151823105,VNKE01002427.1,1,2021,1.33115e-05,148603205,0.978792
D.bunnanda,151823105,VNKE01001269.1,1,2021,1.33115e-05,148605226,0.978805
D.bunnanda,151823105,VNKE01003915.1,1,2020,1.3305e-05,148607246,0.978818
D.bunnanda,151823105,VNKE01000129.1,1,2020,1.3305e-05,148609266,0.978832
D.bunnanda,151823105,VNKE01001862.1,1,2019,1.32984e-05,148611285,0.978845
D.bunnanda,151823105,VNKE01001280.1,1,2019,1.32984e-05,148613304,0.978858
D.bunnanda,151823105,VNKE01000564.1,1,2019,1.32984e-05,148615323,0.978872
D.bunnanda,151823105,VNKE01000320.1,1,2019,1.32984e-05,148617342,0.978885
D.bunnanda,151823105,VNKE01005646.1,1,2018,1.32918e-05,148619360,0.978898
D.bunnanda,151823105,VNKE01005768.1,1,2017,1.32852e-05,148621377,0.978911
D.bunnanda,151823105,VNKE01005209.1,1,2017,1.32852e-05,148623394,0.978925
D.bunnanda,151823105,VNKE01001926.1,1,2016,1.32786e-05,148625410,0.978938
D.bunnanda,151823105,VNKE01000620.1,1,2015,1.3272e-05,148627425,0.978951
D.bunnanda,151823105,VNKE01003258.1,1,2014,1.32654e-05,148629439,0.978965
D.bunnanda,151823105,VNKE01001396.1,1,2013,1.32589e-05,148631452,0.978978
D.bunnanda,151823105,VNKE01006541.1,1,2012,1.32523e-05,148633464,0.978991
D.bunnanda,151823105,VNKE01006536.1,1,2012,1.32523e-05,148635476,0.979004
D.bunnanda,151823105,VNKE01005576.1,1,2012,1.32523e-05,148637488,0.979018
D.bunnanda,151823105,VNKE01004234.1,1,2012,1.32523e-05,148639500,0.979031
D.bunnanda,151823105,VNKE01002570.1,1,2012,1.32523e-05,148641512,0.979044
D.bunnanda,151823105,VNKE01003135.1,1,2011,1.32457e-05,148643523,0.979057
D.bunnanda,151823105,VNKE01005052.1,1,2010,1.32391e-05,148645533,0.979071
D.bunnanda,151823105,VNKE01003941.1,1,2010,1.32391e-05,148647543,0.979084
D.bunnanda,151823105,VNKE01002791.1,1,2010,1.32391e-05,148649553,0.979097
D.bunnanda,151823105,VNKE01001083.1,1,2010,1.32391e-05,148651563,0.97911
D.bunnanda,151823105,VNKE01005593.1,1,2009,1.32325e-05,148653572,0.979124
D.bunnanda,151823105,VNKE01004683.1,1,2009,1.32325e-05,148655581,0.979137
D.bunnanda,151823105,VNKE01003145.1,1,2008,1.32259e-05,148657589,0.97915
D.bunnanda,151823105,VNKE01006499.1,1,2007,1.32193e-05,148659596,0.979163
D.bunnanda,151823105,VNKE01005948.1,1,2007,1.32193e-05,148661603,0.979176
D.bunnanda,151823105,VNKE01004957.1,1,2005,1.32062e-05,148663608,0.97919
D.bunnanda,151823105,VNKE01001913.1,1,2004,1.31996e-05,148665612,0.979203
D.bunnanda,151823105,VNKE01001721.1,1,2004,1.31996e-05,148667616,0.979216
D.bunnanda,151823105,VNKE01000672.1,1,2004,1.31996e-05,148669620,0.979229
D.bunnanda,151823105,VNKE01006519.1,1,2003,1.3193e-05,148671623,0.979242
D.bunnanda,151823105,VNKE01002230.1,1,2003,1.3193e-05,148673626,0.979256
D.bunnanda,151823105,VNKE01000566.1,1,2003,1.3193e-05,148675629,0.979269
D.bunnanda,151823105,VNKE01003159.1,1,2001,1.31798e-05,148677630,0.979282
D.bunnanda,151823105,VNKE01002790.1,1,2001,1.31798e-05,148679631,0.979295
D.bunnanda,151823105,VNKE01004184.1,1,2000,1.31732e-05,148681631,0.979308
D.bunnanda,151823105,VNKE01003708.1,1,2000,1.31732e-05,148683631,0.979322
D.bunnanda,151823105,VNKE01003035.1,1,1997,1.31535e-05,148685628,0.979335
D.bunnanda,151823105,VNKE01000499.1,1,1997,1.31535e-05,148687625,0.979348
D.bunnanda,151823105,VNKE01003707.1,1,1995,1.31403e-05,148689620,0.979361
D.bunnanda,151823105,VNKE01003706.1,1,1995,1.31403e-05,148691615,0.979374
D.bunnanda,151823105,VNKE01003704.1,1,1993,1.31271e-05,148693608,0.979387
D.bunnanda,151823105,VNKE01001438.1,1,1993,1.31271e-05,148695601,0.9794
D.bunnanda,151823105,VNKE01003705.1,1,1992,1.31205e-05,148697593,0.979413
D.bunnanda,151823105,VNKE01002424.1,1,1992,1.31205e-05,148699585,0.979427
D.bunnanda,151823105,VNKE01000619.1,1,1989,1.31008e-05,148701574,0.97944
D.bunnanda,151823105,VNKE01003821.1,1,1987,1.30876e-05,148703561,0.979453
D.bunnanda,151823105,VNKE01001301.1,1,1987,1.30876e-05,148705548,0.979466
D.bunnanda,151823105,VNKE01003679.1,1,1986,1.3081e-05,148707534,0.979479
D.bunnanda,151823105,VNKE01004110.1,1,1984,1.30678e-05,148709518,0.979492
D.bunnanda,151823105,VNKE01002992.1,1,1984,1.30678e-05,148711502,0.979505
D.bunnanda,151823105,VNKE01002014.1,1,1984,1.30678e-05,148713486,0.979518
D.bunnanda,151823105,VNKE01000707.1,1,1984,1.30678e-05,148715470,0.979531
D.bunnanda,151823105,VNKE01003388.1,1,1983,1.30613e-05,148717453,0.979544
D.bunnanda,151823105,VNKE01002734.1,1,1983,1.30613e-05,148719436,0.979557
D.bunnanda,151823105,VNKE01002232.1,1,1983,1.30613e-05,148721419,0.97957
D.bunnanda,151823105,VNKE01001994.1,1,1983,1.30613e-05,148723402,0.979583
D.bunnanda,151823105,VNKE01001658.1,1,1983,1.30613e-05,148725385,0.979597
D.bunnanda,151823105,VNKE01002515.1,1,1982,1.30547e-05,148727367,0.97961
D.bunnanda,151823105,VNKE01006618.1,1,1981,1.30481e-05,148729348,0.979623
D.bunnanda,151823105,VNKE01004369.1,1,1981,1.30481e-05,148731329,0.979636
D.bunnanda,151823105,VNKE01002257.1,1,1980,1.30415e-05,148733309,0.979649
D.bunnanda,151823105,VNKE01002789.1,1,1978,1.30283e-05,148735287,0.979662
D.bunnanda,151823105,VNKE01005680.1,1,1977,1.30217e-05,148737264,0.979675
D.bunnanda,151823105,VNKE01004544.1,1,1977,1.30217e-05,148739241,0.979688
D.bunnanda,151823105,VNKE01003036.1,1,1977,1.30217e-05,148741218,0.979701
D.bunnanda,151823105,VNKE01002314.1,1,1977,1.30217e-05,148743195,0.979714
D.bunnanda,151823105,VNKE01006328.1,1,1976,1.30151e-05,148745171,0.979727
D.bunnanda,151823105,VNKE01005050.1,1,1976,1.30151e-05,148747147,0.97974
D.bunnanda,151823105,VNKE01004829.1,1,1976,1.30151e-05,148749123,0.979753
D.bunnanda,151823105,VNKE01005808.1,1,1974,1.3002e-05,148751097,0.979766
D.bunnanda,151823105,VNKE01005805.1,1,1973,1.29954e-05,148753070,0.979779
D.bunnanda,151823105,VNKE01004006.1,1,1973,1.29954e-05,148755043,0.979792
D.bunnanda,151823105,VNKE01000800.1,1,1973,1.29954e-05,148757016,0.979805
D.bunnanda,151823105,VNKE01003275.1,1,1972,1.29888e-05,148758988,0.979818
D.bunnanda,151823105,VNKE01005975.1,1,1971,1.29822e-05,148760959,0.979831
D.bunnanda,151823105,VNKE01002542.1,1,1971,1.29822e-05,148762930,0.979844
D.bunnanda,151823105,VNKE01004823.1,1,1969,1.2969e-05,148764899,0.979857
D.bunnanda,151823105,VNKE01002543.1,1,1969,1.2969e-05,148766868,0.97987
D.bunnanda,151823105,VNKE01003538.1,1,1966,1.29493e-05,148768834,0.979883
D.bunnanda,151823105,VNKE01003203.1,1,1966,1.29493e-05,148770800,0.979896
D.bunnanda,151823105,VNKE01002788.1,1,1966,1.29493e-05,148772766,0.979909
D.bunnanda,151823105,VNKE01002796.1,1,1965,1.29427e-05,148774731,0.979922
D.bunnanda,151823105,VNKE01002795.1,1,1965,1.29427e-05,148776696,0.979934
D.bunnanda,151823105,VNKE01001720.1,1,1965,1.29427e-05,148778661,0.979947
D.bunnanda,151823105,VNKE01006417.1,1,1964,1.29361e-05,148780625,0.97996
D.bunnanda,151823105,VNKE01005949.1,1,1964,1.29361e-05,148782589,0.979973
D.bunnanda,151823105,VNKE01003936.1,1,1964,1.29361e-05,148784553,0.979986
D.bunnanda,151823105,VNKE01000494.1,1,1963,1.29295e-05,148786516,0.979999
D.bunnanda,151823105,VNKE01005250.1,1,1962,1.29229e-05,148788478,0.980012
D.bunnanda,151823105,VNKE01005931.1,1,1961,1.29163e-05,148790439,0.980025
D.bunnanda,151823105,VNKE01005458.1,1,1961,1.29163e-05,148792400,0.980038
D.bunnanda,151823105,VNKE01003378.1,1,1961,1.29163e-05,148794361,0.980051
D.bunnanda,151823105,VNKE01002076.1,1,1961,1.29163e-05,148796322,0.980064
D.bunnanda,151823105,VNKE01000596.1,1,1961,1.29163e-05,148798283,0.980077
D.bunnanda,151823105,VNKE01006355.1,1,1960,1.29098e-05,148800243,0.98009
D.bunnanda,151823105,VNKE01001276.1,1,1960,1.29098e-05,148802203,0.980102
D.bunnanda,151823105,VNKE01005285.1,1,1959,1.29032e-05,148804162,0.980115
D.bunnanda,151823105,VNKE01004846.1,1,1959,1.29032e-05,148806121,0.980128
D.bunnanda,151823105,VNKE01001813.1,1,1959,1.29032e-05,148808080,0.980141
D.bunnanda,151823105,VNKE01000607.1,1,1958,1.28966e-05,148810038,0.980154
D.bunnanda,151823105,VNKE01003336.1,1,1957,1.289e-05,148811995,0.980167
D.bunnanda,151823105,VNKE01002110.1,1,1956,1.28834e-05,148813951,0.98018
D.bunnanda,151823105,VNKE01003568.1,1,1954,1.28702e-05,148815905,0.980193
D.bunnanda,151823105,VNKE01003703.1,1,1953,1.28637e-05,148817858,0.980206
D.bunnanda,151823105,VNKE01004979.1,1,1950,1.28439e-05,148819808,0.980218
D.bunnanda,151823105,VNKE01003977.1,1,1948,1.28307e-05,148821756,0.980231
D.bunnanda,151823105,VNKE01005995.1,1,1947,1.28241e-05,148823703,0.980244
D.bunnanda,151823105,VNKE01005650.1,1,1947,1.28241e-05,148825650,0.980257
D.bunnanda,151823105,VNKE01005155.1,1,1947,1.28241e-05,148827597,0.98027
D.bunnanda,151823105,VNKE01004835.1,1,1947,1.28241e-05,148829544,0.980283
D.bunnanda,151823105,VNKE01003671.1,1,1947,1.28241e-05,148831491,0.980295
D.bunnanda,151823105,VNKE01006290.1,1,1946,1.28175e-05,148833437,0.980308
D.bunnanda,151823105,VNKE01004187.1,1,1945,1.2811e-05,148835382,0.980321
D.bunnanda,151823105,VNKE01003361.1,1,1945,1.2811e-05,148837327,0.980334
D.bunnanda,151823105,VNKE01003142.1,1,1945,1.2811e-05,148839272,0.980347
D.bunnanda,151823105,VNKE01002445.1,1,1945,1.2811e-05,148841217,0.980359
D.bunnanda,151823105,VNKE01001845.1,1,1945,1.2811e-05,148843162,0.980372
D.bunnanda,151823105,VNKE01000776.1,1,1945,1.2811e-05,148845107,0.980385
D.bunnanda,151823105,VNKE01002324.1,1,1944,1.28044e-05,148847051,0.980398
D.bunnanda,151823105,VNKE01002279.1,1,1944,1.28044e-05,148848995,0.980411
D.bunnanda,151823105,VNKE01005207.1,1,1943,1.27978e-05,148850938,0.980423
D.bunnanda,151823105,VNKE01001293.1,1,1943,1.27978e-05,148852881,0.980436
D.bunnanda,151823105,VNKE01000855.1,1,1942,1.27912e-05,148854823,0.980449
D.bunnanda,151823105,VNKE01003756.1,1,1941,1.27846e-05,148856764,0.980462
D.bunnanda,151823105,VNKE01003374.1,1,1939,1.27714e-05,148858703,0.980475
D.bunnanda,151823105,VNKE01000968.1,1,1939,1.27714e-05,148860642,0.980487
D.bunnanda,151823105,VNKE01002578.1,1,1936,1.27517e-05,148862578,0.9805
D.bunnanda,151823105,VNKE01005567.1,1,1935,1.27451e-05,148864513,0.980513
D.bunnanda,151823105,VNKE01004950.1,1,1935,1.27451e-05,148866448,0.980526
D.bunnanda,151823105,VNKE01004872.1,1,1934,1.27385e-05,148868382,0.980538
D.bunnanda,151823105,VNKE01004578.1,1,1934,1.27385e-05,148870316,0.980551
D.bunnanda,151823105,VNKE01002122.1,1,1933,1.27319e-05,148872249,0.980564
D.bunnanda,151823105,VNKE01001942.1,1,1933,1.27319e-05,148874182,0.980577
D.bunnanda,151823105,VNKE01006287.1,1,1932,1.27253e-05,148876114,0.980589
D.bunnanda,151823105,VNKE01003273.1,1,1932,1.27253e-05,148878046,0.980602
D.bunnanda,151823105,VNKE01003186.1,1,1932,1.27253e-05,148879978,0.980615
D.bunnanda,151823105,VNKE01002263.1,1,1932,1.27253e-05,148881910,0.980627
D.bunnanda,151823105,VNKE01003746.1,1,1931,1.27187e-05,148883841,0.98064
D.bunnanda,151823105,VNKE01003701.1,1,1931,1.27187e-05,148885772,0.980653
D.bunnanda,151823105,VNKE01003642.1,1,1931,1.27187e-05,148887703,0.980666
D.bunnanda,151823105,VNKE01003251.1,1,1931,1.27187e-05,148889634,0.980678
D.bunnanda,151823105,VNKE01000204.1,1,1931,1.27187e-05,148891565,0.980691
D.bunnanda,151823105,VNKE01005354.1,1,1930,1.27122e-05,148893495,0.980704
D.bunnanda,151823105,VNKE01004212.1,1,1930,1.27122e-05,148895425,0.980717
D.bunnanda,151823105,VNKE01001376.1,1,1930,1.27122e-05,148897355,0.980729
D.bunnanda,151823105,VNKE01000206.1,1,1929,1.27056e-05,148899284,0.980742
D.bunnanda,151823105,VNKE01006540.1,1,1928,1.2699e-05,148901212,0.980755
D.bunnanda,151823105,VNKE01005173.1,1,1928,1.2699e-05,148903140,0.980767
D.bunnanda,151823105,VNKE01001404.1,1,1928,1.2699e-05,148905068,0.98078
D.bunnanda,151823105,VNKE01002684.1,1,1927,1.26924e-05,148906995,0.980793
D.bunnanda,151823105,VNKE01001451.1,1,1927,1.26924e-05,148908922,0.980805
D.bunnanda,151823105,VNKE01000760.1,1,1927,1.26924e-05,148910849,0.980818
D.bunnanda,151823105,VNKE01005025.1,1,1926,1.26858e-05,148912775,0.980831
D.bunnanda,151823105,VNKE01004277.1,1,1926,1.26858e-05,148914701,0.980843
D.bunnanda,151823105,VNKE01001492.1,1,1926,1.26858e-05,148916627,0.980856
D.bunnanda,151823105,VNKE01000652.1,1,1926,1.26858e-05,148918553,0.980869
D.bunnanda,151823105,VNKE01005294.1,1,1925,1.26792e-05,148920478,0.980882
D.bunnanda,151823105,VNKE01000300.1,1,1925,1.26792e-05,148922403,0.980894
D.bunnanda,151823105,VNKE01005051.1,1,1924,1.26726e-05,148924327,0.980907
D.bunnanda,151823105,VNKE01001271.1,1,1924,1.26726e-05,148926251,0.98092
D.bunnanda,151823105,VNKE01002897.1,1,1923,1.26661e-05,148928174,0.980932
D.bunnanda,151823105,VNKE01006409.1,1,1922,1.26595e-05,148930096,0.980945
D.bunnanda,151823105,VNKE01006388.1,1,1922,1.26595e-05,148932018,0.980958
D.bunnanda,151823105,VNKE01004945.1,1,1922,1.26595e-05,148933940,0.98097
D.bunnanda,151823105,VNKE01002937.1,1,1922,1.26595e-05,148935862,0.980983
D.bunnanda,151823105,VNKE01005554.1,1,1921,1.26529e-05,148937783,0.980996
D.bunnanda,151823105,VNKE01006217.1,1,1920,1.26463e-05,148939703,0.981008
D.bunnanda,151823105,VNKE01005039.1,1,1920,1.26463e-05,148941623,0.981021
D.bunnanda,151823105,VNKE01000326.1,1,1920,1.26463e-05,148943543,0.981033
D.bunnanda,151823105,VNKE01006226.1,1,1919,1.26397e-05,148945462,0.981046
D.bunnanda,151823105,VNKE01004447.1,1,1919,1.26397e-05,148947381,0.981059
D.bunnanda,151823105,VNKE01001932.1,1,1919,1.26397e-05,148949300,0.981071
D.bunnanda,151823105,VNKE01000852.1,1,1919,1.26397e-05,148951219,0.981084
D.bunnanda,151823105,VNKE01003496.1,1,1918,1.26331e-05,148953137,0.981097
D.bunnanda,151823105,VNKE01000699.1,1,1918,1.26331e-05,148955055,0.981109
D.bunnanda,151823105,VNKE01004603.1,1,1917,1.26265e-05,148956972,0.981122
D.bunnanda,151823105,VNKE01003158.1,1,1917,1.26265e-05,148958889,0.981135
D.bunnanda,151823105,VNKE01005947.1,1,1916,1.262e-05,148960805,0.981147
D.bunnanda,151823105,VNKE01003018.1,1,1916,1.262e-05,148962721,0.98116
D.bunnanda,151823105,VNKE01005453.1,1,1915,1.26134e-05,148964636,0.981172
D.bunnanda,151823105,VNKE01004580.1,1,1915,1.26134e-05,148966551,0.981185
D.bunnanda,151823105,VNKE01000297.1,1,1914,1.26068e-05,148968465,0.981198
D.bunnanda,151823105,VNKE01006034.1,1,1913,1.26002e-05,148970378,0.98121
D.bunnanda,151823105,VNKE01005363.1,1,1913,1.26002e-05,148972291,0.981223
D.bunnanda,151823105,VNKE01000819.1,1,1913,1.26002e-05,148974204,0.981235
D.bunnanda,151823105,VNKE01002681.1,1,1912,1.25936e-05,148976116,0.981248
D.bunnanda,151823105,VNKE01002733.1,1,1911,1.2587e-05,148978027,0.981261
D.bunnanda,151823105,VNKE01002641.1,1,1911,1.2587e-05,148979938,0.981273
D.bunnanda,151823105,VNKE01001930.1,1,1911,1.2587e-05,148981849,0.981286
D.bunnanda,151823105,VNKE01002484.1,1,1909,1.25738e-05,148983758,0.981298
D.bunnanda,151823105,VNKE01003978.1,1,1908,1.25673e-05,148985666,0.981311
D.bunnanda,151823105,VNKE01003586.1,1,1908,1.25673e-05,148987574,0.981323
D.bunnanda,151823105,VNKE01006288.1,1,1907,1.25607e-05,148989481,0.981336
D.bunnanda,151823105,VNKE01003880.1,1,1907,1.25607e-05,148991388,0.981349
D.bunnanda,151823105,VNKE01006293.1,1,1906,1.25541e-05,148993294,0.981361
D.bunnanda,151823105,VNKE01005822.1,1,1905,1.25475e-05,148995199,0.981374
D.bunnanda,151823105,VNKE01005728.1,1,1905,1.25475e-05,148997104,0.981386
D.bunnanda,151823105,VNKE01001003.1,1,1905,1.25475e-05,148999009,0.981399
D.bunnanda,151823105,VNKE01005062.1,1,1904,1.25409e-05,149000913,0.981411
D.bunnanda,151823105,VNKE01004764.1,1,1904,1.25409e-05,149002817,0.981424
D.bunnanda,151823105,VNKE01006509.1,1,1903,1.25343e-05,149004720,0.981436
D.bunnanda,151823105,VNKE01004814.1,1,1903,1.25343e-05,149006623,0.981449
D.bunnanda,151823105,VNKE01004768.1,1,1899,1.2508e-05,149008522,0.981461
D.bunnanda,151823105,VNKE01006294.1,1,1896,1.24882e-05,149010418,0.981474
D.bunnanda,151823105,VNKE01004242.1,1,1896,1.24882e-05,149012314,0.981486
D.bunnanda,151823105,VNKE01000303.1,1,1895,1.24816e-05,149014209,0.981499
D.bunnanda,151823105,VNKE01004731.1,1,1894,1.2475e-05,149016103,0.981511
D.bunnanda,151823105,VNKE01002340.1,1,1894,1.2475e-05,149017997,0.981524
D.bunnanda,151823105,VNKE01000876.1,1,1894,1.2475e-05,149019891,0.981536
D.bunnanda,151823105,VNKE01000805.1,1,1893,1.24685e-05,149021784,0.981549
D.bunnanda,151823105,VNKE01002737.1,1,1892,1.24619e-05,149023676,0.981561
D.bunnanda,151823105,VNKE01002264.1,1,1892,1.24619e-05,149025568,0.981574
D.bunnanda,151823105,VNKE01004685.1,1,1890,1.24487e-05,149027458,0.981586
D.bunnanda,151823105,VNKE01003149.1,1,1890,1.24487e-05,149029348,0.981599
D.bunnanda,151823105,VNKE01002497.1,1,1890,1.24487e-05,149031238,0.981611
D.bunnanda,151823105,VNKE01006155.1,1,1889,1.24421e-05,149033127,0.981623
D.bunnanda,151823105,VNKE01006292.1,1,1887,1.24289e-05,149035014,0.981636
D.bunnanda,151823105,VNKE01002016.1,1,1887,1.24289e-05,149036901,0.981648
D.bunnanda,151823105,VNKE01002766.1,1,1886,1.24224e-05,149038787,0.981661
D.bunnanda,151823105,VNKE01000869.1,1,1885,1.24158e-05,149040672,0.981673
D.bunnanda,151823105,VNKE01003935.1,1,1884,1.24092e-05,149042556,0.981686
D.bunnanda,151823105,VNKE01000523.1,1,1884,1.24092e-05,149044440,0.981698
D.bunnanda,151823105,VNKE01005951.1,1,1883,1.24026e-05,149046323,0.98171
D.bunnanda,151823105,VNKE01005621.1,1,1883,1.24026e-05,149048206,0.981723
D.bunnanda,151823105,VNKE01003931.1,1,1883,1.24026e-05,149050089,0.981735
D.bunnanda,151823105,VNKE01001353.1,1,1883,1.24026e-05,149051972,0.981748
D.bunnanda,151823105,VNKE01000114.1,1,1883,1.24026e-05,149053855,0.98176
D.bunnanda,151823105,VNKE01000294.1,1,1882,1.2396e-05,149055737,0.981772
D.bunnanda,151823105,VNKE01005901.1,1,1880,1.23828e-05,149057617,0.981785
D.bunnanda,151823105,VNKE01005245.1,1,1880,1.23828e-05,149059497,0.981797
D.bunnanda,151823105,VNKE01004305.1,1,1880,1.23828e-05,149061377,0.98181
D.bunnanda,151823105,VNKE01003980.1,1,1877,1.23631e-05,149063254,0.981822
D.bunnanda,151823105,VNKE01002550.1,1,1877,1.23631e-05,149065131,0.981834
D.bunnanda,151823105,VNKE01001983.1,1,1875,1.23499e-05,149067006,0.981847
D.bunnanda,151823105,VNKE01006285.1,1,1873,1.23367e-05,149068879,0.981859
D.bunnanda,151823105,VNKE01004671.1,1,1873,1.23367e-05,149070752,0.981871
D.bunnanda,151823105,VNKE01004605.1,1,1873,1.23367e-05,149072625,0.981884
D.bunnanda,151823105,VNKE01002434.1,1,1873,1.23367e-05,149074498,0.981896
D.bunnanda,151823105,VNKE01003385.1,1,1872,1.23301e-05,149076370,0.981908
D.bunnanda,151823105,VNKE01001397.1,1,1871,1.23236e-05,149078241,0.981921
D.bunnanda,151823105,VNKE01004558.1,1,1870,1.2317e-05,149080111,0.981933
D.bunnanda,151823105,VNKE01003287.1,1,1870,1.2317e-05,149081981,0.981945
D.bunnanda,151823105,VNKE01002111.1,1,1870,1.2317e-05,149083851,0.981958
D.bunnanda,151823105,VNKE01004185.1,1,1868,1.23038e-05,149085719,0.98197
D.bunnanda,151823105,VNKE01003502.1,1,1868,1.23038e-05,149087587,0.981982
D.bunnanda,151823105,VNKE01002213.1,1,1867,1.22972e-05,149089454,0.981994
D.bunnanda,151823105,VNKE01000861.1,1,1867,1.22972e-05,149091321,0.982007
D.bunnanda,151823105,VNKE01004552.1,1,1866,1.22906e-05,149093187,0.982019
D.bunnanda,151823105,VNKE01001846.1,1,1866,1.22906e-05,149095053,0.982031
D.bunnanda,151823105,VNKE01000061.1,1,1866,1.22906e-05,149096919,0.982044
D.bunnanda,151823105,VNKE01005459.1,1,1865,1.2284e-05,149098784,0.982056
D.bunnanda,151823105,VNKE01003115.1,1,1865,1.2284e-05,149100649,0.982068
D.bunnanda,151823105,VNKE01004005.1,1,1864,1.22774e-05,149102513,0.982081
D.bunnanda,151823105,VNKE01006054.1,1,1861,1.22577e-05,149104374,0.982093
D.bunnanda,151823105,VNKE01000459.1,1,1861,1.22577e-05,149106235,0.982105
D.bunnanda,151823105,VNKE01001736.1,1,1860,1.22511e-05,149108095,0.982117
D.bunnanda,151823105,VNKE01005261.1,1,1859,1.22445e-05,149109954,0.98213
D.bunnanda,151823105,VNKE01000302.1,1,1858,1.22379e-05,149111812,0.982142
D.bunnanda,151823105,VNKE01005375.1,1,1857,1.22313e-05,149113669,0.982154
D.bunnanda,151823105,VNKE01002222.1,1,1857,1.22313e-05,149115526,0.982166
D.bunnanda,151823105,VNKE01005311.1,1,1856,1.22248e-05,149117382,0.982178
D.bunnanda,151823105,VNKE01003249.1,1,1856,1.22248e-05,149119238,0.982191
D.bunnanda,151823105,VNKE01004472.1,1,1855,1.22182e-05,149121093,0.982203
D.bunnanda,151823105,VNKE01003293.1,1,1855,1.22182e-05,149122948,0.982215
D.bunnanda,151823105,VNKE01002216.1,1,1855,1.22182e-05,149124803,0.982227
D.bunnanda,151823105,VNKE01002126.1,1,1855,1.22182e-05,149126658,0.98224
D.bunnanda,151823105,VNKE01004464.1,1,1854,1.22116e-05,149128512,0.982252
D.bunnanda,151823105,VNKE01006491.1,1,1853,1.2205e-05,149130365,0.982264
D.bunnanda,151823105,VNKE01006610.1,1,1852,1.21984e-05,149132217,0.982276
D.bunnanda,151823105,VNKE01005575.1,1,1850,1.21852e-05,149134067,0.982288
D.bunnanda,151823105,VNKE01002969.1,1,1850,1.21852e-05,149135917,0.982301
D.bunnanda,151823105,VNKE01001535.1,1,1850,1.21852e-05,149137767,0.982313
D.bunnanda,151823105,VNKE01000181.1,1,1850,1.21852e-05,149139617,0.982325
D.bunnanda,151823105,VNKE01005330.1,1,1848,1.21721e-05,149141465,0.982337
D.bunnanda,151823105,VNKE01002706.1,1,1848,1.21721e-05,149143313,0.982349
D.bunnanda,151823105,VNKE01004224.1,1,1845,1.21523e-05,149145158,0.982361
D.bunnanda,151823105,VNKE01003110.1,1,1845,1.21523e-05,149147003,0.982374
D.bunnanda,151823105,VNKE01002723.1,1,1845,1.21523e-05,149148848,0.982386
D.bunnanda,151823105,VNKE01003892.1,1,1843,1.21391e-05,149150691,0.982398
D.bunnanda,151823105,VNKE01002443.1,1,1843,1.21391e-05,149152534,0.98241
D.bunnanda,151823105,VNKE01000432.1,1,1843,1.21391e-05,149154377,0.982422
D.bunnanda,151823105,VNKE01006286.1,1,1842,1.21325e-05,149156219,0.982434
D.bunnanda,151823105,VNKE01005776.1,1,1842,1.21325e-05,149158061,0.982446
D.bunnanda,151823105,VNKE01005180.1,1,1842,1.21325e-05,149159903,0.982459
D.bunnanda,151823105,VNKE01004919.1,1,1842,1.21325e-05,149161745,0.982471
D.bunnanda,151823105,VNKE01001250.1,1,1842,1.21325e-05,149163587,0.982483
D.bunnanda,151823105,VNKE01005080.1,1,1841,1.2126e-05,149165428,0.982495
D.bunnanda,151823105,VNKE01000446.1,1,1840,1.21194e-05,149167268,0.982507
D.bunnanda,151823105,VNKE01000081.1,1,1840,1.21194e-05,149169108,0.982519
D.bunnanda,151823105,VNKE01005827.1,1,1837,1.20996e-05,149170945,0.982531
D.bunnanda,151823105,VNKE01000301.1,1,1837,1.20996e-05,149172782,0.982543
D.bunnanda,151823105,VNKE01006325.1,1,1836,1.2093e-05,149174618,0.982555
D.bunnanda,151823105,VNKE01006029.1,1,1836,1.2093e-05,149176454,0.982568
D.bunnanda,151823105,VNKE01004802.1,1,1835,1.20864e-05,149178289,0.98258
D.bunnanda,151823105,VNKE01004649.1,1,1835,1.20864e-05,149180124,0.982592
D.bunnanda,151823105,VNKE01003332.1,1,1835,1.20864e-05,149181959,0.982604
D.bunnanda,151823105,VNKE01006435.1,1,1834,1.20798e-05,149183793,0.982616
D.bunnanda,151823105,VNKE01004176.1,1,1834,1.20798e-05,149185627,0.982628
D.bunnanda,151823105,VNKE01001064.1,1,1833,1.20733e-05,149187460,0.98264
D.bunnanda,151823105,VNKE01005689.1,1,1832,1.20667e-05,149189292,0.982652
D.bunnanda,151823105,VNKE01006395.1,1,1830,1.20535e-05,149191122,0.982664
D.bunnanda,151823105,VNKE01000296.1,1,1829,1.20469e-05,149192951,0.982676
D.bunnanda,151823105,VNKE01001565.1,1,1828,1.20403e-05,149194779,0.982688
D.bunnanda,151823105,VNKE01004335.1,1,1825,1.20206e-05,149196604,0.9827
D.bunnanda,151823105,VNKE01003914.1,1,1825,1.20206e-05,149198429,0.982712
D.bunnanda,151823105,VNKE01003047.1,1,1825,1.20206e-05,149200254,0.982724
D.bunnanda,151823105,VNKE01005722.1,1,1824,1.2014e-05,149202078,0.982736
D.bunnanda,151823105,VNKE01003934.1,1,1824,1.2014e-05,149203902,0.982748
D.bunnanda,151823105,VNKE01003823.1,1,1824,1.2014e-05,149205726,0.98276
D.bunnanda,151823105,VNKE01000323.1,1,1823,1.20074e-05,149207549,0.982772
D.bunnanda,151823105,VNKE01004451.1,1,1822,1.20008e-05,149209371,0.982784
D.bunnanda,151823105,VNKE01003441.1,1,1822,1.20008e-05,149211193,0.982796
D.bunnanda,151823105,VNKE01001504.1,1,1820,1.19876e-05,149213013,0.982808
D.bunnanda,151823105,VNKE01002839.1,1,1819,1.1981e-05,149214832,0.98282
D.bunnanda,151823105,VNKE01004932.1,1,1818,1.19745e-05,149216650,0.982832
D.bunnanda,151823105,VNKE01005298.1,1,1817,1.19679e-05,149218467,0.982844
D.bunnanda,151823105,VNKE01001993.1,1,1817,1.19679e-05,149220284,0.982856
D.bunnanda,151823105,VNKE01003975.1,1,1816,1.19613e-05,149222100,0.982868
D.bunnanda,151823105,VNKE01003046.1,1,1816,1.19613e-05,149223916,0.98288
D.bunnanda,151823105,VNKE01002593.1,1,1815,1.19547e-05,149225731,0.982892
D.bunnanda,151823105,VNKE01006002.1,1,1814,1.19481e-05,149227545,0.982904
D.bunnanda,151823105,VNKE01002731.1,1,1814,1.19481e-05,149229359,0.982916
D.bunnanda,151823105,VNKE01000295.1,1,1814,1.19481e-05,149231173,0.982928
D.bunnanda,151823105,VNKE01002736.1,1,1813,1.19415e-05,149232986,0.98294
D.bunnanda,151823105,VNKE01001915.1,1,1812,1.19349e-05,149234798,0.982952
D.bunnanda,151823105,VNKE01001374.1,1,1812,1.19349e-05,149236610,0.982964
D.bunnanda,151823105,VNKE01004016.1,1,1811,1.19284e-05,149238421,0.982976
D.bunnanda,151823105,VNKE01000087.1,1,1811,1.19284e-05,149240232,0.982988
D.bunnanda,151823105,VNKE01003425.1,1,1810,1.19218e-05,149242042,0.983
D.bunnanda,151823105,VNKE01001027.1,1,1810,1.19218e-05,149243852,0.983011
D.bunnanda,151823105,VNKE01002426.1,1,1809,1.19152e-05,149245661,0.983023
D.bunnanda,151823105,VNKE01001436.1,1,1809,1.19152e-05,149247470,0.983035
D.bunnanda,151823105,VNKE01003048.1,1,1808,1.19086e-05,149249278,0.983047
D.bunnanda,151823105,VNKE01004798.1,1,1807,1.1902e-05,149251085,0.983059
D.bunnanda,151823105,VNKE01000793.1,1,1807,1.1902e-05,149252892,0.983071
D.bunnanda,151823105,VNKE01003947.1,1,1806,1.18954e-05,149254698,0.983083
D.bunnanda,151823105,VNKE01001807.1,1,1806,1.18954e-05,149256504,0.983095
D.bunnanda,151823105,VNKE01001453.1,1,1806,1.18954e-05,149258310,0.983107
D.bunnanda,151823105,VNKE01002038.1,1,1804,1.18822e-05,149260114,0.983119
D.bunnanda,151823105,VNKE01005120.1,1,1803,1.18757e-05,149261917,0.98313
D.bunnanda,151823105,VNKE01003820.1,1,1803,1.18757e-05,149263720,0.983142
D.bunnanda,151823105,VNKE01003426.1,1,1803,1.18757e-05,149265523,0.983154
D.bunnanda,151823105,VNKE01005684.1,1,1802,1.18691e-05,149267325,0.983166
D.bunnanda,151823105,VNKE01005840.1,1,1801,1.18625e-05,149269126,0.983178
D.bunnanda,151823105,VNKE01002991.1,1,1800,1.18559e-05,149270926,0.98319
D.bunnanda,151823105,VNKE01003113.1,1,1799,1.18493e-05,149272725,0.983202
D.bunnanda,151823105,VNKE01001296.1,1,1799,1.18493e-05,149274524,0.983213
D.bunnanda,151823105,VNKE01000059.1,1,1799,1.18493e-05,149276323,0.983225
D.bunnanda,151823105,VNKE01006609.1,1,1797,1.18361e-05,149278120,0.983237
D.bunnanda,151823105,VNKE01004593.1,1,1797,1.18361e-05,149279917,0.983249
D.bunnanda,151823105,VNKE01002871.1,1,1796,1.18296e-05,149281713,0.983261
D.bunnanda,151823105,VNKE01002624.1,1,1796,1.18296e-05,149283509,0.983273
D.bunnanda,151823105,VNKE01003427.1,1,1795,1.1823e-05,149285304,0.983284
D.bunnanda,151823105,VNKE01002212.1,1,1795,1.1823e-05,149287099,0.983296
D.bunnanda,151823105,VNKE01003428.1,1,1792,1.18032e-05,149288891,0.983308
D.bunnanda,151823105,VNKE01006436.1,1,1791,1.17966e-05,149290682,0.98332
D.bunnanda,151823105,VNKE01002728.1,1,1791,1.17966e-05,149292473,0.983332
D.bunnanda,151823105,VNKE01003550.1,1,1790,1.179e-05,149294263,0.983343
D.bunnanda,151823105,VNKE01001442.1,1,1790,1.179e-05,149296053,0.983355
D.bunnanda,151823105,VNKE01004684.1,1,1789,1.17835e-05,149297842,0.983367
D.bunnanda,151823105,VNKE01001864.1,1,1789,1.17835e-05,149299631,0.983379
D.bunnanda,151823105,VNKE01003270.1,1,1788,1.17769e-05,149301419,0.983391
D.bunnanda,151823105,VNKE01005887.1,1,1786,1.17637e-05,149303205,0.983402
D.bunnanda,151823105,VNKE01002995.1,1,1786,1.17637e-05,149304991,0.983414
D.bunnanda,151823105,VNKE01006496.1,1,1785,1.17571e-05,149306776,0.983426
D.bunnanda,151823105,VNKE01004020.1,1,1785,1.17571e-05,149308561,0.983438
D.bunnanda,151823105,VNKE01002196.1,1,1785,1.17571e-05,149310346,0.983449
D.bunnanda,151823105,VNKE01000901.1,1,1785,1.17571e-05,149312131,0.983461
D.bunnanda,151823105,VNKE01006350.1,1,1784,1.17505e-05,149313915,0.983473
D.bunnanda,151823105,VNKE01003042.1,1,1783,1.17439e-05,149315698,0.983485
D.bunnanda,151823105,VNKE01003566.1,1,1782,1.17373e-05,149317480,0.983496
D.bunnanda,151823105,VNKE01001495.1,1,1781,1.17308e-05,149319261,0.983508
D.bunnanda,151823105,VNKE01000274.1,1,1781,1.17308e-05,149321042,0.98352
D.bunnanda,151823105,VNKE01002430.1,1,1780,1.17242e-05,149322822,0.983532
D.bunnanda,151823105,VNKE01002177.1,1,1780,1.17242e-05,149324602,0.983543
D.bunnanda,151823105,VNKE01001004.1,1,1780,1.17242e-05,149326382,0.983555
D.bunnanda,151823105,VNKE01005195.1,1,1779,1.17176e-05,149328161,0.983567
D.bunnanda,151823105,VNKE01004741.1,1,1779,1.17176e-05,149329940,0.983578
D.bunnanda,151823105,VNKE01004171.1,1,1778,1.1711e-05,149331718,0.98359
D.bunnanda,151823105,VNKE01003817.1,1,1778,1.1711e-05,149333496,0.983602
D.bunnanda,151823105,VNKE01002479.1,1,1778,1.1711e-05,149335274,0.983614
D.bunnanda,151823105,VNKE01001800.1,1,1778,1.1711e-05,149337052,0.983625
D.bunnanda,151823105,VNKE01006332.1,1,1775,1.16912e-05,149338827,0.983637
D.bunnanda,151823105,VNKE01004727.1,1,1775,1.16912e-05,149340602,0.983649
D.bunnanda,151823105,VNKE01000355.1,1,1775,1.16912e-05,149342377,0.98366
D.bunnanda,151823105,VNKE01005929.1,1,1774,1.16847e-05,149344151,0.983672
D.bunnanda,151823105,VNKE01005848.1,1,1773,1.16781e-05,149345924,0.983684
D.bunnanda,151823105,VNKE01004012.1,1,1773,1.16781e-05,149347697,0.983695
D.bunnanda,151823105,VNKE01005331.1,1,1772,1.16715e-05,149349469,0.983707
D.bunnanda,151823105,VNKE01004682.1,1,1772,1.16715e-05,149351241,0.983719
D.bunnanda,151823105,VNKE01004023.1,1,1772,1.16715e-05,149353013,0.98373
D.bunnanda,151823105,VNKE01003176.1,1,1772,1.16715e-05,149354785,0.983742
D.bunnanda,151823105,VNKE01004728.1,1,1771,1.16649e-05,149356556,0.983754
D.bunnanda,151823105,VNKE01003045.1,1,1771,1.16649e-05,149358327,0.983765
D.bunnanda,151823105,VNKE01002892.1,1,1771,1.16649e-05,149360098,0.983777
D.bunnanda,151823105,VNKE01005725.1,1,1770,1.16583e-05,149361868,0.983789
D.bunnanda,151823105,VNKE01004445.1,1,1770,1.16583e-05,149363638,0.9838
D.bunnanda,151823105,VNKE01000092.1,1,1770,1.16583e-05,149365408,0.983812
D.bunnanda,151823105,VNKE01005492.1,1,1769,1.16517e-05,149367177,0.983824
D.bunnanda,151823105,VNKE01005043.1,1,1769,1.16517e-05,149368946,0.983835
D.bunnanda,151823105,VNKE01003044.1,1,1769,1.16517e-05,149370715,0.983847
D.bunnanda,151823105,VNKE01004516.1,1,1768,1.16451e-05,149372483,0.983859
D.bunnanda,151823105,VNKE01004162.1,1,1768,1.16451e-05,149374251,0.98387
D.bunnanda,151823105,VNKE01002745.1,1,1768,1.16451e-05,149376019,0.983882
D.bunnanda,151823105,VNKE01003848.1,1,1767,1.16385e-05,149377786,0.983894
D.bunnanda,151823105,VNKE01002932.1,1,1767,1.16385e-05,149379553,0.983905
D.bunnanda,151823105,VNKE01001281.1,1,1767,1.16385e-05,149381320,0.983917
D.bunnanda,151823105,VNKE01000371.1,1,1767,1.16385e-05,149383087,0.983929
D.bunnanda,151823105,VNKE01006364.1,1,1766,1.1632e-05,149384853,0.98394
D.bunnanda,151823105,VNKE01004830.1,1,1766,1.1632e-05,149386619,0.983952
D.bunnanda,151823105,VNKE01001544.1,1,1764,1.16188e-05,149388383,0.983963
D.bunnanda,151823105,VNKE01005992.1,1,1763,1.16122e-05,149390146,0.983975
D.bunnanda,151823105,VNKE01003250.1,1,1763,1.16122e-05,149391909,0.983987
D.bunnanda,151823105,VNKE01006231.1,1,1761,1.1599e-05,149393670,0.983998
D.bunnanda,151823105,VNKE01004963.1,1,1761,1.1599e-05,149395431,0.98401
D.bunnanda,151823105,VNKE01005880.1,1,1760,1.15924e-05,149397191,0.984021
D.bunnanda,151823105,VNKE01004458.1,1,1760,1.15924e-05,149398951,0.984033
D.bunnanda,151823105,VNKE01003422.1,1,1760,1.15924e-05,149400711,0.984045
D.bunnanda,151823105,VNKE01001028.1,1,1760,1.15924e-05,149402471,0.984056
D.bunnanda,151823105,VNKE01000411.1,1,1760,1.15924e-05,149404231,0.984068
D.bunnanda,151823105,VNKE01006444.1,1,1759,1.15859e-05,149405990,0.984079
D.bunnanda,151823105,VNKE01002746.1,1,1759,1.15859e-05,149407749,0.984091
D.bunnanda,151823105,VNKE01005924.1,1,1757,1.15727e-05,149409506,0.984103
D.bunnanda,151823105,VNKE01003423.1,1,1757,1.15727e-05,149411263,0.984114
D.bunnanda,151823105,VNKE01006037.1,1,1756,1.15661e-05,149413019,0.984126
D.bunnanda,151823105,VNKE01006031.1,1,1756,1.15661e-05,149414775,0.984137
D.bunnanda,151823105,VNKE01006191.1,1,1755,1.15595e-05,149416530,0.984149
D.bunnanda,151823105,VNKE01005064.1,1,1755,1.15595e-05,149418285,0.98416
D.bunnanda,151823105,VNKE01004175.1,1,1754,1.15529e-05,149420039,0.984172
D.bunnanda,151823105,VNKE01003942.1,1,1754,1.15529e-05,149421793,0.984183
D.bunnanda,151823105,VNKE01001480.1,1,1754,1.15529e-05,149423547,0.984195
D.bunnanda,151823105,VNKE01006211.1,1,1752,1.15397e-05,149425299,0.984207
D.bunnanda,151823105,VNKE01001726.1,1,1751,1.15332e-05,149427050,0.984218
D.bunnanda,151823105,VNKE01000777.1,1,1751,1.15332e-05,149428801,0.98423
D.bunnanda,151823105,VNKE01000015.1,1,1750,1.15266e-05,149430551,0.984241
D.bunnanda,151823105,VNKE01004651.1,1,1748,1.15134e-05,149432299,0.984253
D.bunnanda,151823105,VNKE01003040.1,1,1748,1.15134e-05,149434047,0.984264
D.bunnanda,151823105,VNKE01001299.1,1,1747,1.15068e-05,149435794,0.984276
D.bunnanda,151823105,VNKE01002725.1,1,1746,1.15002e-05,149437540,0.984287
D.bunnanda,151823105,VNKE01001274.1,1,1745,1.14936e-05,149439285,0.984299
D.bunnanda,151823105,VNKE01005756.1,1,1744,1.14871e-05,149441029,0.98431
D.bunnanda,151823105,VNKE01004052.1,1,1744,1.14871e-05,149442773,0.984322
D.bunnanda,151823105,VNKE01003424.1,1,1744,1.14871e-05,149444517,0.984333
D.bunnanda,151823105,VNKE01005587.1,1,1742,1.14739e-05,149446259,0.984345
D.bunnanda,151823105,VNKE01004796.1,1,1740,1.14607e-05,149447999,0.984356
D.bunnanda,151823105,VNKE01002191.1,1,1740,1.14607e-05,149449739,0.984368
D.bunnanda,151823105,VNKE01000031.1,1,1739,1.14541e-05,149451478,0.984379
D.bunnanda,151823105,VNKE01000659.1,1,1738,1.14475e-05,149453216,0.98439
D.bunnanda,151823105,VNKE01005590.1,1,1737,1.14409e-05,149454953,0.984402
D.bunnanda,151823105,VNKE01002464.1,1,1737,1.14409e-05,149456690,0.984413
D.bunnanda,151823105,VNKE01001213.1,1,1736,1.14344e-05,149458426,0.984425
D.bunnanda,151823105,VNKE01000698.1,1,1736,1.14344e-05,149460162,0.984436
D.bunnanda,151823105,VNKE01004538.1,1,1735,1.14278e-05,149461897,0.984448
D.bunnanda,151823105,VNKE01002442.1,1,1735,1.14278e-05,149463632,0.984459
D.bunnanda,151823105,VNKE01002435.1,1,1735,1.14278e-05,149465367,0.98447
D.bunnanda,151823105,VNKE01004233.1,1,1734,1.14212e-05,149467101,0.984482
D.bunnanda,151823105,VNKE01002444.1,1,1734,1.14212e-05,149468835,0.984493
D.bunnanda,151823105,VNKE01001424.1,1,1734,1.14212e-05,149470569,0.984505
D.bunnanda,151823105,VNKE01005591.1,1,1733,1.14146e-05,149472302,0.984516
D.bunnanda,151823105,VNKE01001014.1,1,1733,1.14146e-05,149474035,0.984528
D.bunnanda,151823105,VNKE01005543.1,1,1731,1.14014e-05,149475766,0.984539
D.bunnanda,151823105,VNKE01006200.1,1,1730,1.13948e-05,149477496,0.98455
D.bunnanda,151823105,VNKE01003445.1,1,1729,1.13883e-05,149479225,0.984562
D.bunnanda,151823105,VNKE01002229.1,1,1728,1.13817e-05,149480953,0.984573
D.bunnanda,151823105,VNKE01005644.1,1,1727,1.13751e-05,149482680,0.984585
D.bunnanda,151823105,VNKE01003989.1,1,1727,1.13751e-05,149484407,0.984596
D.bunnanda,151823105,VNKE01003395.1,1,1727,1.13751e-05,149486134,0.984607
D.bunnanda,151823105,VNKE01005329.1,1,1726,1.13685e-05,149487860,0.984619
D.bunnanda,151823105,VNKE01005105.1,1,1726,1.13685e-05,149489586,0.98463
D.bunnanda,151823105,VNKE01002704.1,1,1726,1.13685e-05,149491312,0.984641
D.bunnanda,151823105,VNKE01005833.1,1,1725,1.13619e-05,149493037,0.984653
D.bunnanda,151823105,VNKE01005265.1,1,1725,1.13619e-05,149494762,0.984664
D.bunnanda,151823105,VNKE01001035.1,1,1725,1.13619e-05,149496487,0.984675
D.bunnanda,151823105,VNKE01003220.1,1,1724,1.13553e-05,149498211,0.984687
D.bunnanda,151823105,VNKE01002987.1,1,1721,1.13356e-05,149499932,0.984698
D.bunnanda,151823105,VNKE01001863.1,1,1721,1.13356e-05,149501653,0.984709
D.bunnanda,151823105,VNKE01000250.1,1,1721,1.13356e-05,149503374,0.984721
D.bunnanda,151823105,VNKE01005334.1,1,1720,1.1329e-05,149505094,0.984732
D.bunnanda,151823105,VNKE01001289.1,1,1720,1.1329e-05,149506814,0.984743
D.bunnanda,151823105,VNKE01005631.1,1,1719,1.13224e-05,149508533,0.984755
D.bunnanda,151823105,VNKE01004331.1,1,1718,1.13158e-05,149510251,0.984766
D.bunnanda,151823105,VNKE01004170.1,1,1718,1.13158e-05,149511969,0.984777
D.bunnanda,151823105,VNKE01003539.1,1,1718,1.13158e-05,149513687,0.984789
D.bunnanda,151823105,VNKE01000034.1,1,1718,1.13158e-05,149515405,0.9848
D.bunnanda,151823105,VNKE01001012.1,1,1717,1.13092e-05,149517122,0.984811
D.bunnanda,151823105,VNKE01000580.1,1,1717,1.13092e-05,149518839,0.984823
D.bunnanda,151823105,VNKE01005117.1,1,1716,1.13026e-05,149520555,0.984834
D.bunnanda,151823105,VNKE01006030.1,1,1715,1.1296e-05,149522270,0.984845
D.bunnanda,151823105,VNKE01005777.1,1,1715,1.1296e-05,149523985,0.984857
D.bunnanda,151823105,VNKE01005592.1,1,1715,1.1296e-05,149525700,0.984868
D.bunnanda,151823105,VNKE01005544.1,1,1715,1.1296e-05,149527415,0.984879
D.bunnanda,151823105,VNKE01003926.1,1,1715,1.1296e-05,149529130,0.98489
D.bunnanda,151823105,VNKE01001727.1,1,1715,1.1296e-05,149530845,0.984902
D.bunnanda,151823105,VNKE01000028.1,1,1715,1.1296e-05,149532560,0.984913
D.bunnanda,151823105,VNKE01005214.1,1,1714,1.12895e-05,149534274,0.984924
D.bunnanda,151823105,VNKE01004154.1,1,1714,1.12895e-05,149535988,0.984936
D.bunnanda,151823105,VNKE01001630.1,1,1714,1.12895e-05,149537702,0.984947
D.bunnanda,151823105,VNKE01005333.1,1,1713,1.12829e-05,149539415,0.984958
D.bunnanda,151823105,VNKE01000421.1,1,1713,1.12829e-05,149541128,0.98497
D.bunnanda,151823105,VNKE01003310.1,1,1712,1.12763e-05,149542840,0.984981
D.bunnanda,151823105,VNKE01004833.1,1,1711,1.12697e-05,149544551,0.984992
D.bunnanda,151823105,VNKE01000533.1,1,1711,1.12697e-05,149546262,0.985003
D.bunnanda,151823105,VNKE01004517.1,1,1709,1.12565e-05,149547971,0.985015
D.bunnanda,151823105,VNKE01000662.1,1,1709,1.12565e-05,149549680,0.985026
D.bunnanda,151823105,VNKE01001246.1,1,1708,1.12499e-05,149551388,0.985037
D.bunnanda,151823105,VNKE01000070.1,1,1708,1.12499e-05,149553096,0.985048
D.bunnanda,151823105,VNKE01003264.1,1,1707,1.12433e-05,149554803,0.98506
D.bunnanda,151823105,VNKE01000999.1,1,1707,1.12433e-05,149556510,0.985071
D.bunnanda,151823105,VNKE01005638.1,1,1706,1.12368e-05,149558216,0.985082
D.bunnanda,151823105,VNKE01003997.1,1,1705,1.12302e-05,149559921,0.985093
D.bunnanda,151823105,VNKE01002732.1,1,1705,1.12302e-05,149561626,0.985105
D.bunnanda,151823105,VNKE01002331.1,1,1705,1.12302e-05,149563331,0.985116
D.bunnanda,151823105,VNKE01000139.1,1,1704,1.12236e-05,149565035,0.985127
D.bunnanda,151823105,VNKE01003751.1,1,1703,1.1217e-05,149566738,0.985138
D.bunnanda,151823105,VNKE01000089.1,1,1703,1.1217e-05,149568441,0.985149
D.bunnanda,151823105,VNKE01004399.1,1,1702,1.12104e-05,149570143,0.985161
D.bunnanda,151823105,VNKE01000037.1,1,1702,1.12104e-05,149571845,0.985172
D.bunnanda,151823105,VNKE01005332.1,1,1701,1.12038e-05,149573546,0.985183
D.bunnanda,151823105,VNKE01001692.1,1,1701,1.12038e-05,149575247,0.985194
D.bunnanda,151823105,VNKE01000036.1,1,1701,1.12038e-05,149576948,0.985205
D.bunnanda,151823105,VNKE01005198.1,1,1700,1.11972e-05,149578648,0.985217
D.bunnanda,151823105,VNKE01002983.1,1,1699,1.11907e-05,149580347,0.985228
D.bunnanda,151823105,VNKE01002773.1,1,1699,1.11907e-05,149582046,0.985239
D.bunnanda,151823105,VNKE01005764.1,1,1698,1.11841e-05,149583744,0.98525
D.bunnanda,151823105,VNKE01005594.1,1,1698,1.11841e-05,149585442,0.985261
D.bunnanda,151823105,VNKE01000322.1,1,1698,1.11841e-05,149587140,0.985273
D.bunnanda,151823105,VNKE01005681.1,1,1696,1.11709e-05,149588836,0.985284
D.bunnanda,151823105,VNKE01005595.1,1,1695,1.11643e-05,149590531,0.985295
D.bunnanda,151823105,VNKE01003189.1,1,1694,1.11577e-05,149592225,0.985306
D.bunnanda,151823105,VNKE01000514.1,1,1694,1.11577e-05,149593919,0.985317
D.bunnanda,151823105,VNKE01005536.1,1,1693,1.11511e-05,149595612,0.985328
D.bunnanda,151823105,VNKE01004254.1,1,1692,1.11445e-05,149597304,0.98534
D.bunnanda,151823105,VNKE01004549.1,1,1691,1.1138e-05,149598995,0.985351
D.bunnanda,151823105,VNKE01003646.1,1,1691,1.1138e-05,149600686,0.985362
D.bunnanda,151823105,VNKE01002140.1,1,1691,1.1138e-05,149602377,0.985373
D.bunnanda,151823105,VNKE01000085.1,1,1690,1.11314e-05,149604067,0.985384
D.bunnanda,151823105,VNKE01004874.1,1,1689,1.11248e-05,149605756,0.985395
D.bunnanda,151823105,VNKE01004438.1,1,1689,1.11248e-05,149607445,0.985406
D.bunnanda,151823105,VNKE01000879.1,1,1689,1.11248e-05,149609134,0.985417
D.bunnanda,151823105,VNKE01004177.1,1,1688,1.11182e-05,149610822,0.985429
D.bunnanda,151823105,VNKE01003187.1,1,1688,1.11182e-05,149612510,0.98544
D.bunnanda,151823105,VNKE01000073.1,1,1688,1.11182e-05,149614198,0.985451
D.bunnanda,151823105,VNKE01005596.1,1,1687,1.11116e-05,149615885,0.985462
D.bunnanda,151823105,VNKE01002552.1,1,1685,1.10984e-05,149617570,0.985473
D.bunnanda,151823105,VNKE01006050.1,1,1682,1.10787e-05,149619252,0.985484
D.bunnanda,151823105,VNKE01004327.1,1,1682,1.10787e-05,149620934,0.985495
D.bunnanda,151823105,VNKE01005597.1,1,1680,1.10655e-05,149622614,0.985506
D.bunnanda,151823105,VNKE01000328.1,1,1680,1.10655e-05,149624294,0.985517
D.bunnanda,151823105,VNKE01000033.1,1,1680,1.10655e-05,149625974,0.985528
D.bunnanda,151823105,VNKE01005260.1,1,1679,1.10589e-05,149627653,0.985539
D.bunnanda,151823105,VNKE01003979.1,1,1678,1.10523e-05,149629331,0.98555
D.bunnanda,151823105,VNKE01002540.1,1,1678,1.10523e-05,149631009,0.985562
D.bunnanda,151823105,VNKE01002045.1,1,1678,1.10523e-05,149632687,0.985573
D.bunnanda,151823105,VNKE01001158.1,1,1678,1.10523e-05,149634365,0.985584
D.bunnanda,151823105,VNKE01000029.1,1,1678,1.10523e-05,149636043,0.985595
D.bunnanda,151823105,VNKE01005945.1,1,1677,1.10457e-05,149637720,0.985606
D.bunnanda,151823105,VNKE01000369.1,1,1677,1.10457e-05,149639397,0.985617
D.bunnanda,151823105,VNKE01003190.1,1,1676,1.10392e-05,149641073,0.985628
D.bunnanda,151823105,VNKE01002537.1,1,1676,1.10392e-05,149642749,0.985639
D.bunnanda,151823105,VNKE01000935.1,1,1674,1.1026e-05,149644423,0.98565
D.bunnanda,151823105,VNKE01004983.1,1,1673,1.10194e-05,149646096,0.985661
D.bunnanda,151823105,VNKE01003767.1,1,1673,1.10194e-05,149647769,0.985672
D.bunnanda,151823105,VNKE01003194.1,1,1673,1.10194e-05,149649442,0.985683
D.bunnanda,151823105,VNKE01000780.1,1,1673,1.10194e-05,149651115,0.985694
D.bunnanda,151823105,VNKE01000074.1,1,1673,1.10194e-05,149652788,0.985705
D.bunnanda,151823105,VNKE01005923.1,1,1672,1.10128e-05,149654460,0.985716
D.bunnanda,151823105,VNKE01003195.1,1,1672,1.10128e-05,149656132,0.985727
D.bunnanda,151823105,VNKE01003384.1,1,1671,1.10062e-05,149657803,0.985738
D.bunnanda,151823105,VNKE01005026.1,1,1670,1.09996e-05,149659473,0.985749
D.bunnanda,151823105,VNKE01001722.1,1,1669,1.09931e-05,149661142,0.98576
D.bunnanda,151823105,VNKE01002735.1,1,1667,1.09799e-05,149662809,0.985771
D.bunnanda,151823105,VNKE01006069.1,1,1666,1.09733e-05,149664475,0.985782
D.bunnanda,151823105,VNKE01005102.1,1,1665,1.09667e-05,149666140,0.985793
D.bunnanda,151823105,VNKE01002831.1,1,1665,1.09667e-05,149667805,0.985804
D.bunnanda,151823105,VNKE01002265.1,1,1665,1.09667e-05,149669470,0.985815
D.bunnanda,151823105,VNKE01004021.1,1,1664,1.09601e-05,149671134,0.985826
D.bunnanda,151823105,VNKE01000269.1,1,1664,1.09601e-05,149672798,0.985837
D.bunnanda,151823105,VNKE01006064.1,1,1663,1.09535e-05,149674461,0.985848
D.bunnanda,151823105,VNKE01005905.1,1,1663,1.09535e-05,149676124,0.985859
D.bunnanda,151823105,VNKE01000847.1,1,1663,1.09535e-05,149677787,0.98587
D.bunnanda,151823105,VNKE01000338.1,1,1662,1.0947e-05,149679449,0.985881
D.bunnanda,151823105,VNKE01005235.1,1,1661,1.09404e-05,149681110,0.985892
D.bunnanda,151823105,VNKE01000712.1,1,1661,1.09404e-05,149682771,0.985902
D.bunnanda,151823105,VNKE01006065.1,1,1660,1.09338e-05,149684431,0.985913
D.bunnanda,151823105,VNKE01005803.1,1,1660,1.09338e-05,149686091,0.985924
D.bunnanda,151823105,VNKE01000878.1,1,1660,1.09338e-05,149687751,0.985935
D.bunnanda,151823105,VNKE01006534.1,1,1659,1.09272e-05,149689410,0.985946
D.bunnanda,151823105,VNKE01005268.1,1,1659,1.09272e-05,149691069,0.985957
D.bunnanda,151823105,VNKE01002662.1,1,1659,1.09272e-05,149692728,0.985968
D.bunnanda,151823105,VNKE01006067.1,1,1658,1.09206e-05,149694386,0.985979
D.bunnanda,151823105,VNKE01005100.1,1,1658,1.09206e-05,149696044,0.98599
D.bunnanda,151823105,VNKE01005145.1,1,1657,1.0914e-05,149697701,0.986001
D.bunnanda,151823105,VNKE01002686.1,1,1657,1.0914e-05,149699358,0.986012
D.bunnanda,151823105,VNKE01004644.1,1,1656,1.09074e-05,149701014,0.986023
D.bunnanda,151823105,VNKE01002408.1,1,1656,1.09074e-05,149702670,0.986034
D.bunnanda,151823105,VNKE01000216.1,1,1656,1.09074e-05,149704326,0.986044
D.bunnanda,151823105,VNKE01006450.1,1,1654,1.08943e-05,149705980,0.986055
D.bunnanda,151823105,VNKE01003389.1,1,1654,1.08943e-05,149707634,0.986066
D.bunnanda,151823105,VNKE01000257.1,1,1653,1.08877e-05,149709287,0.986077
D.bunnanda,151823105,VNKE01000027.1,1,1653,1.08877e-05,149710940,0.986088
D.bunnanda,151823105,VNKE01004681.1,1,1652,1.08811e-05,149712592,0.986099
D.bunnanda,151823105,VNKE01001660.1,1,1651,1.08745e-05,149714243,0.98611
D.bunnanda,151823105,VNKE01004843.1,1,1650,1.08679e-05,149715893,0.986121
D.bunnanda,151823105,VNKE01006488.1,1,1649,1.08613e-05,149717542,0.986131
D.bunnanda,151823105,VNKE01005336.1,1,1649,1.08613e-05,149719191,0.986142
D.bunnanda,151823105,VNKE01004220.1,1,1648,1.08547e-05,149720839,0.986153
D.bunnanda,151823105,VNKE01002794.1,1,1648,1.08547e-05,149722487,0.986164
D.bunnanda,151823105,VNKE01002136.1,1,1648,1.08547e-05,149724135,0.986175
D.bunnanda,151823105,VNKE01005421.1,1,1647,1.08482e-05,149725782,0.986186
D.bunnanda,151823105,VNKE01002194.1,1,1647,1.08482e-05,149727429,0.986197
D.bunnanda,151823105,VNKE01004463.1,1,1646,1.08416e-05,149729075,0.986207
D.bunnanda,151823105,VNKE01004065.1,1,1646,1.08416e-05,149730721,0.986218
D.bunnanda,151823105,VNKE01002999.1,1,1646,1.08416e-05,149732367,0.986229
D.bunnanda,151823105,VNKE01001331.1,1,1646,1.08416e-05,149734013,0.98624
D.bunnanda,151823105,VNKE01003698.1,1,1645,1.0835e-05,149735658,0.986251
D.bunnanda,151823105,VNKE01001262.1,1,1644,1.08284e-05,149737302,0.986262
D.bunnanda,151823105,VNKE01000401.1,1,1644,1.08284e-05,149738946,0.986272
D.bunnanda,151823105,VNKE01000001.1,1,1644,1.08284e-05,149740590,0.986283
D.bunnanda,151823105,VNKE01004870.1,1,1642,1.08152e-05,149742232,0.986294
D.bunnanda,151823105,VNKE01002718.1,1,1642,1.08152e-05,149743874,0.986305
D.bunnanda,151823105,VNKE01001817.1,1,1639,1.07955e-05,149745513,0.986316
D.bunnanda,151823105,VNKE01000997.1,1,1639,1.07955e-05,149747152,0.986327
D.bunnanda,151823105,VNKE01003945.1,1,1638,1.07889e-05,149748790,0.986337
D.bunnanda,151823105,VNKE01002702.1,1,1638,1.07889e-05,149750428,0.986348
D.bunnanda,151823105,VNKE01002350.1,1,1638,1.07889e-05,149752066,0.986359
D.bunnanda,151823105,VNKE01000030.1,1,1638,1.07889e-05,149753704,0.98637
D.bunnanda,151823105,VNKE01006107.1,1,1637,1.07823e-05,149755341,0.98638
D.bunnanda,151823105,VNKE01002782.1,1,1636,1.07757e-05,149756977,0.986391
D.bunnanda,151823105,VNKE01000834.1,1,1636,1.07757e-05,149758613,0.986402
D.bunnanda,151823105,VNKE01003759.1,1,1635,1.07691e-05,149760248,0.986413
D.bunnanda,151823105,VNKE01005895.1,1,1634,1.07625e-05,149761882,0.986424
D.bunnanda,151823105,VNKE01004511.1,1,1634,1.07625e-05,149763516,0.986434
D.bunnanda,151823105,VNKE01004173.1,1,1634,1.07625e-05,149765150,0.986445
D.bunnanda,151823105,VNKE01006431.1,1,1633,1.07559e-05,149766783,0.986456
D.bunnanda,151823105,VNKE01004053.1,1,1633,1.07559e-05,149768416,0.986467
D.bunnanda,151823105,VNKE01005234.1,1,1632,1.07494e-05,149770048,0.986477
D.bunnanda,151823105,VNKE01004073.1,1,1629,1.07296e-05,149771677,0.986488
D.bunnanda,151823105,VNKE01002357.1,1,1629,1.07296e-05,149773306,0.986499
D.bunnanda,151823105,VNKE01002033.1,1,1628,1.0723e-05,149774934,0.986509
D.bunnanda,151823105,VNKE01000756.1,1,1628,1.0723e-05,149776562,0.98652
D.bunnanda,151823105,VNKE01001794.1,1,1627,1.07164e-05,149778189,0.986531
D.bunnanda,151823105,VNKE01005645.1,1,1626,1.07098e-05,149779815,0.986542
D.bunnanda,151823105,VNKE01003546.1,1,1626,1.07098e-05,149781441,0.986552
D.bunnanda,151823105,VNKE01002402.1,1,1626,1.07098e-05,149783067,0.986563
D.bunnanda,151823105,VNKE01005946.1,1,1625,1.07032e-05,149784692,0.986574
D.bunnanda,151823105,VNKE01004925.1,1,1625,1.07032e-05,149786317,0.986584
D.bunnanda,151823105,VNKE01002922.1,1,1625,1.07032e-05,149787942,0.986595
D.bunnanda,151823105,VNKE01002356.1,1,1625,1.07032e-05,149789567,0.986606
D.bunnanda,151823105,VNKE01001635.1,1,1625,1.07032e-05,149791192,0.986617
D.bunnanda,151823105,VNKE01006106.1,1,1624,1.06967e-05,149792816,0.986627
D.bunnanda,151823105,VNKE01004138.1,1,1624,1.06967e-05,149794440,0.986638
D.bunnanda,151823105,VNKE01003909.1,1,1624,1.06967e-05,149796064,0.986649
D.bunnanda,151823105,VNKE01004913.1,1,1623,1.06901e-05,149797687,0.986659
D.bunnanda,151823105,VNKE01004566.1,1,1623,1.06901e-05,149799310,0.98667
D.bunnanda,151823105,VNKE01001724.1,1,1623,1.06901e-05,149800933,0.986681
D.bunnanda,151823105,VNKE01006247.1,1,1622,1.06835e-05,149802555,0.986691
D.bunnanda,151823105,VNKE01002471.1,1,1622,1.06835e-05,149804177,0.986702
D.bunnanda,151823105,VNKE01002710.1,1,1620,1.06703e-05,149805797,0.986713
D.bunnanda,151823105,VNKE01002355.1,1,1620,1.06703e-05,149807417,0.986723
D.bunnanda,151823105,VNKE01002354.1,1,1620,1.06703e-05,149809037,0.986734
D.bunnanda,151823105,VNKE01004181.1,1,1618,1.06571e-05,149810655,0.986745
D.bunnanda,151823105,VNKE01002419.1,1,1618,1.06571e-05,149812273,0.986755
D.bunnanda,151823105,VNKE01003816.1,1,1617,1.06506e-05,149813890,0.986766
D.bunnanda,151823105,VNKE01002349.1,1,1617,1.06506e-05,149815507,0.986777
D.bunnanda,151823105,VNKE01003825.1,1,1616,1.0644e-05,149817123,0.986787
D.bunnanda,151823105,VNKE01005882.1,1,1615,1.06374e-05,149818738,0.986798
D.bunnanda,151823105,VNKE01002600.1,1,1615,1.06374e-05,149820353,0.986809
D.bunnanda,151823105,VNKE01002495.1,1,1614,1.06308e-05,149821967,0.986819
D.bunnanda,151823105,VNKE01001857.1,1,1614,1.06308e-05,149823581,0.98683
D.bunnanda,151823105,VNKE01000451.1,1,1614,1.06308e-05,149825195,0.986841
D.bunnanda,151823105,VNKE01002184.1,1,1613,1.06242e-05,149826808,0.986851
D.bunnanda,151823105,VNKE01000384.1,1,1613,1.06242e-05,149828421,0.986862
D.bunnanda,151823105,VNKE01002627.1,1,1612,1.06176e-05,149830033,0.986872
D.bunnanda,151823105,VNKE01002438.1,1,1612,1.06176e-05,149831645,0.986883
D.bunnanda,151823105,VNKE01002348.1,1,1612,1.06176e-05,149833257,0.986894
D.bunnanda,151823105,VNKE01006480.1,1,1611,1.0611e-05,149834868,0.986904
D.bunnanda,151823105,VNKE01006250.1,1,1611,1.0611e-05,149836479,0.986915
D.bunnanda,151823105,VNKE01005227.1,1,1611,1.0611e-05,149838090,0.986925
D.bunnanda,151823105,VNKE01002310.1,1,1611,1.0611e-05,149839701,0.986936
D.bunnanda,151823105,VNKE01003547.1,1,1610,1.06044e-05,149841311,0.986947
D.bunnanda,151823105,VNKE01004670.1,1,1609,1.05979e-05,149842920,0.986957
D.bunnanda,151823105,VNKE01005920.1,1,1607,1.05847e-05,149844527,0.986968
D.bunnanda,151823105,VNKE01002729.1,1,1607,1.05847e-05,149846134,0.986978
D.bunnanda,151823105,VNKE01000509.1,1,1607,1.05847e-05,149847741,0.986989
D.bunnanda,151823105,VNKE01006613.1,1,1606,1.05781e-05,149849347,0.987
D.bunnanda,151823105,VNKE01004474.1,1,1605,1.05715e-05,149850952,0.98701
D.bunnanda,151823105,VNKE01003938.1,1,1605,1.05715e-05,149852557,0.987021
D.bunnanda,151823105,VNKE01003519.1,1,1604,1.05649e-05,149854161,0.987031
D.bunnanda,151823105,VNKE01003011.1,1,1604,1.05649e-05,149855765,0.987042
D.bunnanda,151823105,VNKE01005057.1,1,1603,1.05583e-05,149857368,0.987052
D.bunnanda,151823105,VNKE01004402.1,1,1602,1.05518e-05,149858970,0.987063
D.bunnanda,151823105,VNKE01002506.1,1,1602,1.05518e-05,149860572,0.987074
D.bunnanda,151823105,VNKE01005921.1,1,1601,1.05452e-05,149862173,0.987084
D.bunnanda,151823105,VNKE01005856.1,1,1601,1.05452e-05,149863774,0.987095
D.bunnanda,151823105,VNKE01005855.1,1,1601,1.05452e-05,149865375,0.987105
D.bunnanda,151823105,VNKE01005853.1,1,1600,1.05386e-05,149866975,0.987116
D.bunnanda,151823105,VNKE01005854.1,1,1599,1.0532e-05,149868574,0.987126
D.bunnanda,151823105,VNKE01003761.1,1,1599,1.0532e-05,149870173,0.987137
D.bunnanda,151823105,VNKE01000627.1,1,1597,1.05188e-05,149871770,0.987147
D.bunnanda,151823105,VNKE01000023.1,1,1597,1.05188e-05,149873367,0.987158
D.bunnanda,151823105,VNKE01005084.1,1,1596,1.05122e-05,149874963,0.987168
D.bunnanda,151823105,VNKE01004828.1,1,1596,1.05122e-05,149876559,0.987179
D.bunnanda,151823105,VNKE01003919.1,1,1596,1.05122e-05,149878155,0.987189
D.bunnanda,151823105,VNKE01005636.1,1,1595,1.05056e-05,149879750,0.9872
D.bunnanda,151823105,VNKE01004642.1,1,1595,1.05056e-05,149881345,0.98721
D.bunnanda,151823105,VNKE01002964.1,1,1595,1.05056e-05,149882940,0.987221
D.bunnanda,151823105,VNKE01002337.1,1,1595,1.05056e-05,149884535,0.987231
D.bunnanda,151823105,VNKE01000449.1,1,1595,1.05056e-05,149886130,0.987242
D.bunnanda,151823105,VNKE01005029.1,1,1594,1.04991e-05,149887724,0.987252
D.bunnanda,151823105,VNKE01004803.1,1,1594,1.04991e-05,149889318,0.987263
D.bunnanda,151823105,VNKE01001277.1,1,1594,1.04991e-05,149890912,0.987273
D.bunnanda,151823105,VNKE01005542.1,1,1593,1.04925e-05,149892505,0.987284
D.bunnanda,151823105,VNKE01005851.1,1,1592,1.04859e-05,149894097,0.987294
D.bunnanda,151823105,VNKE01005054.1,1,1592,1.04859e-05,149895689,0.987305
D.bunnanda,151823105,VNKE01001811.1,1,1592,1.04859e-05,149897281,0.987315
D.bunnanda,151823105,VNKE01003290.1,1,1590,1.04727e-05,149898871,0.987326
D.bunnanda,151823105,VNKE01001253.1,1,1590,1.04727e-05,149900461,0.987336
D.bunnanda,151823105,VNKE01005852.1,1,1589,1.04661e-05,149902050,0.987347
D.bunnanda,151823105,VNKE01003256.1,1,1589,1.04661e-05,149903639,0.987357
D.bunnanda,151823105,VNKE01005755.1,1,1587,1.0453e-05,149905226,0.987368
D.bunnanda,151823105,VNKE01003152.1,1,1587,1.0453e-05,149906813,0.987378
D.bunnanda,151823105,VNKE01000538.1,1,1587,1.0453e-05,149908400,0.987389
D.bunnanda,151823105,VNKE01006477.1,1,1586,1.04464e-05,149909986,0.987399
D.bunnanda,151823105,VNKE01002214.1,1,1585,1.04398e-05,149911571,0.987409
D.bunnanda,151823105,VNKE01000367.1,1,1585,1.04398e-05,149913156,0.98742
D.bunnanda,151823105,VNKE01006329.1,1,1584,1.04332e-05,149914740,0.98743
D.bunnanda,151823105,VNKE01005041.1,1,1584,1.04332e-05,149916324,0.987441
D.bunnanda,151823105,VNKE01003039.1,1,1584,1.04332e-05,149917908,0.987451
D.bunnanda,151823105,VNKE01003294.1,1,1583,1.04266e-05,149919491,0.987462
D.bunnanda,151823105,VNKE01001966.1,1,1583,1.04266e-05,149921074,0.987472
D.bunnanda,151823105,VNKE01005843.1,1,1582,1.042e-05,149922656,0.987482
D.bunnanda,151823105,VNKE01004407.1,1,1581,1.04134e-05,149924237,0.987493
D.bunnanda,151823105,VNKE01002753.1,1,1581,1.04134e-05,149925818,0.987503
D.bunnanda,151823105,VNKE01002572.1,1,1581,1.04134e-05,149927399,0.987514
D.bunnanda,151823105,VNKE01001013.1,1,1580,1.04068e-05,149928979,0.987524
D.bunnanda,151823105,VNKE01005559.1,1,1579,1.04003e-05,149930558,0.987535
D.bunnanda,151823105,VNKE01004195.1,1,1578,1.03937e-05,149932136,0.987545
D.bunnanda,151823105,VNKE01004017.1,1,1578,1.03937e-05,149933714,0.987555
D.bunnanda,151823105,VNKE01003038.1,1,1578,1.03937e-05,149935292,0.987566
D.bunnanda,151823105,VNKE01001664.1,1,1578,1.03937e-05,149936870,0.987576
D.bunnanda,151823105,VNKE01005819.1,1,1577,1.03871e-05,149938447,0.987586
D.bunnanda,151823105,VNKE01003972.1,1,1577,1.03871e-05,149940024,0.987597
D.bunnanda,151823105,VNKE01002741.1,1,1577,1.03871e-05,149941601,0.987607
D.bunnanda,151823105,VNKE01002236.1,1,1577,1.03871e-05,149943178,0.987618
D.bunnanda,151823105,VNKE01001814.1,1,1577,1.03871e-05,149944755,0.987628
D.bunnanda,151823105,VNKE01005849.1,1,1574,1.03673e-05,149946329,0.987638
D.bunnanda,151823105,VNKE01001643.1,1,1574,1.03673e-05,149947903,0.987649
D.bunnanda,151823105,VNKE01005416.1,1,1573,1.03607e-05,149949476,0.987659
D.bunnanda,151823105,VNKE01005356.1,1,1573,1.03607e-05,149951049,0.987669
D.bunnanda,151823105,VNKE01004554.1,1,1573,1.03607e-05,149952622,0.98768
D.bunnanda,151823105,VNKE01003970.1,1,1573,1.03607e-05,149954195,0.98769
D.bunnanda,151823105,VNKE01006439.1,1,1571,1.03476e-05,149955766,0.987701
D.bunnanda,151823105,VNKE01004747.1,1,1571,1.03476e-05,149957337,0.987711
D.bunnanda,151823105,VNKE01002633.1,1,1571,1.03476e-05,149958908,0.987721
D.bunnanda,151823105,VNKE01000954.1,1,1571,1.03476e-05,149960479,0.987732
D.bunnanda,151823105,VNKE01005641.1,1,1570,1.0341e-05,149962049,0.987742
D.bunnanda,151823105,VNKE01005850.1,1,1567,1.03212e-05,149963616,0.987752
D.bunnanda,151823105,VNKE01005723.1,1,1566,1.03146e-05,149965182,0.987763
D.bunnanda,151823105,VNKE01002092.1,1,1566,1.03146e-05,149966748,0.987773
D.bunnanda,151823105,VNKE01000145.1,1,1566,1.03146e-05,149968314,0.987783
D.bunnanda,151823105,VNKE01002335.1,1,1565,1.0308e-05,149969879,0.987794
D.bunnanda,151823105,VNKE01003131.1,1,1564,1.03015e-05,149971443,0.987804
D.bunnanda,151823105,VNKE01002178.1,1,1564,1.03015e-05,149973007,0.987814
D.bunnanda,151823105,VNKE01000144.1,1,1564,1.03015e-05,149974571,0.987824
D.bunnanda,151823105,VNKE01005847.1,1,1563,1.02949e-05,149976134,0.987835
D.bunnanda,151823105,VNKE01002414.1,1,1563,1.02949e-05,149977697,0.987845
D.bunnanda,151823105,VNKE01006401.1,1,1561,1.02817e-05,149979258,0.987855
D.bunnanda,151823105,VNKE01002672.1,1,1561,1.02817e-05,149980819,0.987866
D.bunnanda,151823105,VNKE01002500.1,1,1561,1.02817e-05,149982380,0.987876
D.bunnanda,151823105,VNKE01005836.1,1,1560,1.02751e-05,149983940,0.987886
D.bunnanda,151823105,VNKE01002124.1,1,1559,1.02685e-05,149985499,0.987896
D.bunnanda,151823105,VNKE01003007.1,1,1558,1.02619e-05,149987057,0.987907
D.bunnanda,151823105,VNKE01001981.1,1,1558,1.02619e-05,149988615,0.987917
D.bunnanda,151823105,VNKE01002793.1,1,1557,1.02554e-05,149990172,0.987927
D.bunnanda,151823105,VNKE01002670.1,1,1557,1.02554e-05,149991729,0.987937
D.bunnanda,151823105,VNKE01006005.1,1,1556,1.02488e-05,149993285,0.987948
D.bunnanda,151823105,VNKE01003976.1,1,1556,1.02488e-05,149994841,0.987958
D.bunnanda,151823105,VNKE01003753.1,1,1556,1.02488e-05,149996397,0.987968
D.bunnanda,151823105,VNKE01006143.1,1,1555,1.02422e-05,149997952,0.987978
D.bunnanda,151823105,VNKE01000053.1,1,1555,1.02422e-05,149999507,0.987989
D.bunnanda,151823105,VNKE01004106.1,1,1552,1.02224e-05,150001059,0.987999
D.bunnanda,151823105,VNKE01004019.1,1,1552,1.02224e-05,150002611,0.988009
D.bunnanda,151823105,VNKE01003077.1,1,1552,1.02224e-05,150004163,0.988019
D.bunnanda,151823105,VNKE01001011.1,1,1552,1.02224e-05,150005715,0.98803
D.bunnanda,151823105,VNKE01000138.1,1,1552,1.02224e-05,150007267,0.98804
D.bunnanda,151823105,VNKE01000057.1,1,1552,1.02224e-05,150008819,0.98805
D.bunnanda,151823105,VNKE01005484.1,1,1551,1.02158e-05,150010370,0.98806
D.bunnanda,151823105,VNKE01004585.1,1,1551,1.02158e-05,150011921,0.98807
D.bunnanda,151823105,VNKE01005095.1,1,1550,1.02092e-05,150013471,0.988081
D.bunnanda,151823105,VNKE01000485.1,1,1549,1.02027e-05,150015020,0.988091
D.bunnanda,151823105,VNKE01002431.1,1,1548,1.01961e-05,150016568,0.988101
D.bunnanda,151823105,VNKE01001936.1,1,1548,1.01961e-05,150018116,0.988111
D.bunnanda,151823105,VNKE01004996.1,1,1547,1.01895e-05,150019663,0.988121
D.bunnanda,151823105,VNKE01005973.1,1,1546,1.01829e-05,150021209,0.988132
D.bunnanda,151823105,VNKE01003874.1,1,1546,1.01829e-05,150022755,0.988142
D.bunnanda,151823105,VNKE01001264.1,1,1545,1.01763e-05,150024300,0.988152
D.bunnanda,151823105,VNKE01005944.1,1,1544,1.01697e-05,150025844,0.988162
D.bunnanda,151823105,VNKE01003987.1,1,1544,1.01697e-05,150027388,0.988172
D.bunnanda,151823105,VNKE01003854.1,1,1544,1.01697e-05,150028932,0.988182
D.bunnanda,151823105,VNKE01005812.1,1,1543,1.01631e-05,150030475,0.988193
D.bunnanda,151823105,VNKE01005902.1,1,1542,1.01566e-05,150032017,0.988203
D.bunnanda,151823105,VNKE01004336.1,1,1542,1.01566e-05,150033559,0.988213
D.bunnanda,151823105,VNKE01003640.1,1,1542,1.01566e-05,150035101,0.988223
D.bunnanda,151823105,VNKE01005922.1,1,1541,1.015e-05,150036642,0.988233
D.bunnanda,151823105,VNKE01003037.1,1,1540,1.01434e-05,150038182,0.988243
D.bunnanda,151823105,VNKE01003002.1,1,1540,1.01434e-05,150039722,0.988254
D.bunnanda,151823105,VNKE01002041.1,1,1539,1.01368e-05,150041261,0.988264
D.bunnanda,151823105,VNKE01005118.1,1,1538,1.01302e-05,150042799,0.988274
D.bunnanda,151823105,VNKE01005135.1,1,1537,1.01236e-05,150044336,0.988284
D.bunnanda,151823105,VNKE01002960.1,1,1537,1.01236e-05,150045873,0.988294
D.bunnanda,151823105,VNKE01000364.1,1,1537,1.01236e-05,150047410,0.988304
D.bunnanda,151823105,VNKE01006225.1,1,1536,1.0117e-05,150048946,0.988314
D.bunnanda,151823105,VNKE01005719.1,1,1536,1.0117e-05,150050482,0.988324
D.bunnanda,151823105,VNKE01005368.1,1,1536,1.0117e-05,150052018,0.988335
D.bunnanda,151823105,VNKE01000528.1,1,1536,1.0117e-05,150053554,0.988345
D.bunnanda,151823105,VNKE01004054.1,1,1535,1.01105e-05,150055089,0.988355
D.bunnanda,151823105,VNKE01002588.1,1,1535,1.01105e-05,150056624,0.988365
D.bunnanda,151823105,VNKE01002192.1,1,1534,1.01039e-05,150058158,0.988375
D.bunnanda,151823105,VNKE01006237.1,1,1532,1.00907e-05,150059690,0.988385
D.bunnanda,151823105,VNKE01003261.1,1,1532,1.00907e-05,150061222,0.988395
D.bunnanda,151823105,VNKE01006572.1,1,1530,1.00775e-05,150062752,0.988405
D.bunnanda,151823105,VNKE01000858.1,1,1530,1.00775e-05,150064282,0.988415
D.bunnanda,151823105,VNKE01005564.1,1,1529,1.00709e-05,150065811,0.988425
D.bunnanda,151823105,VNKE01005238.1,1,1529,1.00709e-05,150067340,0.988435
D.bunnanda,151823105,VNKE01003798.1,1,1529,1.00709e-05,150068869,0.988446
D.bunnanda,151823105,VNKE01003420.1,1,1529,1.00709e-05,150070398,0.988456
D.bunnanda,151823105,VNKE01001867.1,1,1529,1.00709e-05,150071927,0.988466
D.bunnanda,151823105,VNKE01004648.1,1,1528,1.00643e-05,150073455,0.988476
D.bunnanda,151823105,VNKE01006189.1,1,1527,1.00578e-05,150074982,0.988486
D.bunnanda,151823105,VNKE01000559.1,1,1527,1.00578e-05,150076509,0.988496
D.bunnanda,151823105,VNKE01006278.1,1,1526,1.00512e-05,150078035,0.988506
D.bunnanda,151823105,VNKE01003164.1,1,1526,1.00512e-05,150079561,0.988516
D.bunnanda,151823105,VNKE01002421.1,1,1526,1.00512e-05,150081087,0.988526
D.bunnanda,151823105,VNKE01001946.1,1,1526,1.00512e-05,150082613,0.988536
D.bunnanda,151823105,VNKE01001723.1,1,1526,1.00512e-05,150084139,0.988546
D.bunnanda,151823105,VNKE01000259.1,1,1525,1.00446e-05,150085664,0.988556
D.bunnanda,151823105,VNKE01002108.1,1,1524,1.0038e-05,150087188,0.988566
D.bunnanda,151823105,VNKE01006482.1,1,1523,1.00314e-05,150088711,0.988576
D.bunnanda,151823105,VNKE01005826.1,1,1523,1.00314e-05,150090234,0.988586
D.bunnanda,151823105,VNKE01004470.1,1,1523,1.00314e-05,150091757,0.988596
D.bunnanda,151823105,VNKE01003940.1,1,1523,1.00314e-05,150093280,0.988606
D.bunnanda,151823105,VNKE01002799.1,1,1523,1.00314e-05,150094803,0.988616
D.bunnanda,151823105,VNKE01002798.1,1,1523,1.00314e-05,150096326,0.988626
D.bunnanda,151823105,VNKE01003779.1,1,1522,1.00248e-05,150097848,0.988636
D.bunnanda,151823105,VNKE01002911.1,1,1522,1.00248e-05,150099370,0.988646
D.bunnanda,151823105,VNKE01002587.1,1,1521,1.00182e-05,150100891,0.988656
D.bunnanda,151823105,VNKE01002423.1,1,1521,1.00182e-05,150102412,0.988666
D.bunnanda,151823105,VNKE01002172.1,1,1521,1.00182e-05,150103933,0.988676
D.bunnanda,151823105,VNKE01001629.1,1,1521,1.00182e-05,150105454,0.988686
D.bunnanda,151823105,VNKE01005773.1,1,1520,1.00117e-05,150106974,0.988697
D.bunnanda,151823105,VNKE01003948.1,1,1519,1.00051e-05,150108493,0.988707
D.bunnanda,151823105,VNKE01002740.1,1,1518,9.99848e-06,150110011,0.988717
D.bunnanda,151823105,VNKE01000873.1,1,1518,9.99848e-06,150111529,0.988727
D.bunnanda,151823105,VNKE01003797.1,1,1517,9.99189e-06,150113046,0.988737
D.bunnanda,151823105,VNKE01006615.1,1,1516,9.9853e-06,150114562,0.988746
D.bunnanda,151823105,VNKE01000721.1,1,1516,9.9853e-06,150116078,0.988756
D.bunnanda,151823105,VNKE01003337.1,1,1515,9.97872e-06,150117593,0.988766
D.bunnanda,151823105,VNKE01000609.1,1,1515,9.97872e-06,150119108,0.988776
D.bunnanda,151823105,VNKE01003639.1,1,1514,9.97213e-06,150120622,0.988786
D.bunnanda,151823105,VNKE01003433.1,1,1513,9.96555e-06,150122135,0.988796
D.bunnanda,151823105,VNKE01002590.1,1,1513,9.96555e-06,150123648,0.988806
D.bunnanda,151823105,VNKE01002589.1,1,1513,9.96555e-06,150125161,0.988816
D.bunnanda,151823105,VNKE01001646.1,1,1513,9.96555e-06,150126674,0.988826
D.bunnanda,151823105,VNKE01000251.1,1,1513,9.96555e-06,150128187,0.988836
D.bunnanda,151823105,VNKE01005160.1,1,1511,9.95237e-06,150129698,0.988846
D.bunnanda,151823105,VNKE01004038.1,1,1511,9.95237e-06,150131209,0.988856
D.bunnanda,151823105,VNKE01001878.1,1,1511,9.95237e-06,150132720,0.988866
D.bunnanda,151823105,VNKE01000617.1,1,1511,9.95237e-06,150134231,0.988876
D.bunnanda,151823105,VNKE01000773.1,1,1510,9.94579e-06,150135741,0.988886
D.bunnanda,151823105,VNKE01006367.1,1,1509,9.9392e-06,150137250,0.988896
D.bunnanda,151823105,VNKE01004974.1,1,1509,9.9392e-06,150138759,0.988906
D.bunnanda,151823105,VNKE01003645.1,1,1509,9.9392e-06,150140268,0.988916
D.bunnanda,151823105,VNKE01006036.1,1,1508,9.93261e-06,150141776,0.988926
D.bunnanda,151823105,VNKE01002591.1,1,1508,9.93261e-06,150143284,0.988936
D.bunnanda,151823105,VNKE01002594.1,1,1507,9.92603e-06,150144791,0.988946
D.bunnanda,151823105,VNKE01004398.1,1,1506,9.91944e-06,150146297,0.988956
D.bunnanda,151823105,VNKE01001502.1,1,1506,9.91944e-06,150147803,0.988965
D.bunnanda,151823105,VNKE01000590.1,1,1506,9.91944e-06,150149309,0.988975
D.bunnanda,151823105,VNKE01001702.1,1,1505,9.91285e-06,150150814,0.988985
D.bunnanda,151823105,VNKE01002358.1,1,1504,9.90627e-06,150152318,0.988995
D.bunnanda,151823105,VNKE01002258.1,1,1504,9.90627e-06,150153822,0.989005
D.bunnanda,151823105,VNKE01002252.1,1,1502,9.89309e-06,150155324,0.989015
D.bunnanda,151823105,VNKE01001287.1,1,1502,9.89309e-06,150156826,0.989025
D.bunnanda,151823105,VNKE01000801.1,1,1502,9.89309e-06,150158328,0.989035
D.bunnanda,151823105,VNKE01005814.1,1,1501,9.88651e-06,150159829,0.989045
D.bunnanda,151823105,VNKE01000341.1,1,1501,9.88651e-06,150161330,0.989055
D.bunnanda,151823105,VNKE01005654.1,1,1500,9.87992e-06,150162830,0.989064
D.bunnanda,151823105,VNKE01004837.1,1,1500,9.87992e-06,150164330,0.989074
D.bunnanda,151823105,VNKE01003800.1,1,1500,9.87992e-06,150165830,0.989084
D.bunnanda,151823105,VNKE01002894.1,1,1500,9.87992e-06,150167330,0.989094
D.bunnanda,151823105,VNKE01001739.1,1,1500,9.87992e-06,150168830,0.989104
D.bunnanda,151823105,VNKE01000711.1,1,1500,9.87992e-06,150170330,0.989114
D.bunnanda,151823105,VNKE01000665.1,1,1500,9.87992e-06,150171830,0.989124
D.bunnanda,151823105,VNKE01005281.1,1,1499,9.87333e-06,150173329,0.989134
D.bunnanda,151823105,VNKE01005184.1,1,1499,9.87333e-06,150174828,0.989143
D.bunnanda,151823105,VNKE01002596.1,1,1499,9.87333e-06,150176327,0.989153
D.bunnanda,151823105,VNKE01002592.1,1,1499,9.87333e-06,150177826,0.989163
D.bunnanda,151823105,VNKE01001367.1,1,1498,9.86675e-06,150179324,0.989173
D.bunnanda,151823105,VNKE01005738.1,1,1497,9.86016e-06,150180821,0.989183
D.bunnanda,151823105,VNKE01004869.1,1,1497,9.86016e-06,150182318,0.989193
D.bunnanda,151823105,VNKE01003735.1,1,1496,9.85357e-06,150183814,0.989203
D.bunnanda,151823105,VNKE01004626.1,1,1495,9.84699e-06,150185309,0.989212
D.bunnanda,151823105,VNKE01000843.1,1,1495,9.84699e-06,150186804,0.989222
D.bunnanda,151823105,VNKE01004272.1,1,1494,9.8404e-06,150188298,0.989232
D.bunnanda,151823105,VNKE01002876.1,1,1494,9.8404e-06,150189792,0.989242
D.bunnanda,151823105,VNKE01002595.1,1,1494,9.8404e-06,150191286,0.989252
D.bunnanda,151823105,VNKE01001644.1,1,1494,9.8404e-06,150192780,0.989262
D.bunnanda,151823105,VNKE01005511.1,1,1493,9.83381e-06,150194273,0.989272
D.bunnanda,151823105,VNKE01002947.1,1,1493,9.83381e-06,150195766,0.989281
D.bunnanda,151823105,VNKE01002384.1,1,1493,9.83381e-06,150197259,0.989291
D.bunnanda,151823105,VNKE01001971.1,1,1493,9.83381e-06,150198752,0.989301
D.bunnanda,151823105,VNKE01001437.1,1,1493,9.83381e-06,150200245,0.989311
D.bunnanda,151823105,VNKE01002305.1,1,1492,9.82723e-06,150201737,0.989321
D.bunnanda,151823105,VNKE01005964.1,1,1490,9.81405e-06,150203227,0.98933
D.bunnanda,151823105,VNKE01005647.1,1,1490,9.81405e-06,150204717,0.98934
D.bunnanda,151823105,VNKE01001719.1,1,1489,9.80747e-06,150206206,0.98935
D.bunnanda,151823105,VNKE01001440.1,1,1489,9.80747e-06,150207695,0.98936
D.bunnanda,151823105,VNKE01000236.1,1,1489,9.80747e-06,150209184,0.98937
D.bunnanda,151823105,VNKE01001564.1,1,1488,9.80088e-06,150210672,0.98938
D.bunnanda,151823105,VNKE01006353.1,1,1487,9.79429e-06,150212159,0.989389
D.bunnanda,151823105,VNKE01005169.1,1,1486,9.78771e-06,150213645,0.989399
D.bunnanda,151823105,VNKE01006324.1,1,1484,9.77453e-06,150215129,0.989409
D.bunnanda,151823105,VNKE01005993.1,1,1484,9.77453e-06,150216613,0.989419
D.bunnanda,151823105,VNKE01004686.1,1,1484,9.77453e-06,150218097,0.989428
D.bunnanda,151823105,VNKE01001079.1,1,1484,9.77453e-06,150219581,0.989438
D.bunnanda,151823105,VNKE01000631.1,1,1484,9.77453e-06,150221065,0.989448
D.bunnanda,151823105,VNKE01006098.1,1,1483,9.76795e-06,150222548,0.989458
D.bunnanda,151823105,VNKE01002304.1,1,1483,9.76795e-06,150224031,0.989468
D.bunnanda,151823105,VNKE01000854.1,1,1483,9.76795e-06,150225514,0.989477
D.bunnanda,151823105,VNKE01005399.1,1,1480,9.74819e-06,150226994,0.989487
D.bunnanda,151823105,VNKE01000864.1,1,1480,9.74819e-06,150228474,0.989497
D.bunnanda,151823105,VNKE01000056.1,1,1479,9.7416e-06,150229953,0.989507
D.bunnanda,151823105,VNKE01006232.1,1,1478,9.73501e-06,150231431,0.989516
D.bunnanda,151823105,VNKE01006052.1,1,1478,9.73501e-06,150232909,0.989526
D.bunnanda,151823105,VNKE01005170.1,1,1478,9.73501e-06,150234387,0.989536
D.bunnanda,151823105,VNKE01001256.1,1,1478,9.73501e-06,150235865,0.989545
D.bunnanda,151823105,VNKE01000577.1,1,1478,9.73501e-06,150237343,0.989555
D.bunnanda,151823105,VNKE01006228.1,1,1477,9.72843e-06,150238820,0.989565
D.bunnanda,151823105,VNKE01005482.1,1,1476,9.72184e-06,150240296,0.989575
D.bunnanda,151823105,VNKE01004914.1,1,1476,9.72184e-06,150241772,0.989584
D.bunnanda,151823105,VNKE01004269.1,1,1476,9.72184e-06,150243248,0.989594
D.bunnanda,151823105,VNKE01002877.1,1,1476,9.72184e-06,150244724,0.989604
D.bunnanda,151823105,VNKE01002870.1,1,1475,9.71525e-06,150246199,0.989614
D.bunnanda,151823105,VNKE01002006.1,1,1475,9.71525e-06,150247674,0.989623
D.bunnanda,151823105,VNKE01001976.1,1,1475,9.71525e-06,150249149,0.989633
D.bunnanda,151823105,VNKE01006476.1,1,1474,9.70867e-06,150250623,0.989643
D.bunnanda,151823105,VNKE01005172.1,1,1474,9.70867e-06,150252097,0.989652
D.bunnanda,151823105,VNKE01002720.1,1,1474,9.70867e-06,150253571,0.989662
D.bunnanda,151823105,VNKE01005165.1,1,1473,9.70208e-06,150255044,0.989672
D.bunnanda,151823105,VNKE01003000.1,1,1473,9.70208e-06,150256517,0.989681
D.bunnanda,151823105,VNKE01002211.1,1,1473,9.70208e-06,150257990,0.989691
D.bunnanda,151823105,VNKE01001018.1,1,1473,9.70208e-06,150259463,0.989701
D.bunnanda,151823105,VNKE01003565.1,1,1472,9.69549e-06,150260935,0.989711
D.bunnanda,151823105,VNKE01002530.1,1,1472,9.69549e-06,150262407,0.98972
D.bunnanda,151823105,VNKE01005089.1,1,1471,9.68891e-06,150263878,0.98973
D.bunnanda,151823105,VNKE01004319.1,1,1471,9.68891e-06,150265349,0.98974
D.bunnanda,151823105,VNKE01002906.1,1,1470,9.68232e-06,150266819,0.989749
D.bunnanda,151823105,VNKE01001868.1,1,1470,9.68232e-06,150268289,0.989759
D.bunnanda,151823105,VNKE01005357.1,1,1469,9.67573e-06,150269758,0.989769
D.bunnanda,151823105,VNKE01001907.1,1,1469,9.67573e-06,150271227,0.989778
D.bunnanda,151823105,VNKE01000618.1,1,1469,9.67573e-06,150272696,0.989788
D.bunnanda,151823105,VNKE01006493.1,1,1468,9.66915e-06,150274164,0.989798
D.bunnanda,151823105,VNKE01005139.1,1,1468,9.66915e-06,150275632,0.989807
D.bunnanda,151823105,VNKE01004146.1,1,1468,9.66915e-06,150277100,0.989817
D.bunnanda,151823105,VNKE01004027.1,1,1468,9.66915e-06,150278568,0.989827
D.bunnanda,151823105,VNKE01004007.1,1,1468,9.66915e-06,150280036,0.989836
D.bunnanda,151823105,VNKE01002009.1,1,1468,9.66915e-06,150281504,0.989846
D.bunnanda,151823105,VNKE01001138.1,1,1468,9.66915e-06,150282972,0.989856
D.bunnanda,151823105,VNKE01005027.1,1,1467,9.66256e-06,150284439,0.989865
D.bunnanda,151823105,VNKE01003165.1,1,1467,9.66256e-06,150285906,0.989875
D.bunnanda,151823105,VNKE01001170.1,1,1467,9.66256e-06,150287373,0.989885
D.bunnanda,151823105,VNKE01000565.1,1,1467,9.66256e-06,150288840,0.989894
D.bunnanda,151823105,VNKE01005166.1,1,1466,9.65597e-06,150290306,0.989904
D.bunnanda,151823105,VNKE01003535.1,1,1466,9.65597e-06,150291772,0.989914
D.bunnanda,151823105,VNKE01000574.1,1,1466,9.65597e-06,150293238,0.989923
D.bunnanda,151823105,VNKE01005147.1,1,1465,9.64939e-06,150294703,0.989933
D.bunnanda,151823105,VNKE01000612.1,1,1465,9.64939e-06,150296168,0.989943
D.bunnanda,151823105,VNKE01006611.1,1,1464,9.6428e-06,150297632,0.989952
D.bunnanda,151823105,VNKE01002618.1,1,1464,9.6428e-06,150299096,0.989962
D.bunnanda,151823105,VNKE01002288.1,1,1464,9.6428e-06,150300560,0.989972
D.bunnanda,151823105,VNKE01001159.1,1,1464,9.6428e-06,150302024,0.989981
D.bunnanda,151823105,VNKE01005635.1,1,1463,9.63621e-06,150303487,0.989991
D.bunnanda,151823105,VNKE01006521.1,1,1462,9.62963e-06,150304949,0.99
D.bunnanda,151823105,VNKE01005485.1,1,1462,9.62963e-06,150306411,0.99001
D.bunnanda,151823105,VNKE01005101.1,1,1462,9.62963e-06,150307873,0.99002
D.bunnanda,151823105,VNKE01004144.1,1,1461,9.62304e-06,150309334,0.990029
D.bunnanda,151823105,VNKE01003197.1,1,1461,9.62304e-06,150310795,0.990039
D.bunnanda,151823105,VNKE01001853.1,1,1461,9.62304e-06,150312256,0.990049
D.bunnanda,151823105,VNKE01005171.1,1,1460,9.61645e-06,150313716,0.990058
D.bunnanda,151823105,VNKE01003465.1,1,1460,9.61645e-06,150315176,0.990068
D.bunnanda,151823105,VNKE01003291.1,1,1459,9.60987e-06,150316635,0.990077
D.bunnanda,151823105,VNKE01003850.1,1,1458,9.60328e-06,150318093,0.990087
D.bunnanda,151823105,VNKE01002533.1,1,1458,9.60328e-06,150319551,0.990097
D.bunnanda,151823105,VNKE01002039.1,1,1458,9.60328e-06,150321009,0.990106
D.bunnanda,151823105,VNKE01001443.1,1,1458,9.60328e-06,150322467,0.990116
D.bunnanda,151823105,VNKE01000757.1,1,1458,9.60328e-06,150323925,0.990125
D.bunnanda,151823105,VNKE01006009.1,1,1457,9.59669e-06,150325382,0.990135
D.bunnanda,151823105,VNKE01005477.1,1,1457,9.59669e-06,150326839,0.990145
D.bunnanda,151823105,VNKE01003879.1,1,1456,9.59011e-06,150328295,0.990154
D.bunnanda,151823105,VNKE01005028.1,1,1454,9.57693e-06,150329749,0.990164
D.bunnanda,151823105,VNKE01005021.1,1,1454,9.57693e-06,150331203,0.990173
D.bunnanda,151823105,VNKE01002907.1,1,1454,9.57693e-06,150332657,0.990183
D.bunnanda,151823105,VNKE01002417.1,1,1454,9.57693e-06,150334111,0.990193
D.bunnanda,151823105,VNKE01000898.1,1,1454,9.57693e-06,150335565,0.990202
D.bunnanda,151823105,VNKE01005456.1,1,1452,9.56376e-06,150337017,0.990212
D.bunnanda,151823105,VNKE01004513.1,1,1452,9.56376e-06,150338469,0.990221
D.bunnanda,151823105,VNKE01002422.1,1,1452,9.56376e-06,150339921,0.990231
D.bunnanda,151823105,VNKE01002044.1,1,1452,9.56376e-06,150341373,0.99024
D.bunnanda,151823105,VNKE01002403.1,1,1450,9.55059e-06,150342823,0.99025
D.bunnanda,151823105,VNKE01001075.1,1,1450,9.55059e-06,150344273,0.99026
D.bunnanda,151823105,VNKE01000348.1,1,1449,9.544e-06,150345722,0.990269
D.bunnanda,151823105,VNKE01003192.1,1,1448,9.53742e-06,150347170,0.990279
D.bunnanda,151823105,VNKE01001073.1,1,1448,9.53742e-06,150348618,0.990288
D.bunnanda,151823105,VNKE01003411.1,1,1447,9.53083e-06,150350065,0.990298
D.bunnanda,151823105,VNKE01002560.1,1,1446,9.52424e-06,150351511,0.990307
D.bunnanda,151823105,VNKE01005496.1,1,1445,9.51766e-06,150352956,0.990317
D.bunnanda,151823105,VNKE01000950.1,1,1445,9.51766e-06,150354401,0.990326
D.bunnanda,151823105,VNKE01006481.1,1,1444,9.51107e-06,150355845,0.990336
D.bunnanda,151823105,VNKE01006466.1,1,1444,9.51107e-06,150357289,0.990345
D.bunnanda,151823105,VNKE01002719.1,1,1444,9.51107e-06,150358733,0.990355
D.bunnanda,151823105,VNKE01005168.1,1,1443,9.50448e-06,150360176,0.990364
D.bunnanda,151823105,VNKE01005123.1,1,1443,9.50448e-06,150361619,0.990374
D.bunnanda,151823105,VNKE01001454.1,1,1443,9.50448e-06,150363062,0.990383
D.bunnanda,151823105,VNKE01000660.1,1,1443,9.50448e-06,150364505,0.990393
D.bunnanda,151823105,VNKE01005754.1,1,1442,9.4979e-06,150365947,0.990402
D.bunnanda,151823105,VNKE01002553.1,1,1442,9.4979e-06,150367389,0.990412
D.bunnanda,151823105,VNKE01001309.1,1,1442,9.4979e-06,150368831,0.990421
D.bunnanda,151823105,VNKE01000558.1,1,1442,9.4979e-06,150370273,0.990431
D.bunnanda,151823105,VNKE01000327.1,1,1442,9.4979e-06,150371715,0.99044
D.bunnanda,151823105,VNKE01005727.1,1,1441,9.49131e-06,150373156,0.99045
D.bunnanda,151823105,VNKE01005163.1,1,1441,9.49131e-06,150374597,0.990459
D.bunnanda,151823105,VNKE01004822.1,1,1441,9.49131e-06,150376038,0.990469
D.bunnanda,151823105,VNKE01002792.1,1,1440,9.48472e-06,150377478,0.990478
D.bunnanda,151823105,VNKE01001984.1,1,1440,9.48472e-06,150378918,0.990488
D.bunnanda,151823105,VNKE01000498.1,1,1440,9.48472e-06,150380358,0.990497
D.bunnanda,151823105,VNKE01000282.1,1,1440,9.48472e-06,150381798,0.990507
D.bunnanda,151823105,VNKE01004333.1,1,1439,9.47814e-06,150383237,0.990516
D.bunnanda,151823105,VNKE01003982.1,1,1439,9.47814e-06,150384676,0.990526
D.bunnanda,151823105,VNKE01001294.1,1,1439,9.47814e-06,150386115,0.990535
D.bunnanda,151823105,VNKE01003907.1,1,1438,9.47155e-06,150387553,0.990545
D.bunnanda,151823105,VNKE01005164.1,1,1435,9.45179e-06,150388988,0.990554
D.bunnanda,151823105,VNKE01002755.1,1,1435,9.45179e-06,150390423,0.990563
D.bunnanda,151823105,VNKE01000785.1,1,1435,9.45179e-06,150391858,0.990573
D.bunnanda,151823105,VNKE01005157.1,1,1434,9.4452e-06,150393292,0.990582
D.bunnanda,151823105,VNKE01002878.1,1,1434,9.4452e-06,150394726,0.990592
D.bunnanda,151823105,VNKE01002176.1,1,1433,9.43862e-06,150396159,0.990601
D.bunnanda,151823105,VNKE01000636.1,1,1433,9.43862e-06,150397592,0.990611
D.bunnanda,151823105,VNKE01000412.1,1,1433,9.43862e-06,150399025,0.99062
D.bunnanda,151823105,VNKE01004801.1,1,1432,9.43203e-06,150400457,0.99063
D.bunnanda,151823105,VNKE01004251.1,1,1432,9.43203e-06,150401889,0.990639
D.bunnanda,151823105,VNKE01003518.1,1,1432,9.43203e-06,150403321,0.990648
D.bunnanda,151823105,VNKE01002914.1,1,1432,9.43203e-06,150404753,0.990658
D.bunnanda,151823105,VNKE01001614.1,1,1432,9.43203e-06,150406185,0.990667
D.bunnanda,151823105,VNKE01000173.1,1,1432,9.43203e-06,150407617,0.990677
D.bunnanda,151823105,VNKE01003160.1,1,1431,9.42544e-06,150409048,0.990686
D.bunnanda,151823105,VNKE01001219.1,1,1431,9.42544e-06,150410479,0.990696
D.bunnanda,151823105,VNKE01000088.1,1,1431,9.42544e-06,150411910,0.990705
D.bunnanda,151823105,VNKE01004628.1,1,1430,9.41886e-06,150413340,0.990714
D.bunnanda,151823105,VNKE01006590.1,1,1429,9.41227e-06,150414769,0.990724
D.bunnanda,151823105,VNKE01006539.1,1,1429,9.41227e-06,150416198,0.990733
D.bunnanda,151823105,VNKE01006204.1,1,1429,9.41227e-06,150417627,0.990743
D.bunnanda,151823105,VNKE01002469.1,1,1429,9.41227e-06,150419056,0.990752
D.bunnanda,151823105,VNKE01001869.1,1,1429,9.41227e-06,150420485,0.990761
D.bunnanda,151823105,VNKE01002879.1,1,1428,9.40568e-06,150421913,0.990771
D.bunnanda,151823105,VNKE01001979.1,1,1428,9.40568e-06,150423341,0.99078
D.bunnanda,151823105,VNKE01001978.1,1,1428,9.40568e-06,150424769,0.99079
D.bunnanda,151823105,VNKE01001545.1,1,1427,9.3991e-06,150426196,0.990799
D.bunnanda,151823105,VNKE01001486.1,1,1427,9.3991e-06,150427623,0.990809
D.bunnanda,151823105,VNKE01006443.1,1,1426,9.39251e-06,150429049,0.990818
D.bunnanda,151823105,VNKE01006178.1,1,1426,9.39251e-06,150430475,0.990827
D.bunnanda,151823105,VNKE01000491.1,1,1426,9.39251e-06,150431901,0.990837
D.bunnanda,151823105,VNKE01003386.1,1,1425,9.38592e-06,150433326,0.990846
D.bunnanda,151823105,VNKE01003193.1,1,1425,9.38592e-06,150434751,0.990855
D.bunnanda,151823105,VNKE01001275.1,1,1425,9.38592e-06,150436176,0.990865
D.bunnanda,151823105,VNKE01000896.1,1,1425,9.38592e-06,150437601,0.990874
D.bunnanda,151823105,VNKE01003702.1,1,1424,9.37934e-06,150439025,0.990884
D.bunnanda,151823105,VNKE01002738.1,1,1424,9.37934e-06,150440449,0.990893
D.bunnanda,151823105,VNKE01001221.1,1,1424,9.37934e-06,150441873,0.990902
D.bunnanda,151823105,VNKE01006331.1,1,1423,9.37275e-06,150443296,0.990912
D.bunnanda,151823105,VNKE01005075.1,1,1423,9.37275e-06,150444719,0.990921
D.bunnanda,151823105,VNKE01006438.1,1,1422,9.36616e-06,150446141,0.99093
D.bunnanda,151823105,VNKE01005878.1,1,1421,9.35958e-06,150447562,0.99094
D.bunnanda,151823105,VNKE01004817.1,1,1421,9.35958e-06,150448983,0.990949
D.bunnanda,151823105,VNKE01000403.1,1,1421,9.35958e-06,150450404,0.990959
D.bunnanda,151823105,VNKE01000176.1,1,1421,9.35958e-06,150451825,0.990968
D.bunnanda,151823105,VNKE01001977.1,1,1420,9.35299e-06,150453245,0.990977
D.bunnanda,151823105,VNKE01004923.1,1,1419,9.3464e-06,150454664,0.990987
D.bunnanda,151823105,VNKE01003580.1,1,1419,9.3464e-06,150456083,0.990996
D.bunnanda,151823105,VNKE01003172.1,1,1419,9.3464e-06,150457502,0.991005
D.bunnanda,151823105,VNKE01002669.1,1,1419,9.3464e-06,150458921,0.991015
D.bunnanda,151823105,VNKE01005347.1,1,1418,9.33982e-06,150460339,0.991024
D.bunnanda,151823105,VNKE01002996.1,1,1418,9.33982e-06,150461757,0.991033
D.bunnanda,151823105,VNKE01005049.1,1,1417,9.33323e-06,150463174,0.991043
D.bunnanda,151823105,VNKE01004515.1,1,1417,9.33323e-06,150464591,0.991052
D.bunnanda,151823105,VNKE01003974.1,1,1417,9.33323e-06,150466008,0.991061
D.bunnanda,151823105,VNKE01005907.1,1,1416,9.32664e-06,150467424,0.991071
D.bunnanda,151823105,VNKE01003107.1,1,1416,9.32664e-06,150468840,0.99108
D.bunnanda,151823105,VNKE01000593.1,1,1414,9.31347e-06,150470254,0.991089
D.bunnanda,151823105,VNKE01001803.1,1,1412,9.3003e-06,150471666,0.991099
D.bunnanda,151823105,VNKE01005556.1,1,1411,9.29371e-06,150473077,0.991108
D.bunnanda,151823105,VNKE01003191.1,1,1411,9.29371e-06,150474488,0.991117
D.bunnanda,151823105,VNKE01003183.1,1,1410,9.28712e-06,150475898,0.991126
D.bunnanda,151823105,VNKE01005668.1,1,1409,9.28054e-06,150477307,0.991136
D.bunnanda,151823105,VNKE01004755.1,1,1409,9.28054e-06,150478716,0.991145
D.bunnanda,151823105,VNKE01005648.1,1,1408,9.27395e-06,150480124,0.991154
D.bunnanda,151823105,VNKE01004442.1,1,1408,9.27395e-06,150481532,0.991164
D.bunnanda,151823105,VNKE01001975.1,1,1408,9.27395e-06,150482940,0.991173
D.bunnanda,151823105,VNKE01001818.1,1,1408,9.27395e-06,150484348,0.991182
D.bunnanda,151823105,VNKE01003027.1,1,1407,9.26736e-06,150485755,0.991191
D.bunnanda,151823105,VNKE01005493.1,1,1406,9.26078e-06,150487161,0.991201
D.bunnanda,151823105,VNKE01001974.1,1,1406,9.26078e-06,150488567,0.99121
D.bunnanda,151823105,VNKE01001902.1,1,1406,9.26078e-06,150489973,0.991219
D.bunnanda,151823105,VNKE01000339.1,1,1406,9.26078e-06,150491379,0.991228
D.bunnanda,151823105,VNKE01003992.1,1,1404,9.2476e-06,150492783,0.991238
D.bunnanda,151823105,VNKE01002416.1,1,1404,9.2476e-06,150494187,0.991247
D.bunnanda,151823105,VNKE01001973.1,1,1404,9.2476e-06,150495591,0.991256
D.bunnanda,151823105,VNKE01000605.1,1,1404,9.2476e-06,150496995,0.991265
D.bunnanda,151823105,VNKE01006507.1,1,1403,9.24102e-06,150498398,0.991275
D.bunnanda,151823105,VNKE01006467.1,1,1403,9.24102e-06,150499801,0.991284
D.bunnanda,151823105,VNKE01006366.1,1,1403,9.24102e-06,150501204,0.991293
D.bunnanda,151823105,VNKE01006055.1,1,1403,9.24102e-06,150502607,0.991302
D.bunnanda,151823105,VNKE01005413.1,1,1403,9.24102e-06,150504010,0.991312
D.bunnanda,151823105,VNKE01003248.1,1,1403,9.24102e-06,150505413,0.991321
D.bunnanda,151823105,VNKE01002116.1,1,1403,9.24102e-06,150506816,0.99133
D.bunnanda,151823105,VNKE01000201.1,1,1403,9.24102e-06,150508219,0.991339
D.bunnanda,151823105,VNKE01006102.1,1,1402,9.23443e-06,150509621,0.991349
D.bunnanda,151823105,VNKE01005982.1,1,1402,9.23443e-06,150511023,0.991358
D.bunnanda,151823105,VNKE01002260.1,1,1402,9.23443e-06,150512425,0.991367
D.bunnanda,151823105,VNKE01001931.1,1,1402,9.23443e-06,150513827,0.991376
D.bunnanda,151823105,VNKE01004899.1,1,1401,9.22784e-06,150515228,0.991386
D.bunnanda,151823105,VNKE01004156.1,1,1401,9.22784e-06,150516629,0.991395
D.bunnanda,151823105,VNKE01003288.1,1,1401,9.22784e-06,150518030,0.991404
D.bunnanda,151823105,VNKE01001201.1,1,1401,9.22784e-06,150519431,0.991413
D.bunnanda,151823105,VNKE01001259.1,1,1400,9.22126e-06,150520831,0.991422
D.bunnanda,151823105,VNKE01005452.1,1,1399,9.21467e-06,150522230,0.991432
D.bunnanda,151823105,VNKE01001972.1,1,1399,9.21467e-06,150523629,0.991441
D.bunnanda,151823105,VNKE01000264.1,1,1399,9.21467e-06,150525028,0.99145
D.bunnanda,151823105,VNKE01004179.1,1,1398,9.20808e-06,150526426,0.991459
D.bunnanda,151823105,VNKE01001029.1,1,1398,9.20808e-06,150527824,0.991468
D.bunnanda,151823105,VNKE01000038.1,1,1398,9.20808e-06,150529222,0.991478
D.bunnanda,151823105,VNKE01005560.1,1,1396,9.19491e-06,150530618,0.991487
D.bunnanda,151823105,VNKE01000655.1,1,1396,9.19491e-06,150532014,0.991496
D.bunnanda,151823105,VNKE01005206.1,1,1395,9.18832e-06,150533409,0.991505
D.bunnanda,151823105,VNKE01002065.1,1,1395,9.18832e-06,150534804,0.991514
D.bunnanda,151823105,VNKE01000277.1,1,1395,9.18832e-06,150536199,0.991524
D.bunnanda,151823105,VNKE01004387.1,1,1394,9.18174e-06,150537593,0.991533
D.bunnanda,151823105,VNKE01003869.1,1,1393,9.17515e-06,150538986,0.991542
D.bunnanda,151823105,VNKE01006363.1,1,1392,9.16856e-06,150540378,0.991551
D.bunnanda,151823105,VNKE01005562.1,1,1392,9.16856e-06,150541770,0.99156
D.bunnanda,151823105,VNKE01006428.1,1,1391,9.16198e-06,150543161,0.99157
D.bunnanda,151823105,VNKE01006235.1,1,1391,9.16198e-06,150544552,0.991579
D.bunnanda,151823105,VNKE01002374.1,1,1391,9.16198e-06,150545943,0.991588
D.bunnanda,151823105,VNKE01002771.1,1,1390,9.15539e-06,150547333,0.991597
D.bunnanda,151823105,VNKE01005801.1,1,1389,9.14881e-06,150548722,0.991606
D.bunnanda,151823105,VNKE01002566.1,1,1389,9.14881e-06,150550111,0.991615
D.bunnanda,151823105,VNKE01000319.1,1,1389,9.14881e-06,150551500,0.991624
D.bunnanda,151823105,VNKE01005675.1,1,1388,9.14222e-06,150552888,0.991634
D.bunnanda,151823105,VNKE01005272.1,1,1388,9.14222e-06,150554276,0.991643
D.bunnanda,151823105,VNKE01001730.1,1,1387,9.13563e-06,150555663,0.991652
D.bunnanda,151823105,VNKE01000374.1,1,1387,9.13563e-06,150557050,0.991661
D.bunnanda,151823105,VNKE01005817.1,1,1386,9.12905e-06,150558436,0.99167
D.bunnanda,151823105,VNKE01003757.1,1,1386,9.12905e-06,150559822,0.991679
D.bunnanda,151823105,VNKE01000043.1,1,1386,9.12905e-06,150561208,0.991688
D.bunnanda,151823105,VNKE01002142.1,1,1385,9.12246e-06,150562593,0.991697
D.bunnanda,151823105,VNKE01001435.1,1,1385,9.12246e-06,150563978,0.991707
D.bunnanda,151823105,VNKE01006501.1,1,1384,9.11587e-06,150565362,0.991716
D.bunnanda,151823105,VNKE01006427.1,1,1384,9.11587e-06,150566746,0.991725
D.bunnanda,151823105,VNKE01002765.1,1,1383,9.10929e-06,150568129,0.991734
D.bunnanda,151823105,VNKE01002262.1,1,1383,9.10929e-06,150569512,0.991743
D.bunnanda,151823105,VNKE01000584.1,1,1383,9.10929e-06,150570895,0.991752
D.bunnanda,151823105,VNKE01005804.1,1,1382,9.1027e-06,150572277,0.991761
D.bunnanda,151823105,VNKE01004519.1,1,1382,9.1027e-06,150573659,0.99177
D.bunnanda,151823105,VNKE01000318.1,1,1382,9.1027e-06,150575041,0.991779
D.bunnanda,151823105,VNKE01004766.1,1,1381,9.09611e-06,150576422,0.991789
D.bunnanda,151823105,VNKE01000317.1,1,1381,9.09611e-06,150577803,0.991798
D.bunnanda,151823105,VNKE01006356.1,1,1380,9.08953e-06,150579183,0.991807
D.bunnanda,151823105,VNKE01005277.1,1,1380,9.08953e-06,150580563,0.991816
D.bunnanda,151823105,VNKE01002400.1,1,1380,9.08953e-06,150581943,0.991825
D.bunnanda,151823105,VNKE01002315.1,1,1380,9.08953e-06,150583323,0.991834
D.bunnanda,151823105,VNKE01005463.1,1,1379,9.08294e-06,150584702,0.991843
D.bunnanda,151823105,VNKE01006589.1,1,1378,9.07635e-06,150586080,0.991852
D.bunnanda,151823105,VNKE01003726.1,1,1378,9.07635e-06,150587458,0.991861
D.bunnanda,151823105,VNKE01000316.1,1,1378,9.07635e-06,150588836,0.99187
D.bunnanda,151823105,VNKE01005724.1,1,1377,9.06977e-06,150590213,0.991879
D.bunnanda,151823105,VNKE01002920.1,1,1377,9.06977e-06,150591590,0.991888
D.bunnanda,151823105,VNKE01005210.1,1,1376,9.06318e-06,150592966,0.991898
D.bunnanda,151823105,VNKE01004510.1,1,1376,9.06318e-06,150594342,0.991907
D.bunnanda,151823105,VNKE01003507.1,1,1374,9.05001e-06,150595716,0.991916
D.bunnanda,151823105,VNKE01002873.1,1,1374,9.05001e-06,150597090,0.991925
D.bunnanda,151823105,VNKE01002013.1,1,1374,9.05001e-06,150598464,0.991934
D.bunnanda,151823105,VNKE01002396.1,1,1373,9.04342e-06,150599837,0.991943
D.bunnanda,151823105,VNKE01001738.1,1,1373,9.04342e-06,150601210,0.991952
D.bunnanda,151823105,VNKE01002739.1,1,1372,9.03683e-06,150602582,0.991961
D.bunnanda,151823105,VNKE01001821.1,1,1372,9.03683e-06,150603954,0.99197
D.bunnanda,151823105,VNKE01000981.1,1,1372,9.03683e-06,150605326,0.991979
D.bunnanda,151823105,VNKE01000315.1,1,1372,9.03683e-06,150606698,0.991988
D.bunnanda,151823105,VNKE01002875.1,1,1371,9.03025e-06,150608069,0.991997
D.bunnanda,151823105,VNKE01000063.1,1,1371,9.03025e-06,150609440,0.992006
D.bunnanda,151823105,VNKE01006284.1,1,1370,9.02366e-06,150610810,0.992015
D.bunnanda,151823105,VNKE01006061.1,1,1370,9.02366e-06,150612180,0.992024
D.bunnanda,151823105,VNKE01000859.1,1,1369,9.01707e-06,150613549,0.992033
D.bunnanda,151823105,VNKE01004687.1,1,1368,9.01049e-06,150614917,0.992042
D.bunnanda,151823105,VNKE01002945.1,1,1368,9.01049e-06,150616285,0.992051
D.bunnanda,151823105,VNKE01002880.1,1,1368,9.01049e-06,150617653,0.99206
D.bunnanda,151823105,VNKE01001669.1,1,1368,9.01049e-06,150619021,0.992069
D.bunnanda,151823105,VNKE01000661.1,1,1368,9.01049e-06,150620389,0.992078
D.bunnanda,151823105,VNKE01000654.1,1,1368,9.01049e-06,150621757,0.992087
D.bunnanda,151823105,VNKE01001808.1,1,1367,9.0039e-06,150623124,0.992096
D.bunnanda,151823105,VNKE01000521.1,1,1367,9.0039e-06,150624491,0.992105
D.bunnanda,151823105,VNKE01000314.1,1,1367,9.0039e-06,150625858,0.992114
D.bunnanda,151823105,VNKE01000313.1,1,1367,9.0039e-06,150627225,0.992123
D.bunnanda,151823105,VNKE01000079.1,1,1367,9.0039e-06,150628592,0.992132
D.bunnanda,151823105,VNKE01000830.1,1,1366,8.99731e-06,150629958,0.992141
D.bunnanda,151823105,VNKE01004311.1,1,1364,8.98414e-06,150631322,0.99215
D.bunnanda,151823105,VNKE01004155.1,1,1364,8.98414e-06,150632686,0.992159
D.bunnanda,151823105,VNKE01003750.1,1,1364,8.98414e-06,150634050,0.992168
D.bunnanda,151823105,VNKE01000311.1,1,1363,8.97755e-06,150635413,0.992177
D.bunnanda,151823105,VNKE01005894.1,1,1362,8.97097e-06,150636775,0.992186
D.bunnanda,151823105,VNKE01002289.1,1,1361,8.96438e-06,150638136,0.992195
D.bunnanda,151823105,VNKE01004749.1,1,1360,8.95779e-06,150639496,0.992204
D.bunnanda,151823105,VNKE01004036.1,1,1360,8.95779e-06,150640856,0.992213
D.bunnanda,151823105,VNKE01002694.1,1,1360,8.95779e-06,150642216,0.992222
D.bunnanda,151823105,VNKE01003360.1,1,1359,8.95121e-06,150643575,0.992231
D.bunnanda,151823105,VNKE01000717.1,1,1358,8.94462e-06,150644933,0.99224
D.bunnanda,151823105,VNKE01004274.1,1,1356,8.93145e-06,150646289,0.992249
D.bunnanda,151823105,VNKE01006071.1,1,1355,8.92486e-06,150647644,0.992258
D.bunnanda,151823105,VNKE01005059.1,1,1355,8.92486e-06,150648999,0.992267
D.bunnanda,151823105,VNKE01002011.1,1,1355,8.92486e-06,150650354,0.992276
D.bunnanda,151823105,VNKE01005137.1,1,1354,8.91827e-06,150651708,0.992284
D.bunnanda,151823105,VNKE01005224.1,1,1353,8.91169e-06,150653061,0.992293
D.bunnanda,151823105,VNKE01002323.1,1,1353,8.91169e-06,150654414,0.992302
D.bunnanda,151823105,VNKE01005018.1,1,1352,8.9051e-06,150655766,0.992311
D.bunnanda,151823105,VNKE01004562.1,1,1352,8.9051e-06,150657118,0.99232
D.bunnanda,151823105,VNKE01004551.1,1,1352,8.9051e-06,150658470,0.992329
D.bunnanda,151823105,VNKE01003440.1,1,1352,8.9051e-06,150659822,0.992338
D.bunnanda,151823105,VNKE01002584.1,1,1352,8.9051e-06,150661174,0.992347
D.bunnanda,151823105,VNKE01002432.1,1,1352,8.9051e-06,150662526,0.992356
D.bunnanda,151823105,VNKE01005679.1,1,1351,8.89851e-06,150663877,0.992365
D.bunnanda,151823105,VNKE01005106.1,1,1351,8.89851e-06,150665228,0.992374
D.bunnanda,151823105,VNKE01005082.1,1,1351,8.89851e-06,150666579,0.992382
D.bunnanda,151823105,VNKE01002320.1,1,1351,8.89851e-06,150667930,0.992391
D.bunnanda,151823105,VNKE01000385.1,1,1351,8.89851e-06,150669281,0.9924
D.bunnanda,151823105,VNKE01004375.1,1,1350,8.89193e-06,150670631,0.992409
D.bunnanda,151823105,VNKE01002561.1,1,1350,8.89193e-06,150671981,0.992418
D.bunnanda,151823105,VNKE01001047.1,1,1350,8.89193e-06,150673331,0.992427
D.bunnanda,151823105,VNKE01000806.1,1,1350,8.89193e-06,150674681,0.992436
D.bunnanda,151823105,VNKE01006039.1,1,1347,8.87217e-06,150676028,0.992445
D.bunnanda,151823105,VNKE01005288.1,1,1347,8.87217e-06,150677375,0.992454
D.bunnanda,151823105,VNKE01004308.1,1,1347,8.87217e-06,150678722,0.992462
D.bunnanda,151823105,VNKE01001427.1,1,1347,8.87217e-06,150680069,0.992471
D.bunnanda,151823105,VNKE01000249.1,1,1347,8.87217e-06,150681416,0.99248
D.bunnanda,151823105,VNKE01003442.1,1,1346,8.86558e-06,150682762,0.992489
D.bunnanda,151823105,VNKE01003308.1,1,1346,8.86558e-06,150684108,0.992498
D.bunnanda,151823105,VNKE01001188.1,1,1346,8.86558e-06,150685454,0.992507
D.bunnanda,151823105,VNKE01005248.1,1,1345,8.85899e-06,150686799,0.992516
D.bunnanda,151823105,VNKE01004598.1,1,1345,8.85899e-06,150688144,0.992524
D.bunnanda,151823105,VNKE01001998.1,1,1345,8.85899e-06,150689489,0.992533
D.bunnanda,151823105,VNKE01003443.1,1,1344,8.85241e-06,150690833,0.992542
D.bunnanda,151823105,VNKE01002574.1,1,1344,8.85241e-06,150692177,0.992551
D.bunnanda,151823105,VNKE01002237.1,1,1344,8.85241e-06,150693521,0.99256
D.bunnanda,151823105,VNKE01000255.1,1,1344,8.85241e-06,150694865,0.992569
D.bunnanda,151823105,VNKE01003358.1,1,1343,8.84582e-06,150696208,0.992578
D.bunnanda,151823105,VNKE01001203.1,1,1343,8.84582e-06,150697551,0.992586
D.bunnanda,151823105,VNKE01005915.1,1,1342,8.83923e-06,150698893,0.992595
D.bunnanda,151823105,VNKE01003419.1,1,1342,8.83923e-06,150700235,0.992604
D.bunnanda,151823105,VNKE01002565.1,1,1342,8.83923e-06,150701577,0.992613
D.bunnanda,151823105,VNKE01004386.1,1,1341,8.83265e-06,150702918,0.992622
D.bunnanda,151823105,VNKE01000343.1,1,1341,8.83265e-06,150704259,0.992631
D.bunnanda,151823105,VNKE01005726.1,1,1340,8.82606e-06,150705599,0.992639
D.bunnanda,151823105,VNKE01004958.1,1,1340,8.82606e-06,150706939,0.992648
D.bunnanda,151823105,VNKE01004863.1,1,1340,8.82606e-06,150708279,0.992657
D.bunnanda,151823105,VNKE01004467.1,1,1340,8.82606e-06,150709619,0.992666
D.bunnanda,151823105,VNKE01004290.1,1,1340,8.82606e-06,150710959,0.992675
D.bunnanda,151823105,VNKE01003436.1,1,1340,8.82606e-06,150712299,0.992684
D.bunnanda,151823105,VNKE01002651.1,1,1340,8.82606e-06,150713639,0.992692
D.bunnanda,151823105,VNKE01002528.1,1,1340,8.82606e-06,150714979,0.992701
D.bunnanda,151823105,VNKE01001741.1,1,1340,8.82606e-06,150716319,0.99271
D.bunnanda,151823105,VNKE01000634.1,1,1340,8.82606e-06,150717659,0.992719
D.bunnanda,151823105,VNKE01005677.1,1,1339,8.81947e-06,150718998,0.992728
D.bunnanda,151823105,VNKE01005328.1,1,1339,8.81947e-06,150720337,0.992736
D.bunnanda,151823105,VNKE01005215.1,1,1339,8.81947e-06,150721676,0.992745
D.bunnanda,151823105,VNKE01002148.1,1,1339,8.81947e-06,150723015,0.992754
D.bunnanda,151823105,VNKE01000157.1,1,1339,8.81947e-06,150724354,0.992763
D.bunnanda,151823105,VNKE01005960.1,1,1338,8.81289e-06,150725692,0.992772
D.bunnanda,151823105,VNKE01004499.1,1,1338,8.81289e-06,150727030,0.992781
D.bunnanda,151823105,VNKE01002073.1,1,1338,8.81289e-06,150728368,0.992789
D.bunnanda,151823105,VNKE01002255.1,1,1337,8.8063e-06,150729705,0.992798
D.bunnanda,151823105,VNKE01000803.1,1,1337,8.8063e-06,150731042,0.992807
D.bunnanda,151823105,VNKE01006508.1,1,1336,8.79971e-06,150732378,0.992816
D.bunnanda,151823105,VNKE01005629.1,1,1336,8.79971e-06,150733714,0.992825
D.bunnanda,151823105,VNKE01004911.1,1,1336,8.79971e-06,150735050,0.992833
D.bunnanda,151823105,VNKE01003438.1,1,1336,8.79971e-06,150736386,0.992842
D.bunnanda,151823105,VNKE01003437.1,1,1336,8.79971e-06,150737722,0.992851
D.bunnanda,151823105,VNKE01002195.1,1,1336,8.79971e-06,150739058,0.99286
D.bunnanda,151823105,VNKE01000632.1,1,1336,8.79971e-06,150740394,0.992869
D.bunnanda,151823105,VNKE01002786.1,1,1335,8.79313e-06,150741729,0.992877
D.bunnanda,151823105,VNKE01006066.1,1,1334,8.78654e-06,150743063,0.992886
D.bunnanda,151823105,VNKE01005061.1,1,1334,8.78654e-06,150744397,0.992895
D.bunnanda,151823105,VNKE01004540.1,1,1334,8.78654e-06,150745731,0.992904
D.bunnanda,151823105,VNKE01004397.1,1,1334,8.78654e-06,150747065,0.992913
D.bunnanda,151823105,VNKE01003439.1,1,1334,8.78654e-06,150748399,0.992921
D.bunnanda,151823105,VNKE01002112.1,1,1334,8.78654e-06,150749733,0.99293
D.bunnanda,151823105,VNKE01004659.1,1,1333,8.77995e-06,150751066,0.992939
D.bunnanda,151823105,VNKE01001696.1,1,1333,8.77995e-06,150752399,0.992948
D.bunnanda,151823105,VNKE01005730.1,1,1332,8.77337e-06,150753731,0.992956
D.bunnanda,151823105,VNKE01005032.1,1,1332,8.77337e-06,150755063,0.992965
D.bunnanda,151823105,VNKE01004193.1,1,1332,8.77337e-06,150756395,0.992974
D.bunnanda,151823105,VNKE01003896.1,1,1332,8.77337e-06,150757727,0.992983
D.bunnanda,151823105,VNKE01001558.1,1,1332,8.77337e-06,150759059,0.992992
D.bunnanda,151823105,VNKE01005402.1,1,1331,8.76678e-06,150760390,0.993
D.bunnanda,151823105,VNKE01004066.1,1,1331,8.76678e-06,150761721,0.993009
D.bunnanda,151823105,VNKE01005753.1,1,1330,8.76019e-06,150763051,0.993018
D.bunnanda,151823105,VNKE01002401.1,1,1330,8.76019e-06,150764381,0.993027
D.bunnanda,151823105,VNKE01002070.1,1,1330,8.76019e-06,150765711,0.993035
D.bunnanda,151823105,VNKE01001879.1,1,1330,8.76019e-06,150767041,0.993044
D.bunnanda,151823105,VNKE01006007.1,1,1329,8.75361e-06,150768370,0.993053
D.bunnanda,151823105,VNKE01003908.1,1,1329,8.75361e-06,150769699,0.993062
D.bunnanda,151823105,VNKE01003725.1,1,1329,8.75361e-06,150771028,0.99307
D.bunnanda,151823105,VNKE01002043.1,1,1329,8.75361e-06,150772357,0.993079
D.bunnanda,151823105,VNKE01003434.1,1,1328,8.74702e-06,150773685,0.993088
D.bunnanda,151823105,VNKE01002240.1,1,1327,8.74044e-06,150775012,0.993097
D.bunnanda,151823105,VNKE01003944.1,1,1326,8.73385e-06,150776338,0.993105
D.bunnanda,151823105,VNKE01002978.1,1,1326,8.73385e-06,150777664,0.993114
D.bunnanda,151823105,VNKE01001137.1,1,1326,8.73385e-06,150778990,0.993123
D.bunnanda,151823105,VNKE01004245.1,1,1325,8.72726e-06,150780315,0.993132
D.bunnanda,151823105,VNKE01005889.1,1,1324,8.72068e-06,150781639,0.99314
D.bunnanda,151823105,VNKE01000431.1,1,1324,8.72068e-06,150782963,0.993149
D.bunnanda,151823105,VNKE01001642.1,1,1323,8.71409e-06,150784286,0.993158
D.bunnanda,151823105,VNKE01002671.1,1,1321,8.70092e-06,150785607,0.993166
D.bunnanda,151823105,VNKE01001508.1,1,1321,8.70092e-06,150786928,0.993175
D.bunnanda,151823105,VNKE01000583.1,1,1321,8.70092e-06,150788249,0.993184
D.bunnanda,151823105,VNKE01006180.1,1,1320,8.69433e-06,150789569,0.993192
D.bunnanda,151823105,VNKE01004751.1,1,1320,8.69433e-06,150790889,0.993201
D.bunnanda,151823105,VNKE01003030.1,1,1320,8.69433e-06,150792209,0.99321
D.bunnanda,151823105,VNKE01002982.1,1,1320,8.69433e-06,150793529,0.993219
D.bunnanda,151823105,VNKE01001943.1,1,1320,8.69433e-06,150794849,0.993227
D.bunnanda,151823105,VNKE01001899.1,1,1320,8.69433e-06,150796169,0.993236
D.bunnanda,151823105,VNKE01001150.1,1,1320,8.69433e-06,150797489,0.993245
D.bunnanda,151823105,VNKE01000646.1,1,1320,8.69433e-06,150798809,0.993253
D.bunnanda,151823105,VNKE01006072.1,1,1319,8.68774e-06,150800128,0.993262
D.bunnanda,151823105,VNKE01005798.1,1,1319,8.68774e-06,150801447,0.993271
D.bunnanda,151823105,VNKE01005053.1,1,1319,8.68774e-06,150802766,0.993279
D.bunnanda,151823105,VNKE01002635.1,1,1319,8.68774e-06,150804085,0.993288
D.bunnanda,151823105,VNKE01002284.1,1,1319,8.68774e-06,150805404,0.993297
D.bunnanda,151823105,VNKE01000298.1,1,1319,8.68774e-06,150806723,0.993305
D.bunnanda,151823105,VNKE01005705.1,1,1318,8.68116e-06,150808041,0.993314
D.bunnanda,151823105,VNKE01002721.1,1,1318,8.68116e-06,150809359,0.993323
D.bunnanda,151823105,VNKE01003263.1,1,1317,8.67457e-06,150810676,0.993332
D.bunnanda,151823105,VNKE01002115.1,1,1316,8.66798e-06,150811992,0.99334
D.bunnanda,151823105,VNKE01005630.1,1,1315,8.6614e-06,150813307,0.993349
D.bunnanda,151823105,VNKE01003357.1,1,1315,8.6614e-06,150814622,0.993358
D.bunnanda,151823105,VNKE01006526.1,1,1314,8.65481e-06,150815936,0.993366
D.bunnanda,151823105,VNKE01006073.1,1,1314,8.65481e-06,150817250,0.993375
D.bunnanda,151823105,VNKE01006035.1,1,1314,8.65481e-06,150818564,0.993383
D.bunnanda,151823105,VNKE01000585.1,1,1314,8.65481e-06,150819878,0.993392
D.bunnanda,151823105,VNKE01006619.1,1,1313,8.64822e-06,150821191,0.993401
D.bunnanda,151823105,VNKE01002575.1,1,1313,8.64822e-06,150822504,0.993409
D.bunnanda,151823105,VNKE01004645.1,1,1311,8.63505e-06,150823815,0.993418
D.bunnanda,151823105,VNKE01004987.1,1,1310,8.62846e-06,150825125,0.993427
D.bunnanda,151823105,VNKE01004639.1,1,1310,8.62846e-06,150826435,0.993435
D.bunnanda,151823105,VNKE01003840.1,1,1310,8.62846e-06,150827745,0.993444
D.bunnanda,151823105,VNKE01002687.1,1,1310,8.62846e-06,150829055,0.993453
D.bunnanda,151823105,VNKE01004546.1,1,1309,8.62188e-06,150830364,0.993461
D.bunnanda,151823105,VNKE01002544.1,1,1309,8.62188e-06,150831673,0.99347
D.bunnanda,151823105,VNKE01000589.1,1,1308,8.61529e-06,150832981,0.993478
D.bunnanda,151823105,VNKE01000582.1,1,1308,8.61529e-06,150834289,0.993487
D.bunnanda,151823105,VNKE01000581.1,1,1308,8.61529e-06,150835597,0.993496
D.bunnanda,151823105,VNKE01004800.1,1,1307,8.6087e-06,150836904,0.993504
D.bunnanda,151823105,VNKE01002344.1,1,1307,8.6087e-06,150838211,0.993513
D.bunnanda,151823105,VNKE01006215.1,1,1306,8.60212e-06,150839517,0.993521
D.bunnanda,151823105,VNKE01006096.1,1,1306,8.60212e-06,150840823,0.99353
D.bunnanda,151823105,VNKE01002959.1,1,1306,8.60212e-06,150842129,0.993539
D.bunnanda,151823105,VNKE01000503.1,1,1306,8.60212e-06,150843435,0.993547
D.bunnanda,151823105,VNKE01006424.1,1,1305,8.59553e-06,150844740,0.993556
D.bunnanda,151823105,VNKE01005893.1,1,1305,8.59553e-06,150846045,0.993564
D.bunnanda,151823105,VNKE01003923.1,1,1305,8.59553e-06,150847350,0.993573
D.bunnanda,151823105,VNKE01003242.1,1,1304,8.58894e-06,150848654,0.993582
D.bunnanda,151823105,VNKE01001686.1,1,1304,8.58894e-06,150849958,0.99359
D.bunnanda,151823105,VNKE01003431.1,1,1303,8.58236e-06,150851261,0.993599
D.bunnanda,151823105,VNKE01002750.1,1,1303,8.58236e-06,150852564,0.993607
D.bunnanda,151823105,VNKE01001420.1,1,1303,8.58236e-06,150853867,0.993616
D.bunnanda,151823105,VNKE01000266.1,1,1302,8.57577e-06,150855169,0.993625
D.bunnanda,151823105,VNKE01005952.1,1,1301,8.56918e-06,150856470,0.993633
D.bunnanda,151823105,VNKE01001081.1,1,1301,8.56918e-06,150857771,0.993642
D.bunnanda,151823105,VNKE01006513.1,1,1300,8.5626e-06,150859071,0.99365
D.bunnanda,151823105,VNKE01003780.1,1,1299,8.55601e-06,150860370,0.993659
D.bunnanda,151823105,VNKE01001716.1,1,1299,8.55601e-06,150861669,0.993667
D.bunnanda,151823105,VNKE01001441.1,1,1299,8.55601e-06,150862968,0.993676
D.bunnanda,151823105,VNKE01001015.1,1,1299,8.55601e-06,150864267,0.993685
D.bunnanda,151823105,VNKE01000588.1,1,1299,8.55601e-06,150865566,0.993693
D.bunnanda,151823105,VNKE01006233.1,1,1298,8.54942e-06,150866864,0.993702
D.bunnanda,151823105,VNKE01003429.1,1,1298,8.54942e-06,150868162,0.99371
D.bunnanda,151823105,VNKE01002762.1,1,1298,8.54942e-06,150869460,0.993719
D.bunnanda,151823105,VNKE01002460.1,1,1298,8.54942e-06,150870758,0.993727
D.bunnanda,151823105,VNKE01005249.1,1,1297,8.54284e-06,150872055,0.993736
D.bunnanda,151823105,VNKE01002476.1,1,1297,8.54284e-06,150873352,0.993744
D.bunnanda,151823105,VNKE01006162.1,1,1296,8.53625e-06,150874648,0.993753
D.bunnanda,151823105,VNKE01002986.1,1,1296,8.53625e-06,150875944,0.993761
D.bunnanda,151823105,VNKE01002325.1,1,1296,8.53625e-06,150877240,0.99377
D.bunnanda,151823105,VNKE01001025.1,1,1296,8.53625e-06,150878536,0.993778
D.bunnanda,151823105,VNKE01005017.1,1,1295,8.52966e-06,150879831,0.993787
D.bunnanda,151823105,VNKE01003508.1,1,1295,8.52966e-06,150881126,0.993796
D.bunnanda,151823105,VNKE01002638.1,1,1295,8.52966e-06,150882421,0.993804
D.bunnanda,151823105,VNKE01004374.1,1,1294,8.52308e-06,150883715,0.993813
D.bunnanda,151823105,VNKE01004108.1,1,1294,8.52308e-06,150885009,0.993821
D.bunnanda,151823105,VNKE01000330.1,1,1294,8.52308e-06,150886303,0.99383
D.bunnanda,151823105,VNKE01002235.1,1,1293,8.51649e-06,150887596,0.993838
D.bunnanda,151823105,VNKE01001498.1,1,1293,8.51649e-06,150888889,0.993847
D.bunnanda,151823105,VNKE01001313.1,1,1293,8.51649e-06,150890182,0.993855
D.bunnanda,151823105,VNKE01000265.1,1,1293,8.51649e-06,150891475,0.993864
D.bunnanda,151823105,VNKE01006423.1,1,1292,8.5099e-06,150892767,0.993872
D.bunnanda,151823105,VNKE01000862.1,1,1292,8.5099e-06,150894059,0.993881
D.bunnanda,151823105,VNKE01003430.1,1,1291,8.50332e-06,150895350,0.993889
D.bunnanda,151823105,VNKE01001266.1,1,1291,8.50332e-06,150896641,0.993898
D.bunnanda,151823105,VNKE01000241.1,1,1291,8.50332e-06,150897932,0.993906
D.bunnanda,151823105,VNKE01005451.1,1,1290,8.49673e-06,150899222,0.993915
D.bunnanda,151823105,VNKE01003289.1,1,1290,8.49673e-06,150900512,0.993923
D.bunnanda,151823105,VNKE01006362.1,1,1289,8.49014e-06,150901801,0.993932
D.bunnanda,151823105,VNKE01005178.1,1,1289,8.49014e-06,150903090,0.99394
D.bunnanda,151823105,VNKE01003736.1,1,1289,8.49014e-06,150904379,0.993949
D.bunnanda,151823105,VNKE01002965.1,1,1289,8.49014e-06,150905668,0.993957
D.bunnanda,151823105,VNKE01000325.1,1,1289,8.49014e-06,150906957,0.993966
D.bunnanda,151823105,VNKE01004995.1,1,1288,8.48356e-06,150908245,0.993974
D.bunnanda,151823105,VNKE01003752.1,1,1288,8.48356e-06,150909533,0.993983
D.bunnanda,151823105,VNKE01003733.1,1,1288,8.48356e-06,150910821,0.993991
D.bunnanda,151823105,VNKE01001901.1,1,1288,8.48356e-06,150912109,0.994
D.bunnanda,151823105,VNKE01004452.1,1,1287,8.47697e-06,150913396,0.994008
D.bunnanda,151823105,VNKE01002261.1,1,1287,8.47697e-06,150914683,0.994017
D.bunnanda,151823105,VNKE01005355.1,1,1286,8.47038e-06,150915969,0.994025
D.bunnanda,151823105,VNKE01002567.1,1,1286,8.47038e-06,150917255,0.994034
D.bunnanda,151823105,VNKE01002397.1,1,1286,8.47038e-06,150918541,0.994042
D.bunnanda,151823105,VNKE01001900.1,1,1286,8.47038e-06,150919827,0.99405
D.bunnanda,151823105,VNKE01001626.1,1,1285,8.4638e-06,150921112,0.994059
D.bunnanda,151823105,VNKE01000243.1,1,1285,8.4638e-06,150922397,0.994067
D.bunnanda,151823105,VNKE01005957.1,1,1284,8.45721e-06,150923681,0.994076
D.bunnanda,151823105,VNKE01002047.1,1,1284,8.45721e-06,150924965,0.994084
D.bunnanda,151823105,VNKE01001030.1,1,1284,8.45721e-06,150926249,0.994093
D.bunnanda,151823105,VNKE01000379.1,1,1284,8.45721e-06,150927533,0.994101
D.bunnanda,151823105,VNKE01000212.1,1,1284,8.45721e-06,150928817,0.99411
D.bunnanda,151823105,VNKE01004708.1,1,1283,8.45062e-06,150930100,0.994118
D.bunnanda,151823105,VNKE01000140.1,1,1283,8.45062e-06,150931383,0.994127
D.bunnanda,151823105,VNKE01004069.1,1,1282,8.44404e-06,150932665,0.994135
D.bunnanda,151823105,VNKE01002763.1,1,1282,8.44404e-06,150933947,0.994143
D.bunnanda,151823105,VNKE01002226.1,1,1281,8.43745e-06,150935228,0.994152
D.bunnanda,151823105,VNKE01004344.1,1,1280,8.43086e-06,150936508,0.99416
D.bunnanda,151823105,VNKE01004866.1,1,1279,8.42428e-06,150937787,0.994169
D.bunnanda,151823105,VNKE01003734.1,1,1278,8.41769e-06,150939065,0.994177
D.bunnanda,151823105,VNKE01000193.1,1,1278,8.41769e-06,150940343,0.994186
D.bunnanda,151823105,VNKE01006176.1,1,1277,8.4111e-06,150941620,0.994194
D.bunnanda,151823105,VNKE01000278.1,1,1276,8.40452e-06,150942896,0.994202
D.bunnanda,151823105,VNKE01004565.1,1,1275,8.39793e-06,150944171,0.994211
D.bunnanda,151823105,VNKE01000170.1,1,1275,8.39793e-06,150945446,0.994219
D.bunnanda,151823105,VNKE01005642.1,1,1274,8.39134e-06,150946720,0.994228
D.bunnanda,151823105,VNKE01000239.1,1,1274,8.39134e-06,150947994,0.994236
D.bunnanda,151823105,VNKE01003363.1,1,1273,8.38476e-06,150949267,0.994244
D.bunnanda,151823105,VNKE01004389.1,1,1272,8.37817e-06,150950539,0.994253
D.bunnanda,151823105,VNKE01003466.1,1,1272,8.37817e-06,150951811,0.994261
D.bunnanda,151823105,VNKE01000874.1,1,1272,8.37817e-06,150953083,0.99427
D.bunnanda,151823105,VNKE01006330.1,1,1271,8.37158e-06,150954354,0.994278
D.bunnanda,151823105,VNKE01004689.1,1,1271,8.37158e-06,150955625,0.994286
D.bunnanda,151823105,VNKE01000012.1,1,1270,8.365e-06,150956895,0.994295
D.bunnanda,151823105,VNKE01002557.1,1,1269,8.35841e-06,150958164,0.994303
D.bunnanda,151823105,VNKE01005535.1,1,1268,8.35182e-06,150959432,0.994311
D.bunnanda,151823105,VNKE01003739.1,1,1268,8.35182e-06,150960700,0.99432
D.bunnanda,151823105,VNKE01003740.1,1,1267,8.34524e-06,150961967,0.994328
D.bunnanda,151823105,VNKE01002835.1,1,1267,8.34524e-06,150963234,0.994336
D.bunnanda,151823105,VNKE01000956.1,1,1267,8.34524e-06,150964501,0.994345
D.bunnanda,151823105,VNKE01006095.1,1,1266,8.33865e-06,150965767,0.994353
D.bunnanda,151823105,VNKE01005890.1,1,1266,8.33865e-06,150967033,0.994361
D.bunnanda,151823105,VNKE01003737.1,1,1266,8.33865e-06,150968299,0.99437
D.bunnanda,151823105,VNKE01001380.1,1,1265,8.33207e-06,150969564,0.994378
D.bunnanda,151823105,VNKE01005757.1,1,1264,8.32548e-06,150970828,0.994386
D.bunnanda,151823105,VNKE01004034.1,1,1264,8.32548e-06,150972092,0.994395
D.bunnanda,151823105,VNKE01001872.1,1,1264,8.32548e-06,150973356,0.994403
D.bunnanda,151823105,VNKE01000666.1,1,1264,8.32548e-06,150974620,0.994411
D.bunnanda,151823105,VNKE01006393.1,1,1263,8.31889e-06,150975883,0.99442
D.bunnanda,151823105,VNKE01005909.1,1,1263,8.31889e-06,150977146,0.994428
D.bunnanda,151823105,VNKE01002218.1,1,1263,8.31889e-06,150978409,0.994436
D.bunnanda,151823105,VNKE01002329.1,1,1262,8.31231e-06,150979671,0.994445
D.bunnanda,151823105,VNKE01005450.1,1,1261,8.30572e-06,150980932,0.994453
D.bunnanda,151823105,VNKE01004674.1,1,1261,8.30572e-06,150982193,0.994461
D.bunnanda,151823105,VNKE01003993.1,1,1261,8.30572e-06,150983454,0.99447
D.bunnanda,151823105,VNKE01003803.1,1,1261,8.30572e-06,150984715,0.994478
D.bunnanda,151823105,VNKE01004652.1,1,1260,8.29913e-06,150985975,0.994486
D.bunnanda,151823105,VNKE01002239.1,1,1260,8.29913e-06,150987235,0.994494
D.bunnanda,151823105,VNKE01001674.1,1,1260,8.29913e-06,150988495,0.994503
D.bunnanda,151823105,VNKE01000769.1,1,1260,8.29913e-06,150989755,0.994511
D.bunnanda,151823105,VNKE01000567.1,1,1260,8.29913e-06,150991015,0.994519
D.bunnanda,151823105,VNKE01005031.1,1,1259,8.29255e-06,150992274,0.994528
D.bunnanda,151823105,VNKE01003377.1,1,1259,8.29255e-06,150993533,0.994536
D.bunnanda,151823105,VNKE01002872.1,1,1259,8.29255e-06,150994792,0.994544
D.bunnanda,151823105,VNKE01005422.1,1,1258,8.28596e-06,150996050,0.994553
D.bunnanda,151823105,VNKE01004275.1,1,1258,8.28596e-06,150997308,0.994561
D.bunnanda,151823105,VNKE01003741.1,1,1258,8.28596e-06,150998566,0.994569
D.bunnanda,151823105,VNKE01003738.1,1,1258,8.28596e-06,150999824,0.994577
D.bunnanda,151823105,VNKE01002352.1,1,1258,8.28596e-06,151001082,0.994586
D.bunnanda,151823105,VNKE01000486.1,1,1258,8.28596e-06,151002340,0.994594
D.bunnanda,151823105,VNKE01005816.1,1,1257,8.27937e-06,151003597,0.994602
D.bunnanda,151823105,VNKE01004213.1,1,1257,8.27937e-06,151004854,0.99461
D.bunnanda,151823105,VNKE01000718.1,1,1257,8.27937e-06,151006111,0.994619
D.bunnanda,151823105,VNKE01001112.1,1,1256,8.27279e-06,151007367,0.994627
D.bunnanda,151823105,VNKE01002488.1,1,1255,8.2662e-06,151008622,0.994635
D.bunnanda,151823105,VNKE01000754.1,1,1255,8.2662e-06,151009877,0.994644
D.bunnanda,151823105,VNKE01000077.1,1,1255,8.2662e-06,151011132,0.994652
D.bunnanda,151823105,VNKE01000060.1,1,1255,8.2662e-06,151012387,0.99466
D.bunnanda,151823105,VNKE01004589.1,1,1254,8.25961e-06,151013641,0.994668
D.bunnanda,151823105,VNKE01001611.1,1,1254,8.25961e-06,151014895,0.994677
D.bunnanda,151823105,VNKE01005958.1,1,1253,8.25303e-06,151016148,0.994685
D.bunnanda,151823105,VNKE01004924.1,1,1253,8.25303e-06,151017401,0.994693
D.bunnanda,151823105,VNKE01001805.1,1,1253,8.25303e-06,151018654,0.994701
D.bunnanda,151823105,VNKE01006032.1,1,1252,8.24644e-06,151019906,0.99471
D.bunnanda,151823105,VNKE01002529.1,1,1252,8.24644e-06,151021158,0.994718
D.bunnanda,151823105,VNKE01006242.1,1,1251,8.23985e-06,151022409,0.994726
D.bunnanda,151823105,VNKE01003601.1,1,1251,8.23985e-06,151023660,0.994734
D.bunnanda,151823105,VNKE01001561.1,1,1251,8.23985e-06,151024911,0.994743
D.bunnanda,151823105,VNKE01001032.1,1,1251,8.23985e-06,151026162,0.994751
D.bunnanda,151823105,VNKE01005640.1,1,1250,8.23327e-06,151027412,0.994759
D.bunnanda,151823105,VNKE01005377.1,1,1250,8.23327e-06,151028662,0.994767
D.bunnanda,151823105,VNKE01004312.1,1,1250,8.23327e-06,151029912,0.994776
D.bunnanda,151823105,VNKE01003731.1,1,1250,8.23327e-06,151031162,0.994784
D.bunnanda,151823105,VNKE01005968.1,1,1249,8.22668e-06,151032411,0.994792
D.bunnanda,151823105,VNKE01005731.1,1,1248,8.22009e-06,151033659,0.9948
D.bunnanda,151823105,VNKE01005534.1,1,1248,8.22009e-06,151034907,0.994808
D.bunnanda,151823105,VNKE01004390.1,1,1248,8.22009e-06,151036155,0.994817
D.bunnanda,151823105,VNKE01003857.1,1,1248,8.22009e-06,151037403,0.994825
D.bunnanda,151823105,VNKE01005563.1,1,1247,8.21351e-06,151038650,0.994833
D.bunnanda,151823105,VNKE01005364.1,1,1247,8.21351e-06,151039897,0.994841
D.bunnanda,151823105,VNKE01002480.1,1,1247,8.21351e-06,151041144,0.99485
D.bunnanda,151823105,VNKE01000781.1,1,1247,8.21351e-06,151042391,0.994858
D.bunnanda,151823105,VNKE01006165.1,1,1246,8.20692e-06,151043637,0.994866
D.bunnanda,151823105,VNKE01003742.1,1,1246,8.20692e-06,151044883,0.994874
D.bunnanda,151823105,VNKE01001657.1,1,1246,8.20692e-06,151046129,0.994882
D.bunnanda,151823105,VNKE01001505.1,1,1246,8.20692e-06,151047375,0.994891
D.bunnanda,151823105,VNKE01001627.1,1,1245,8.20033e-06,151048620,0.994899
D.bunnanda,151823105,VNKE01000090.1,1,1245,8.20033e-06,151049865,0.994907
D.bunnanda,151823105,VNKE01000272.1,1,1244,8.19375e-06,151051109,0.994915
D.bunnanda,151823105,VNKE01003552.1,1,1243,8.18716e-06,151052352,0.994923
D.bunnanda,151823105,VNKE01005885.1,1,1242,8.18057e-06,151053594,0.994932
D.bunnanda,151823105,VNKE01005085.1,1,1242,8.18057e-06,151054836,0.99494
D.bunnanda,151823105,VNKE01001877.1,1,1242,8.18057e-06,151056078,0.994948
D.bunnanda,151823105,VNKE01001314.1,1,1242,8.18057e-06,151057320,0.994956
D.bunnanda,151823105,VNKE01002749.1,1,1239,8.16081e-06,151058559,0.994964
D.bunnanda,151823105,VNKE01001809.1,1,1239,8.16081e-06,151059798,0.994972
D.bunnanda,151823105,VNKE01005651.1,1,1238,8.15423e-06,151061036,0.994981
D.bunnanda,151823105,VNKE01002415.1,1,1237,8.14764e-06,151062273,0.994989
D.bunnanda,151823105,VNKE01001263.1,1,1236,8.14105e-06,151063509,0.994997
D.bunnanda,151823105,VNKE01004690.1,1,1235,8.13447e-06,151064744,0.995005
D.bunnanda,151823105,VNKE01003973.1,1,1235,8.13447e-06,151065979,0.995013
D.bunnanda,151823105,VNKE01005670.1,1,1234,8.12788e-06,151067213,0.995021
D.bunnanda,151823105,VNKE01004539.1,1,1234,8.12788e-06,151068447,0.995029
D.bunnanda,151823105,VNKE01001855.1,1,1234,8.12788e-06,151069681,0.995037
D.bunnanda,151823105,VNKE01001497.1,1,1234,8.12788e-06,151070915,0.995046
D.bunnanda,151823105,VNKE01001815.1,1,1233,8.12129e-06,151072148,0.995054
D.bunnanda,151823105,VNKE01005205.1,1,1232,8.11471e-06,151073380,0.995062
D.bunnanda,151823105,VNKE01005099.1,1,1232,8.11471e-06,151074612,0.99507
D.bunnanda,151823105,VNKE01005813.1,1,1231,8.10812e-06,151075843,0.995078
D.bunnanda,151823105,VNKE01004848.1,1,1230,8.10153e-06,151077073,0.995086
D.bunnanda,151823105,VNKE01006387.1,1,1229,8.09495e-06,151078302,0.995094
D.bunnanda,151823105,VNKE01006092.1,1,1229,8.09495e-06,151079531,0.995102
D.bunnanda,151823105,VNKE01004933.1,1,1229,8.09495e-06,151080760,0.99511
D.bunnanda,151823105,VNKE01002429.1,1,1229,8.09495e-06,151081989,0.995119
D.bunnanda,151823105,VNKE01001733.1,1,1229,8.09495e-06,151083218,0.995127
D.bunnanda,151823105,VNKE01004928.1,1,1228,8.08836e-06,151084446,0.995135
D.bunnanda,151823105,VNKE01004082.1,1,1228,8.08836e-06,151085674,0.995143
D.bunnanda,151823105,VNKE01002217.1,1,1228,8.08836e-06,151086902,0.995151
D.bunnanda,151823105,VNKE01004926.1,1,1227,8.08177e-06,151088129,0.995159
D.bunnanda,151823105,VNKE01003777.1,1,1225,8.0686e-06,151089354,0.995167
D.bunnanda,151823105,VNKE01003635.1,1,1225,8.0686e-06,151090579,0.995175
D.bunnanda,151823105,VNKE01000774.1,1,1225,8.0686e-06,151091804,0.995183
D.bunnanda,151823105,VNKE01003284.1,1,1224,8.06201e-06,151093028,0.995191
D.bunnanda,151823105,VNKE01000798.1,1,1224,8.06201e-06,151094252,0.995199
D.bunnanda,151823105,VNKE01000244.1,1,1224,8.06201e-06,151095476,0.995207
D.bunnanda,151823105,VNKE01004149.1,1,1223,8.05543e-06,151096699,0.995215
D.bunnanda,151823105,VNKE01002742.1,1,1223,8.05543e-06,151097922,0.995224
D.bunnanda,151823105,VNKE01001017.1,1,1223,8.05543e-06,151099145,0.995232
D.bunnanda,151823105,VNKE01001649.1,1,1222,8.04884e-06,151100367,0.99524
D.bunnanda,151823105,VNKE01001536.1,1,1222,8.04884e-06,151101589,0.995248
D.bunnanda,151823105,VNKE01000671.1,1,1222,8.04884e-06,151102811,0.995256
D.bunnanda,151823105,VNKE01002579.1,1,1221,8.04225e-06,151104032,0.995264
D.bunnanda,151823105,VNKE01002562.1,1,1221,8.04225e-06,151105253,0.995272
D.bunnanda,151823105,VNKE01006612.1,1,1220,8.03567e-06,151106473,0.99528
D.bunnanda,151823105,VNKE01006421.1,1,1220,8.03567e-06,151107693,0.995288
D.bunnanda,151823105,VNKE01002532.1,1,1220,8.03567e-06,151108913,0.995296
D.bunnanda,151823105,VNKE01000336.1,1,1220,8.03567e-06,151110133,0.995304
D.bunnanda,151823105,VNKE01001737.1,1,1219,8.02908e-06,151111352,0.995312
D.bunnanda,151823105,VNKE01005136.1,1,1218,8.02249e-06,151112570,0.99532
D.bunnanda,151823105,VNKE01002576.1,1,1218,8.02249e-06,151113788,0.995328
D.bunnanda,151823105,VNKE01006230.1,1,1217,8.01591e-06,151115005,0.995336
D.bunnanda,151823105,VNKE01004547.1,1,1217,8.01591e-06,151116222,0.995344
D.bunnanda,151823105,VNKE01002395.1,1,1217,8.01591e-06,151117439,0.995352
D.bunnanda,151823105,VNKE01001255.1,1,1217,8.01591e-06,151118656,0.99536
D.bunnanda,151823105,VNKE01005685.1,1,1216,8.00932e-06,151119872,0.995368
D.bunnanda,151823105,VNKE01001507.1,1,1216,8.00932e-06,151121088,0.995376
D.bunnanda,151823105,VNKE01001148.1,1,1215,8.00273e-06,151122303,0.995384
D.bunnanda,151823105,VNKE01005240.1,1,1214,7.99615e-06,151123517,0.995392
D.bunnanda,151823105,VNKE01002696.1,1,1214,7.99615e-06,151124731,0.9954
D.bunnanda,151823105,VNKE01000932.1,1,1214,7.99615e-06,151125945,0.995408
D.bunnanda,151823105,VNKE01006276.1,1,1213,7.98956e-06,151127158,0.995416
D.bunnanda,151823105,VNKE01005449.1,1,1213,7.98956e-06,151128371,0.995424
D.bunnanda,151823105,VNKE01003677.1,1,1213,7.98956e-06,151129584,0.995432
D.bunnanda,151823105,VNKE01003233.1,1,1213,7.98956e-06,151130797,0.99544
D.bunnanda,151823105,VNKE01002971.1,1,1213,7.98956e-06,151132010,0.995448
D.bunnanda,151823105,VNKE01005146.1,1,1212,7.98297e-06,151133222,0.995456
D.bunnanda,151823105,VNKE01003749.1,1,1211,7.97639e-06,151134433,0.995464
D.bunnanda,151823105,VNKE01002829.1,1,1211,7.97639e-06,151135644,0.995472
D.bunnanda,151823105,VNKE01000504.1,1,1211,7.97639e-06,151136855,0.99548
D.bunnanda,151823105,VNKE01006425.1,1,1207,7.95004e-06,151138062,0.995488
D.bunnanda,151823105,VNKE01005127.1,1,1207,7.95004e-06,151139269,0.995496
D.bunnanda,151823105,VNKE01004560.1,1,1207,7.95004e-06,151140476,0.995504
D.bunnanda,151823105,VNKE01003297.1,1,1207,7.95004e-06,151141683,0.995512
D.bunnanda,151823105,VNKE01003211.1,1,1207,7.95004e-06,151142890,0.99552
D.bunnanda,151823105,VNKE01002925.1,1,1207,7.95004e-06,151144097,0.995528
D.bunnanda,151823105,VNKE01001220.1,1,1207,7.95004e-06,151145304,0.995536
D.bunnanda,151823105,VNKE01003778.1,1,1206,7.94345e-06,151146510,0.995544
D.bunnanda,151823105,VNKE01003093.1,1,1206,7.94345e-06,151147716,0.995551
D.bunnanda,151823105,VNKE01002152.1,1,1206,7.94345e-06,151148922,0.995559
D.bunnanda,151823105,VNKE01004439.1,1,1205,7.93687e-06,151150127,0.995567
D.bunnanda,151823105,VNKE01002927.1,1,1205,7.93687e-06,151151332,0.995575
D.bunnanda,151823105,VNKE01002491.1,1,1205,7.93687e-06,151152537,0.995583
D.bunnanda,151823105,VNKE01001136.1,1,1205,7.93687e-06,151153742,0.995591
D.bunnanda,151823105,VNKE01000983.1,1,1205,7.93687e-06,151154947,0.995599
D.bunnanda,151823105,VNKE01000767.1,1,1205,7.93687e-06,151156152,0.995607
D.bunnanda,151823105,VNKE01000608.1,1,1205,7.93687e-06,151157357,0.995615
D.bunnanda,151823105,VNKE01006244.1,1,1204,7.93028e-06,151158561,0.995623
D.bunnanda,151823105,VNKE01002388.1,1,1204,7.93028e-06,151159765,0.995631
D.bunnanda,151823105,VNKE01000980.1,1,1204,7.93028e-06,151160969,0.995639
D.bunnanda,151823105,VNKE01005262.1,1,1203,7.9237e-06,151162172,0.995647
D.bunnanda,151823105,VNKE01002333.1,1,1203,7.9237e-06,151163375,0.995655
D.bunnanda,151823105,VNKE01004334.1,1,1202,7.91711e-06,151164577,0.995663
D.bunnanda,151823105,VNKE01001740.1,1,1202,7.91711e-06,151165779,0.99567
D.bunnanda,151823105,VNKE01001506.1,1,1202,7.91711e-06,151166981,0.995678
D.bunnanda,151823105,VNKE01006160.1,1,1201,7.91052e-06,151168182,0.995686
D.bunnanda,151823105,VNKE01000372.1,1,1201,7.91052e-06,151169383,0.995694
D.bunnanda,151823105,VNKE01005382.1,1,1200,7.90394e-06,151170583,0.995702
D.bunnanda,151823105,VNKE01005243.1,1,1200,7.90394e-06,151171783,0.99571
D.bunnanda,151823105,VNKE01000132.1,1,1200,7.90394e-06,151172983,0.995718
D.bunnanda,151823105,VNKE01006430.1,1,1199,7.89735e-06,151174182,0.995726
D.bunnanda,151823105,VNKE01004743.1,1,1199,7.89735e-06,151175381,0.995734
D.bunnanda,151823105,VNKE01002935.1,1,1199,7.89735e-06,151176580,0.995742
D.bunnanda,151823105,VNKE01006429.1,1,1198,7.89076e-06,151177778,0.995749
D.bunnanda,151823105,VNKE01005578.1,1,1198,7.89076e-06,151178976,0.995757
D.bunnanda,151823105,VNKE01003260.1,1,1198,7.89076e-06,151180174,0.995765
D.bunnanda,151823105,VNKE01002950.1,1,1198,7.89076e-06,151181372,0.995773
D.bunnanda,151823105,VNKE01000245.1,1,1198,7.89076e-06,151182570,0.995781
D.bunnanda,151823105,VNKE01005488.1,1,1197,7.88418e-06,151183767,0.995789
D.bunnanda,151823105,VNKE01001725.1,1,1197,7.88418e-06,151184964,0.995797
D.bunnanda,151823105,VNKE01005391.1,1,1196,7.87759e-06,151186160,0.995805
D.bunnanda,151823105,VNKE01003693.1,1,1196,7.87759e-06,151187356,0.995813
D.bunnanda,151823105,VNKE01003153.1,1,1196,7.87759e-06,151188552,0.99582
D.bunnanda,151823105,VNKE01002498.1,1,1196,7.87759e-06,151189748,0.995828
D.bunnanda,151823105,VNKE01004276.1,1,1195,7.871e-06,151190943,0.995836
D.bunnanda,151823105,VNKE01002979.1,1,1195,7.871e-06,151192138,0.995844
D.bunnanda,151823105,VNKE01006262.1,1,1194,7.86442e-06,151193332,0.995852
D.bunnanda,151823105,VNKE01003913.1,1,1194,7.86442e-06,151194526,0.99586
D.bunnanda,151823105,VNKE01003488.1,1,1194,7.86442e-06,151195720,0.995868
D.bunnanda,151823105,VNKE01003599.1,1,1193,7.85783e-06,151196913,0.995876
D.bunnanda,151823105,VNKE01001700.1,1,1193,7.85783e-06,151198106,0.995883
D.bunnanda,151823105,VNKE01004816.1,1,1192,7.85124e-06,151199298,0.995891
D.bunnanda,151823105,VNKE01004592.1,1,1192,7.85124e-06,151200490,0.995899
D.bunnanda,151823105,VNKE01002951.1,1,1191,7.84466e-06,151201681,0.995907
D.bunnanda,151823105,VNKE01006464.1,1,1190,7.83807e-06,151202871,0.995915
D.bunnanda,151823105,VNKE01006056.1,1,1190,7.83807e-06,151204061,0.995923
D.bunnanda,151823105,VNKE01006010.1,1,1190,7.83807e-06,151205251,0.99593
D.bunnanda,151823105,VNKE01004805.1,1,1190,7.83807e-06,151206441,0.995938
D.bunnanda,151823105,VNKE01004864.1,1,1189,7.83148e-06,151207630,0.995946
D.bunnanda,151823105,VNKE01003238.1,1,1189,7.83148e-06,151208819,0.995954
D.bunnanda,151823105,VNKE01002665.1,1,1189,7.83148e-06,151210008,0.995962
D.bunnanda,151823105,VNKE01002234.1,1,1189,7.83148e-06,151211197,0.99597
D.bunnanda,151823105,VNKE01000575.1,1,1189,7.83148e-06,151212386,0.995977
D.bunnanda,151823105,VNKE01005077.1,1,1188,7.8249e-06,151213574,0.995985
D.bunnanda,151823105,VNKE01004147.1,1,1188,7.8249e-06,151214762,0.995993
D.bunnanda,151823105,VNKE01003658.1,1,1188,7.8249e-06,151215950,0.996001
D.bunnanda,151823105,VNKE01002952.1,1,1188,7.8249e-06,151217138,0.996009
D.bunnanda,151823105,VNKE01002175.1,1,1188,7.8249e-06,151218326,0.996017
D.bunnanda,151823105,VNKE01000753.1,1,1188,7.8249e-06,151219514,0.996024
D.bunnanda,151823105,VNKE01006063.1,1,1187,7.81831e-06,151220701,0.996032
D.bunnanda,151823105,VNKE01002954.1,1,1187,7.81831e-06,151221888,0.99604
D.bunnanda,151823105,VNKE01002953.1,1,1187,7.81831e-06,151223075,0.996048
D.bunnanda,151823105,VNKE01002420.1,1,1187,7.81831e-06,151224262,0.996056
D.bunnanda,151823105,VNKE01001258.1,1,1187,7.81831e-06,151225449,0.996063
D.bunnanda,151823105,VNKE01000458.1,1,1187,7.81831e-06,151226636,0.996071
D.bunnanda,151823105,VNKE01005144.1,1,1186,7.81172e-06,151227822,0.996079
D.bunnanda,151823105,VNKE01004350.1,1,1186,7.81172e-06,151229008,0.996087
D.bunnanda,151823105,VNKE01002032.1,1,1186,7.81172e-06,151230194,0.996095
D.bunnanda,151823105,VNKE01001639.1,1,1186,7.81172e-06,151231380,0.996103
D.bunnanda,151823105,VNKE01000626.1,1,1186,7.81172e-06,151232566,0.99611
D.bunnanda,151823105,VNKE01002046.1,1,1185,7.80514e-06,151233751,0.996118
D.bunnanda,151823105,VNKE01000713.1,1,1185,7.80514e-06,151234936,0.996126
D.bunnanda,151823105,VNKE01000100.1,1,1185,7.80514e-06,151236121,0.996134
D.bunnanda,151823105,VNKE01006263.1,1,1184,7.79855e-06,151237305,0.996142
D.bunnanda,151823105,VNKE01005815.1,1,1184,7.79855e-06,151238489,0.996149
D.bunnanda,151823105,VNKE01005506.1,1,1183,7.79196e-06,151239672,0.996157
D.bunnanda,151823105,VNKE01005455.1,1,1183,7.79196e-06,151240855,0.996165
D.bunnanda,151823105,VNKE01005213.1,1,1183,7.79196e-06,151242038,0.996173
D.bunnanda,151823105,VNKE01006384.1,1,1182,7.78538e-06,151243220,0.996181
D.bunnanda,151823105,VNKE01002955.1,1,1182,7.78538e-06,151244402,0.996188
D.bunnanda,151823105,VNKE01001685.1,1,1182,7.78538e-06,151245584,0.996196
D.bunnanda,151823105,VNKE01000736.1,1,1182,7.78538e-06,151246766,0.996204
D.bunnanda,151823105,VNKE01000148.1,1,1182,7.78538e-06,151247948,0.996212
D.bunnanda,151823105,VNKE01005613.1,1,1180,7.7722e-06,151249128,0.996219
D.bunnanda,151823105,VNKE01004691.1,1,1180,7.7722e-06,151250308,0.996227
D.bunnanda,151823105,VNKE01002748.1,1,1180,7.7722e-06,151251488,0.996235
D.bunnanda,151823105,VNKE01006516.1,1,1178,7.75903e-06,151252666,0.996243
D.bunnanda,151823105,VNKE01004482.1,1,1178,7.75903e-06,151253844,0.99625
D.bunnanda,151823105,VNKE01000381.1,1,1178,7.75903e-06,151255022,0.996258
D.bunnanda,151823105,VNKE01006261.1,1,1177,7.75244e-06,151256199,0.996266
D.bunnanda,151823105,VNKE01005141.1,1,1177,7.75244e-06,151257376,0.996274
D.bunnanda,151823105,VNKE01004672.1,1,1177,7.75244e-06,151258553,0.996282
D.bunnanda,151823105,VNKE01003918.1,1,1177,7.75244e-06,151259730,0.996289
D.bunnanda,151823105,VNKE01001819.1,1,1177,7.75244e-06,151260907,0.996297
D.bunnanda,151823105,VNKE01004724.1,1,1176,7.74586e-06,151262083,0.996305
D.bunnanda,151823105,VNKE01003400.1,1,1176,7.74586e-06,151263259,0.996313
D.bunnanda,151823105,VNKE01001666.1,1,1176,7.74586e-06,151264435,0.99632
D.bunnanda,151823105,VNKE01001134.1,1,1176,7.74586e-06,151265611,0.996328
D.bunnanda,151823105,VNKE01003382.1,1,1175,7.73927e-06,151266786,0.996336
D.bunnanda,151823105,VNKE01002962.1,1,1175,7.73927e-06,151267961,0.996343
D.bunnanda,151823105,VNKE01000900.1,1,1175,7.73927e-06,151269136,0.996351
D.bunnanda,151823105,VNKE01000656.1,1,1175,7.73927e-06,151270311,0.996359
D.bunnanda,151823105,VNKE01000653.1,1,1175,7.73927e-06,151271486,0.996367
D.bunnanda,151823105,VNKE01000633.1,1,1175,7.73927e-06,151272661,0.996374
D.bunnanda,151823105,VNKE01000076.1,1,1175,7.73927e-06,151273836,0.996382
D.bunnanda,151823105,VNKE01005669.1,1,1174,7.73268e-06,151275010,0.99639
D.bunnanda,151823105,VNKE01004665.1,1,1174,7.73268e-06,151276184,0.996398
D.bunnanda,151823105,VNKE01002956.1,1,1173,7.7261e-06,151277357,0.996405
D.bunnanda,151823105,VNKE01000949.1,1,1173,7.7261e-06,151278530,0.996413
D.bunnanda,151823105,VNKE01001605.1,1,1172,7.71951e-06,151279702,0.996421
D.bunnanda,151823105,VNKE01001407.1,1,1172,7.71951e-06,151280874,0.996429
D.bunnanda,151823105,VNKE01005426.1,1,1171,7.71292e-06,151282045,0.996436
D.bunnanda,151823105,VNKE01004537.1,1,1171,7.71292e-06,151283216,0.996444
D.bunnanda,151823105,VNKE01003782.1,1,1171,7.71292e-06,151284387,0.996452
D.bunnanda,151823105,VNKE01000915.1,1,1171,7.71292e-06,151285558,0.996459
D.bunnanda,151823105,VNKE01005599.1,1,1170,7.70634e-06,151286728,0.996467
D.bunnanda,151823105,VNKE01002062.1,1,1170,7.70634e-06,151287898,0.996475
D.bunnanda,151823105,VNKE01005959.1,1,1169,7.69975e-06,151289067,0.996482
D.bunnanda,151823105,VNKE01006407.1,1,1168,7.69316e-06,151290235,0.99649
D.bunnanda,151823105,VNKE01005539.1,1,1168,7.69316e-06,151291403,0.996498
D.bunnanda,151823105,VNKE01003432.1,1,1168,7.69316e-06,151292571,0.996506
D.bunnanda,151823105,VNKE01002958.1,1,1168,7.69316e-06,151293739,0.996513
D.bunnanda,151823105,VNKE01001848.1,1,1168,7.69316e-06,151294907,0.996521
D.bunnanda,151823105,VNKE01000625.1,1,1168,7.69316e-06,151296075,0.996529
D.bunnanda,151823105,VNKE01000141.1,1,1168,7.69316e-06,151297243,0.996536
D.bunnanda,151823105,VNKE01002404.1,1,1167,7.68658e-06,151298410,0.996544
D.bunnanda,151823105,VNKE01001717.1,1,1167,7.68658e-06,151299577,0.996552
D.bunnanda,151823105,VNKE01001038.1,1,1167,7.68658e-06,151300744,0.996559
D.bunnanda,151823105,VNKE01000078.1,1,1167,7.68658e-06,151301911,0.996567
D.bunnanda,151823105,VNKE01004157.1,1,1166,7.67999e-06,151303077,0.996575
D.bunnanda,151823105,VNKE01001698.1,1,1166,7.67999e-06,151304243,0.996582
D.bunnanda,151823105,VNKE01001672.1,1,1166,7.67999e-06,151305409,0.99659
D.bunnanda,151823105,VNKE01004536.1,1,1165,7.6734e-06,151306574,0.996598
D.bunnanda,151823105,VNKE01001500.1,1,1165,7.6734e-06,151307739,0.996605
D.bunnanda,151823105,VNKE01000594.1,1,1165,7.6734e-06,151308904,0.996613
D.bunnanda,151823105,VNKE01006291.1,1,1164,7.66682e-06,151310068,0.996621
D.bunnanda,151823105,VNKE01005045.1,1,1164,7.66682e-06,151311232,0.996628
D.bunnanda,151823105,VNKE01004821.1,1,1164,7.66682e-06,151312396,0.996636
D.bunnanda,151823105,VNKE01004117.1,1,1164,7.66682e-06,151313560,0.996644
D.bunnanda,151823105,VNKE01002934.1,1,1163,7.66023e-06,151314723,0.996651
D.bunnanda,151823105,VNKE01002504.1,1,1163,7.66023e-06,151315886,0.996659
D.bunnanda,151823105,VNKE01000488.1,1,1163,7.66023e-06,151317049,0.996667
D.bunnanda,151823105,VNKE01000045.1,1,1162,7.65364e-06,151318211,0.996674
D.bunnanda,151823105,VNKE01005199.1,1,1160,7.64047e-06,151319371,0.996682
D.bunnanda,151823105,VNKE01002577.1,1,1160,7.64047e-06,151320531,0.99669
D.bunnanda,151823105,VNKE01005237.1,1,1159,7.63388e-06,151321690,0.996697
D.bunnanda,151823105,VNKE01002117.1,1,1159,7.63388e-06,151322849,0.996705
D.bunnanda,151823105,VNKE01002387.1,1,1158,7.6273e-06,151324007,0.996713
D.bunnanda,151823105,VNKE01000606.1,1,1158,7.6273e-06,151325165,0.99672
D.bunnanda,151823105,VNKE01005874.1,1,1157,7.62071e-06,151326322,0.996728
D.bunnanda,151823105,VNKE01005962.1,1,1156,7.61412e-06,151327478,0.996735
D.bunnanda,151823105,VNKE01004415.1,1,1156,7.61412e-06,151328634,0.996743
D.bunnanda,151823105,VNKE01002322.1,1,1156,7.61412e-06,151329790,0.996751
D.bunnanda,151823105,VNKE01006100.1,1,1155,7.60754e-06,151330945,0.996758
D.bunnanda,151823105,VNKE01006188.1,1,1154,7.60095e-06,151332099,0.996766
D.bunnanda,151823105,VNKE01004991.1,1,1154,7.60095e-06,151333253,0.996774
D.bunnanda,151823105,VNKE01002190.1,1,1154,7.60095e-06,151334407,0.996781
D.bunnanda,151823105,VNKE01004522.1,1,1153,7.59436e-06,151335560,0.996789
D.bunnanda,151823105,VNKE01006351.1,1,1152,7.58778e-06,151336712,0.996796
D.bunnanda,151823105,VNKE01004248.1,1,1152,7.58778e-06,151337864,0.996804
D.bunnanda,151823105,VNKE01003049.1,1,1152,7.58778e-06,151339016,0.996811
D.bunnanda,151823105,VNKE01000044.1,1,1152,7.58778e-06,151340168,0.996819
D.bunnanda,151823105,VNKE01003010.1,1,1151,7.58119e-06,151341319,0.996827
D.bunnanda,151823105,VNKE01002241.1,1,1151,7.58119e-06,151342470,0.996834
D.bunnanda,151823105,VNKE01000047.1,1,1151,7.58119e-06,151343621,0.996842
D.bunnanda,151823105,VNKE01000629.1,1,1150,7.5746e-06,151344771,0.996849
D.bunnanda,151823105,VNKE01000046.1,1,1150,7.5746e-06,151345921,0.996857
D.bunnanda,151823105,VNKE01003711.1,1,1149,7.56802e-06,151347070,0.996865
D.bunnanda,151823105,VNKE01002492.1,1,1149,7.56802e-06,151348219,0.996872
D.bunnanda,151823105,VNKE01000735.1,1,1149,7.56802e-06,151349368,0.99688
D.bunnanda,151823105,VNKE01000049.1,1,1149,7.56802e-06,151350517,0.996887
D.bunnanda,151823105,VNKE01005489.1,1,1148,7.56143e-06,151351665,0.996895
D.bunnanda,151823105,VNKE01004918.1,1,1148,7.56143e-06,151352813,0.996902
D.bunnanda,151823105,VNKE01005457.1,1,1147,7.55484e-06,151353960,0.99691
D.bunnanda,151823105,VNKE01005430.1,1,1147,7.55484e-06,151355107,0.996917
D.bunnanda,151823105,VNKE01005092.1,1,1147,7.55484e-06,151356254,0.996925
D.bunnanda,151823105,VNKE01003841.1,1,1147,7.55484e-06,151357401,0.996933
D.bunnanda,151823105,VNKE01004416.1,1,1146,7.54826e-06,151358547,0.99694
D.bunnanda,151823105,VNKE01003464.1,1,1146,7.54826e-06,151359693,0.996948
D.bunnanda,151823105,VNKE01000866.1,1,1146,7.54826e-06,151360839,0.996955
D.bunnanda,151823105,VNKE01005547.1,1,1145,7.54167e-06,151361984,0.996963
D.bunnanda,151823105,VNKE01003557.1,1,1145,7.54167e-06,151363129,0.99697
D.bunnanda,151823105,VNKE01000429.1,1,1145,7.54167e-06,151364274,0.996978
D.bunnanda,151823105,VNKE01005965.1,1,1144,7.53508e-06,151365418,0.996985
D.bunnanda,151823105,VNKE01005879.1,1,1144,7.53508e-06,151366562,0.996993
D.bunnanda,151823105,VNKE01005758.1,1,1144,7.53508e-06,151367706,0.997
D.bunnanda,151823105,VNKE01005386.1,1,1144,7.53508e-06,151368850,0.997008
D.bunnanda,151823105,VNKE01003315.1,1,1144,7.53508e-06,151369994,0.997016
D.bunnanda,151823105,VNKE01000102.1,1,1144,7.53508e-06,151371138,0.997023
D.bunnanda,151823105,VNKE01004782.1,1,1143,7.5285e-06,151372281,0.997031
D.bunnanda,151823105,VNKE01006396.1,1,1141,7.51533e-06,151373422,0.997038
D.bunnanda,151823105,VNKE01005763.1,1,1141,7.51533e-06,151374563,0.997046
D.bunnanda,151823105,VNKE01005589.1,1,1141,7.51533e-06,151375704,0.997053
D.bunnanda,151823105,VNKE01005275.1,1,1141,7.51533e-06,151376845,0.997061
D.bunnanda,151823105,VNKE01002776.1,1,1141,7.51533e-06,151377986,0.997068
D.bunnanda,151823105,VNKE01002042.1,1,1141,7.51533e-06,151379127,0.997076
D.bunnanda,151823105,VNKE01001378.1,1,1141,7.51533e-06,151380268,0.997083
D.bunnanda,151823105,VNKE01000630.1,1,1141,7.51533e-06,151381409,0.997091
D.bunnanda,151823105,VNKE01000048.1,1,1141,7.51533e-06,151382550,0.997098
D.bunnanda,151823105,VNKE01005274.1,1,1140,7.50874e-06,151383690,0.997106
D.bunnanda,151823105,VNKE01004663.1,1,1140,7.50874e-06,151384830,0.997113
D.bunnanda,151823105,VNKE01001851.1,1,1140,7.50874e-06,151385970,0.997121
D.bunnanda,151823105,VNKE01000940.1,1,1140,7.50874e-06,151387110,0.997128
D.bunnanda,151823105,VNKE01003748.1,1,1139,7.50215e-06,151388249,0.997136
D.bunnanda,151823105,VNKE01006283.1,1,1138,7.49557e-06,151389387,0.997143
D.bunnanda,151823105,VNKE01005745.1,1,1138,7.49557e-06,151390525,0.997151
D.bunnanda,151823105,VNKE01004391.1,1,1138,7.49557e-06,151391663,0.997158
D.bunnanda,151823105,VNKE01002309.1,1,1138,7.49557e-06,151392801,0.997166
D.bunnanda,151823105,VNKE01001456.1,1,1138,7.49557e-06,151393939,0.997173
D.bunnanda,151823105,VNKE01006440.1,1,1137,7.48898e-06,151395076,0.997181
D.bunnanda,151823105,VNKE01004868.1,1,1137,7.48898e-06,151396213,0.997188
D.bunnanda,151823105,VNKE01004844.1,1,1136,7.48239e-06,151397349,0.997196
D.bunnanda,151823105,VNKE01001829.1,1,1136,7.48239e-06,151398485,0.997203
D.bunnanda,151823105,VNKE01001541.1,1,1136,7.48239e-06,151399621,0.997211
D.bunnanda,151823105,VNKE01006008.1,1,1135,7.47581e-06,151400756,0.997218
D.bunnanda,151823105,VNKE01005491.1,1,1135,7.47581e-06,151401891,0.997226
D.bunnanda,151823105,VNKE01000974.1,1,1135,7.47581e-06,151403026,0.997233
D.bunnanda,151823105,VNKE01005203.1,1,1134,7.46922e-06,151404160,0.997241
D.bunnanda,151823105,VNKE01000522.1,1,1134,7.46922e-06,151405294,0.997248
D.bunnanda,151823105,VNKE01000051.1,1,1134,7.46922e-06,151406428,0.997256
D.bunnanda,151823105,VNKE01000050.1,1,1134,7.46922e-06,151407562,0.997263
D.bunnanda,151823105,VNKE01000042.1,1,1133,7.46263e-06,151408695,0.99727
D.bunnanda,151823105,VNKE01000041.1,1,1133,7.46263e-06,151409828,0.997278
D.bunnanda,151823105,VNKE01003417.1,1,1132,7.45605e-06,151410960,0.997285
D.bunnanda,151823105,VNKE01003210.1,1,1132,7.45605e-06,151412092,0.997293
D.bunnanda,151823105,VNKE01002701.1,1,1132,7.45605e-06,151413224,0.9973
D.bunnanda,151823105,VNKE01006229.1,1,1131,7.44946e-06,151414355,0.997308
D.bunnanda,151823105,VNKE01002074.1,1,1131,7.44946e-06,151415486,0.997315
D.bunnanda,151823105,VNKE01001423.1,1,1131,7.44946e-06,151416617,0.997323
D.bunnanda,151823105,VNKE01005671.1,1,1130,7.44287e-06,151417747,0.99733
D.bunnanda,151823105,VNKE01002219.1,1,1130,7.44287e-06,151418877,0.997338
D.bunnanda,151823105,VNKE01001801.1,1,1130,7.44287e-06,151420007,0.997345
D.bunnanda,151823105,VNKE01001383.1,1,1130,7.44287e-06,151421137,0.997352
D.bunnanda,151823105,VNKE01005972.1,1,1129,7.43629e-06,151422266,0.99736
D.bunnanda,151823105,VNKE01004420.1,1,1128,7.4297e-06,151423394,0.997367
D.bunnanda,151823105,VNKE01003634.1,1,1128,7.4297e-06,151424522,0.997375
D.bunnanda,151823105,VNKE01002709.1,1,1128,7.4297e-06,151425650,0.997382
D.bunnanda,151823105,VNKE01002461.1,1,1128,7.4297e-06,151426778,0.99739
D.bunnanda,151823105,VNKE01006538.1,1,1127,7.42311e-06,151427905,0.997397
D.bunnanda,151823105,VNKE01003111.1,1,1127,7.42311e-06,151429032,0.997404
D.bunnanda,151823105,VNKE01002715.1,1,1127,7.42311e-06,151430159,0.997412
D.bunnanda,151823105,VNKE01001701.1,1,1127,7.42311e-06,151431286,0.997419
D.bunnanda,151823105,VNKE01005718.1,1,1126,7.41653e-06,151432412,0.997427
D.bunnanda,151823105,VNKE01003209.1,1,1126,7.41653e-06,151433538,0.997434
D.bunnanda,151823105,VNKE01003208.1,1,1126,7.41653e-06,151434664,0.997441
D.bunnanda,151823105,VNKE01002505.1,1,1126,7.41653e-06,151435790,0.997449
D.bunnanda,151823105,VNKE01001699.1,1,1126,7.41653e-06,151436916,0.997456
D.bunnanda,151823105,VNKE01004673.1,1,1125,7.40994e-06,151438041,0.997464
D.bunnanda,151823105,VNKE01004622.1,1,1125,7.40994e-06,151439166,0.997471
D.bunnanda,151823105,VNKE01003206.1,1,1125,7.40994e-06,151440291,0.997479
D.bunnanda,151823105,VNKE01001734.1,1,1125,7.40994e-06,151441416,0.997486
D.bunnanda,151823105,VNKE01006265.1,1,1124,7.40335e-06,151442540,0.997493
D.bunnanda,151823105,VNKE01004873.1,1,1124,7.40335e-06,151443664,0.997501
D.bunnanda,151823105,VNKE01004396.1,1,1124,7.40335e-06,151444788,0.997508
D.bunnanda,151823105,VNKE01002494.1,1,1124,7.40335e-06,151445912,0.997516
D.bunnanda,151823105,VNKE01001796.1,1,1124,7.40335e-06,151447036,0.997523
D.bunnanda,151823105,VNKE01001774.1,1,1124,7.40335e-06,151448160,0.99753
D.bunnanda,151823105,VNKE01003207.1,1,1123,7.39677e-06,151449283,0.997538
D.bunnanda,151823105,VNKE01002319.1,1,1123,7.39677e-06,151450406,0.997545
D.bunnanda,151823105,VNKE01002181.1,1,1123,7.39677e-06,151451529,0.997553
D.bunnanda,151823105,VNKE01005138.1,1,1122,7.39018e-06,151452651,0.99756
D.bunnanda,151823105,VNKE01006104.1,1,1121,7.38359e-06,151453772,0.997567
D.bunnanda,151823105,VNKE01003937.1,1,1121,7.38359e-06,151454893,0.997575
D.bunnanda,151823105,VNKE01001024.1,1,1121,7.38359e-06,151456014,0.997582
D.bunnanda,151823105,VNKE01005131.1,1,1120,7.37701e-06,151457134,0.997589
D.bunnanda,151823105,VNKE01004650.1,1,1120,7.37701e-06,151458254,0.997597
D.bunnanda,151823105,VNKE01001567.1,1,1120,7.37701e-06,151459374,0.997604
D.bunnanda,151823105,VNKE01001242.1,1,1120,7.37701e-06,151460494,0.997612
D.bunnanda,151823105,VNKE01005930.1,1,1119,7.37042e-06,151461613,0.997619
D.bunnanda,151823105,VNKE01005672.1,1,1119,7.37042e-06,151462732,0.997626
D.bunnanda,151823105,VNKE01003713.1,1,1119,7.37042e-06,151463851,0.997634
D.bunnanda,151823105,VNKE01005891.1,1,1118,7.36383e-06,151464969,0.997641
D.bunnanda,151823105,VNKE01003239.1,1,1118,7.36383e-06,151466087,0.997648
D.bunnanda,151823105,VNKE01002556.1,1,1118,7.36383e-06,151467205,0.997656
D.bunnanda,151823105,VNKE01005154.1,1,1117,7.35725e-06,151468322,0.997663
D.bunnanda,151823105,VNKE01006591.1,1,1116,7.35066e-06,151469438,0.997671
D.bunnanda,151823105,VNKE01006514.1,1,1116,7.35066e-06,151470554,0.997678
D.bunnanda,151823105,VNKE01003413.1,1,1116,7.35066e-06,151471670,0.997685
D.bunnanda,151823105,VNKE01003108.1,1,1116,7.35066e-06,151472786,0.997693
D.bunnanda,151823105,VNKE01003204.1,1,1114,7.33749e-06,151473900,0.9977
D.bunnanda,151823105,VNKE01001372.1,1,1114,7.33749e-06,151475014,0.997707
D.bunnanda,151823105,VNKE01006193.1,1,1113,7.3309e-06,151476127,0.997715
D.bunnanda,151823105,VNKE01004819.1,1,1113,7.3309e-06,151477240,0.997722
D.bunnanda,151823105,VNKE01004413.1,1,1113,7.3309e-06,151478353,0.997729
D.bunnanda,151823105,VNKE01002874.1,1,1113,7.3309e-06,151479466,0.997737
D.bunnanda,151823105,VNKE01000299.1,1,1113,7.3309e-06,151480579,0.997744
D.bunnanda,151823105,VNKE01001477.1,1,1111,7.31773e-06,151481690,0.997751
D.bunnanda,151823105,VNKE01003043.1,1,1109,7.30455e-06,151482799,0.997759
D.bunnanda,151823105,VNKE01002697.1,1,1109,7.30455e-06,151483908,0.997766
D.bunnanda,151823105,VNKE01002489.1,1,1109,7.30455e-06,151485017,0.997773
D.bunnanda,151823105,VNKE01002399.1,1,1109,7.30455e-06,151486126,0.99778
D.bunnanda,151823105,VNKE01005464.1,1,1108,7.29797e-06,151487234,0.997788
D.bunnanda,151823105,VNKE01005362.1,1,1108,7.29797e-06,151488342,0.997795
D.bunnanda,151823105,VNKE01001033.1,1,1108,7.29797e-06,151489450,0.997802
D.bunnanda,151823105,VNKE01000083.1,1,1108,7.29797e-06,151490558,0.99781
D.bunnanda,151823105,VNKE01001852.1,1,1107,7.29138e-06,151491665,0.997817
D.bunnanda,151823105,VNKE01006515.1,1,1106,7.28479e-06,151492771,0.997824
D.bunnanda,151823105,VNKE01006049.1,1,1106,7.28479e-06,151493877,0.997832
D.bunnanda,151823105,VNKE01005888.1,1,1106,7.28479e-06,151494983,0.997839
D.bunnanda,151823105,VNKE01004037.1,1,1106,7.28479e-06,151496089,0.997846
D.bunnanda,151823105,VNKE01002040.1,1,1106,7.28479e-06,151497195,0.997853
D.bunnanda,151823105,VNKE01001679.1,1,1106,7.28479e-06,151498301,0.997861
D.bunnanda,151823105,VNKE01000651.1,1,1106,7.28479e-06,151499407,0.997868
D.bunnanda,151823105,VNKE01000130.1,1,1106,7.28479e-06,151500513,0.997875
D.bunnanda,151823105,VNKE01003852.1,1,1105,7.27821e-06,151501618,0.997882
D.bunnanda,151823105,VNKE01000240.1,1,1105,7.27821e-06,151502723,0.99789
D.bunnanda,151823105,VNKE01005574.1,1,1104,7.27162e-06,151503827,0.997897
D.bunnanda,151823105,VNKE01005022.1,1,1104,7.27162e-06,151504931,0.997904
D.bunnanda,151823105,VNKE01003205.1,1,1104,7.27162e-06,151506035,0.997912
D.bunnanda,151823105,VNKE01002564.1,1,1104,7.27162e-06,151507139,0.997919
D.bunnanda,151823105,VNKE01001531.1,1,1103,7.26503e-06,151508242,0.997926
D.bunnanda,151823105,VNKE01001718.1,1,1102,7.25845e-06,151509344,0.997933
D.bunnanda,151823105,VNKE01000706.1,1,1102,7.25845e-06,151510446,0.997941
D.bunnanda,151823105,VNKE01004930.1,1,1101,7.25186e-06,151511547,0.997948
D.bunnanda,151823105,VNKE01003034.1,1,1101,7.25186e-06,151512648,0.997955
D.bunnanda,151823105,VNKE01000784.1,1,1101,7.25186e-06,151513749,0.997962
D.bunnanda,151823105,VNKE01005538.1,1,1100,7.24527e-06,151514849,0.99797
D.bunnanda,151823105,VNKE01002225.1,1,1100,7.24527e-06,151515949,0.997977
D.bunnanda,151823105,VNKE01002197.1,1,1100,7.24527e-06,151517049,0.997984
D.bunnanda,151823105,VNKE01005961.1,1,1099,7.23869e-06,151518148,0.997991
D.bunnanda,151823105,VNKE01003212.1,1,1099,7.23869e-06,151519247,0.997999
D.bunnanda,151823105,VNKE01001068.1,1,1099,7.23869e-06,151520346,0.998006
D.bunnanda,151823105,VNKE01003213.1,1,1098,7.2321e-06,151521444,0.998013
D.bunnanda,151823105,VNKE01001354.1,1,1098,7.2321e-06,151522542,0.99802
D.bunnanda,151823105,VNKE01005908.1,1,1097,7.22551e-06,151523639,0.998028
D.bunnanda,151823105,VNKE01005412.1,1,1097,7.22551e-06,151524736,0.998035
D.bunnanda,151823105,VNKE01003236.1,1,1097,7.22551e-06,151525833,0.998042
D.bunnanda,151823105,VNKE01005302.1,1,1096,7.21893e-06,151526929,0.998049
D.bunnanda,151823105,VNKE01002942.1,1,1096,7.21893e-06,151528025,0.998056
D.bunnanda,151823105,VNKE01002558.1,1,1096,7.21893e-06,151529121,0.998064
D.bunnanda,151823105,VNKE01000268.1,1,1096,7.21893e-06,151530217,0.998071
D.bunnanda,151823105,VNKE01005673.1,1,1095,7.21234e-06,151531312,0.998078
D.bunnanda,151823105,VNKE01004871.1,1,1095,7.21234e-06,151532407,0.998085
D.bunnanda,151823105,VNKE01004067.1,1,1095,7.21234e-06,151533502,0.998092
D.bunnanda,151823105,VNKE01004033.1,1,1095,7.21234e-06,151534597,0.9981
D.bunnanda,151823105,VNKE01000897.1,1,1095,7.21234e-06,151535692,0.998107
D.bunnanda,151823105,VNKE01003768.1,1,1094,7.20575e-06,151536786,0.998114
D.bunnanda,151823105,VNKE01000407.1,1,1094,7.20575e-06,151537880,0.998121
D.bunnanda,151823105,VNKE01004071.1,1,1092,7.19258e-06,151538972,0.998129
D.bunnanda,151823105,VNKE01000007.1,1,1092,7.19258e-06,151540064,0.998136
D.bunnanda,151823105,VNKE01005986.1,1,1091,7.18599e-06,151541155,0.998143
D.bunnanda,151823105,VNKE01005643.1,1,1091,7.18599e-06,151542246,0.99815
D.bunnanda,151823105,VNKE01005361.1,1,1091,7.18599e-06,151543337,0.998157
D.bunnanda,151823105,VNKE01004559.1,1,1091,7.18599e-06,151544428,0.998164
D.bunnanda,151823105,VNKE01000903.1,1,1091,7.18599e-06,151545519,0.998172
D.bunnanda,151823105,VNKE01005201.1,1,1090,7.17941e-06,151546609,0.998179
D.bunnanda,151823105,VNKE01005729.1,1,1089,7.17282e-06,151547698,0.998186
D.bunnanda,151823105,VNKE01004152.1,1,1088,7.16623e-06,151548786,0.998193
D.bunnanda,151823105,VNKE01003632.1,1,1088,7.16623e-06,151549874,0.9982
D.bunnanda,151823105,VNKE01002478.1,1,1088,7.16623e-06,151550962,0.998207
D.bunnanda,151823105,VNKE01002029.1,1,1088,7.16623e-06,151552050,0.998215
D.bunnanda,151823105,VNKE01000376.1,1,1088,7.16623e-06,151553138,0.998222
D.bunnanda,151823105,VNKE01001377.1,1,1087,7.15965e-06,151554225,0.998229
D.bunnanda,151823105,VNKE01004423.1,1,1086,7.15306e-06,151555311,0.998236
D.bunnanda,151823105,VNKE01003376.1,1,1086,7.15306e-06,151556397,0.998243
D.bunnanda,151823105,VNKE01002001.1,1,1086,7.15306e-06,151557483,0.99825
D.bunnanda,151823105,VNKE01000828.1,1,1086,7.15306e-06,151558569,0.998258
D.bunnanda,151823105,VNKE01001795.1,1,1085,7.14647e-06,151559654,0.998265
D.bunnanda,151823105,VNKE01001355.1,1,1085,7.14647e-06,151560739,0.998272
D.bunnanda,151823105,VNKE01005060.1,1,1084,7.13989e-06,151561823,0.998279
D.bunnanda,151823105,VNKE01004417.1,1,1084,7.13989e-06,151562907,0.998286
D.bunnanda,151823105,VNKE01003883.1,1,1084,7.13989e-06,151563991,0.998293
D.bunnanda,151823105,VNKE01000827.1,1,1084,7.13989e-06,151565075,0.9983
D.bunnanda,151823105,VNKE01006108.1,1,1083,7.1333e-06,151566158,0.998308
D.bunnanda,151823105,VNKE01006097.1,1,1083,7.1333e-06,151567241,0.998315
D.bunnanda,151823105,VNKE01005831.1,1,1083,7.1333e-06,151568324,0.998322
D.bunnanda,151823105,VNKE01002188.1,1,1083,7.1333e-06,151569407,0.998329
D.bunnanda,151823105,VNKE01001898.1,1,1083,7.1333e-06,151570490,0.998336
D.bunnanda,151823105,VNKE01003871.1,1,1081,7.12013e-06,151571571,0.998343
D.bunnanda,151823105,VNKE01001350.1,1,1081,7.12013e-06,151572652,0.99835
D.bunnanda,151823105,VNKE01000824.1,1,1081,7.12013e-06,151573733,0.998357
D.bunnanda,151823105,VNKE01000822.1,1,1081,7.12013e-06,151574814,0.998365
D.bunnanda,151823105,VNKE01000448.1,1,1081,7.12013e-06,151575895,0.998372
D.bunnanda,151823105,VNKE01006167.1,1,1080,7.11354e-06,151576975,0.998379
D.bunnanda,151823105,VNKE01005228.1,1,1080,7.11354e-06,151578055,0.998386
D.bunnanda,151823105,VNKE01000131.1,1,1080,7.11354e-06,151579135,0.998393
D.bunnanda,151823105,VNKE01002048.1,1,1079,7.10696e-06,151580214,0.9984
D.bunnanda,151823105,VNKE01002496.1,1,1078,7.10037e-06,151581292,0.998407
D.bunnanda,151823105,VNKE01004068.1,1,1077,7.09378e-06,151582369,0.998414
D.bunnanda,151823105,VNKE01003958.1,1,1077,7.09378e-06,151583446,0.998421
D.bunnanda,151823105,VNKE01004192.1,1,1076,7.0872e-06,151584522,0.998429
D.bunnanda,151823105,VNKE01003004.1,1,1076,7.0872e-06,151585598,0.998436
D.bunnanda,151823105,VNKE01000242.1,1,1076,7.0872e-06,151586674,0.998443
D.bunnanda,151823105,VNKE01002418.1,1,1075,7.08061e-06,151587749,0.99845
D.bunnanda,151823105,VNKE01002077.1,1,1075,7.08061e-06,151588824,0.998457
D.bunnanda,151823105,VNKE01006365.1,1,1074,7.07402e-06,151589898,0.998464
D.bunnanda,151823105,VNKE01005682.1,1,1074,7.07402e-06,151590972,0.998471
D.bunnanda,151823105,VNKE01005211.1,1,1074,7.07402e-06,151592046,0.998478
D.bunnanda,151823105,VNKE01004419.1,1,1074,7.07402e-06,151593120,0.998485
D.bunnanda,151823105,VNKE01002977.1,1,1074,7.07402e-06,151594194,0.998492
D.bunnanda,151823105,VNKE01005503.1,1,1073,7.06744e-06,151595267,0.998499
D.bunnanda,151823105,VNKE01002976.1,1,1073,7.06744e-06,151596340,0.998506
D.bunnanda,151823105,VNKE01001929.1,1,1073,7.06744e-06,151597413,0.998513
D.bunnanda,151823105,VNKE01003359.1,1,1072,7.06085e-06,151598485,0.998521
D.bunnanda,151823105,VNKE01002568.1,1,1072,7.06085e-06,151599557,0.998528
D.bunnanda,151823105,VNKE01000108.1,1,1072,7.06085e-06,151600629,0.998535
D.bunnanda,151823105,VNKE01002703.1,1,1071,7.05426e-06,151601700,0.998542
D.bunnanda,151823105,VNKE01001804.1,1,1071,7.05426e-06,151602771,0.998549
D.bunnanda,151823105,VNKE01001292.1,1,1071,7.05426e-06,151603842,0.998556
D.bunnanda,151823105,VNKE01002908.1,1,1070,7.04768e-06,151604912,0.998563
D.bunnanda,151823105,VNKE01002114.1,1,1070,7.04768e-06,151605982,0.99857
D.bunnanda,151823105,VNKE01001359.1,1,1069,7.04109e-06,151607051,0.998577
D.bunnanda,151823105,VNKE01001019.1,1,1067,7.02792e-06,151608118,0.998584
D.bunnanda,151823105,VNKE01004189.1,1,1066,7.02133e-06,151609184,0.998591
D.bunnanda,151823105,VNKE01001744.1,1,1066,7.02133e-06,151610250,0.998598
D.bunnanda,151823105,VNKE01001358.1,1,1066,7.02133e-06,151611316,0.998605
D.bunnanda,151823105,VNKE01001311.1,1,1065,7.01474e-06,151612381,0.998612
D.bunnanda,151823105,VNKE01005823.1,1,1064,7.00816e-06,151613445,0.998619
D.bunnanda,151823105,VNKE01004372.1,1,1064,7.00816e-06,151614509,0.998626
D.bunnanda,151823105,VNKE01003091.1,1,1064,7.00816e-06,151615573,0.998633
D.bunnanda,151823105,VNKE01002307.1,1,1064,7.00816e-06,151616637,0.99864
D.bunnanda,151823105,VNKE01002220.1,1,1064,7.00816e-06,151617701,0.998647
D.bunnanda,151823105,VNKE01006531.1,1,1063,7.00157e-06,151618764,0.998654
D.bunnanda,151823105,VNKE01005284.1,1,1063,7.00157e-06,151619827,0.998661
D.bunnanda,151823105,VNKE01005283.1,1,1063,7.00157e-06,151620890,0.998668
D.bunnanda,151823105,VNKE01004440.1,1,1063,7.00157e-06,151621953,0.998675
D.bunnanda,151823105,VNKE01003564.1,1,1063,7.00157e-06,151623016,0.998682
D.bunnanda,151823105,VNKE01002215.1,1,1063,7.00157e-06,151624079,0.998689
D.bunnanda,151823105,VNKE01001260.1,1,1063,7.00157e-06,151625142,0.998696
D.bunnanda,151823105,VNKE01000520.1,1,1063,7.00157e-06,151626205,0.998703
D.bunnanda,151823105,VNKE01004723.1,1,1062,6.99498e-06,151627267,0.99871
D.bunnanda,151823105,VNKE01003167.1,1,1062,6.99498e-06,151628329,0.998717
D.bunnanda,151823105,VNKE01000337.1,1,1062,6.99498e-06,151629391,0.998724
D.bunnanda,151823105,VNKE01000040.1,1,1061,6.9884e-06,151630452,0.998731
D.bunnanda,151823105,VNKE01005910.1,1,1060,6.98181e-06,151631512,0.998738
D.bunnanda,151823105,VNKE01005317.1,1,1060,6.98181e-06,151632572,0.998745
D.bunnanda,151823105,VNKE01005076.1,1,1060,6.98181e-06,151633632,0.998752
D.bunnanda,151823105,VNKE01004612.1,1,1060,6.98181e-06,151634692,0.998759
D.bunnanda,151823105,VNKE01002206.1,1,1060,6.98181e-06,151635752,0.998766
D.bunnanda,151823105,VNKE01005626.1,1,1059,6.97522e-06,151636811,0.998773
D.bunnanda,151823105,VNKE01004418.1,1,1059,6.97522e-06,151637870,0.99878
D.bunnanda,151823105,VNKE01003878.1,1,1059,6.97522e-06,151638929,0.998787
D.bunnanda,151823105,VNKE01001810.1,1,1059,6.97522e-06,151639988,0.998794
D.bunnanda,151823105,VNKE01000624.1,1,1059,6.97522e-06,151641047,0.998801
D.bunnanda,151823105,VNKE01006179.1,1,1058,6.96864e-06,151642105,0.998808
D.bunnanda,151823105,VNKE01005802.1,1,1058,6.96864e-06,151643163,0.998815
D.bunnanda,151823105,VNKE01005231.1,1,1058,6.96864e-06,151644221,0.998822
D.bunnanda,151823105,VNKE01004542.1,1,1058,6.96864e-06,151645279,0.998829
D.bunnanda,151823105,VNKE01004818.1,1,1057,6.96205e-06,151646336,0.998836
D.bunnanda,151823105,VNKE01004668.1,1,1057,6.96205e-06,151647393,0.998843
D.bunnanda,151823105,VNKE01004158.1,1,1056,6.95546e-06,151648449,0.99885
D.bunnanda,151823105,VNKE01001257.1,1,1056,6.95546e-06,151649505,0.998857
D.bunnanda,151823105,VNKE01001063.1,1,1056,6.95546e-06,151650561,0.998864
D.bunnanda,151823105,VNKE01000751.1,1,1056,6.95546e-06,151651617,0.99887
D.bunnanda,151823105,VNKE01004865.1,1,1055,6.94888e-06,151652672,0.998877
D.bunnanda,151823105,VNKE01004483.1,1,1055,6.94888e-06,151653727,0.998884
D.bunnanda,151823105,VNKE01004471.1,1,1055,6.94888e-06,151654782,0.998891
D.bunnanda,151823105,VNKE01005980.1,1,1054,6.94229e-06,151655836,0.998898
D.bunnanda,151823105,VNKE01004584.1,1,1054,6.94229e-06,151656890,0.998905
D.bunnanda,151823105,VNKE01004484.1,1,1054,6.94229e-06,151657944,0.998912
D.bunnanda,151823105,VNKE01003847.1,1,1054,6.94229e-06,151658998,0.998919
D.bunnanda,151823105,VNKE01000460.1,1,1054,6.94229e-06,151660052,0.998926
D.bunnanda,151823105,VNKE01003951.1,1,1053,6.9357e-06,151661105,0.998933
D.bunnanda,151823105,VNKE01001160.1,1,1053,6.9357e-06,151662158,0.99894
D.bunnanda,151823105,VNKE01003166.1,1,1052,6.92912e-06,151663210,0.998947
D.bunnanda,151823105,VNKE01002754.1,1,1052,6.92912e-06,151664262,0.998954
D.bunnanda,151823105,VNKE01001310.1,1,1052,6.92912e-06,151665314,0.998961
D.bunnanda,151823105,VNKE01000663.1,1,1052,6.92912e-06,151666366,0.998968
D.bunnanda,151823105,VNKE01000375.1,1,1052,6.92912e-06,151667418,0.998975
D.bunnanda,151823105,VNKE01000305.1,1,1052,6.92912e-06,151668470,0.998981
D.bunnanda,151823105,VNKE01002185.1,1,1051,6.92253e-06,151669521,0.998988
D.bunnanda,151823105,VNKE01006047.1,1,1050,6.91594e-06,151670571,0.998995
D.bunnanda,151823105,VNKE01004478.1,1,1050,6.91594e-06,151671621,0.999002
D.bunnanda,151823105,VNKE01002559.1,1,1050,6.91594e-06,151672671,0.999009
D.bunnanda,151823105,VNKE01004151.1,1,1049,6.90936e-06,151673720,0.999016
D.bunnanda,151823105,VNKE01002347.1,1,1049,6.90936e-06,151674769,0.999023
D.bunnanda,151823105,VNKE01005634.1,1,1048,6.90277e-06,151675817,0.99903
D.bunnanda,151823105,VNKE01002926.1,1,1048,6.90277e-06,151676865,0.999037
D.bunnanda,151823105,VNKE01002179.1,1,1048,6.90277e-06,151677913,0.999044
D.bunnanda,151823105,VNKE01003802.1,1,1047,6.89618e-06,151678960,0.999051
D.bunnanda,151823105,VNKE01001941.1,1,1047,6.89618e-06,151680007,0.999057
D.bunnanda,151823105,VNKE01004479.1,1,1046,6.8896e-06,151681053,0.999064
D.bunnanda,151823105,VNKE01005967.1,1,1045,6.88301e-06,151682098,0.999071
D.bunnanda,151823105,VNKE01005378.1,1,1045,6.88301e-06,151683143,0.999078
D.bunnanda,151823105,VNKE01003520.1,1,1045,6.88301e-06,151684188,0.999085
D.bunnanda,151823105,VNKE01002917.1,1,1045,6.88301e-06,151685233,0.999092
D.bunnanda,151823105,VNKE01006103.1,1,1044,6.87642e-06,151686277,0.999099
D.bunnanda,151823105,VNKE01004480.1,1,1044,6.87642e-06,151687321,0.999106
D.bunnanda,151823105,VNKE01001822.1,1,1044,6.87642e-06,151688365,0.999113
D.bunnanda,151823105,VNKE01004481.1,1,1043,6.86984e-06,151689408,0.999119
D.bunnanda,151823105,VNKE01000904.1,1,1043,6.86984e-06,151690451,0.999126
D.bunnanda,151823105,VNKE01004550.1,1,1042,6.86325e-06,151691493,0.999133
D.bunnanda,151823105,VNKE01005877.1,1,1041,6.85666e-06,151692534,0.99914
D.bunnanda,151823105,VNKE01003234.1,1,1041,6.85666e-06,151693575,0.999147
D.bunnanda,151823105,VNKE01000342.1,1,1041,6.85666e-06,151694616,0.999154
D.bunnanda,151823105,VNKE01004646.1,1,1040,6.85008e-06,151695656,0.999161
D.bunnanda,151823105,VNKE01004487.1,1,1040,6.85008e-06,151696696,0.999167
D.bunnanda,151823105,VNKE01004486.1,1,1040,6.85008e-06,151697736,0.999174
D.bunnanda,151823105,VNKE01003747.1,1,1040,6.85008e-06,151698776,0.999181
D.bunnanda,151823105,VNKE01003724.1,1,1040,6.85008e-06,151699816,0.999188
D.bunnanda,151823105,VNKE01004849.1,1,1039,6.84349e-06,151700855,0.999195
D.bunnanda,151823105,VNKE01002221.1,1,1039,6.84349e-06,151701894,0.999202
D.bunnanda,151823105,VNKE01006505.1,1,1038,6.8369e-06,151702932,0.999208
D.bunnanda,151823105,VNKE01005912.1,1,1037,6.83032e-06,151703969,0.999215
D.bunnanda,151823105,VNKE01005104.1,1,1037,6.83032e-06,151705006,0.999222
D.bunnanda,151823105,VNKE01004625.1,1,1037,6.83032e-06,151706043,0.999229
D.bunnanda,151823105,VNKE01006385.1,1,1036,6.82373e-06,151707079,0.999236
D.bunnanda,151823105,VNKE01006312.1,1,1036,6.82373e-06,151708115,0.999243
D.bunnanda,151823105,VNKE01005797.1,1,1036,6.82373e-06,151709151,0.999249
D.bunnanda,151823105,VNKE01005431.1,1,1036,6.82373e-06,151710187,0.999256
D.bunnanda,151823105,VNKE01005398.1,1,1036,6.82373e-06,151711223,0.999263
D.bunnanda,151823105,VNKE01004002.1,1,1036,6.82373e-06,151712259,0.99927
D.bunnanda,151823105,VNKE01003185.1,1,1036,6.82373e-06,151713295,0.999277
D.bunnanda,151823105,VNKE01002802.1,1,1036,6.82373e-06,151714331,0.999284
D.bunnanda,151823105,VNKE01002311.1,1,1036,6.82373e-06,151715367,0.99929
D.bunnanda,151823105,VNKE01001715.1,1,1036,6.82373e-06,151716403,0.999297
D.bunnanda,151823105,VNKE01001566.1,1,1036,6.82373e-06,151717439,0.999304
D.bunnanda,151823105,VNKE01005674.1,1,1034,6.81056e-06,151718473,0.999311
D.bunnanda,151823105,VNKE01001671.1,1,1034,6.81056e-06,151719507,0.999318
D.bunnanda,151823105,VNKE01000668.1,1,1034,6.81056e-06,151720541,0.999324
D.bunnanda,151823105,VNKE01001986.1,1,1033,6.80397e-06,151721574,0.999331
D.bunnanda,151823105,VNKE01006227.1,1,1032,6.79738e-06,151722606,0.999338
D.bunnanda,151823105,VNKE01003829.1,1,1032,6.79738e-06,151723638,0.999345
D.bunnanda,151823105,VNKE01005396.1,1,1031,6.7908e-06,151724669,0.999352
D.bunnanda,151823105,VNKE01004355.1,1,1031,6.7908e-06,151725700,0.999358
D.bunnanda,151823105,VNKE01003932.1,1,1031,6.7908e-06,151726731,0.999365
D.bunnanda,151823105,VNKE01004393.1,1,1030,6.78421e-06,151727761,0.999372
D.bunnanda,151823105,VNKE01001419.1,1,1030,6.78421e-06,151728791,0.999379
D.bunnanda,151823105,VNKE01001034.1,1,1030,6.78421e-06,151729821,0.999386
D.bunnanda,151823105,VNKE01000032.1,1,1030,6.78421e-06,151730851,0.999392
D.bunnanda,151823105,VNKE01005397.1,1,1029,6.77762e-06,151731880,0.999399
D.bunnanda,151823105,VNKE01005501.1,1,1028,6.77104e-06,151732908,0.999406
D.bunnanda,151823105,VNKE01003983.1,1,1028,6.77104e-06,151733936,0.999413
D.bunnanda,151823105,VNKE01002308.1,1,1028,6.77104e-06,151734964,0.999419
D.bunnanda,151823105,VNKE01004512.1,1,1027,6.76445e-06,151735991,0.999426
D.bunnanda,151823105,VNKE01006542.1,1,1026,6.75786e-06,151737017,0.999433
D.bunnanda,151823105,VNKE01006251.1,1,1026,6.75786e-06,151738043,0.99944
D.bunnanda,151823105,VNKE01004030.1,1,1025,6.75128e-06,151739068,0.999446
D.bunnanda,151823105,VNKE01005783.1,1,1024,6.74469e-06,151740092,0.999453
D.bunnanda,151823105,VNKE01005732.1,1,1024,6.74469e-06,151741116,0.99946
D.bunnanda,151823105,VNKE01001044.1,1,1023,6.7381e-06,151742139,0.999467
D.bunnanda,151823105,VNKE01000519.1,1,1023,6.7381e-06,151743162,0.999473
D.bunnanda,151823105,VNKE01006517.1,1,1022,6.73152e-06,151744184,0.99948
D.bunnanda,151823105,VNKE01005395.1,1,1022,6.73152e-06,151745206,0.999487
D.bunnanda,151823105,VNKE01005392.1,1,1022,6.73152e-06,151746228,0.999494
D.bunnanda,151823105,VNKE01005246.1,1,1022,6.73152e-06,151747250,0.9995
D.bunnanda,151823105,VNKE01003801.1,1,1022,6.73152e-06,151748272,0.999507
D.bunnanda,151823105,VNKE01002428.1,1,1022,6.73152e-06,151749294,0.999514
D.bunnanda,151823105,VNKE01006033.1,1,1021,6.72493e-06,151750315,0.999521
D.bunnanda,151823105,VNKE01005393.1,1,1021,6.72493e-06,151751336,0.999527
D.bunnanda,151823105,VNKE01005200.1,1,1021,6.72493e-06,151752357,0.999534
D.bunnanda,151823105,VNKE01001927.1,1,1021,6.72493e-06,151753378,0.999541
D.bunnanda,151823105,VNKE01001487.1,1,1021,6.72493e-06,151754399,0.999547
D.bunnanda,151823105,VNKE01005202.1,1,1020,6.71835e-06,151755419,0.999554
D.bunnanda,151823105,VNKE01004910.1,1,1020,6.71835e-06,151756439,0.999561
D.bunnanda,151823105,VNKE01003946.1,1,1020,6.71835e-06,151757459,0.999568
D.bunnanda,151823105,VNKE01001254.1,1,1020,6.71835e-06,151758479,0.999574
D.bunnanda,151823105,VNKE01001037.1,1,1020,6.71835e-06,151759499,0.999581
D.bunnanda,151823105,VNKE01000080.1,1,1020,6.71835e-06,151760519,0.999588
D.bunnanda,151823105,VNKE01006587.1,1,1019,6.71176e-06,151761538,0.999594
D.bunnanda,151823105,VNKE01006518.1,1,1019,6.71176e-06,151762557,0.999601
D.bunnanda,151823105,VNKE01006386.1,1,1019,6.71176e-06,151763576,0.999608
D.bunnanda,151823105,VNKE01001421.1,1,1019,6.71176e-06,151764595,0.999615
D.bunnanda,151823105,VNKE01004662.1,1,1018,6.70517e-06,151765613,0.999621
D.bunnanda,151823105,VNKE01005627.1,1,1016,6.692e-06,151766629,0.999628
D.bunnanda,151823105,VNKE01003851.1,1,1016,6.692e-06,151767645,0.999635
D.bunnanda,151823105,VNKE01001876.1,1,1016,6.692e-06,151768661,0.999641
D.bunnanda,151823105,VNKE01000839.1,1,1016,6.692e-06,151769677,0.999648
D.bunnanda,151823105,VNKE01005737.1,1,1015,6.68541e-06,151770692,0.999655
D.bunnanda,151823105,VNKE01004271.1,1,1015,6.68541e-06,151771707,0.999661
D.bunnanda,151823105,VNKE01002767.1,1,1015,6.68541e-06,151772722,0.999668
D.bunnanda,151823105,VNKE01005401.1,1,1014,6.67883e-06,151773736,0.999675
D.bunnanda,151823105,VNKE01004188.1,1,1014,6.67883e-06,151774750,0.999682
D.bunnanda,151823105,VNKE01003364.1,1,1014,6.67883e-06,151775764,0.999688
D.bunnanda,151823105,VNKE01003235.1,1,1014,6.67883e-06,151776778,0.999695
D.bunnanda,151823105,VNKE01003163.1,1,1013,6.67224e-06,151777791,0.999702
D.bunnanda,151823105,VNKE01001381.1,1,1013,6.67224e-06,151778804,0.999708
D.bunnanda,151823105,VNKE01001261.1,1,1013,6.67224e-06,151779817,0.999715
D.bunnanda,151823105,VNKE01000560.1,1,1013,6.67224e-06,151780830,0.999722
D.bunnanda,151823105,VNKE01006635.1,1,1011,6.65907e-06,151781841,0.999728
D.bunnanda,151823105,VNKE01002744.1,1,1011,6.65907e-06,151782852,0.999735
D.bunnanda,151823105,VNKE01002168.1,1,1011,6.65907e-06,151783863,0.999742
D.bunnanda,151823105,VNKE01006105.1,1,1010,6.65248e-06,151784873,0.999748
D.bunnanda,151823105,VNKE01005809.1,1,1010,6.65248e-06,151785883,0.999755
D.bunnanda,151823105,VNKE01004611.1,1,1010,6.65248e-06,151786893,0.999761
D.bunnanda,151823105,VNKE01003033.1,1,1010,6.65248e-06,151787903,0.999768
D.bunnanda,151823105,VNKE01002170.1,1,1010,6.65248e-06,151788913,0.999775
D.bunnanda,151823105,VNKE01002167.1,1,1010,6.65248e-06,151789923,0.999781
D.bunnanda,151823105,VNKE01001928.1,1,1010,6.65248e-06,151790933,0.999788
D.bunnanda,151823105,VNKE01001422.1,1,1010,6.65248e-06,151791943,0.999795
D.bunnanda,151823105,VNKE01001218.1,1,1010,6.65248e-06,151792953,0.999801
D.bunnanda,151823105,VNKE01005690.1,1,1009,6.64589e-06,151793962,0.999808
D.bunnanda,151823105,VNKE01003949.1,1,1009,6.64589e-06,151794971,0.999815
D.bunnanda,151823105,VNKE01002169.1,1,1009,6.64589e-06,151795980,0.999821
D.bunnanda,151823105,VNKE01000845.1,1,1009,6.64589e-06,151796989,0.999828
D.bunnanda,151823105,VNKE01000450.1,1,1009,6.64589e-06,151797998,0.999835
D.bunnanda,151823105,VNKE01004412.1,1,1008,6.63931e-06,151799006,0.999841
D.bunnanda,151823105,VNKE01002327.1,1,1008,6.63931e-06,151800014,0.999848
D.bunnanda,151823105,VNKE01002321.1,1,1008,6.63931e-06,151801022,0.999855
D.bunnanda,151823105,VNKE01001678.1,1,1008,6.63931e-06,151802030,0.999861
D.bunnanda,151823105,VNKE01004600.1,1,1007,6.63272e-06,151803037,0.999868
D.bunnanda,151823105,VNKE01003410.1,1,1007,6.63272e-06,151804044,0.999874
D.bunnanda,151823105,VNKE01002602.1,1,1007,6.63272e-06,151805051,0.999881
D.bunnanda,151823105,VNKE01001499.1,1,1007,6.63272e-06,151806058,0.999888
D.bunnanda,151823105,VNKE01006614.1,1,1006,6.62613e-06,151807064,0.999894
D.bunnanda,151823105,VNKE01002171.1,1,1006,6.62613e-06,151808070,0.999901
D.bunnanda,151823105,VNKE01001496.1,1,1005,6.61955e-06,151809075,0.999908
D.bunnanda,151823105,VNKE01002283.1,1,1004,6.61296e-06,151810079,0.999914
D.bunnanda,151823105,VNKE01001364.1,1,1004,6.61296e-06,151811083,0.999921
D.bunnanda,151823105,VNKE01000902.1,1,1004,6.61296e-06,151812087,0.999927
D.bunnanda,151823105,VNKE01005926.1,1,1003,6.60637e-06,151813090,0.999934
D.bunnanda,151823105,VNKE01000150.1,1,1003,6.60637e-06,151814093,0.999941
D.bunnanda,151823105,VNKE01006337.1,1,1002,6.59979e-06,151815095,0.999947
D.bunnanda,151823105,VNKE01006239.1,1,1002,6.59979e-06,151816097,0.999954
D.bunnanda,151823105,VNKE01006181.1,1,1002,6.59979e-06,151817099,0.99996
D.bunnanda,151823105,VNKE01004851.1,1,1002,6.59979e-06,151818101,0.999967
D.bunnanda,151823105,VNKE01002174.1,1,1002,6.59979e-06,151819103,0.999974
D.bunnanda,151823105,VNKE01004349.1,1,1001,6.5932e-06,151820104,0.99998
D.bunnanda,151823105,VNKE01001268.1,1,1001,6.5932e-06,151821105,0.999987
D.bunnanda,151823105,VNKE01006453.1,1,1000,6.58661e-06,151822105,0.999993
D.bunnanda,151823105,VNKE01006238.1,1,1000,6.58661e-06,151823105,1
D.birchii,156593892,VNKA01006283.1,1,1501252,0.00958691,1501252,0.00958691
D.birchii,156593892,VNKA01002603.1,1,1130458,0.00721904,2631710,0.016806
D.birchii,156593892,VNKA01004934.1,1,1082546,0.00691308,3714256,0.023719
D.birchii,156593892,VNKA01002936.1,1,982675,0.00627531,4696931,0.0299943
D.birchii,156593892,VNKA01003715.1,1,942106,0.00601624,5639037,0.0360106
D.birchii,156593892,VNKA01003713.1,1,837845,0.00535043,6476882,0.041361
D.birchii,156593892,VNKA01007461.1,1,828743,0.00529231,7305625,0.0466533
D.birchii,156593892,VNKA01000023.1,1,809269,0.00516795,8114894,0.0518213
D.birchii,156593892,VNKA01007250.1,1,782974,0.00500003,8897868,0.0568213
D.birchii,156593892,VNKA01005635.1,1,780388,0.00498351,9678256,0.0618048
D.birchii,156593892,VNKA01000463.1,1,770555,0.00492072,10448811,0.0667255
D.birchii,156593892,VNKA01006431.1,1,769227,0.00491224,11218038,0.0716378
D.birchii,156593892,VNKA01003431.1,1,746283,0.00476572,11964321,0.0764035
D.birchii,156593892,VNKA01005364.1,1,742185,0.00473955,12706506,0.081143
D.birchii,156593892,VNKA01000216.1,1,739781,0.0047242,13446287,0.0858673
D.birchii,156593892,VNKA01004124.1,1,715620,0.00456991,14161907,0.0904372
D.birchii,156593892,VNKA01001030.1,1,707601,0.0045187,14869508,0.0949559
D.birchii,156593892,VNKA01002107.1,1,703129,0.00449014,15572637,0.099446
D.birchii,156593892,VNKA01003542.1,1,700272,0.0044719,16272909,0.103918
D.birchii,156593892,VNKA01004349.1,1,691282,0.00441449,16964191,0.108332
D.birchii,156593892,VNKA01002297.1,1,672902,0.00429712,17637093,0.11263
D.birchii,156593892,VNKA01005462.1,1,663528,0.00423725,18300621,0.116867
D.birchii,156593892,VNKA01006054.1,1,657525,0.00419892,18958146,0.121066
D.birchii,156593892,VNKA01002198.1,1,655320,0.00418484,19613466,0.125251
D.birchii,156593892,VNKA01002195.1,1,632905,0.0040417,20246371,0.129292
D.birchii,156593892,VNKA01002447.1,1,623701,0.00398292,20870072,0.133275
D.birchii,156593892,VNKA01000166.1,1,616924,0.00393964,21486996,0.137215
D.birchii,156593892,VNKA01005215.1,1,608077,0.00388315,22095073,0.141098
D.birchii,156593892,VNKA01003121.1,1,594997,0.00379962,22690070,0.144898
D.birchii,156593892,VNKA01004657.1,1,583118,0.00372376,23273188,0.148621
D.birchii,156593892,VNKA01004361.1,1,571176,0.0036475,23844364,0.152269
D.birchii,156593892,VNKA01006436.1,1,570631,0.00364402,24414995,0.155913
D.birchii,156593892,VNKA01000633.1,1,566569,0.00361808,24981564,0.159531
D.birchii,156593892,VNKA01004828.1,1,566328,0.00361654,25547892,0.163147
D.birchii,156593892,VNKA01002064.1,1,564533,0.00360508,26112425,0.166753
D.birchii,156593892,VNKA01002643.1,1,563789,0.00360033,26676214,0.170353
D.birchii,156593892,VNKA01006138.1,1,555096,0.00354481,27231310,0.173898
D.birchii,156593892,VNKA01003065.1,1,545873,0.00348592,27777183,0.177384
D.birchii,156593892,VNKA01002488.1,1,542222,0.0034626,28319405,0.180846
D.birchii,156593892,VNKA01000571.1,1,530622,0.00338852,28850027,0.184235
D.birchii,156593892,VNKA01002735.1,1,525747,0.00335739,29375774,0.187592
D.birchii,156593892,VNKA01005600.1,1,521471,0.00333009,29897245,0.190922
D.birchii,156593892,VNKA01001010.1,1,519924,0.00332021,30417169,0.194242
D.birchii,156593892,VNKA01005595.1,1,517429,0.00330427,30934598,0.197547
D.birchii,156593892,VNKA01006056.1,1,517288,0.00330337,31451886,0.20085
D.birchii,156593892,VNKA01005958.1,1,516706,0.00329966,31968592,0.20415
D.birchii,156593892,VNKA01002744.1,1,516191,0.00329637,32484783,0.207446
D.birchii,156593892,VNKA01002606.1,1,515433,0.00329153,33000216,0.210738
D.birchii,156593892,VNKA01000253.1,1,504383,0.00322096,33504599,0.213959
D.birchii,156593892,VNKA01001903.1,1,504275,0.00322027,34008874,0.217179
D.birchii,156593892,VNKA01004165.1,1,503063,0.00321253,34511937,0.220391
D.birchii,156593892,VNKA01006139.1,1,502997,0.00321211,35014934,0.223603
D.birchii,156593892,VNKA01004253.1,1,494168,0.00315573,35509102,0.226759
D.birchii,156593892,VNKA01000710.1,1,491700,0.00313997,36000802,0.229899
D.birchii,156593892,VNKA01001025.1,1,471435,0.00301056,36472237,0.23291
D.birchii,156593892,VNKA01001287.1,1,466879,0.00298146,36939116,0.235891
D.birchii,156593892,VNKA01005502.1,1,466297,0.00297775,37405413,0.238869
D.birchii,156593892,VNKA01000641.1,1,465741,0.0029742,37871154,0.241843
D.birchii,156593892,VNKA01001820.1,1,464096,0.00296369,38335250,0.244807
D.birchii,156593892,VNKA01003710.1,1,463050,0.00295701,38798300,0.247764
D.birchii,156593892,VNKA01004745.1,1,462745,0.00295506,39261045,0.250719
D.birchii,156593892,VNKA01002789.1,1,461210,0.00294526,39722255,0.253664
D.birchii,156593892,VNKA01005548.1,1,452585,0.00289018,40174840,0.256554
D.birchii,156593892,VNKA01007424.1,1,451040,0.00288032,40625880,0.259435
D.birchii,156593892,VNKA01001141.1,1,449783,0.00287229,41075663,0.262307
D.birchii,156593892,VNKA01000711.1,1,448765,0.00286579,41524428,0.265173
D.birchii,156593892,VNKA01004170.1,1,446230,0.0028496,41970658,0.268022
D.birchii,156593892,VNKA01002605.1,1,443781,0.00283396,42414439,0.270856
D.birchii,156593892,VNKA01002202.1,1,437168,0.00279173,42851607,0.273648
D.birchii,156593892,VNKA01004166.1,1,435166,0.00277895,43286773,0.276427
D.birchii,156593892,VNKA01005554.1,1,431512,0.00275561,43718285,0.279183
D.birchii,156593892,VNKA01001492.1,1,429175,0.00274069,44147460,0.281923
D.birchii,156593892,VNKA01002199.1,1,426666,0.00272467,44574126,0.284648
D.birchii,156593892,VNKA01000031.1,1,420654,0.00268627,44994780,0.287334
D.birchii,156593892,VNKA01001937.1,1,420193,0.00268333,45414973,0.290018
D.birchii,156593892,VNKA01003642.1,1,417862,0.00266844,45832835,0.292686
D.birchii,156593892,VNKA01003956.1,1,415278,0.00265194,46248113,0.295338
D.birchii,156593892,VNKA01000752.1,1,413663,0.00264163,46661776,0.29798
D.birchii,156593892,VNKA01003461.1,1,406986,0.00259899,47068762,0.300579
D.birchii,156593892,VNKA01007256.1,1,398102,0.00254226,47466864,0.303121
D.birchii,156593892,VNKA01002710.1,1,396619,0.00253279,47863483,0.305654
D.birchii,156593892,VNKA01002278.1,1,396526,0.00253219,48260009,0.308186
D.birchii,156593892,VNKA01001789.1,1,394717,0.00252064,48654726,0.310706
D.birchii,156593892,VNKA01002194.1,1,391263,0.00249858,49045989,0.313205
D.birchii,156593892,VNKA01005436.1,1,382940,0.00244543,49428929,0.31565
D.birchii,156593892,VNKA01004075.1,1,381813,0.00243824,49810742,0.318089
D.birchii,156593892,VNKA01002581.1,1,380594,0.00243045,50191336,0.320519
D.birchii,156593892,VNKA01000631.1,1,378659,0.0024181,50569995,0.322937
D.birchii,156593892,VNKA01000219.1,1,375207,0.00239605,50945202,0.325333
D.birchii,156593892,VNKA01000307.1,1,371819,0.00237442,51317021,0.327708
D.birchii,156593892,VNKA01005573.1,1,368130,0.00235086,51685151,0.330059
D.birchii,156593892,VNKA01005552.1,1,367982,0.00234991,52053133,0.332408
D.birchii,156593892,VNKA01004429.1,1,365512,0.00233414,52418645,0.334743
D.birchii,156593892,VNKA01001825.1,1,361840,0.00231069,52780485,0.337053
D.birchii,156593892,VNKA01002486.1,1,361778,0.00231029,53142263,0.339364
D.birchii,156593892,VNKA01006142.1,1,360854,0.00230439,53503117,0.341668
D.birchii,156593892,VNKA01006188.1,1,357896,0.0022855,53861013,0.343953
D.birchii,156593892,VNKA01000077.1,1,353660,0.00225845,54214673,0.346212
D.birchii,156593892,VNKA01007167.1,1,352345,0.00225006,54567018,0.348462
D.birchii,156593892,VNKA01005431.1,1,350345,0.00223728,54917363,0.350699
D.birchii,156593892,VNKA01005892.1,1,349987,0.002235,55267350,0.352934
D.birchii,156593892,VNKA01003401.1,1,347957,0.00222203,55615307,0.355156
D.birchii,156593892,VNKA01001283.1,1,342628,0.002188,55957935,0.357344
D.birchii,156593892,VNKA01000443.1,1,338501,0.00216165,56296436,0.359506
D.birchii,156593892,VNKA01006430.1,1,337407,0.00215466,56633843,0.361661
D.birchii,156593892,VNKA01005666.1,1,336014,0.00214577,56969857,0.363806
D.birchii,156593892,VNKA01006184.1,1,333354,0.00212878,57303211,0.365935
D.birchii,156593892,VNKA01002109.1,1,331289,0.00211559,57634500,0.368051
D.birchii,156593892,VNKA01002031.1,1,330424,0.00211007,57964924,0.370161
D.birchii,156593892,VNKA01005792.1,1,329008,0.00210103,58293932,0.372262
D.birchii,156593892,VNKA01000250.1,1,328439,0.00209739,58622371,0.374359
D.birchii,156593892,VNKA01002105.1,1,326333,0.00208394,58948704,0.376443
D.birchii,156593892,VNKA01002832.1,1,325982,0.0020817,59274686,0.378525
D.birchii,156593892,VNKA01000018.1,1,324998,0.00207542,59599684,0.3806
D.birchii,156593892,VNKA01003213.1,1,321581,0.0020536,59921265,0.382654
D.birchii,156593892,VNKA01005789.1,1,321184,0.00205106,60242449,0.384705
D.birchii,156593892,VNKA01006521.1,1,320283,0.00204531,60562732,0.38675
D.birchii,156593892,VNKA01001821.1,1,319707,0.00204163,60882439,0.388792
D.birchii,156593892,VNKA01003454.1,1,318923,0.00203662,61201362,0.390829
D.birchii,156593892,VNKA01006137.1,1,316601,0.0020218,61517963,0.39285
D.birchii,156593892,VNKA01005130.1,1,316365,0.00202029,61834328,0.394871
D.birchii,156593892,VNKA01005893.1,1,315170,0.00201266,62149498,0.396883
D.birchii,156593892,VNKA01000987.1,1,314627,0.00200919,62464125,0.398892
D.birchii,156593892,VNKA01000465.1,1,312376,0.00199482,62776501,0.400887
D.birchii,156593892,VNKA01000469.1,1,308708,0.00197139,63085209,0.402859
D.birchii,156593892,VNKA01003703.1,1,308328,0.00196897,63393537,0.404828
D.birchii,156593892,VNKA01005447.1,1,306847,0.00195951,63700384,0.406787
D.birchii,156593892,VNKA01003127.1,1,306429,0.00195684,64006813,0.408744
D.birchii,156593892,VNKA01006493.1,1,297116,0.00189737,64303929,0.410641
D.birchii,156593892,VNKA01005700.1,1,292766,0.00186959,64596695,0.412511
D.birchii,156593892,VNKA01001284.1,1,291834,0.00186364,64888529,0.414375
D.birchii,156593892,VNKA01001827.1,1,290416,0.00185458,65178945,0.416229
D.birchii,156593892,VNKA01001717.1,1,289029,0.00184572,65467974,0.418075
D.birchii,156593892,VNKA01002103.1,1,287895,0.00183848,65755869,0.419913
D.birchii,156593892,VNKA01003772.1,1,287882,0.0018384,66043751,0.421752
D.birchii,156593892,VNKA01003691.1,1,285370,0.00182236,66329121,0.423574
D.birchii,156593892,VNKA01005784.1,1,285361,0.0018223,66614482,0.425396
D.birchii,156593892,VNKA01002286.1,1,282594,0.00180463,66897076,0.427201
D.birchii,156593892,VNKA01006001.1,1,281956,0.00180056,67179032,0.429002
D.birchii,156593892,VNKA01004785.1,1,280472,0.00179108,67459504,0.430793
D.birchii,156593892,VNKA01002440.1,1,278146,0.00177623,67737650,0.432569
D.birchii,156593892,VNKA01001546.1,1,276511,0.00176578,68014161,0.434335
D.birchii,156593892,VNKA01004158.1,1,275516,0.00175943,68289677,0.436094
D.birchii,156593892,VNKA01000937.1,1,275290,0.00175799,68564967,0.437852
D.birchii,156593892,VNKA01004547.1,1,274857,0.00175522,68839824,0.439607
D.birchii,156593892,VNKA01004899.1,1,274232,0.00175123,69114056,0.441359
D.birchii,156593892,VNKA01000251.1,1,273432,0.00174612,69387488,0.443105
D.birchii,156593892,VNKA01001281.1,1,273261,0.00174503,69660749,0.44485
D.birchii,156593892,VNKA01001286.1,1,272329,0.00173908,69933078,0.446589
D.birchii,156593892,VNKA01001206.1,1,267326,0.00170713,70200404,0.448296
D.birchii,156593892,VNKA01005136.1,1,267235,0.00170655,70467639,0.450002
D.birchii,156593892,VNKA01003352.1,1,267019,0.00170517,70734658,0.451708
D.birchii,156593892,VNKA01001207.1,1,265906,0.00169806,71000564,0.453406
D.birchii,156593892,VNKA01004579.1,1,263357,0.00168178,71263921,0.455087
D.birchii,156593892,VNKA01001475.1,1,263215,0.00168088,71527136,0.456768
D.birchii,156593892,VNKA01002579.1,1,262546,0.0016766,71789682,0.458445
D.birchii,156593892,VNKA01006143.1,1,261374,0.00166912,72051056,0.460114
D.birchii,156593892,VNKA01002388.1,1,261276,0.00166849,72312332,0.461783
D.birchii,156593892,VNKA01001209.1,1,261098,0.00166736,72573430,0.46345
D.birchii,156593892,VNKA01006865.1,1,260930,0.00166628,72834360,0.465116
D.birchii,156593892,VNKA01003601.1,1,258625,0.00165157,73092985,0.466768
D.birchii,156593892,VNKA01000085.1,1,256019,0.00163492,73349004,0.468403
D.birchii,156593892,VNKA01003690.1,1,255960,0.00163455,73604964,0.470037
D.birchii,156593892,VNKA01005033.1,1,254783,0.00162703,73859747,0.471664
D.birchii,156593892,VNKA01004327.1,1,254453,0.00162492,74114200,0.473289
D.birchii,156593892,VNKA01005556.1,1,253716,0.00162022,74367916,0.474909
D.birchii,156593892,VNKA01003117.1,1,252872,0.00161483,74620788,0.476524
D.birchii,156593892,VNKA01005665.1,1,252700,0.00161373,74873488,0.478138
D.birchii,156593892,VNKA01001824.1,1,251324,0.00160494,75124812,0.479743
D.birchii,156593892,VNKA01001773.1,1,250428,0.00159922,75375240,0.481342
D.birchii,156593892,VNKA01002446.1,1,249921,0.00159598,75625161,0.482938
D.birchii,156593892,VNKA01006368.1,1,249690,0.00159451,75874851,0.484533
D.birchii,156593892,VNKA01002600.1,1,248653,0.00158788,76123504,0.486121
D.birchii,156593892,VNKA01004646.1,1,247763,0.0015822,76371267,0.487703
D.birchii,156593892,VNKA01005350.1,1,246454,0.00157384,76617721,0.489277
D.birchii,156593892,VNKA01005555.1,1,245524,0.0015679,76863245,0.490844
D.birchii,156593892,VNKA01004490.1,1,245058,0.00156493,77108303,0.492409
D.birchii,156593892,VNKA01002805.1,1,244978,0.00156442,77353281,0.493974
D.birchii,156593892,VNKA01000639.1,1,244960,0.0015643,77598241,0.495538
D.birchii,156593892,VNKA01003955.1,1,244246,0.00155974,77842487,0.497098
D.birchii,156593892,VNKA01003839.1,1,243609,0.00155567,78086096,0.498654
D.birchii,156593892,VNKA01000442.1,1,242398,0.00154794,78328494,0.500201
D.birchii,156593892,VNKA01000305.1,1,241411,0.00154164,78569905,0.501743
D.birchii,156593892,VNKA01003882.1,1,241281,0.00154081,78811186,0.503284
D.birchii,156593892,VNKA01001162.1,1,240963,0.00153878,79052149,0.504823
D.birchii,156593892,VNKA01005343.1,1,240730,0.00153729,79292879,0.50636
D.birchii,156593892,VNKA01004197.1,1,239307,0.0015282,79532186,0.507888
D.birchii,156593892,VNKA01006242.1,1,237576,0.00151715,79769762,0.509405
D.birchii,156593892,VNKA01001272.1,1,236810,0.00151226,80006572,0.510918
D.birchii,156593892,VNKA01006435.1,1,236545,0.00151056,80243117,0.512428
D.birchii,156593892,VNKA01005001.1,1,236216,0.00150846,80479333,0.513937
D.birchii,156593892,VNKA01005331.1,1,235860,0.00150619,80715193,0.515443
D.birchii,156593892,VNKA01006094.1,1,235736,0.0015054,80950929,0.516948
D.birchii,156593892,VNKA01006172.1,1,234875,0.0014999,81185804,0.518448
D.birchii,156593892,VNKA01005553.1,1,230323,0.00147083,81416127,0.519919
D.birchii,156593892,VNKA01006217.1,1,230133,0.00146962,81646260,0.521389
D.birchii,156593892,VNKA01004931.1,1,229191,0.0014636,81875451,0.522852
D.birchii,156593892,VNKA01004702.1,1,229091,0.00146296,82104542,0.524315
D.birchii,156593892,VNKA01001389.1,1,225925,0.00144274,82330467,0.525758
D.birchii,156593892,VNKA01000249.1,1,224444,0.00143329,82554911,0.527191
D.birchii,156593892,VNKA01006873.1,1,223148,0.00142501,82778059,0.528616
D.birchii,156593892,VNKA01000080.1,1,221519,0.00141461,82999578,0.530031
D.birchii,156593892,VNKA01001502.1,1,219200,0.0013998,83218778,0.531431
D.birchii,156593892,VNKA01005701.1,1,217903,0.00139152,83436681,0.532822
D.birchii,156593892,VNKA01001553.1,1,215499,0.00137616,83652180,0.534198
D.birchii,156593892,VNKA01004877.1,1,214713,0.00137115,83866893,0.535569
D.birchii,156593892,VNKA01006609.1,1,213880,0.00136583,84080773,0.536935
D.birchii,156593892,VNKA01001550.1,1,212604,0.00135768,84293377,0.538293
D.birchii,156593892,VNKA01007434.1,1,212219,0.00135522,84505596,0.539648
D.birchii,156593892,VNKA01005549.1,1,211718,0.00135202,84717314,0.541
D.birchii,156593892,VNKA01004855.1,1,211000,0.00134743,84928314,0.542348
D.birchii,156593892,VNKA01000218.1,1,209731,0.00133933,85138045,0.543687
D.birchii,156593892,VNKA01004254.1,1,209165,0.00133572,85347210,0.545023
D.birchii,156593892,VNKA01005572.1,1,209028,0.00133484,85556238,0.546357
D.birchii,156593892,VNKA01004452.1,1,208755,0.0013331,85764993,0.547691
D.birchii,156593892,VNKA01002902.1,1,208576,0.00133195,85973569,0.549022
D.birchii,156593892,VNKA01001593.1,1,207515,0.00132518,86181084,0.550348
D.birchii,156593892,VNKA01005158.1,1,207248,0.00132347,86388332,0.551671
D.birchii,156593892,VNKA01007108.1,1,207053,0.00132223,86595385,0.552993
D.birchii,156593892,VNKA01002485.1,1,206411,0.00131813,86801796,0.554312
D.birchii,156593892,VNKA01004671.1,1,206273,0.00131725,87008069,0.555629
D.birchii,156593892,VNKA01005709.1,1,205375,0.00131151,87213444,0.55694
D.birchii,156593892,VNKA01006121.1,1,205361,0.00131142,87418805,0.558252
D.birchii,156593892,VNKA01003124.1,1,205129,0.00130994,87623934,0.559562
D.birchii,156593892,VNKA01006629.1,1,204247,0.00130431,87828181,0.560866
D.birchii,156593892,VNKA01000427.1,1,204216,0.00130411,88032397,0.56217
D.birchii,156593892,VNKA01004927.1,1,203984,0.00130263,88236381,0.563473
D.birchii,156593892,VNKA01002666.1,1,203903,0.00130211,88440284,0.564775
D.birchii,156593892,VNKA01005328.1,1,203514,0.00129963,88643798,0.566074
D.birchii,156593892,VNKA01002066.1,1,203167,0.00129741,88846965,0.567372
D.birchii,156593892,VNKA01003287.1,1,203084,0.00129688,89050049,0.568669
D.birchii,156593892,VNKA01003066.1,1,201455,0.00128648,89251504,0.569955
D.birchii,156593892,VNKA01005596.1,1,200973,0.0012834,89452477,0.571239
D.birchii,156593892,VNKA01004933.1,1,200077,0.00127768,89652554,0.572516
D.birchii,156593892,VNKA01000268.1,1,199659,0.00127501,89852213,0.573791
D.birchii,156593892,VNKA01006136.1,1,198083,0.00126495,90050296,0.575056
D.birchii,156593892,VNKA01001321.1,1,197494,0.00126119,90247790,0.576317
D.birchii,156593892,VNKA01001400.1,1,196518,0.00125495,90444308,0.577572
D.birchii,156593892,VNKA01007119.1,1,191417,0.00122238,90635725,0.578795
D.birchii,156593892,VNKA01004495.1,1,191300,0.00122163,90827025,0.580016
D.birchii,156593892,VNKA01001940.1,1,190825,0.0012186,91017850,0.581235
D.birchii,156593892,VNKA01004645.1,1,190444,0.00121616,91208294,0.582451
D.birchii,156593892,VNKA01001280.1,1,189629,0.00121096,91397923,0.583662
D.birchii,156593892,VNKA01006427.1,1,188095,0.00120116,91586018,0.584863
D.birchii,156593892,VNKA01000078.1,1,187733,0.00119885,91773751,0.586062
D.birchii,156593892,VNKA01006890.1,1,185465,0.00118437,91959216,0.587247
D.birchii,156593892,VNKA01005624.1,1,185309,0.00118337,92144525,0.58843
D.birchii,156593892,VNKA01002201.1,1,183991,0.00117496,92328516,0.589605
D.birchii,156593892,VNKA01001833.1,1,182774,0.00116718,92511290,0.590772
D.birchii,156593892,VNKA01001641.1,1,182696,0.00116669,92693986,0.591939
D.birchii,156593892,VNKA01002439.1,1,182672,0.00116653,92876658,0.593105
D.birchii,156593892,VNKA01001501.1,1,181239,0.00115738,93057897,0.594263
D.birchii,156593892,VNKA01005162.1,1,180930,0.00115541,93238827,0.595418
D.birchii,156593892,VNKA01000015.1,1,180253,0.00115109,93419080,0.596569
D.birchii,156593892,VNKA01005129.1,1,180187,0.00115066,93599267,0.59772
D.birchii,156593892,VNKA01001208.1,1,179192,0.00114431,93778459,0.598864
D.birchii,156593892,VNKA01001730.1,1,176835,0.00112926,93955294,0.599993
D.birchii,156593892,VNKA01004155.1,1,176635,0.00112798,94131929,0.601121
D.birchii,156593892,VNKA01000988.1,1,176045,0.00112421,94307974,0.602246
D.birchii,156593892,VNKA01002660.1,1,175641,0.00112163,94483615,0.603367
D.birchii,156593892,VNKA01004351.1,1,175167,0.00111861,94658782,0.604486
D.birchii,156593892,VNKA01004775.1,1,174620,0.00111511,94833402,0.605601
D.birchii,156593892,VNKA01001343.1,1,174243,0.00111271,95007645,0.606714
D.birchii,156593892,VNKA01001481.1,1,173441,0.00110758,95181086,0.607821
D.birchii,156593892,VNKA01006973.1,1,172731,0.00110305,95353817,0.608924
D.birchii,156593892,VNKA01004936.1,1,172443,0.00110121,95526260,0.610025
D.birchii,156593892,VNKA01002580.1,1,171747,0.00109677,95698007,0.611122
D.birchii,156593892,VNKA01003377.1,1,171194,0.00109324,95869201,0.612215
D.birchii,156593892,VNKA01004932.1,1,170993,0.00109195,96040194,0.613307
D.birchii,156593892,VNKA01005979.1,1,169971,0.00108543,96210165,0.614393
D.birchii,156593892,VNKA01002934.1,1,167991,0.00107278,96378156,0.615466
D.birchii,156593892,VNKA01000302.1,1,167595,0.00107025,96545751,0.616536
D.birchii,156593892,VNKA01002133.1,1,167356,0.00106873,96713107,0.617605
D.birchii,156593892,VNKA01000897.1,1,165727,0.00105832,96878834,0.618663
D.birchii,156593892,VNKA01000446.1,1,163738,0.00104562,97042572,0.619709
D.birchii,156593892,VNKA01000940.1,1,162582,0.00103824,97205154,0.620747
D.birchii,156593892,VNKA01000180.1,1,161924,0.00103404,97367078,0.621781
D.birchii,156593892,VNKA01002933.1,1,161654,0.00103231,97528732,0.622813
D.birchii,156593892,VNKA01006066.1,1,159590,0.00101913,97688322,0.623832
D.birchii,156593892,VNKA01006611.1,1,158300,0.0010109,97846622,0.624843
D.birchii,156593892,VNKA01006007.1,1,157684,0.00100696,98004306,0.62585
D.birchii,156593892,VNKA01007032.1,1,156460,0.000999145,98160766,0.626849
D.birchii,156593892,VNKA01005428.1,1,154810,0.000988608,98315576,0.627838
D.birchii,156593892,VNKA01004773.1,1,154801,0.000988551,98470377,0.628826
D.birchii,156593892,VNKA01004487.1,1,153845,0.000982446,98624222,0.629809
D.birchii,156593892,VNKA01005551.1,1,153721,0.000981654,98777943,0.630791
D.birchii,156593892,VNKA01005783.1,1,153416,0.000979706,98931359,0.63177
D.birchii,156593892,VNKA01007064.1,1,151138,0.000965159,99082497,0.632735
D.birchii,156593892,VNKA01003113.1,1,150497,0.000961066,99232994,0.633696
D.birchii,156593892,VNKA01004091.1,1,150448,0.000960753,99383442,0.634657
D.birchii,156593892,VNKA01006604.1,1,150421,0.00096058,99533863,0.635618
D.birchii,156593892,VNKA01004260.1,1,150054,0.000958237,99683917,0.636576
D.birchii,156593892,VNKA01002448.1,1,148334,0.000947253,99832251,0.637523
D.birchii,156593892,VNKA01007118.1,1,148164,0.000946167,99980415,0.638469
D.birchii,156593892,VNKA01003990.1,1,146758,0.000937189,100127173,0.639407
D.birchii,156593892,VNKA01005456.1,1,146049,0.000932661,100273222,0.640339
D.birchii,156593892,VNKA01001282.1,1,145254,0.000927584,100418476,0.641267
D.birchii,156593892,VNKA01005430.1,1,144615,0.000923503,100563091,0.64219
D.birchii,156593892,VNKA01002442.1,1,144305,0.000921524,100707396,0.643112
D.birchii,156593892,VNKA01003260.1,1,142321,0.000908854,100849717,0.644021
D.birchii,156593892,VNKA01002943.1,1,141191,0.000901638,100990908,0.644922
D.birchii,156593892,VNKA01005512.1,1,140375,0.000896427,101131283,0.645819
D.birchii,156593892,VNKA01000247.1,1,139869,0.000893196,101271152,0.646712
D.birchii,156593892,VNKA01004252.1,1,139863,0.000893157,101411015,0.647605
D.birchii,156593892,VNKA01001278.1,1,139693,0.000892072,101550708,0.648497
D.birchii,156593892,VNKA01003119.1,1,139688,0.00089204,101690396,0.649389
D.birchii,156593892,VNKA01001769.1,1,139162,0.000888681,101829558,0.650278
D.birchii,156593892,VNKA01004063.1,1,138838,0.000886612,101968396,0.651165
D.birchii,156593892,VNKA01004058.1,1,138478,0.000884313,102106874,0.652049
D.birchii,156593892,VNKA01003953.1,1,138098,0.000881886,102244972,0.652931
D.birchii,156593892,VNKA01005790.1,1,136972,0.000874696,102381944,0.653805
D.birchii,156593892,VNKA01000433.1,1,136729,0.000873144,102518673,0.654679
D.birchii,156593892,VNKA01003960.1,1,134946,0.000861758,102653619,0.65554
D.birchii,156593892,VNKA01001285.1,1,134087,0.000856272,102787706,0.656397
D.birchii,156593892,VNKA01004930.1,1,133730,0.000853992,102921436,0.657251
D.birchii,156593892,VNKA01002026.1,1,133455,0.000852236,103054891,0.658103
D.birchii,156593892,VNKA01005984.1,1,132233,0.000844433,103187124,0.658947
D.birchii,156593892,VNKA01000390.1,1,131746,0.000841323,103318870,0.659789
D.birchii,156593892,VNKA01005157.1,1,130562,0.000833762,103449432,0.660622
D.birchii,156593892,VNKA01004540.1,1,129197,0.000825045,103578629,0.661447
D.birchii,156593892,VNKA01006707.1,1,129176,0.000824911,103707805,0.662272
D.birchii,156593892,VNKA01007321.1,1,129136,0.000824655,103836941,0.663097
D.birchii,156593892,VNKA01003885.1,1,128902,0.000823161,103965843,0.66392
D.birchii,156593892,VNKA01001035.1,1,128725,0.000822031,104094568,0.664742
D.birchii,156593892,VNKA01005651.1,1,127850,0.000816443,104222418,0.665559
D.birchii,156593892,VNKA01004935.1,1,127716,0.000815587,104350134,0.666374
D.birchii,156593892,VNKA01007326.1,1,127104,0.000811679,104477238,0.667186
D.birchii,156593892,VNKA01006434.1,1,125731,0.000802911,104602969,0.667989
D.birchii,156593892,VNKA01007059.1,1,124598,0.000795676,104727567,0.668784
D.birchii,156593892,VNKA01001828.1,1,123860,0.000790963,104851427,0.669575
D.birchii,156593892,VNKA01003188.1,1,123807,0.000790625,104975234,0.670366
D.birchii,156593892,VNKA01005465.1,1,122730,0.000783747,105097964,0.67115
D.birchii,156593892,VNKA01001424.1,1,122598,0.000782904,105220562,0.671933
D.birchii,156593892,VNKA01003903.1,1,122317,0.00078111,105342879,0.672714
D.birchii,156593892,VNKA01005505.1,1,121825,0.000777968,105464704,0.673492
D.birchii,156593892,VNKA01001826.1,1,120874,0.000771895,105585578,0.674264
D.birchii,156593892,VNKA01001036.1,1,120438,0.00076911,105706016,0.675033
D.birchii,156593892,VNKA01005202.1,1,118770,0.000758459,105824786,0.675791
D.birchii,156593892,VNKA01000187.1,1,118253,0.000755157,105943039,0.676546
D.birchii,156593892,VNKA01002860.1,1,117262,0.000748829,106060301,0.677295
D.birchii,156593892,VNKA01004059.1,1,116260,0.00074243,106176561,0.678038
D.birchii,156593892,VNKA01003614.1,1,115040,0.000734639,106291601,0.678772
D.birchii,156593892,VNKA01005032.1,1,112921,0.000721107,106404522,0.679493
D.birchii,156593892,VNKA01007149.1,1,111871,0.000714402,106516393,0.680208
D.birchii,156593892,VNKA01005607.1,1,110146,0.000703386,106626539,0.680911
D.birchii,156593892,VNKA01006503.1,1,109405,0.000698654,106735944,0.68161
D.birchii,156593892,VNKA01001697.1,1,109131,0.000696905,106845075,0.682307
D.birchii,156593892,VNKA01000548.1,1,108984,0.000695966,106954059,0.683003
D.birchii,156593892,VNKA01006535.1,1,108592,0.000693463,107062651,0.683696
D.birchii,156593892,VNKA01001551.1,1,108042,0.00068995,107170693,0.684386
D.birchii,156593892,VNKA01002804.1,1,107894,0.000689005,107278587,0.685075
D.birchii,156593892,VNKA01001489.1,1,107878,0.000688903,107386465,0.685764
D.birchii,156593892,VNKA01002647.1,1,107046,0.00068359,107493511,0.686448
D.birchii,156593892,VNKA01006432.1,1,106560,0.000680486,107600071,0.687128
D.birchii,156593892,VNKA01007106.1,1,106391,0.000679407,107706462,0.687808
D.birchii,156593892,VNKA01006487.1,1,106387,0.000679382,107812849,0.688487
D.birchii,156593892,VNKA01001993.1,1,106331,0.000679024,107919180,0.689166
D.birchii,156593892,VNKA01002445.1,1,106043,0.000677185,108025223,0.689843
D.birchii,156593892,VNKA01005978.1,1,105427,0.000673251,108130650,0.690516
D.birchii,156593892,VNKA01003465.1,1,104142,0.000665045,108234792,0.691181
D.birchii,156593892,VNKA01004251.1,1,103901,0.000663506,108338693,0.691845
D.birchii,156593892,VNKA01002571.1,1,103901,0.000663506,108442594,0.692508
D.birchii,156593892,VNKA01007042.1,1,103498,0.000660933,108546092,0.693169
D.birchii,156593892,VNKA01004064.1,1,103215,0.000659125,108649307,0.693829
D.birchii,156593892,VNKA01001210.1,1,102244,0.000652925,108751551,0.694481
D.birchii,156593892,VNKA01007362.1,1,102129,0.00065219,108853680,0.695134
D.birchii,156593892,VNKA01002921.1,1,102083,0.000651896,108955763,0.695786
D.birchii,156593892,VNKA01004929.1,1,101244,0.000646539,109057007,0.696432
D.birchii,156593892,VNKA01002974.1,1,100748,0.000643371,109157755,0.697075
D.birchii,156593892,VNKA01001256.1,1,100153,0.000639572,109257908,0.697715
D.birchii,156593892,VNKA01003381.1,1,99596,0.000636015,109357504,0.698351
D.birchii,156593892,VNKA01005788.1,1,98062,0.000626219,109455566,0.698977
D.birchii,156593892,VNKA01002032.1,1,97733,0.000624118,109553299,0.699601
D.birchii,156593892,VNKA01000386.1,1,97635,0.000623492,109650934,0.700225
D.birchii,156593892,VNKA01001547.1,1,96923,0.000618945,109747857,0.700844
D.birchii,156593892,VNKA01005408.1,1,96790,0.000618096,109844647,0.701462
D.birchii,156593892,VNKA01005497.1,1,96653,0.000617221,109941300,0.702079
D.birchii,156593892,VNKA01002051.1,1,95981,0.000612929,110037281,0.702692
D.birchii,156593892,VNKA01001211.1,1,94586,0.000604021,110131867,0.703296
D.birchii,156593892,VNKA01003639.1,1,93290,0.000595745,110225157,0.703892
D.birchii,156593892,VNKA01005435.1,1,92395,0.000590029,110317552,0.704482
D.birchii,156593892,VNKA01001561.1,1,92373,0.000589889,110409925,0.705072
D.birchii,156593892,VNKA01000580.1,1,92271,0.000589238,110502196,0.705661
D.birchii,156593892,VNKA01005710.1,1,92139,0.000588395,110594335,0.706249
D.birchii,156593892,VNKA01005983.1,1,91415,0.000583771,110685750,0.706833
D.birchii,156593892,VNKA01003005.1,1,91322,0.000583177,110777072,0.707416
D.birchii,156593892,VNKA01002893.1,1,90920,0.00058061,110867992,0.707997
D.birchii,156593892,VNKA01005938.1,1,90678,0.000579065,110958670,0.708576
D.birchii,156593892,VNKA01002034.1,1,89918,0.000574211,111048588,0.70915
D.birchii,156593892,VNKA01002030.1,1,89168,0.000569422,111137756,0.70972
D.birchii,156593892,VNKA01003218.1,1,88616,0.000565897,111226372,0.710286
D.birchii,156593892,VNKA01001493.1,1,88435,0.000564741,111314807,0.71085
D.birchii,156593892,VNKA01000339.1,1,88340,0.000564134,111403147,0.711414
D.birchii,156593892,VNKA01005295.1,1,88055,0.000562314,111491202,0.711977
D.birchii,156593892,VNKA01002196.1,1,86400,0.000551746,111577602,0.712528
D.birchii,156593892,VNKA01005365.1,1,85909,0.00054861,111663511,0.713077
D.birchii,156593892,VNKA01000856.1,1,85909,0.00054861,111749420,0.713626
D.birchii,156593892,VNKA01001204.1,1,85716,0.000547378,111835136,0.714173
D.birchii,156593892,VNKA01002193.1,1,85498,0.000545986,111920634,0.714719
D.birchii,156593892,VNKA01000895.1,1,85419,0.000545481,112006053,0.715265
D.birchii,156593892,VNKA01000107.1,1,85374,0.000545194,112091427,0.71581
D.birchii,156593892,VNKA01004517.1,1,84405,0.000539006,112175832,0.716349
D.birchii,156593892,VNKA01000213.1,1,83212,0.000531387,112259044,0.71688
D.birchii,156593892,VNKA01001494.1,1,83194,0.000531272,112342238,0.717411
D.birchii,156593892,VNKA01004928.1,1,82325,0.000525723,112424563,0.717937
D.birchii,156593892,VNKA01005495.1,1,81975,0.000523488,112506538,0.718461
D.birchii,156593892,VNKA01006433.1,1,81534,0.000520672,112588072,0.718981
D.birchii,156593892,VNKA01005013.1,1,81478,0.000520314,112669550,0.719502
D.birchii,156593892,VNKA01001822.1,1,81290,0.000519113,112750840,0.720021
D.birchii,156593892,VNKA01005981.1,1,80353,0.00051313,112831193,0.720534
D.birchii,156593892,VNKA01007322.1,1,79212,0.000505843,112910405,0.72104
D.birchii,156593892,VNKA01002108.1,1,79077,0.000504981,112989482,0.721545
D.birchii,156593892,VNKA01006300.1,1,78843,0.000503487,113068325,0.722048
D.birchii,156593892,VNKA01001279.1,1,78103,0.000498761,113146428,0.722547
D.birchii,156593892,VNKA01004525.1,1,77514,0.000495,113223942,0.723042
D.birchii,156593892,VNKA01004085.1,1,77368,0.000494068,113301310,0.723536
D.birchii,156593892,VNKA01004786.1,1,77272,0.000493455,113378582,0.724029
D.birchii,156593892,VNKA01003544.1,1,77019,0.000491839,113455601,0.724521
D.birchii,156593892,VNKA01004521.1,1,76454,0.000488231,113532055,0.725009
D.birchii,156593892,VNKA01002877.1,1,75679,0.000483282,113607734,0.725493
D.birchii,156593892,VNKA01000384.1,1,74919,0.000478429,113682653,0.725971
D.birchii,156593892,VNKA01004380.1,1,74791,0.000477611,113757444,0.726449
D.birchii,156593892,VNKA01006367.1,1,74676,0.000476877,113832120,0.726926
D.birchii,156593892,VNKA01005791.1,1,74374,0.000474948,113906494,0.727401
D.birchii,156593892,VNKA01006403.1,1,74206,0.000473875,113980700,0.727874
D.birchii,156593892,VNKA01000564.1,1,73059,0.000466551,114053759,0.728341
D.birchii,156593892,VNKA01001548.1,1,72956,0.000465893,114126715,0.728807
D.birchii,156593892,VNKA01003539.1,1,72696,0.000464233,114199411,0.729271
D.birchii,156593892,VNKA01005656.1,1,72060,0.000460171,114271471,0.729731
D.birchii,156593892,VNKA01004156.1,1,72053,0.000460127,114343524,0.730191
D.birchii,156593892,VNKA01006845.1,1,71984,0.000459686,114415508,0.730651
D.birchii,156593892,VNKA01007109.1,1,71734,0.000458089,114487242,0.731109
D.birchii,156593892,VNKA01001212.1,1,71407,0.000456001,114558649,0.731565
D.birchii,156593892,VNKA01005695.1,1,70864,0.000452534,114629513,0.732018
D.birchii,156593892,VNKA01000242.1,1,70801,0.000452131,114700314,0.73247
D.birchii,156593892,VNKA01003386.1,1,70732,0.000451691,114771046,0.732922
D.birchii,156593892,VNKA01006899.1,1,70584,0.000450746,114841630,0.733372
D.birchii,156593892,VNKA01005785.1,1,70532,0.000450413,114912162,0.733823
D.birchii,156593892,VNKA01005221.1,1,70119,0.000447776,114982281,0.734271
D.birchii,156593892,VNKA01002035.1,1,69996,0.000446991,115052277,0.734718
D.birchii,156593892,VNKA01002497.1,1,69824,0.000445892,115122101,0.735163
D.birchii,156593892,VNKA01000389.1,1,69820,0.000445867,115191921,0.735609
D.birchii,156593892,VNKA01005222.1,1,69733,0.000445311,115261654,0.736055
D.birchii,156593892,VNKA01006240.1,1,69407,0.000443229,115331061,0.736498
D.birchii,156593892,VNKA01001213.1,1,68921,0.000440126,115399982,0.736938
D.birchii,156593892,VNKA01000825.1,1,68319,0.000436281,115468301,0.737374
D.birchii,156593892,VNKA01001945.1,1,68062,0.00043464,115536363,0.737809
D.birchii,156593892,VNKA01005154.1,1,68013,0.000434327,115604376,0.738243
D.birchii,156593892,VNKA01006437.1,1,67517,0.00043116,115671893,0.738674
D.birchii,156593892,VNKA01006304.1,1,67330,0.000429966,115739223,0.739104
D.birchii,156593892,VNKA01006068.1,1,67245,0.000429423,115806468,0.739534
D.birchii,156593892,VNKA01004624.1,1,67214,0.000429225,115873682,0.739963
D.birchii,156593892,VNKA01006815.1,1,66323,0.000423535,115940005,0.740387
D.birchii,156593892,VNKA01002036.1,1,66270,0.000423197,116006275,0.74081
D.birchii,156593892,VNKA01001259.1,1,66162,0.000422507,116072437,0.741232
D.birchii,156593892,VNKA01004827.1,1,65904,0.000420859,116138341,0.741653
D.birchii,156593892,VNKA01000385.1,1,65541,0.000418541,116203882,0.742072
D.birchii,156593892,VNKA01001013.1,1,64691,0.000413113,116268573,0.742485
D.birchii,156593892,VNKA01005161.1,1,64361,0.000411006,116332934,0.742896
D.birchii,156593892,VNKA01000576.1,1,63667,0.000406574,116396601,0.743302
D.birchii,156593892,VNKA01001552.1,1,63664,0.000406555,116460265,0.743709
D.birchii,156593892,VNKA01003899.1,1,63580,0.000406018,116523845,0.744115
D.birchii,156593892,VNKA01000642.1,1,63010,0.000402378,116586855,0.744517
D.birchii,156593892,VNKA01002444.1,1,62771,0.000400852,116649626,0.744918
D.birchii,156593892,VNKA01005831.1,1,62537,0.000399358,116712163,0.745317
D.birchii,156593892,VNKA01002973.1,1,61920,0.000395418,116774083,0.745713
D.birchii,156593892,VNKA01004524.1,1,61633,0.000393585,116835716,0.746106
D.birchii,156593892,VNKA01000388.1,1,61405,0.000392129,116897121,0.746499
D.birchii,156593892,VNKA01005113.1,1,61362,0.000391854,116958483,0.74689
D.birchii,156593892,VNKA01007098.1,1,61168,0.000390615,117019651,0.747281
D.birchii,156593892,VNKA01005691.1,1,61017,0.000389651,117080668,0.747671
D.birchii,156593892,VNKA01001549.1,1,60687,0.000387544,117141355,0.748058
D.birchii,156593892,VNKA01006389.1,1,59870,0.000382327,117201225,0.748441
D.birchii,156593892,VNKA01000381.1,1,59597,0.000380583,117260822,0.748821
D.birchii,156593892,VNKA01000387.1,1,59316,0.000378789,117320138,0.7492
D.birchii,156593892,VNKA01005980.1,1,59020,0.000376898,117379158,0.749577
D.birchii,156593892,VNKA01005208.1,1,58869,0.000375934,117438027,0.749953
D.birchii,156593892,VNKA01002443.1,1,58406,0.000372978,117496433,0.750326
D.birchii,156593892,VNKA01004016.1,1,58378,0.000372799,117554811,0.750699
D.birchii,156593892,VNKA01000383.1,1,58241,0.000371924,117613052,0.75107
D.birchii,156593892,VNKA01003404.1,1,58186,0.000371573,117671238,0.751442
D.birchii,156593892,VNKA01002111.1,1,58178,0.000371522,117729416,0.751814
D.birchii,156593892,VNKA01006788.1,1,57508,0.000367243,117786924,0.752181
D.birchii,156593892,VNKA01001450.1,1,57347,0.000366215,117844271,0.752547
D.birchii,156593892,VNKA01007342.1,1,57173,0.000365104,117901444,0.752912
D.birchii,156593892,VNKA01005982.1,1,57124,0.000364791,117958568,0.753277
D.birchii,156593892,VNKA01002396.1,1,56640,0.0003617,118015208,0.753639
D.birchii,156593892,VNKA01005574.1,1,56422,0.000360308,118071630,0.753999
D.birchii,156593892,VNKA01000604.1,1,56041,0.000357875,118127671,0.754357
D.birchii,156593892,VNKA01003688.1,1,55649,0.000355371,118183320,0.754712
D.birchii,156593892,VNKA01000559.1,1,55456,0.000354139,118238776,0.755066
D.birchii,156593892,VNKA01006438.1,1,54548,0.000348341,118293324,0.755415
D.birchii,156593892,VNKA01006897.1,1,54254,0.000346463,118347578,0.755761
D.birchii,156593892,VNKA01000892.1,1,54051,0.000345167,118401629,0.756106
D.birchii,156593892,VNKA01001700.1,1,53778,0.000343423,118455407,0.75645
D.birchii,156593892,VNKA01000505.1,1,53487,0.000341565,118508894,0.756791
D.birchii,156593892,VNKA01001124.1,1,53359,0.000340748,118562253,0.757132
D.birchii,156593892,VNKA01003860.1,1,53267,0.00034016,118615520,0.757472
D.birchii,156593892,VNKA01004060.1,1,53151,0.000339419,118668671,0.757812
D.birchii,156593892,VNKA01005387.1,1,53142,0.000339362,118721813,0.758151
D.birchii,156593892,VNKA01005348.1,1,53063,0.000338857,118774876,0.75849
D.birchii,156593892,VNKA01001452.1,1,52645,0.000336188,118827521,0.758826
D.birchii,156593892,VNKA01000941.1,1,52626,0.000336067,118880147,0.759162
D.birchii,156593892,VNKA01000727.1,1,52202,0.000333359,118932349,0.759495
D.birchii,156593892,VNKA01006455.1,1,52028,0.000332248,118984377,0.759828
D.birchii,156593892,VNKA01005374.1,1,52008,0.00033212,119036385,0.76016
D.birchii,156593892,VNKA01003125.1,1,51884,0.000331328,119088269,0.760491
D.birchii,156593892,VNKA01006343.1,1,51781,0.000330671,119140050,0.760822
D.birchii,156593892,VNKA01003685.1,1,51143,0.000326596,119191193,0.761148
D.birchii,156593892,VNKA01007235.1,1,49817,0.000318129,119241010,0.761467
D.birchii,156593892,VNKA01004796.1,1,49470,0.000315913,119290480,0.761782
D.birchii,156593892,VNKA01005224.1,1,49295,0.000314795,119339775,0.762097
D.birchii,156593892,VNKA01005159.1,1,48988,0.000312835,119388763,0.76241
D.birchii,156593892,VNKA01004385.1,1,48956,0.00031263,119437719,0.762723
D.birchii,156593892,VNKA01000363.1,1,48950,0.000312592,119486669,0.763035
D.birchii,156593892,VNKA01001205.1,1,48904,0.000312298,119535573,0.763348
D.birchii,156593892,VNKA01003126.1,1,48892,0.000312222,119584465,0.76366
D.birchii,156593892,VNKA01004061.1,1,48759,0.000311372,119633224,0.763971
D.birchii,156593892,VNKA01000382.1,1,48559,0.000310095,119681783,0.764281
D.birchii,156593892,VNKA01006802.1,1,48262,0.000308198,119730045,0.764589
D.birchii,156593892,VNKA01002578.1,1,48214,0.000307892,119778259,0.764897
D.birchii,156593892,VNKA01000300.1,1,47866,0.00030567,119826125,0.765203
D.birchii,156593892,VNKA01002629.1,1,47653,0.000304309,119873778,0.765507
D.birchii,156593892,VNKA01001665.1,1,47639,0.00030422,119921417,0.765812
D.birchii,156593892,VNKA01002039.1,1,47141,0.00030104,119968558,0.766113
D.birchii,156593892,VNKA01005786.1,1,47128,0.000300957,120015686,0.766414
D.birchii,156593892,VNKA01001108.1,1,47086,0.000300689,120062772,0.766714
D.birchii,156593892,VNKA01007428.1,1,46842,0.00029913,120109614,0.767013
D.birchii,156593892,VNKA01001253.1,1,46825,0.000299022,120156439,0.767312
D.birchii,156593892,VNKA01003616.1,1,46768,0.000298658,120203207,0.767611
D.birchii,156593892,VNKA01003423.1,1,46597,0.000297566,120249804,0.767909
D.birchii,156593892,VNKA01004171.1,1,46270,0.000295478,120296074,0.768204
D.birchii,156593892,VNKA01001936.1,1,46222,0.000295171,120342296,0.768499
D.birchii,156593892,VNKA01005107.1,1,46108,0.000294443,120388404,0.768794
D.birchii,156593892,VNKA01006811.1,1,46107,0.000294437,120434511,0.769088
D.birchii,156593892,VNKA01000298.1,1,45186,0.000288555,120479697,0.769377
D.birchii,156593892,VNKA01003210.1,1,44986,0.000287278,120524683,0.769664
D.birchii,156593892,VNKA01005638.1,1,44756,0.000285809,120569439,0.76995
D.birchii,156593892,VNKA01007113.1,1,44167,0.000282048,120613606,0.770232
D.birchii,156593892,VNKA01001608.1,1,43905,0.000280375,120657511,0.770512
D.birchii,156593892,VNKA01000671.1,1,43897,0.000280324,120701408,0.770793
D.birchii,156593892,VNKA01007074.1,1,43553,0.000278127,120744961,0.771071
D.birchii,156593892,VNKA01003949.1,1,43374,0.000276984,120788335,0.771348
D.birchii,156593892,VNKA01003808.1,1,43253,0.000276211,120831588,0.771624
D.birchii,156593892,VNKA01004663.1,1,43189,0.000275803,120874777,0.7719
D.birchii,156593892,VNKA01000256.1,1,43182,0.000275758,120917959,0.772175
D.birchii,156593892,VNKA01006952.1,1,42626,0.000272207,120960585,0.772448
D.birchii,156593892,VNKA01000739.1,1,42544,0.000271684,121003129,0.772719
D.birchii,156593892,VNKA01002774.1,1,42320,0.000270253,121045449,0.77299
D.birchii,156593892,VNKA01002110.1,1,42087,0.000268765,121087536,0.773258
D.birchii,156593892,VNKA01000306.1,1,41714,0.000266383,121129250,0.773525
D.birchii,156593892,VNKA01004723.1,1,41649,0.000265968,121170899,0.773791
D.birchii,156593892,VNKA01003114.1,1,41282,0.000263625,121212181,0.774054
D.birchii,156593892,VNKA01005207.1,1,41134,0.000262679,121253315,0.774317
D.birchii,156593892,VNKA01007508.1,1,41058,0.000262194,121294373,0.774579
D.birchii,156593892,VNKA01002106.1,1,41000,0.000261824,121335373,0.774841
D.birchii,156593892,VNKA01000248.1,1,40961,0.000261575,121376334,0.775103
D.birchii,156593892,VNKA01005731.1,1,40958,0.000261556,121417292,0.775364
D.birchii,156593892,VNKA01006065.1,1,40939,0.000261434,121458231,0.775626
D.birchii,156593892,VNKA01006512.1,1,40638,0.000259512,121498869,0.775885
D.birchii,156593892,VNKA01004834.1,1,40266,0.000257136,121539135,0.776142
D.birchii,156593892,VNKA01001436.1,1,39882,0.000254684,121579017,0.776397
D.birchii,156593892,VNKA01004062.1,1,39744,0.000253803,121618761,0.776651
D.birchii,156593892,VNKA01003611.1,1,39592,0.000252832,121658353,0.776904
D.birchii,156593892,VNKA01004219.1,1,39410,0.00025167,121697763,0.777155
D.birchii,156593892,VNKA01006891.1,1,39402,0.000251619,121737165,0.777407
D.birchii,156593892,VNKA01006190.1,1,39195,0.000250297,121776360,0.777657
D.birchii,156593892,VNKA01005124.1,1,39034,0.000249269,121815394,0.777906
D.birchii,156593892,VNKA01006534.1,1,38878,0.000248273,121854272,0.778155
D.birchii,156593892,VNKA01003742.1,1,38862,0.000248171,121893134,0.778403
D.birchii,156593892,VNKA01005787.1,1,38728,0.000247315,121931862,0.77865
D.birchii,156593892,VNKA01007462.1,1,38704,0.000247162,121970566,0.778897
D.birchii,156593892,VNKA01005887.1,1,38378,0.00024508,122008944,0.779142
D.birchii,156593892,VNKA01002296.1,1,38350,0.000244901,122047294,0.779387
D.birchii,156593892,VNKA01002938.1,1,38202,0.000243956,122085496,0.779631
D.birchii,156593892,VNKA01000911.1,1,38119,0.000243426,122123615,0.779875
D.birchii,156593892,VNKA01007105.1,1,37873,0.000241855,122161488,0.780117
D.birchii,156593892,VNKA01007175.1,1,37803,0.000241408,122199291,0.780358
D.birchii,156593892,VNKA01007398.1,1,37643,0.000240386,122236934,0.780598
D.birchii,156593892,VNKA01004178.1,1,37334,0.000238413,122274268,0.780837
D.birchii,156593892,VNKA01002672.1,1,37275,0.000238036,122311543,0.781075
D.birchii,156593892,VNKA01000627.1,1,37265,0.000237972,122348808,0.781313
D.birchii,156593892,VNKA01000790.1,1,37137,0.000237155,122385945,0.78155
D.birchii,156593892,VNKA01005754.1,1,36585,0.00023363,122422530,0.781784
D.birchii,156593892,VNKA01003634.1,1,36443,0.000232723,122458973,0.782016
D.birchii,156593892,VNKA01003884.1,1,36427,0.000232621,122495400,0.782249
D.birchii,156593892,VNKA01007233.1,1,36388,0.000232372,122531788,0.782481
D.birchii,156593892,VNKA01004621.1,1,35914,0.000229345,122567702,0.782711
D.birchii,156593892,VNKA01004405.1,1,35645,0.000227627,122603347,0.782938
D.birchii,156593892,VNKA01000090.1,1,35637,0.000227576,122638984,0.783166
D.birchii,156593892,VNKA01006271.1,1,35534,0.000226918,122674518,0.783393
D.birchii,156593892,VNKA01003747.1,1,35367,0.000225852,122709885,0.783619
D.birchii,156593892,VNKA01003591.1,1,35309,0.000225481,122745194,0.783844
D.birchii,156593892,VNKA01006876.1,1,35091,0.000224089,122780285,0.784068
D.birchii,156593892,VNKA01007097.1,1,35039,0.000223757,122815324,0.784292
D.birchii,156593892,VNKA01007526.1,1,34729,0.000221777,122850053,0.784514
D.birchii,156593892,VNKA01001986.1,1,34368,0.000219472,122884421,0.784733
D.birchii,156593892,VNKA01004944.1,1,34275,0.000218878,122918696,0.784952
D.birchii,156593892,VNKA01006207.1,1,34259,0.000218776,122952955,0.785171
D.birchii,156593892,VNKA01003061.1,1,34108,0.000217812,122987063,0.785389
D.birchii,156593892,VNKA01006077.1,1,34094,0.000217722,123021157,0.785606
D.birchii,156593892,VNKA01000781.1,1,34045,0.00021741,123055202,0.785824
D.birchii,156593892,VNKA01001958.1,1,34031,0.00021732,123089233,0.786041
D.birchii,156593892,VNKA01004066.1,1,33987,0.000217039,123123220,0.786258
D.birchii,156593892,VNKA01002599.1,1,33776,0.000215692,123156996,0.786474
D.birchii,156593892,VNKA01007535.1,1,33774,0.000215679,123190770,0.786689
D.birchii,156593892,VNKA01003612.1,1,33674,0.00021504,123224444,0.786905
D.birchii,156593892,VNKA01003758.1,1,33522,0.00021407,123257966,0.787119
D.birchii,156593892,VNKA01005900.1,1,33495,0.000213897,123291461,0.787333
D.birchii,156593892,VNKA01001966.1,1,33392,0.000213239,123324853,0.787546
D.birchii,156593892,VNKA01000175.1,1,33266,0.000212435,123358119,0.787758
D.birchii,156593892,VNKA01005557.1,1,33218,0.000212128,123391337,0.78797
D.birchii,156593892,VNKA01000577.1,1,33124,0.000211528,123424461,0.788182
D.birchii,156593892,VNKA01007099.1,1,32893,0.000210053,123457354,0.788392
D.birchii,156593892,VNKA01003397.1,1,32884,0.000209995,123490238,0.788602
D.birchii,156593892,VNKA01002104.1,1,32880,0.00020997,123523118,0.788812
D.birchii,156593892,VNKA01001181.1,1,32738,0.000209063,123555856,0.789021
D.birchii,156593892,VNKA01004139.1,1,32730,0.000209012,123588586,0.78923
D.birchii,156593892,VNKA01006559.1,1,32697,0.000208801,123621283,0.789439
D.birchii,156593892,VNKA01004849.1,1,32645,0.000208469,123653928,0.789647
D.birchii,156593892,VNKA01001999.1,1,32477,0.000207396,123686405,0.789855
D.birchii,156593892,VNKA01007112.1,1,32449,0.000207218,123718854,0.790062
D.birchii,156593892,VNKA01004067.1,1,32416,0.000207007,123751270,0.790269
D.birchii,156593892,VNKA01004440.1,1,32268,0.000206062,123783538,0.790475
D.birchii,156593892,VNKA01002608.1,1,32229,0.000205813,123815767,0.790681
D.birchii,156593892,VNKA01000241.1,1,32116,0.000205091,123847883,0.790886
D.birchii,156593892,VNKA01007262.1,1,31717,0.000202543,123879600,0.791088
D.birchii,156593892,VNKA01002989.1,1,31406,0.000200557,123911006,0.791289
D.birchii,156593892,VNKA01001260.1,1,31036,0.000198194,123942042,0.791487
D.birchii,156593892,VNKA01004734.1,1,30616,0.000195512,123972658,0.791683
D.birchii,156593892,VNKA01001660.1,1,30584,0.000195308,124003242,0.791878
D.birchii,156593892,VNKA01005868.1,1,30468,0.000194567,124033710,0.792072
D.birchii,156593892,VNKA01002376.1,1,30389,0.000194062,124064099,0.792267
D.birchii,156593892,VNKA01000933.1,1,30378,0.000193992,124094477,0.792461
D.birchii,156593892,VNKA01001939.1,1,30374,0.000193967,124124851,0.792654
D.birchii,156593892,VNKA01004823.1,1,29947,0.00019124,124154798,0.792846
D.birchii,156593892,VNKA01007311.1,1,29874,0.000190774,124184672,0.793036
D.birchii,156593892,VNKA01003281.1,1,29736,0.000189892,124214408,0.793226
D.birchii,156593892,VNKA01004795.1,1,29607,0.000189069,124244015,0.793415
D.birchii,156593892,VNKA01004610.1,1,29554,0.00018873,124273569,0.793604
D.birchii,156593892,VNKA01002323.1,1,29468,0.000188181,124303037,0.793792
D.birchii,156593892,VNKA01003193.1,1,29350,0.000187427,124332387,0.79398
D.birchii,156593892,VNKA01007204.1,1,29110,0.000185895,124361497,0.794166
D.birchii,156593892,VNKA01004826.1,1,28917,0.000184662,124390414,0.79435
D.birchii,156593892,VNKA01002924.1,1,28882,0.000184439,124419296,0.794535
D.birchii,156593892,VNKA01000809.1,1,28745,0.000183564,124448041,0.794718
D.birchii,156593892,VNKA01007373.1,1,28737,0.000183513,124476778,0.794902
D.birchii,156593892,VNKA01002327.1,1,28633,0.000182849,124505411,0.795085
D.birchii,156593892,VNKA01006817.1,1,28563,0.000182402,124533974,0.795267
D.birchii,156593892,VNKA01004777.1,1,28513,0.000182082,124562487,0.795449
D.birchii,156593892,VNKA01001942.1,1,28067,0.000179234,124590554,0.795628
D.birchii,156593892,VNKA01001957.1,1,28048,0.000179113,124618602,0.795808
D.birchii,156593892,VNKA01001988.1,1,27999,0.0001788,124646601,0.795986
D.birchii,156593892,VNKA01000158.1,1,27626,0.000176418,124674227,0.796163
D.birchii,156593892,VNKA01001072.1,1,27532,0.000175818,124701759,0.796339
D.birchii,156593892,VNKA01000432.1,1,27487,0.00017553,124729246,0.796514
D.birchii,156593892,VNKA01000581.1,1,27310,0.0001744,124756556,0.796689
D.birchii,156593892,VNKA01004765.1,1,27223,0.000173845,124783779,0.796862
D.birchii,156593892,VNKA01007104.1,1,27097,0.00017304,124810876,0.797035
D.birchii,156593892,VNKA01004548.1,1,27061,0.00017281,124837937,0.797208
D.birchii,156593892,VNKA01003306.1,1,27037,0.000172657,124864974,0.797381
D.birchii,156593892,VNKA01007320.1,1,26944,0.000172063,124891918,0.797553
D.birchii,156593892,VNKA01005271.1,1,26912,0.000171859,124918830,0.797725
D.birchii,156593892,VNKA01001060.1,1,26886,0.000171693,124945716,0.797896
D.birchii,156593892,VNKA01004453.1,1,26876,0.000171629,124972592,0.798068
D.birchii,156593892,VNKA01004670.1,1,26707,0.000170549,124999299,0.798239
D.birchii,156593892,VNKA01006041.1,1,26662,0.000170262,125025961,0.798409
D.birchii,156593892,VNKA01002703.1,1,26639,0.000170115,125052600,0.798579
D.birchii,156593892,VNKA01000821.1,1,26507,0.000169272,125079107,0.798748
D.birchii,156593892,VNKA01006816.1,1,26421,0.000168723,125105528,0.798917
D.birchii,156593892,VNKA01004384.1,1,26369,0.000168391,125131897,0.799085
D.birchii,156593892,VNKA01002978.1,1,26244,0.000167593,125158141,0.799253
D.birchii,156593892,VNKA01004535.1,1,26064,0.000166443,125184205,0.799419
D.birchii,156593892,VNKA01003375.1,1,25950,0.000165715,125210155,0.799585
D.birchii,156593892,VNKA01006214.1,1,25918,0.000165511,125236073,0.799751
D.birchii,156593892,VNKA01003603.1,1,25887,0.000165313,125261960,0.799916
D.birchii,156593892,VNKA01005046.1,1,25880,0.000165268,125287840,0.800081
D.birchii,156593892,VNKA01006831.1,1,25879,0.000165262,125313719,0.800247
D.birchii,156593892,VNKA01007506.1,1,25813,0.00016484,125339532,0.800411
D.birchii,156593892,VNKA01001938.1,1,25659,0.000163857,125365191,0.800575
D.birchii,156593892,VNKA01001392.1,1,25602,0.000163493,125390793,0.800739
D.birchii,156593892,VNKA01001006.1,1,25477,0.000162695,125416270,0.800901
D.birchii,156593892,VNKA01003378.1,1,25402,0.000162216,125441672,0.801064
D.birchii,156593892,VNKA01007267.1,1,25383,0.000162094,125467055,0.801226
D.birchii,156593892,VNKA01000373.1,1,25344,0.000161845,125492399,0.801388
D.birchii,156593892,VNKA01002576.1,1,25281,0.000161443,125517680,0.801549
D.birchii,156593892,VNKA01003615.1,1,25261,0.000161315,125542941,0.80171
D.birchii,156593892,VNKA01004142.1,1,25233,0.000161137,125568174,0.801871
D.birchii,156593892,VNKA01006053.1,1,25200,0.000160926,125593374,0.802032
D.birchii,156593892,VNKA01000309.1,1,25197,0.000160907,125618571,0.802193
D.birchii,156593892,VNKA01003129.1,1,25182,0.000160811,125643753,0.802354
D.birchii,156593892,VNKA01003185.1,1,25098,0.000160274,125668851,0.802514
D.birchii,156593892,VNKA01006989.1,1,25040,0.000159904,125693891,0.802674
D.birchii,156593892,VNKA01006235.1,1,24982,0.000159534,125718873,0.802834
D.birchii,156593892,VNKA01004488.1,1,24852,0.000158704,125743725,0.802993
D.birchii,156593892,VNKA01000689.1,1,24787,0.000158288,125768512,0.803151
D.birchii,156593892,VNKA01000808.1,1,24778,0.000158231,125793290,0.803309
D.birchii,156593892,VNKA01004220.1,1,24750,0.000158052,125818040,0.803467
D.birchii,156593892,VNKA01005385.1,1,24730,0.000157924,125842770,0.803625
D.birchii,156593892,VNKA01002788.1,1,24636,0.000157324,125867406,0.803782
D.birchii,156593892,VNKA01007227.1,1,24631,0.000157292,125892037,0.80394
D.birchii,156593892,VNKA01003122.1,1,24531,0.000156654,125916568,0.804096
D.birchii,156593892,VNKA01007503.1,1,24427,0.000155989,125940995,0.804252
D.birchii,156593892,VNKA01000380.1,1,24420,0.000155945,125965415,0.804408
D.birchii,156593892,VNKA01006690.1,1,24419,0.000155938,125989834,0.804564
D.birchii,156593892,VNKA01000238.1,1,24382,0.000155702,126014216,0.80472
D.birchii,156593892,VNKA01001236.1,1,24360,0.000155562,126038576,0.804875
D.birchii,156593892,VNKA01000765.1,1,24348,0.000155485,126062924,0.805031
D.birchii,156593892,VNKA01004065.1,1,24327,0.000155351,126087251,0.805186
D.birchii,156593892,VNKA01000771.1,1,24312,0.000155255,126111563,0.805342
D.birchii,156593892,VNKA01001951.1,1,24222,0.00015468,126135785,0.805496
D.birchii,156593892,VNKA01006532.1,1,24207,0.000154585,126159992,0.805651
D.birchii,156593892,VNKA01001149.1,1,24111,0.000153972,126184103,0.805805
D.birchii,156593892,VNKA01003440.1,1,24096,0.000153876,126208199,0.805959
D.birchii,156593892,VNKA01003818.1,1,24054,0.000153608,126232253,0.806112
D.birchii,156593892,VNKA01000311.1,1,24032,0.000153467,126256285,0.806266
D.birchii,156593892,VNKA01000254.1,1,23942,0.000152892,126280227,0.806419
D.birchii,156593892,VNKA01005986.1,1,23918,0.000152739,126304145,0.806571
D.birchii,156593892,VNKA01003861.1,1,23903,0.000152643,126328048,0.806724
D.birchii,156593892,VNKA01007107.1,1,23719,0.000151468,126351767,0.806875
D.birchii,156593892,VNKA01002009.1,1,23701,0.000151353,126375468,0.807027
D.birchii,156593892,VNKA01007242.1,1,23694,0.000151309,126399162,0.807178
D.birchii,156593892,VNKA01003373.1,1,23613,0.000150791,126422775,0.807329
D.birchii,156593892,VNKA01000523.1,1,23500,0.00015007,126446275,0.807479
D.birchii,156593892,VNKA01003916.1,1,23433,0.000149642,126469708,0.807629
D.birchii,156593892,VNKA01002279.1,1,23412,0.000149508,126493120,0.807778
D.birchii,156593892,VNKA01005646.1,1,23328,0.000148971,126516448,0.807927
D.birchii,156593892,VNKA01004871.1,1,23293,0.000148748,126539741,0.808076
D.birchii,156593892,VNKA01002070.1,1,23256,0.000148512,126562997,0.808224
D.birchii,156593892,VNKA01007197.1,1,23247,0.000148454,126586244,0.808373
D.birchii,156593892,VNKA01002982.1,1,23156,0.000147873,126609400,0.808521
D.birchii,156593892,VNKA01003806.1,1,22970,0.000146685,126632370,0.808667
D.birchii,156593892,VNKA01005073.1,1,22946,0.000146532,126655316,0.808814
D.birchii,156593892,VNKA01000270.1,1,22911,0.000146308,126678227,0.80896
D.birchii,156593892,VNKA01003771.1,1,22833,0.00014581,126701060,0.809106
D.birchii,156593892,VNKA01001655.1,1,22773,0.000145427,126723833,0.809251
D.birchii,156593892,VNKA01002256.1,1,22763,0.000145363,126746596,0.809397
D.birchii,156593892,VNKA01007563.1,1,22745,0.000145248,126769341,0.809542
D.birchii,156593892,VNKA01006563.1,1,22736,0.000145191,126792077,0.809687
D.birchii,156593892,VNKA01002531.1,1,22731,0.000145159,126814808,0.809832
D.birchii,156593892,VNKA01003590.1,1,22725,0.000145121,126837533,0.809978
D.birchii,156593892,VNKA01005484.1,1,22678,0.00014482,126860211,0.810122
D.birchii,156593892,VNKA01001689.1,1,22673,0.000144789,126882884,0.810267
D.birchii,156593892,VNKA01002371.1,1,22662,0.000144718,126905546,0.810412
D.birchii,156593892,VNKA01001531.1,1,22638,0.000144565,126928184,0.810556
D.birchii,156593892,VNKA01000004.1,1,22584,0.00014422,126950768,0.810701
D.birchii,156593892,VNKA01005544.1,1,22558,0.000144054,126973326,0.810845
D.birchii,156593892,VNKA01003123.1,1,22552,0.000144016,126995878,0.810989
D.birchii,156593892,VNKA01000295.1,1,22482,0.000143569,127018360,0.811132
D.birchii,156593892,VNKA01004904.1,1,22446,0.000143339,127040806,0.811276
D.birchii,156593892,VNKA01002888.1,1,22436,0.000143275,127063242,0.811419
D.birchii,156593892,VNKA01007412.1,1,22348,0.000142713,127085590,0.811562
D.birchii,156593892,VNKA01001758.1,1,22305,0.000142439,127107895,0.811704
D.birchii,156593892,VNKA01005896.1,1,22290,0.000142343,127130185,0.811846
D.birchii,156593892,VNKA01001750.1,1,22273,0.000142234,127152458,0.811989
D.birchii,156593892,VNKA01007339.1,1,22264,0.000142177,127174722,0.812131
D.birchii,156593892,VNKA01003402.1,1,22201,0.000141774,127196923,0.812273
D.birchii,156593892,VNKA01003643.1,1,22094,0.000141091,127219017,0.812414
D.birchii,156593892,VNKA01005993.1,1,22036,0.000140721,127241053,0.812554
D.birchii,156593892,VNKA01001918.1,1,21966,0.000140274,127263019,0.812695
D.birchii,156593892,VNKA01006728.1,1,21904,0.000139878,127284923,0.812835
D.birchii,156593892,VNKA01003067.1,1,21897,0.000139833,127306820,0.812974
D.birchii,156593892,VNKA01000079.1,1,21804,0.000139239,127328624,0.813114
D.birchii,156593892,VNKA01004256.1,1,21770,0.000139022,127350394,0.813253
D.birchii,156593892,VNKA01000337.1,1,21743,0.00013885,127372137,0.813391
D.birchii,156593892,VNKA01003080.1,1,21588,0.00013786,127393725,0.813529
D.birchii,156593892,VNKA01004906.1,1,21555,0.000137649,127415280,0.813667
D.birchii,156593892,VNKA01006108.1,1,21554,0.000137643,127436834,0.813805
D.birchii,156593892,VNKA01004258.1,1,21539,0.000137547,127458373,0.813942
D.birchii,156593892,VNKA01001125.1,1,21531,0.000137496,127479904,0.81408
D.birchii,156593892,VNKA01005217.1,1,21462,0.000137055,127501366,0.814217
D.birchii,156593892,VNKA01001273.1,1,21408,0.00013671,127522774,0.814353
D.birchii,156593892,VNKA01006151.1,1,21363,0.000136423,127544137,0.81449
D.birchii,156593892,VNKA01002894.1,1,21341,0.000136282,127565478,0.814626
D.birchii,156593892,VNKA01002523.1,1,21332,0.000136225,127586810,0.814762
D.birchii,156593892,VNKA01003432.1,1,21322,0.000136161,127608132,0.814899
D.birchii,156593892,VNKA01006814.1,1,21299,0.000136014,127629431,0.815035
D.birchii,156593892,VNKA01000200.1,1,21261,0.000135772,127650692,0.81517
D.birchii,156593892,VNKA01006704.1,1,21230,0.000135574,127671922,0.815306
D.birchii,156593892,VNKA01002043.1,1,21226,0.000135548,127693148,0.815441
D.birchii,156593892,VNKA01002782.1,1,21167,0.000135171,127714315,0.815577
D.birchii,156593892,VNKA01000778.1,1,21149,0.000135056,127735464,0.815712
D.birchii,156593892,VNKA01002867.1,1,21076,0.00013459,127756540,0.815846
D.birchii,156593892,VNKA01002141.1,1,21070,0.000134552,127777610,0.815981
D.birchii,156593892,VNKA01004886.1,1,21049,0.000134418,127798659,0.816115
D.birchii,156593892,VNKA01000763.1,1,21048,0.000134411,127819707,0.81625
D.birchii,156593892,VNKA01004522.1,1,20946,0.00013376,127840653,0.816383
D.birchii,156593892,VNKA01000045.1,1,20829,0.000133013,127861482,0.816516
D.birchii,156593892,VNKA01007132.1,1,20747,0.000132489,127882229,0.816649
D.birchii,156593892,VNKA01005973.1,1,20745,0.000132476,127902974,0.816781
D.birchii,156593892,VNKA01001107.1,1,20710,0.000132253,127923684,0.816914
D.birchii,156593892,VNKA01005169.1,1,20683,0.000132081,127944367,0.817046
D.birchii,156593892,VNKA01003379.1,1,20442,0.000130541,127964809,0.817176
D.birchii,156593892,VNKA01003613.1,1,20426,0.000130439,127985235,0.817307
D.birchii,156593892,VNKA01006764.1,1,20399,0.000130267,128005634,0.817437
D.birchii,156593892,VNKA01005241.1,1,20385,0.000130177,128026019,0.817567
D.birchii,156593892,VNKA01001941.1,1,20350,0.000129954,128046369,0.817697
D.birchii,156593892,VNKA01002665.1,1,20331,0.000129833,128066700,0.817827
D.birchii,156593892,VNKA01000206.1,1,20304,0.00012966,128087004,0.817957
D.birchii,156593892,VNKA01000481.1,1,20297,0.000129616,128107301,0.818086
D.birchii,156593892,VNKA01001559.1,1,20265,0.000129411,128127566,0.818216
D.birchii,156593892,VNKA01000622.1,1,20259,0.000129373,128147825,0.818345
D.birchii,156593892,VNKA01002275.1,1,20216,0.000129098,128168041,0.818474
D.birchii,156593892,VNKA01002482.1,1,20150,0.000128677,128188191,0.818603
D.birchii,156593892,VNKA01004080.1,1,20117,0.000128466,128208308,0.818731
D.birchii,156593892,VNKA01000500.1,1,20070,0.000128166,128228378,0.818859
D.birchii,156593892,VNKA01000659.1,1,20067,0.000128147,128248445,0.818988
D.birchii,156593892,VNKA01001555.1,1,20064,0.000128128,128268509,0.819116
D.birchii,156593892,VNKA01005634.1,1,20019,0.00012784,128288528,0.819243
D.birchii,156593892,VNKA01000924.1,1,20019,0.00012784,128308547,0.819371
D.birchii,156593892,VNKA01003120.1,1,20008,0.00012777,128328555,0.819499
D.birchii,156593892,VNKA01004743.1,1,19873,0.000126908,128348428,0.819626
D.birchii,156593892,VNKA01000855.1,1,19864,0.00012685,128368292,0.819753
D.birchii,156593892,VNKA01007388.1,1,19840,0.000126697,128388132,0.81988
D.birchii,156593892,VNKA01005292.1,1,19837,0.000126678,128407969,0.820006
D.birchii,156593892,VNKA01003380.1,1,19826,0.000126608,128427795,0.820133
D.birchii,156593892,VNKA01001636.1,1,19747,0.000126103,128447542,0.820259
D.birchii,156593892,VNKA01002305.1,1,19710,0.000125867,128467252,0.820385
D.birchii,156593892,VNKA01000473.1,1,19576,0.000125011,128486828,0.82051
D.birchii,156593892,VNKA01001962.1,1,19557,0.00012489,128506385,0.820635
D.birchii,156593892,VNKA01000783.1,1,19540,0.000124781,128525925,0.82076
D.birchii,156593892,VNKA01007126.1,1,19519,0.000124647,128545444,0.820884
D.birchii,156593892,VNKA01000970.1,1,19513,0.000124609,128564957,0.821009
D.birchii,156593892,VNKA01002748.1,1,19502,0.000124539,128584459,0.821133
D.birchii,156593892,VNKA01007100.1,1,19497,0.000124507,128603956,0.821258
D.birchii,156593892,VNKA01005526.1,1,19432,0.000124092,128623388,0.821382
D.birchii,156593892,VNKA01005190.1,1,19369,0.000123689,128642757,0.821506
D.birchii,156593892,VNKA01006905.1,1,19296,0.000123223,128662053,0.821629
D.birchii,156593892,VNKA01001302.1,1,19194,0.000122572,128681247,0.821751
D.birchii,156593892,VNKA01003351.1,1,19110,0.000122035,128700357,0.821873
D.birchii,156593892,VNKA01005895.1,1,19101,0.000121978,128719458,0.821995
D.birchii,156593892,VNKA01003551.1,1,19005,0.000121365,128738463,0.822117
D.birchii,156593892,VNKA01001456.1,1,19003,0.000121352,128757466,0.822238
D.birchii,156593892,VNKA01007279.1,1,18965,0.000121109,128776431,0.822359
D.birchii,156593892,VNKA01000155.1,1,18941,0.000120956,128795372,0.82248
D.birchii,156593892,VNKA01000774.1,1,18913,0.000120777,128814285,0.822601
D.birchii,156593892,VNKA01006398.1,1,18906,0.000120733,128833191,0.822722
D.birchii,156593892,VNKA01000355.1,1,18896,0.000120669,128852087,0.822842
D.birchii,156593892,VNKA01003081.1,1,18871,0.000120509,128870958,0.822963
D.birchii,156593892,VNKA01003403.1,1,18753,0.000119756,128889711,0.823083
D.birchii,156593892,VNKA01001728.1,1,18730,0.000119609,128908441,0.823202
D.birchii,156593892,VNKA01002433.1,1,18670,0.000119226,128927111,0.823321
D.birchii,156593892,VNKA01006598.1,1,18667,0.000119206,128945778,0.823441
D.birchii,156593892,VNKA01004768.1,1,18623,0.000118925,128964401,0.82356
D.birchii,156593892,VNKA01004492.1,1,18493,0.000118095,128982894,0.823678
D.birchii,156593892,VNKA01004132.1,1,18453,0.00011784,129001347,0.823796
D.birchii,156593892,VNKA01001864.1,1,18405,0.000117533,129019752,0.823913
D.birchii,156593892,VNKA01000011.1,1,18400,0.000117501,129038152,0.824031
D.birchii,156593892,VNKA01007103.1,1,18390,0.000117438,129056542,0.824148
D.birchii,156593892,VNKA01007522.1,1,18385,0.000117406,129074927,0.824265
D.birchii,156593892,VNKA01005053.1,1,18347,0.000117163,129093274,0.824383
D.birchii,156593892,VNKA01003889.1,1,18347,0.000117163,129111621,0.8245
D.birchii,156593892,VNKA01001887.1,1,18320,0.000116991,129129941,0.824617
D.birchii,156593892,VNKA01000619.1,1,18319,0.000116984,129148260,0.824734
D.birchii,156593892,VNKA01004292.1,1,18313,0.000116946,129166573,0.824851
D.birchii,156593892,VNKA01007206.1,1,18289,0.000116793,129184862,0.824967
D.birchii,156593892,VNKA01003887.1,1,18282,0.000116748,129203144,0.825084
D.birchii,156593892,VNKA01007403.1,1,18169,0.000116026,129221313,0.8252
D.birchii,156593892,VNKA01000344.1,1,18156,0.000115943,129239469,0.825316
D.birchii,156593892,VNKA01005316.1,1,18153,0.000115924,129257622,0.825432
D.birchii,156593892,VNKA01005684.1,1,18113,0.000115669,129275735,0.825548
D.birchii,156593892,VNKA01002112.1,1,18103,0.000115605,129293838,0.825663
D.birchii,156593892,VNKA01004802.1,1,18098,0.000115573,129311936,0.825779
D.birchii,156593892,VNKA01000563.1,1,18063,0.000115349,129329999,0.825894
D.birchii,156593892,VNKA01000400.1,1,18049,0.00011526,129348048,0.82601
D.birchii,156593892,VNKA01004903.1,1,18027,0.000115119,129366075,0.826125
D.birchii,156593892,VNKA01002496.1,1,17987,0.000114864,129384062,0.82624
D.birchii,156593892,VNKA01002466.1,1,17980,0.000114819,129402042,0.826354
D.birchii,156593892,VNKA01006747.1,1,17970,0.000114755,129420012,0.826469
D.birchii,156593892,VNKA01002547.1,1,17936,0.000114538,129437948,0.826584
D.birchii,156593892,VNKA01006949.1,1,17935,0.000114532,129455883,0.826698
D.birchii,156593892,VNKA01006331.1,1,17925,0.000114468,129473808,0.826813
D.birchii,156593892,VNKA01006560.1,1,17921,0.000114443,129491729,0.826927
D.birchii,156593892,VNKA01002324.1,1,17921,0.000114443,129509650,0.827042
D.birchii,156593892,VNKA01006558.1,1,17912,0.000114385,129527562,0.827156
D.birchii,156593892,VNKA01003665.1,1,17911,0.000114379,129545473,0.82727
D.birchii,156593892,VNKA01005567.1,1,17861,0.000114059,129563334,0.827384
D.birchii,156593892,VNKA01006813.1,1,17816,0.000113772,129581150,0.827498
D.birchii,156593892,VNKA01001894.1,1,17681,0.00011291,129598831,0.827611
D.birchii,156593892,VNKA01000197.1,1,17671,0.000112846,129616502,0.827724
D.birchii,156593892,VNKA01004468.1,1,17636,0.000112623,129634138,0.827836
D.birchii,156593892,VNKA01004898.1,1,17583,0.000112284,129651721,0.827949
D.birchii,156593892,VNKA01003058.1,1,17567,0.000112182,129669288,0.828061
D.birchii,156593892,VNKA01002961.1,1,17549,0.000112067,129686837,0.828173
D.birchii,156593892,VNKA01002401.1,1,17497,0.000111735,129704334,0.828285
D.birchii,156593892,VNKA01001119.1,1,17447,0.000111416,129721781,0.828396
D.birchii,156593892,VNKA01007101.1,1,17395,0.000111084,129739176,0.828507
D.birchii,156593892,VNKA01007467.1,1,17314,0.000110566,129756490,0.828618
D.birchii,156593892,VNKA01003466.1,1,17303,0.000110496,129773793,0.828728
D.birchii,156593892,VNKA01002662.1,1,17238,0.000110081,129791031,0.828838
D.birchii,156593892,VNKA01003756.1,1,17235,0.000110062,129808266,0.828948
D.birchii,156593892,VNKA01003267.1,1,17232,0.000110043,129825498,0.829059
D.birchii,156593892,VNKA01005689.1,1,17205,0.00010987,129842703,0.829168
D.birchii,156593892,VNKA01000341.1,1,17196,0.000109813,129859899,0.829278
D.birchii,156593892,VNKA01001948.1,1,17176,0.000109685,129877075,0.829388
D.birchii,156593892,VNKA01007048.1,1,17125,0.000109359,129894200,0.829497
D.birchii,156593892,VNKA01006689.1,1,17108,0.000109251,129911308,0.829606
D.birchii,156593892,VNKA01004485.1,1,17091,0.000109142,129928399,0.829716
D.birchii,156593892,VNKA01000827.1,1,17074,0.000109034,129945473,0.829825
D.birchii,156593892,VNKA01005339.1,1,17044,0.000108842,129962517,0.829934
D.birchii,156593892,VNKA01001664.1,1,17039,0.00010881,129979556,0.830042
D.birchii,156593892,VNKA01004259.1,1,17010,0.000108625,129996566,0.830151
D.birchii,156593892,VNKA01004057.1,1,17005,0.000108593,130013571,0.83026
D.birchii,156593892,VNKA01000822.1,1,16995,0.000108529,130030566,0.830368
D.birchii,156593892,VNKA01005080.1,1,16989,0.000108491,130047555,0.830477
D.birchii,156593892,VNKA01006999.1,1,16974,0.000108395,130064529,0.830585
D.birchii,156593892,VNKA01006352.1,1,16958,0.000108293,130081487,0.830693
D.birchii,156593892,VNKA01005985.1,1,16932,0.000108127,130098419,0.830801
D.birchii,156593892,VNKA01001926.1,1,16928,0.000108101,130115347,0.830909
D.birchii,156593892,VNKA01000171.1,1,16920,0.00010805,130132267,0.831018
D.birchii,156593892,VNKA01003284.1,1,16901,0.000107929,130149168,0.831125
D.birchii,156593892,VNKA01002281.1,1,16879,0.000107788,130166047,0.831233
D.birchii,156593892,VNKA01002731.1,1,16843,0.000107558,130182890,0.831341
D.birchii,156593892,VNKA01000016.1,1,16812,0.000107361,130199702,0.831448
D.birchii,156593892,VNKA01002792.1,1,16801,0.00010729,130216503,0.831555
D.birchii,156593892,VNKA01001778.1,1,16789,0.000107214,130233292,0.831663
D.birchii,156593892,VNKA01004968.1,1,16748,0.000106952,130250040,0.83177
D.birchii,156593892,VNKA01002656.1,1,16748,0.000106952,130266788,0.831877
D.birchii,156593892,VNKA01003383.1,1,16741,0.000106907,130283529,0.831983
D.birchii,156593892,VNKA01005089.1,1,16736,0.000106875,130300265,0.83209
D.birchii,156593892,VNKA01000726.1,1,16728,0.000106824,130316993,0.832197
D.birchii,156593892,VNKA01002259.1,1,16672,0.000106466,130333665,0.832304
D.birchii,156593892,VNKA01006449.1,1,16614,0.000106096,130350279,0.83241
D.birchii,156593892,VNKA01003285.1,1,16592,0.000105956,130366871,0.832516
D.birchii,156593892,VNKA01002754.1,1,16576,0.000105853,130383447,0.832622
D.birchii,156593892,VNKA01003856.1,1,16573,0.000105834,130400020,0.832727
D.birchii,156593892,VNKA01003588.1,1,16546,0.000105662,130416566,0.832833
D.birchii,156593892,VNKA01003569.1,1,16530,0.00010556,130433096,0.832939
D.birchii,156593892,VNKA01001029.1,1,16525,0.000105528,130449621,0.833044
D.birchii,156593892,VNKA01007406.1,1,16492,0.000105317,130466113,0.833149
D.birchii,156593892,VNKA01006820.1,1,16472,0.000105189,130482585,0.833255
D.birchii,156593892,VNKA01001771.1,1,16468,0.000105164,130499053,0.83336
D.birchii,156593892,VNKA01007115.1,1,16454,0.000105074,130515507,0.833465
D.birchii,156593892,VNKA01006682.1,1,16437,0.000104966,130531944,0.83357
D.birchii,156593892,VNKA01002574.1,1,16369,0.000104532,130548313,0.833674
D.birchii,156593892,VNKA01006301.1,1,16352,0.000104423,130564665,0.833779
D.birchii,156593892,VNKA01004947.1,1,16318,0.000104206,130580983,0.833883
D.birchii,156593892,VNKA01000506.1,1,16295,0.000104059,130597278,0.833987
D.birchii,156593892,VNKA01005076.1,1,16293,0.000104046,130613571,0.834091
D.birchii,156593892,VNKA01004571.1,1,16279,0.000103957,130629850,0.834195
D.birchii,156593892,VNKA01007393.1,1,16242,0.000103721,130646092,0.834299
D.birchii,156593892,VNKA01000071.1,1,16224,0.000103606,130662316,0.834402
D.birchii,156593892,VNKA01007348.1,1,16204,0.000103478,130678520,0.834506
D.birchii,156593892,VNKA01003443.1,1,16203,0.000103471,130694723,0.834609
D.birchii,156593892,VNKA01000498.1,1,16164,0.000103222,130710887,0.834713
D.birchii,156593892,VNKA01004184.1,1,16151,0.000103139,130727038,0.834816
D.birchii,156593892,VNKA01001684.1,1,16151,0.000103139,130743189,0.834919
D.birchii,156593892,VNKA01003464.1,1,16145,0.000103101,130759334,0.835022
D.birchii,156593892,VNKA01001218.1,1,16135,0.000103037,130775469,0.835125
D.birchii,156593892,VNKA01005338.1,1,16132,0.000103018,130791601,0.835228
D.birchii,156593892,VNKA01001719.1,1,16067,0.000102603,130807668,0.835331
D.birchii,156593892,VNKA01006055.1,1,16050,0.000102494,130823718,0.835433
D.birchii,156593892,VNKA01004287.1,1,16050,0.000102494,130839768,0.835536
D.birchii,156593892,VNKA01000468.1,1,16032,0.000102379,130855800,0.835638
D.birchii,156593892,VNKA01001027.1,1,16019,0.000102296,130871819,0.83574
D.birchii,156593892,VNKA01003003.1,1,16015,0.000102271,130887834,0.835843
D.birchii,156593892,VNKA01003951.1,1,15988,0.000102098,130903822,0.835945
D.birchii,156593892,VNKA01000094.1,1,15976,0.000102022,130919798,0.836047
D.birchii,156593892,VNKA01006537.1,1,15964,0.000101945,130935762,0.836149
D.birchii,156593892,VNKA01007102.1,1,15910,0.0001016,130951672,0.83625
D.birchii,156593892,VNKA01003442.1,1,15897,0.000101517,130967569,0.836352
D.birchii,156593892,VNKA01001739.1,1,15875,0.000101377,130983444,0.836453
D.birchii,156593892,VNKA01004479.1,1,15859,0.000101275,130999303,0.836554
D.birchii,156593892,VNKA01004480.1,1,15847,0.000101198,131015150,0.836656
D.birchii,156593892,VNKA01000584.1,1,15837,0.000101134,131030987,0.836757
D.birchii,156593892,VNKA01002167.1,1,15821,0.000101032,131046808,0.836858
D.birchii,156593892,VNKA01002410.1,1,15813,0.000100981,131062621,0.836959
D.birchii,156593892,VNKA01003115.1,1,15805,0.00010093,131078426,0.83706
D.birchii,156593892,VNKA01002709.1,1,15790,0.000100834,131094216,0.83716
D.birchii,156593892,VNKA01003446.1,1,15736,0.000100489,131109952,0.837261
D.birchii,156593892,VNKA01001202.1,1,15709,0.000100317,131125661,0.837361
D.birchii,156593892,VNKA01000621.1,1,15709,0.000100317,131141370,0.837462
D.birchii,156593892,VNKA01003128.1,1,15702,0.000100272,131157072,0.837562
D.birchii,156593892,VNKA01006812.1,1,15699,0.000100253,131172771,0.837662
D.birchii,156593892,VNKA01000308.1,1,15676,0.000100106,131188447,0.837762
D.birchii,156593892,VNKA01003382.1,1,15656,9.99784e-05,131204103,0.837862
D.birchii,156593892,VNKA01003824.1,1,15642,9.9889e-05,131219745,0.837962
D.birchii,156593892,VNKA01005414.1,1,15635,9.98443e-05,131235380,0.838062
D.birchii,156593892,VNKA01000411.1,1,15626,9.97868e-05,131251006,0.838162
D.birchii,156593892,VNKA01004362.1,1,15625,9.97804e-05,131266631,0.838262
D.birchii,156593892,VNKA01003722.1,1,15619,9.97421e-05,131282250,0.838361
D.birchii,156593892,VNKA01006893.1,1,15596,9.95952e-05,131297846,0.838461
D.birchii,156593892,VNKA01002827.1,1,15596,9.95952e-05,131313442,0.83856
D.birchii,156593892,VNKA01006789.1,1,15587,9.95377e-05,131329029,0.83866
D.birchii,156593892,VNKA01004778.1,1,15571,9.94356e-05,131344600,0.838759
D.birchii,156593892,VNKA01000578.1,1,15552,9.93142e-05,131360152,0.838859
D.birchii,156593892,VNKA01004867.1,1,15546,9.92759e-05,131375698,0.838958
D.birchii,156593892,VNKA01006396.1,1,15532,9.91865e-05,131391230,0.839057
D.birchii,156593892,VNKA01006977.1,1,15526,9.91482e-05,131406756,0.839156
D.birchii,156593892,VNKA01005015.1,1,15515,9.90779e-05,131422271,0.839255
D.birchii,156593892,VNKA01000616.1,1,15483,9.88736e-05,131437754,0.839354
D.birchii,156593892,VNKA01005487.1,1,15466,9.8765e-05,131453220,0.839453
D.birchii,156593892,VNKA01006333.1,1,15456,9.87012e-05,131468676,0.839552
D.birchii,156593892,VNKA01005019.1,1,15434,9.85607e-05,131484110,0.83965
D.birchii,156593892,VNKA01006042.1,1,15421,9.84777e-05,131499531,0.839749
D.birchii,156593892,VNKA01004847.1,1,15394,9.83052e-05,131514925,0.839847
D.birchii,156593892,VNKA01001672.1,1,15389,9.82733e-05,131530314,0.839945
D.birchii,156593892,VNKA01001526.1,1,15355,9.80562e-05,131545669,0.840043
D.birchii,156593892,VNKA01006200.1,1,15352,9.8037e-05,131561021,0.840141
D.birchii,156593892,VNKA01003841.1,1,15350,9.80243e-05,131576371,0.840239
D.birchii,156593892,VNKA01004546.1,1,15332,9.79093e-05,131591703,0.840337
D.birchii,156593892,VNKA01002728.1,1,15304,9.77305e-05,131607007,0.840435
D.birchii,156593892,VNKA01002696.1,1,15269,9.7507e-05,131622276,0.840533
D.birchii,156593892,VNKA01000244.1,1,15268,9.75006e-05,131637544,0.84063
D.birchii,156593892,VNKA01007052.1,1,15263,9.74687e-05,131652807,0.840728
D.birchii,156593892,VNKA01003312.1,1,15237,9.73026e-05,131668044,0.840825
D.birchii,156593892,VNKA01000557.1,1,15173,9.68939e-05,131683217,0.840922
D.birchii,156593892,VNKA01007466.1,1,15157,9.67918e-05,131698374,0.841019
D.birchii,156593892,VNKA01007210.1,1,15141,9.66896e-05,131713515,0.841115
D.birchii,156593892,VNKA01005363.1,1,15114,9.65172e-05,131728629,0.841212
D.birchii,156593892,VNKA01000817.1,1,15100,9.64278e-05,131743729,0.841308
D.birchii,156593892,VNKA01004961.1,1,15094,9.63895e-05,131758823,0.841405
D.birchii,156593892,VNKA01005075.1,1,15083,9.63192e-05,131773906,0.841501
D.birchii,156593892,VNKA01004451.1,1,15062,9.61851e-05,131788968,0.841597
D.birchii,156593892,VNKA01006600.1,1,15046,9.60829e-05,131804014,0.841693
D.birchii,156593892,VNKA01004271.1,1,15046,9.60829e-05,131819060,0.841789
D.birchii,156593892,VNKA01005655.1,1,15038,9.60318e-05,131834098,0.841885
D.birchii,156593892,VNKA01000020.1,1,15032,9.59935e-05,131849130,0.841981
D.birchii,156593892,VNKA01004842.1,1,15024,9.59424e-05,131864154,0.842077
D.birchii,156593892,VNKA01006031.1,1,14982,9.56742e-05,131879136,0.842173
D.birchii,156593892,VNKA01002655.1,1,14977,9.56423e-05,131894113,0.842269
D.birchii,156593892,VNKA01004752.1,1,14960,9.55337e-05,131909073,0.842364
D.birchii,156593892,VNKA01006004.1,1,14907,9.51953e-05,131923980,0.842459
D.birchii,156593892,VNKA01004181.1,1,14905,9.51825e-05,131938885,0.842554
D.birchii,156593892,VNKA01000946.1,1,14879,9.50165e-05,131953764,0.842649
D.birchii,156593892,VNKA01002050.1,1,14834,9.47291e-05,131968598,0.842744
D.birchii,156593892,VNKA01003376.1,1,14827,9.46844e-05,131983425,0.842839
D.birchii,156593892,VNKA01002467.1,1,14815,9.46078e-05,131998240,0.842934
D.birchii,156593892,VNKA01004576.1,1,14800,9.4512e-05,132013040,0.843028
D.birchii,156593892,VNKA01006497.1,1,14783,9.44034e-05,132027823,0.843122
D.birchii,156593892,VNKA01002331.1,1,14763,9.42757e-05,132042586,0.843217
D.birchii,156593892,VNKA01002284.1,1,14746,9.41671e-05,132057332,0.843311
D.birchii,156593892,VNKA01007173.1,1,14716,9.39756e-05,132072048,0.843405
D.birchii,156593892,VNKA01004536.1,1,14715,9.39692e-05,132086763,0.843499
D.birchii,156593892,VNKA01004173.1,1,14692,9.38223e-05,132101455,0.843593
D.birchii,156593892,VNKA01007239.1,1,14684,9.37712e-05,132116139,0.843686
D.birchii,156593892,VNKA01001706.1,1,14675,9.37137e-05,132130814,0.84378
D.birchii,156593892,VNKA01006164.1,1,14648,9.35413e-05,132145462,0.843874
D.birchii,156593892,VNKA01006079.1,1,14621,9.33689e-05,132160083,0.843967
D.birchii,156593892,VNKA01002369.1,1,14596,9.32093e-05,132174679,0.84406
D.birchii,156593892,VNKA01006060.1,1,14541,9.2858e-05,132189220,0.844153
D.birchii,156593892,VNKA01004382.1,1,14531,9.27942e-05,132203751,0.844246
D.birchii,156593892,VNKA01003907.1,1,14530,9.27878e-05,132218281,0.844339
D.birchii,156593892,VNKA01003444.1,1,14503,9.26154e-05,132232784,0.844431
D.birchii,156593892,VNKA01003973.1,1,14436,9.21875e-05,132247220,0.844523
D.birchii,156593892,VNKA01003768.1,1,14436,9.21875e-05,132261656,0.844616
D.birchii,156593892,VNKA01003304.1,1,14436,9.21875e-05,132276092,0.844708
D.birchii,156593892,VNKA01007525.1,1,14428,9.21364e-05,132290520,0.8448
D.birchii,156593892,VNKA01001098.1,1,14428,9.21364e-05,132304948,0.844892
D.birchii,156593892,VNKA01002529.1,1,14420,9.20853e-05,132319368,0.844984
D.birchii,156593892,VNKA01005848.1,1,14414,9.2047e-05,132333782,0.845076
D.birchii,156593892,VNKA01005966.1,1,14396,9.19321e-05,132348178,0.845168
D.birchii,156593892,VNKA01006765.1,1,14366,9.17405e-05,132362544,0.84526
D.birchii,156593892,VNKA01001293.1,1,14308,9.13701e-05,132376852,0.845351
D.birchii,156593892,VNKA01000974.1,1,14300,9.1319e-05,132391152,0.845443
D.birchii,156593892,VNKA01003886.1,1,14286,9.12296e-05,132405438,0.845534
D.birchii,156593892,VNKA01003908.1,1,14254,9.10253e-05,132419692,0.845625
D.birchii,156593892,VNKA01003692.1,1,14253,9.10189e-05,132433945,0.845716
D.birchii,156593892,VNKA01003420.1,1,14240,9.09359e-05,132448185,0.845807
D.birchii,156593892,VNKA01006392.1,1,14235,9.09039e-05,132462420,0.845898
D.birchii,156593892,VNKA01000454.1,1,14188,9.06038e-05,132476608,0.845988
D.birchii,156593892,VNKA01002546.1,1,14152,9.03739e-05,132490760,0.846079
D.birchii,156593892,VNKA01007330.1,1,14135,9.02653e-05,132504895,0.846169
D.birchii,156593892,VNKA01007041.1,1,14135,9.02653e-05,132519030,0.846259
D.birchii,156593892,VNKA01005064.1,1,14133,9.02526e-05,132533163,0.84635
D.birchii,156593892,VNKA01001604.1,1,14114,9.01312e-05,132547277,0.84644
D.birchii,156593892,VNKA01005668.1,1,14113,9.01248e-05,132561390,0.84653
D.birchii,156593892,VNKA01003891.1,1,14041,8.96651e-05,132575431,0.846619
D.birchii,156593892,VNKA01005228.1,1,14034,8.96204e-05,132589465,0.846709
D.birchii,156593892,VNKA01001622.1,1,14021,8.95373e-05,132603486,0.846799
D.birchii,156593892,VNKA01002831.1,1,14020,8.9531e-05,132617506,0.846888
D.birchii,156593892,VNKA01005957.1,1,14015,8.9499e-05,132631521,0.846978
D.birchii,156593892,VNKA01005060.1,1,14013,8.94862e-05,132645534,0.847067
D.birchii,156593892,VNKA01004824.1,1,14002,8.9416e-05,132659536,0.847157
D.birchii,156593892,VNKA01006818.1,1,13982,8.92883e-05,132673518,0.847246
D.birchii,156593892,VNKA01003280.1,1,13978,8.92627e-05,132687496,0.847335
D.birchii,156593892,VNKA01003085.1,1,13978,8.92627e-05,132701474,0.847424
D.birchii,156593892,VNKA01004246.1,1,13968,8.91989e-05,132715442,0.847514
D.birchii,156593892,VNKA01007423.1,1,13932,8.8969e-05,132729374,0.847602
D.birchii,156593892,VNKA01000681.1,1,13929,8.89498e-05,132743303,0.847691
D.birchii,156593892,VNKA01006773.1,1,13904,8.87902e-05,132757207,0.84778
D.birchii,156593892,VNKA01003434.1,1,13904,8.87902e-05,132771111,0.847869
D.birchii,156593892,VNKA01001275.1,1,13902,8.87774e-05,132785013,0.847958
D.birchii,156593892,VNKA01003001.1,1,13883,8.86561e-05,132798896,0.848046
D.birchii,156593892,VNKA01000650.1,1,13873,8.85922e-05,132812769,0.848135
D.birchii,156593892,VNKA01006394.1,1,13855,8.84773e-05,132826624,0.848224
D.birchii,156593892,VNKA01007260.1,1,13831,8.8324e-05,132840455,0.848312
D.birchii,156593892,VNKA01001470.1,1,13810,8.81899e-05,132854265,0.8484
D.birchii,156593892,VNKA01003374.1,1,13809,8.81835e-05,132868074,0.848488
D.birchii,156593892,VNKA01004161.1,1,13804,8.81516e-05,132881878,0.848576
D.birchii,156593892,VNKA01004154.1,1,13797,8.81069e-05,132895675,0.848664
D.birchii,156593892,VNKA01005735.1,1,13795,8.80941e-05,132909470,0.848753
D.birchii,156593892,VNKA01005147.1,1,13779,8.79919e-05,132923249,0.848841
D.birchii,156593892,VNKA01007181.1,1,13776,8.79728e-05,132937025,0.848929
D.birchii,156593892,VNKA01003724.1,1,13776,8.79728e-05,132950801,0.849017
D.birchii,156593892,VNKA01004541.1,1,13771,8.79409e-05,132964572,0.849104
D.birchii,156593892,VNKA01001858.1,1,13723,8.76343e-05,132978295,0.849192
D.birchii,156593892,VNKA01004606.1,1,13686,8.7398e-05,132991981,0.849279
D.birchii,156593892,VNKA01005026.1,1,13676,8.73342e-05,133005657,0.849367
D.birchii,156593892,VNKA01005912.1,1,13670,8.72959e-05,133019327,0.849454
D.birchii,156593892,VNKA01006089.1,1,13666,8.72703e-05,133032993,0.849541
D.birchii,156593892,VNKA01005576.1,1,13634,8.7066e-05,133046627,0.849628
D.birchii,156593892,VNKA01002945.1,1,13619,8.69702e-05,133060246,0.849715
D.birchii,156593892,VNKA01003833.1,1,13604,8.68744e-05,133073850,0.849802
D.birchii,156593892,VNKA01000391.1,1,13594,8.68105e-05,133087444,0.849889
D.birchii,156593892,VNKA01005062.1,1,13591,8.67914e-05,133101035,0.849976
D.birchii,156593892,VNKA01002695.1,1,13585,8.67531e-05,133114620,0.850063
D.birchii,156593892,VNKA01003384.1,1,13568,8.66445e-05,133128188,0.850149
D.birchii,156593892,VNKA01004549.1,1,13541,8.64721e-05,133141729,0.850236
D.birchii,156593892,VNKA01006029.1,1,13536,8.64402e-05,133155265,0.850322
D.birchii,156593892,VNKA01000507.1,1,13524,8.63635e-05,133168789,0.850409
D.birchii,156593892,VNKA01003372.1,1,13517,8.63188e-05,133182306,0.850495
D.birchii,156593892,VNKA01006298.1,1,13511,8.62805e-05,133195817,0.850581
D.birchii,156593892,VNKA01006504.1,1,13486,8.61209e-05,133209303,0.850667
D.birchii,156593892,VNKA01000118.1,1,13435,8.57952e-05,133222738,0.850753
D.birchii,156593892,VNKA01000005.1,1,13417,8.56802e-05,133236155,0.850839
D.birchii,156593892,VNKA01000037.1,1,13393,8.5527e-05,133249548,0.850924
D.birchii,156593892,VNKA01002548.1,1,13392,8.55206e-05,133262940,0.85101
D.birchii,156593892,VNKA01002535.1,1,13363,8.53354e-05,133276303,0.851095
D.birchii,156593892,VNKA01003947.1,1,13352,8.52651e-05,133289655,0.85118
D.birchii,156593892,VNKA01002501.1,1,13334,8.51502e-05,133302989,0.851266
D.birchii,156593892,VNKA01004435.1,1,13333,8.51438e-05,133316322,0.851351
D.birchii,156593892,VNKA01002890.1,1,13331,8.5131e-05,133329653,0.851436
D.birchii,156593892,VNKA01004082.1,1,13317,8.50416e-05,133342970,0.851521
D.birchii,156593892,VNKA01000013.1,1,13312,8.50097e-05,133356282,0.851606
D.birchii,156593892,VNKA01001554.1,1,13254,8.46393e-05,133369536,0.851691
D.birchii,156593892,VNKA01006569.1,1,13251,8.46202e-05,133382787,0.851775
D.birchii,156593892,VNKA01007209.1,1,13247,8.45946e-05,133396034,0.85186
D.birchii,156593892,VNKA01002785.1,1,13215,8.43903e-05,133409249,0.851944
D.birchii,156593892,VNKA01001624.1,1,13215,8.43903e-05,133422464,0.852029
D.birchii,156593892,VNKA01005626.1,1,13194,8.42562e-05,133435658,0.852113
D.birchii,156593892,VNKA01002234.1,1,13170,8.41029e-05,133448828,0.852197
D.birchii,156593892,VNKA01004383.1,1,13151,8.39816e-05,133461979,0.852281
D.birchii,156593892,VNKA01002661.1,1,13143,8.39305e-05,133475122,0.852365
D.birchii,156593892,VNKA01006570.1,1,13135,8.38794e-05,133488257,0.852449
D.birchii,156593892,VNKA01004807.1,1,13133,8.38666e-05,133501390,0.852533
D.birchii,156593892,VNKA01002538.1,1,13130,8.38475e-05,133514520,0.852616
D.birchii,156593892,VNKA01002575.1,1,13091,8.35984e-05,133527611,0.8527
D.birchii,156593892,VNKA01000587.1,1,13088,8.35792e-05,133540699,0.852784
D.birchii,156593892,VNKA01002047.1,1,13082,8.35409e-05,133553781,0.852867
D.birchii,156593892,VNKA01007179.1,1,13055,8.33685e-05,133566836,0.85295
D.birchii,156593892,VNKA01000613.1,1,13047,8.33174e-05,133579883,0.853034
D.birchii,156593892,VNKA01003231.1,1,13037,8.32536e-05,133592920,0.853117
D.birchii,156593892,VNKA01001675.1,1,12993,8.29726e-05,133605913,0.8532
D.birchii,156593892,VNKA01005194.1,1,12956,8.27363e-05,133618869,0.853283
D.birchii,156593892,VNKA01006805.1,1,12953,8.27171e-05,133631822,0.853365
D.birchii,156593892,VNKA01003248.1,1,12916,8.24809e-05,133644738,0.853448
D.birchii,156593892,VNKA01001068.1,1,12900,8.23787e-05,133657638,0.85353
D.birchii,156593892,VNKA01007045.1,1,12888,8.23021e-05,133670526,0.853613
D.birchii,156593892,VNKA01006975.1,1,12866,8.21616e-05,133683392,0.853695
D.birchii,156593892,VNKA01000129.1,1,12834,8.19572e-05,133696226,0.853777
D.birchii,156593892,VNKA01001126.1,1,12831,8.19381e-05,133709057,0.853859
D.birchii,156593892,VNKA01007316.1,1,12826,8.19061e-05,133721883,0.853941
D.birchii,156593892,VNKA01002274.1,1,12803,8.17593e-05,133734686,0.854022
D.birchii,156593892,VNKA01005319.1,1,12733,8.13122e-05,133747419,0.854104
D.birchii,156593892,VNKA01001846.1,1,12718,8.12165e-05,133760137,0.854185
D.birchii,156593892,VNKA01000413.1,1,12690,8.10376e-05,133772827,0.854266
D.birchii,156593892,VNKA01003854.1,1,12672,8.09227e-05,133785499,0.854347
D.birchii,156593892,VNKA01005225.1,1,12671,8.09163e-05,133798170,0.854428
D.birchii,156593892,VNKA01001513.1,1,12670,8.09099e-05,133810840,0.854509
D.birchii,156593892,VNKA01000006.1,1,12641,8.07247e-05,133823481,0.854589
D.birchii,156593892,VNKA01000245.1,1,12640,8.07183e-05,133836121,0.85467
D.birchii,156593892,VNKA01004112.1,1,12636,8.06928e-05,133848757,0.854751
D.birchii,156593892,VNKA01000615.1,1,12635,8.06864e-05,133861392,0.854832
D.birchii,156593892,VNKA01003669.1,1,12631,8.06609e-05,133874023,0.854912
D.birchii,156593892,VNKA01006045.1,1,12623,8.06098e-05,133886646,0.854993
D.birchii,156593892,VNKA01003079.1,1,12615,8.05587e-05,133899261,0.855073
D.birchii,156593892,VNKA01002657.1,1,12612,8.05395e-05,133911873,0.855154
D.birchii,156593892,VNKA01007354.1,1,12605,8.04948e-05,133924478,0.855234
D.birchii,156593892,VNKA01002726.1,1,12592,8.04118e-05,133937070,0.855315
D.birchii,156593892,VNKA01001399.1,1,12583,8.03543e-05,133949653,0.855395
D.birchii,156593892,VNKA01005014.1,1,12578,8.03224e-05,133962231,0.855475
D.birchii,156593892,VNKA01000267.1,1,12572,8.02841e-05,133974803,0.855556
D.birchii,156593892,VNKA01002866.1,1,12550,8.01436e-05,133987353,0.855636
D.birchii,156593892,VNKA01005697.1,1,12544,8.01053e-05,133999897,0.855716
D.birchii,156593892,VNKA01001001.1,1,12543,8.00989e-05,134012440,0.855796
D.birchii,156593892,VNKA01004484.1,1,12535,8.00478e-05,134024975,0.855876
D.birchii,156593892,VNKA01005513.1,1,12516,7.99265e-05,134037491,0.855956
D.birchii,156593892,VNKA01004837.1,1,12513,7.99073e-05,134050004,0.856036
D.birchii,156593892,VNKA01003016.1,1,12506,7.98626e-05,134062510,0.856116
D.birchii,156593892,VNKA01000202.1,1,12480,7.96966e-05,134074990,0.856196
D.birchii,156593892,VNKA01006517.1,1,12474,7.96583e-05,134087464,0.856275
D.birchii,156593892,VNKA01003677.1,1,12455,7.95369e-05,134099919,0.856355
D.birchii,156593892,VNKA01005340.1,1,12441,7.94475e-05,134112360,0.856434
D.birchii,156593892,VNKA01003247.1,1,12441,7.94475e-05,134124801,0.856514
D.birchii,156593892,VNKA01004738.1,1,12438,7.94284e-05,134137239,0.856593
D.birchii,156593892,VNKA01005268.1,1,12424,7.9339e-05,134149663,0.856672
D.birchii,156593892,VNKA01005238.1,1,12420,7.93134e-05,134162083,0.856752
D.birchii,156593892,VNKA01004911.1,1,12368,7.89814e-05,134174451,0.856831
D.birchii,156593892,VNKA01002793.1,1,12363,7.89494e-05,134186814,0.85691
D.birchii,156593892,VNKA01000496.1,1,12346,7.88409e-05,134199160,0.856988
D.birchii,156593892,VNKA01002499.1,1,12288,7.84705e-05,134211448,0.857067
D.birchii,156593892,VNKA01006829.1,1,12282,7.84322e-05,134223730,0.857145
D.birchii,156593892,VNKA01005688.1,1,12279,7.8413e-05,134236009,0.857224
D.birchii,156593892,VNKA01004628.1,1,12274,7.83811e-05,134248283,0.857302
D.birchii,156593892,VNKA01002502.1,1,12274,7.83811e-05,134260557,0.857381
D.birchii,156593892,VNKA01006970.1,1,12264,7.83172e-05,134272821,0.857459
D.birchii,156593892,VNKA01002585.1,1,12247,7.82087e-05,134285068,0.857537
D.birchii,156593892,VNKA01006638.1,1,12246,7.82023e-05,134297314,0.857615
D.birchii,156593892,VNKA01005721.1,1,12227,7.8081e-05,134309541,0.857693
D.birchii,156593892,VNKA01007470.1,1,12211,7.79788e-05,134321752,0.857771
D.birchii,156593892,VNKA01006116.1,1,12204,7.79341e-05,134333956,0.857849
D.birchii,156593892,VNKA01003723.1,1,12196,7.7883e-05,134346152,0.857927
D.birchii,156593892,VNKA01005654.1,1,12176,7.77553e-05,134358328,0.858005
D.birchii,156593892,VNKA01001295.1,1,12155,7.76212e-05,134370483,0.858083
D.birchii,156593892,VNKA01004519.1,1,12144,7.75509e-05,134382627,0.85816
D.birchii,156593892,VNKA01001617.1,1,12142,7.75381e-05,134394769,0.858238
D.birchii,156593892,VNKA01003847.1,1,12140,7.75254e-05,134406909,0.858315
D.birchii,156593892,VNKA01002932.1,1,12131,7.74679e-05,134419040,0.858393
D.birchii,156593892,VNKA01006589.1,1,12121,7.7404e-05,134431161,0.85847
D.birchii,156593892,VNKA01003235.1,1,12121,7.7404e-05,134443282,0.858547
D.birchii,156593892,VNKA01005413.1,1,12103,7.72891e-05,134455385,0.858625
D.birchii,156593892,VNKA01000055.1,1,12094,7.72316e-05,134467479,0.858702
D.birchii,156593892,VNKA01006607.1,1,12087,7.71869e-05,134479566,0.858779
D.birchii,156593892,VNKA01005729.1,1,12081,7.71486e-05,134491647,0.858856
D.birchii,156593892,VNKA01003709.1,1,12075,7.71103e-05,134503722,0.858933
D.birchii,156593892,VNKA01003962.1,1,12061,7.70209e-05,134515783,0.85901
D.birchii,156593892,VNKA01006919.1,1,12056,7.6989e-05,134527839,0.859087
D.birchii,156593892,VNKA01002006.1,1,12049,7.69443e-05,134539888,0.859164
D.birchii,156593892,VNKA01003385.1,1,12045,7.69187e-05,134551933,0.859241
D.birchii,156593892,VNKA01007343.1,1,12036,7.68612e-05,134563969,0.859318
D.birchii,156593892,VNKA01007203.1,1,12020,7.67591e-05,134575989,0.859395
D.birchii,156593892,VNKA01002613.1,1,11997,7.66122e-05,134587986,0.859471
D.birchii,156593892,VNKA01007431.1,1,11982,7.65164e-05,134599968,0.859548
D.birchii,156593892,VNKA01000342.1,1,11972,7.64525e-05,134611940,0.859624
D.birchii,156593892,VNKA01007150.1,1,11965,7.64078e-05,134623905,0.859701
D.birchii,156593892,VNKA01005542.1,1,11962,7.63887e-05,134635867,0.859777
D.birchii,156593892,VNKA01005293.1,1,11958,7.63631e-05,134647825,0.859854
D.birchii,156593892,VNKA01005639.1,1,11954,7.63376e-05,134659779,0.85993
D.birchii,156593892,VNKA01004186.1,1,11952,7.63248e-05,134671731,0.860006
D.birchii,156593892,VNKA01003979.1,1,11952,7.63248e-05,134683683,0.860083
D.birchii,156593892,VNKA01000324.1,1,11938,7.62354e-05,134695621,0.860159
D.birchii,156593892,VNKA01004733.1,1,11932,7.61971e-05,134707553,0.860235
D.birchii,156593892,VNKA01001638.1,1,11900,7.59927e-05,134719453,0.860311
D.birchii,156593892,VNKA01007421.1,1,11894,7.59544e-05,134731347,0.860387
D.birchii,156593892,VNKA01000618.1,1,11892,7.59417e-05,134743239,0.860463
D.birchii,156593892,VNKA01002794.1,1,11853,7.56926e-05,134755092,0.860539
D.birchii,156593892,VNKA01007345.1,1,11846,7.56479e-05,134766938,0.860614
D.birchii,156593892,VNKA01005687.1,1,11843,7.56287e-05,134778781,0.86069
D.birchii,156593892,VNKA01004196.1,1,11840,7.56096e-05,134790621,0.860766
D.birchii,156593892,VNKA01005657.1,1,11828,7.5533e-05,134802449,0.860841
D.birchii,156593892,VNKA01006412.1,1,11811,7.54244e-05,134814260,0.860916
D.birchii,156593892,VNKA01005546.1,1,11806,7.53925e-05,134826066,0.860992
D.birchii,156593892,VNKA01005394.1,1,11802,7.53669e-05,134837868,0.861067
D.birchii,156593892,VNKA01002950.1,1,11793,7.53095e-05,134849661,0.861143
D.birchii,156593892,VNKA01001128.1,1,11790,7.52903e-05,134861451,0.861218
D.birchii,156593892,VNKA01002935.1,1,11787,7.52711e-05,134873238,0.861293
D.birchii,156593892,VNKA01000330.1,1,11785,7.52584e-05,134885023,0.861368
D.birchii,156593892,VNKA01000035.1,1,11772,7.51753e-05,134896795,0.861444
D.birchii,156593892,VNKA01007494.1,1,11767,7.51434e-05,134908562,0.861519
D.birchii,156593892,VNKA01003062.1,1,11765,7.51306e-05,134920327,0.861594
D.birchii,156593892,VNKA01003928.1,1,11745,7.50029e-05,134932072,0.861669
D.birchii,156593892,VNKA01004042.1,1,11740,7.4971e-05,134943812,0.861744
D.birchii,156593892,VNKA01001008.1,1,11722,7.4856e-05,134955534,0.861819
D.birchii,156593892,VNKA01004300.1,1,11720,7.48433e-05,134967254,0.861893
D.birchii,156593892,VNKA01002375.1,1,11715,7.48113e-05,134978969,0.861968
D.birchii,156593892,VNKA01005039.1,1,11706,7.47539e-05,134990675,0.862043
D.birchii,156593892,VNKA01001545.1,1,11705,7.47475e-05,135002380,0.862118
D.birchii,156593892,VNKA01006574.1,1,11703,7.47347e-05,135014083,0.862193
D.birchii,156593892,VNKA01007154.1,1,11700,7.47156e-05,135025783,0.862267
D.birchii,156593892,VNKA01002851.1,1,11696,7.469e-05,135037479,0.862342
D.birchii,156593892,VNKA01006243.1,1,11679,7.45815e-05,135049158,0.862417
D.birchii,156593892,VNKA01000003.1,1,11672,7.45368e-05,135060830,0.862491
D.birchii,156593892,VNKA01003083.1,1,11655,7.44282e-05,135072485,0.862565
D.birchii,156593892,VNKA01007518.1,1,11642,7.43452e-05,135084127,0.86264
D.birchii,156593892,VNKA01007222.1,1,11642,7.43452e-05,135095769,0.862714
D.birchii,156593892,VNKA01002239.1,1,11641,7.43388e-05,135107410,0.862789
D.birchii,156593892,VNKA01003858.1,1,11640,7.43324e-05,135119050,0.862863
D.birchii,156593892,VNKA01003290.1,1,11632,7.42813e-05,135130682,0.862937
D.birchii,156593892,VNKA01001695.1,1,11615,7.41728e-05,135142297,0.863011
D.birchii,156593892,VNKA01000441.1,1,11608,7.41281e-05,135153905,0.863085
D.birchii,156593892,VNKA01000673.1,1,11590,7.40131e-05,135165495,0.863159
D.birchii,156593892,VNKA01005085.1,1,11582,7.3962e-05,135177077,0.863233
D.birchii,156593892,VNKA01002272.1,1,11574,7.39109e-05,135188651,0.863307
D.birchii,156593892,VNKA01006650.1,1,11561,7.38279e-05,135200212,0.863381
D.birchii,156593892,VNKA01000535.1,1,11561,7.38279e-05,135211773,0.863455
D.birchii,156593892,VNKA01002429.1,1,11544,7.37194e-05,135223317,0.863529
D.birchii,156593892,VNKA01007296.1,1,11543,7.3713e-05,135234860,0.863602
D.birchii,156593892,VNKA01000651.1,1,11541,7.37002e-05,135246401,0.863676
D.birchii,156593892,VNKA01007353.1,1,11530,7.36299e-05,135257931,0.86375
D.birchii,156593892,VNKA01003116.1,1,11519,7.35597e-05,135269450,0.863823
D.birchii,156593892,VNKA01001139.1,1,11505,7.34703e-05,135280955,0.863897
D.birchii,156593892,VNKA01002995.1,1,11492,7.33873e-05,135292447,0.86397
D.birchii,156593892,VNKA01001965.1,1,11492,7.33873e-05,135303939,0.864044
D.birchii,156593892,VNKA01007072.1,1,11482,7.33234e-05,135315421,0.864117
D.birchii,156593892,VNKA01007078.1,1,11478,7.32979e-05,135326899,0.86419
D.birchii,156593892,VNKA01005617.1,1,11459,7.31765e-05,135338358,0.864263
D.birchii,156593892,VNKA01006189.1,1,11458,7.31702e-05,135349816,0.864336
D.birchii,156593892,VNKA01004151.1,1,11456,7.31574e-05,135361272,0.86441
D.birchii,156593892,VNKA01001946.1,1,11434,7.30169e-05,135372706,0.864483
D.birchii,156593892,VNKA01000178.1,1,11422,7.29403e-05,135384128,0.864556
D.birchii,156593892,VNKA01005802.1,1,11381,7.26784e-05,135395509,0.864628
D.birchii,156593892,VNKA01007469.1,1,11379,7.26657e-05,135406888,0.864701
D.birchii,156593892,VNKA01006927.1,1,11378,7.26593e-05,135418266,0.864774
D.birchii,156593892,VNKA01006405.1,1,11371,7.26146e-05,135429637,0.864846
D.birchii,156593892,VNKA01005275.1,1,11367,7.2589e-05,135441004,0.864919
D.birchii,156593892,VNKA01006768.1,1,11362,7.25571e-05,135452366,0.864991
D.birchii,156593892,VNKA01002604.1,1,11353,7.24996e-05,135463719,0.865064
D.birchii,156593892,VNKA01003436.1,1,11317,7.22697e-05,135475036,0.865136
D.birchii,156593892,VNKA01001935.1,1,11315,7.2257e-05,135486351,0.865208
D.birchii,156593892,VNKA01003204.1,1,11305,7.21931e-05,135497656,0.865281
D.birchii,156593892,VNKA01001171.1,1,11298,7.21484e-05,135508954,0.865353
D.birchii,156593892,VNKA01006640.1,1,11276,7.20079e-05,135520230,0.865425
D.birchii,156593892,VNKA01004088.1,1,11270,7.19696e-05,135531500,0.865497
D.birchii,156593892,VNKA01005373.1,1,11254,7.18674e-05,135542754,0.865569
D.birchii,156593892,VNKA01000823.1,1,11247,7.18227e-05,135554001,0.86564
D.birchii,156593892,VNKA01003208.1,1,11246,7.18163e-05,135565247,0.865712
D.birchii,156593892,VNKA01005914.1,1,11236,7.17525e-05,135576483,0.865784
D.birchii,156593892,VNKA01004692.1,1,11231,7.17205e-05,135587714,0.865856
D.birchii,156593892,VNKA01005323.1,1,11226,7.16886e-05,135598940,0.865927
D.birchii,156593892,VNKA01004140.1,1,11216,7.16248e-05,135610156,0.865999
D.birchii,156593892,VNKA01005511.1,1,11209,7.15801e-05,135621365,0.866071
D.birchii,156593892,VNKA01004014.1,1,11200,7.15226e-05,135632565,0.866142
D.birchii,156593892,VNKA01007487.1,1,11189,7.14523e-05,135643754,0.866214
D.birchii,156593892,VNKA01007375.1,1,11176,7.13693e-05,135654930,0.866285
D.birchii,156593892,VNKA01003878.1,1,11161,7.12735e-05,135666091,0.866356
D.birchii,156593892,VNKA01004892.1,1,11149,7.11969e-05,135677240,0.866427
D.birchii,156593892,VNKA01005069.1,1,11143,7.11586e-05,135688383,0.866499
D.birchii,156593892,VNKA01006336.1,1,11139,7.1133e-05,135699522,0.86657
D.birchii,156593892,VNKA01007561.1,1,11134,7.11011e-05,135710656,0.866641
D.birchii,156593892,VNKA01002317.1,1,11131,7.1082e-05,135721787,0.866712
D.birchii,156593892,VNKA01005933.1,1,11109,7.09415e-05,135732896,0.866783
D.birchii,156593892,VNKA01001805.1,1,11107,7.09287e-05,135744003,0.866854
D.birchii,156593892,VNKA01003181.1,1,11093,7.08393e-05,135755096,0.866925
D.birchii,156593892,VNKA01007407.1,1,11080,7.07563e-05,135766176,0.866995
D.birchii,156593892,VNKA01006722.1,1,11073,7.07116e-05,135777249,0.867066
D.birchii,156593892,VNKA01003415.1,1,11073,7.07116e-05,135788322,0.867137
D.birchii,156593892,VNKA01004526.1,1,11070,7.06924e-05,135799392,0.867207
D.birchii,156593892,VNKA01002041.1,1,11066,7.06669e-05,135810458,0.867278
D.birchii,156593892,VNKA01001947.1,1,11066,7.06669e-05,135821524,0.867349
D.birchii,156593892,VNKA01000239.1,1,11066,7.06669e-05,135832590,0.867419
D.birchii,156593892,VNKA01002988.1,1,11055,7.05966e-05,135843645,0.86749
D.birchii,156593892,VNKA01004200.1,1,11054,7.05902e-05,135854699,0.867561
D.birchii,156593892,VNKA01005847.1,1,11052,7.05775e-05,135865751,0.867631
D.birchii,156593892,VNKA01002136.1,1,11045,7.05328e-05,135876796,0.867702
D.birchii,156593892,VNKA01003445.1,1,11040,7.05008e-05,135887836,0.867772
D.birchii,156593892,VNKA01005653.1,1,11037,7.04817e-05,135898873,0.867843
D.birchii,156593892,VNKA01005890.1,1,11002,7.02582e-05,135909875,0.867913
D.birchii,156593892,VNKA01003829.1,1,10983,7.01368e-05,135920858,0.867983
D.birchii,156593892,VNKA01003459.1,1,10943,6.98814e-05,135931801,0.868053
D.birchii,156593892,VNKA01007110.1,1,10929,6.9792e-05,135942730,0.868123
D.birchii,156593892,VNKA01005632.1,1,10899,6.96004e-05,135953629,0.868192
D.birchii,156593892,VNKA01006648.1,1,10895,6.95749e-05,135964524,0.868262
D.birchii,156593892,VNKA01004137.1,1,10886,6.95174e-05,135975410,0.868332
D.birchii,156593892,VNKA01005891.1,1,10885,6.9511e-05,135986295,0.868401
D.birchii,156593892,VNKA01004326.1,1,10878,6.94663e-05,135997173,0.86847
D.birchii,156593892,VNKA01000421.1,1,10875,6.94472e-05,136008048,0.86854
D.birchii,156593892,VNKA01005723.1,1,10859,6.9345e-05,136018907,0.868609
D.birchii,156593892,VNKA01004516.1,1,10856,6.93258e-05,136029763,0.868679
D.birchii,156593892,VNKA01001109.1,1,10840,6.92236e-05,136040603,0.868748
D.birchii,156593892,VNKA01004666.1,1,10838,6.92109e-05,136051441,0.868817
D.birchii,156593892,VNKA01001735.1,1,10836,6.91981e-05,136062277,0.868886
D.birchii,156593892,VNKA01004272.1,1,10828,6.9147e-05,136073105,0.868955
D.birchii,156593892,VNKA01006192.1,1,10826,6.91342e-05,136083931,0.869025
D.birchii,156593892,VNKA01004046.1,1,10816,6.90704e-05,136094747,0.869094
D.birchii,156593892,VNKA01004047.1,1,10813,6.90512e-05,136105560,0.869163
D.birchii,156593892,VNKA01002847.1,1,10809,6.90257e-05,136116369,0.869232
D.birchii,156593892,VNKA01000069.1,1,10808,6.90193e-05,136127177,0.869301
D.birchii,156593892,VNKA01004654.1,1,10805,6.90001e-05,136137982,0.86937
D.birchii,156593892,VNKA01002652.1,1,10802,6.8981e-05,136148784,0.869439
D.birchii,156593892,VNKA01005100.1,1,10783,6.88596e-05,136159567,0.869508
D.birchii,156593892,VNKA01001066.1,1,10779,6.88341e-05,136170346,0.869576
D.birchii,156593892,VNKA01004312.1,1,10766,6.87511e-05,136181112,0.869645
D.birchii,156593892,VNKA01004803.1,1,10763,6.87319e-05,136191875,0.869714
D.birchii,156593892,VNKA01003354.1,1,10758,6.87e-05,136202633,0.869783
D.birchii,156593892,VNKA01006166.1,1,10751,6.86553e-05,136213384,0.869851
D.birchii,156593892,VNKA01002610.1,1,10745,6.8617e-05,136224129,0.86992
D.birchii,156593892,VNKA01002472.1,1,10742,6.85978e-05,136234871,0.869988
D.birchii,156593892,VNKA01000445.1,1,10740,6.85851e-05,136245611,0.870057
D.birchii,156593892,VNKA01006003.1,1,10712,6.84062e-05,136256323,0.870125
D.birchii,156593892,VNKA01000428.1,1,10712,6.84062e-05,136267035,0.870194
D.birchii,156593892,VNKA01006019.1,1,10701,6.8336e-05,136277736,0.870262
D.birchii,156593892,VNKA01004736.1,1,10700,6.83296e-05,136288436,0.87033
D.birchii,156593892,VNKA01003111.1,1,10688,6.8253e-05,136299124,0.870399
D.birchii,156593892,VNKA01005503.1,1,10668,6.81253e-05,136309792,0.870467
D.birchii,156593892,VNKA01005263.1,1,10635,6.79145e-05,136320427,0.870535
D.birchii,156593892,VNKA01001791.1,1,10632,6.78954e-05,136331059,0.870603
D.birchii,156593892,VNKA01000029.1,1,10620,6.78187e-05,136341679,0.87067
D.birchii,156593892,VNKA01004482.1,1,10613,6.7774e-05,136352292,0.870738
D.birchii,156593892,VNKA01003648.1,1,10603,6.77102e-05,136362895,0.870806
D.birchii,156593892,VNKA01007089.1,1,10597,6.76719e-05,136373492,0.870874
D.birchii,156593892,VNKA01003046.1,1,10595,6.76591e-05,136384087,0.870941
D.birchii,156593892,VNKA01003853.1,1,10594,6.76527e-05,136394681,0.871009
D.birchii,156593892,VNKA01002542.1,1,10588,6.76144e-05,136405269,0.871077
D.birchii,156593892,VNKA01000221.1,1,10578,6.75505e-05,136415847,0.871144
D.birchii,156593892,VNKA01005800.1,1,10572,6.75122e-05,136426419,0.871212
D.birchii,156593892,VNKA01007069.1,1,10571,6.75058e-05,136436990,0.871279
D.birchii,156593892,VNKA01003152.1,1,10570,6.74994e-05,136447560,0.871347
D.birchii,156593892,VNKA01002569.1,1,10550,6.73717e-05,136458110,0.871414
D.birchii,156593892,VNKA01000880.1,1,10542,6.73206e-05,136468652,0.871481
D.birchii,156593892,VNKA01000458.1,1,10542,6.73206e-05,136479194,0.871549
D.birchii,156593892,VNKA01007022.1,1,10523,6.71993e-05,136489717,0.871616
D.birchii,156593892,VNKA01005837.1,1,10504,6.7078e-05,136500221,0.871683
D.birchii,156593892,VNKA01000032.1,1,10501,6.70588e-05,136510722,0.87175
D.birchii,156593892,VNKA01003670.1,1,10493,6.70077e-05,136521215,0.871817
D.birchii,156593892,VNKA01000565.1,1,10481,6.69311e-05,136531696,0.871884
D.birchii,156593892,VNKA01007163.1,1,10442,6.6682e-05,136542138,0.871951
D.birchii,156593892,VNKA01000263.1,1,10442,6.6682e-05,136552580,0.872017
D.birchii,156593892,VNKA01000501.1,1,10441,6.66757e-05,136563021,0.872084
D.birchii,156593892,VNKA01007121.1,1,10434,6.6631e-05,136573455,0.872151
D.birchii,156593892,VNKA01003192.1,1,10405,6.64458e-05,136583860,0.872217
D.birchii,156593892,VNKA01007378.1,1,10396,6.63883e-05,136594256,0.872283
D.birchii,156593892,VNKA01001474.1,1,10393,6.63691e-05,136604649,0.87235
D.birchii,156593892,VNKA01006885.1,1,10387,6.63308e-05,136615036,0.872416
D.birchii,156593892,VNKA01003408.1,1,10376,6.62606e-05,136625412,0.872482
D.birchii,156593892,VNKA01007430.1,1,10344,6.60562e-05,136635756,0.872548
D.birchii,156593892,VNKA01004825.1,1,10343,6.60498e-05,136646099,0.872614
D.birchii,156593892,VNKA01003462.1,1,10326,6.59413e-05,136656425,0.87268
D.birchii,156593892,VNKA01000867.1,1,10323,6.59221e-05,136666748,0.872746
D.birchii,156593892,VNKA01003927.1,1,10318,6.58902e-05,136677066,0.872812
D.birchii,156593892,VNKA01003068.1,1,10305,6.58072e-05,136687371,0.872878
D.birchii,156593892,VNKA01001601.1,1,10293,6.57305e-05,136697664,0.872944
D.birchii,156593892,VNKA01006616.1,1,10287,6.56922e-05,136707951,0.873009
D.birchii,156593892,VNKA01002470.1,1,10278,6.56347e-05,136718229,0.873075
D.birchii,156593892,VNKA01003645.1,1,10257,6.55006e-05,136728486,0.873141
D.birchii,156593892,VNKA01004709.1,1,10249,6.54496e-05,136738735,0.873206
D.birchii,156593892,VNKA01006557.1,1,10245,6.5424e-05,136748980,0.873271
D.birchii,156593892,VNKA01002498.1,1,10245,6.5424e-05,136759225,0.873337
D.birchii,156593892,VNKA01000325.1,1,10245,6.5424e-05,136769470,0.873402
D.birchii,156593892,VNKA01004113.1,1,10244,6.54176e-05,136779714,0.873468
D.birchii,156593892,VNKA01002901.1,1,10229,6.53218e-05,136789943,0.873533
D.birchii,156593892,VNKA01001311.1,1,10226,6.53027e-05,136800169,0.873598
D.birchii,156593892,VNKA01002892.1,1,10224,6.52899e-05,136810393,0.873664
D.birchii,156593892,VNKA01004748.1,1,10223,6.52835e-05,136820616,0.873729
D.birchii,156593892,VNKA01005481.1,1,10216,6.52388e-05,136830832,0.873794
D.birchii,156593892,VNKA01006907.1,1,10212,6.52133e-05,136841044,0.873859
D.birchii,156593892,VNKA01003602.1,1,10205,6.51686e-05,136851249,0.873925
D.birchii,156593892,VNKA01007047.1,1,10200,6.51366e-05,136861449,0.87399
D.birchii,156593892,VNKA01001430.1,1,10199,6.51303e-05,136871648,0.874055
D.birchii,156593892,VNKA01000291.1,1,10186,6.50472e-05,136881834,0.87412
D.birchii,156593892,VNKA01001498.1,1,10180,6.50089e-05,136892014,0.874185
D.birchii,156593892,VNKA01006639.1,1,10179,6.50025e-05,136902193,0.87425
D.birchii,156593892,VNKA01001145.1,1,10173,6.49642e-05,136912366,0.874315
D.birchii,156593892,VNKA01004426.1,1,10156,6.48557e-05,136922522,0.87438
D.birchii,156593892,VNKA01002550.1,1,10147,6.47982e-05,136932669,0.874445
D.birchii,156593892,VNKA01004172.1,1,10130,6.46896e-05,136942799,0.874509
D.birchii,156593892,VNKA01003568.1,1,10105,6.453e-05,136952904,0.874574
D.birchii,156593892,VNKA01001129.1,1,10102,6.45108e-05,136963006,0.874638
D.birchii,156593892,VNKA01002359.1,1,10099,6.44917e-05,136973105,0.874703
D.birchii,156593892,VNKA01006862.1,1,10088,6.44214e-05,136983193,0.874767
D.birchii,156593892,VNKA01005205.1,1,10061,6.4249e-05,136993254,0.874831
D.birchii,156593892,VNKA01000198.1,1,10055,6.42107e-05,137003309,0.874896
D.birchii,156593892,VNKA01006556.1,1,10036,6.40893e-05,137013345,0.87496
D.birchii,156593892,VNKA01005195.1,1,10021,6.39936e-05,137023366,0.875024
D.birchii,156593892,VNKA01007218.1,1,10019,6.39808e-05,137033385,0.875088
D.birchii,156593892,VNKA01006210.1,1,10012,6.39361e-05,137043397,0.875152
D.birchii,156593892,VNKA01005164.1,1,9999,6.38531e-05,137053396,0.875215
D.birchii,156593892,VNKA01003029.1,1,9977,6.37126e-05,137063373,0.875279
D.birchii,156593892,VNKA01001315.1,1,9976,6.37062e-05,137073349,0.875343
D.birchii,156593892,VNKA01000951.1,1,9948,6.35274e-05,137083297,0.875406
D.birchii,156593892,VNKA01000916.1,1,9934,6.3438e-05,137093231,0.87547
D.birchii,156593892,VNKA01003906.1,1,9931,6.34188e-05,137103162,0.875533
D.birchii,156593892,VNKA01000089.1,1,9931,6.34188e-05,137113093,0.875597
D.birchii,156593892,VNKA01001329.1,1,9930,6.34124e-05,137123023,0.87566
D.birchii,156593892,VNKA01000350.1,1,9921,6.3355e-05,137132944,0.875723
D.birchii,156593892,VNKA01006647.1,1,9906,6.32592e-05,137142850,0.875787
D.birchii,156593892,VNKA01000743.1,1,9904,6.32464e-05,137152754,0.87585
D.birchii,156593892,VNKA01006909.1,1,9890,6.3157e-05,137162644,0.875913
D.birchii,156593892,VNKA01001519.1,1,9880,6.30931e-05,137172524,0.875976
D.birchii,156593892,VNKA01000025.1,1,9879,6.30868e-05,137182403,0.876039
D.birchii,156593892,VNKA01007389.1,1,9871,6.30357e-05,137192274,0.876102
D.birchii,156593892,VNKA01002887.1,1,9857,6.29463e-05,137202131,0.876165
D.birchii,156593892,VNKA01001173.1,1,9844,6.28632e-05,137211975,0.876228
D.birchii,156593892,VNKA01000114.1,1,9833,6.2793e-05,137221808,0.876291
D.birchii,156593892,VNKA01001132.1,1,9827,6.27547e-05,137231635,0.876354
D.birchii,156593892,VNKA01007208.1,1,9820,6.271e-05,137241455,0.876416
D.birchii,156593892,VNKA01000914.1,1,9810,6.26461e-05,137251265,0.876479
D.birchii,156593892,VNKA01007096.1,1,9808,6.26333e-05,137261073,0.876542
D.birchii,156593892,VNKA01005664.1,1,9798,6.25695e-05,137270871,0.876604
D.birchii,156593892,VNKA01003448.1,1,9789,6.2512e-05,137280660,0.876667
D.birchii,156593892,VNKA01001691.1,1,9787,6.24992e-05,137290447,0.876729
D.birchii,156593892,VNKA01007091.1,1,9785,6.24865e-05,137300232,0.876792
D.birchii,156593892,VNKA01002829.1,1,9783,6.24737e-05,137310015,0.876854
D.birchii,156593892,VNKA01002922.1,1,9771,6.23971e-05,137319786,0.876917
D.birchii,156593892,VNKA01004746.1,1,9738,6.21863e-05,137329524,0.876979
D.birchii,156593892,VNKA01006721.1,1,9729,6.21289e-05,137339253,0.877041
D.birchii,156593892,VNKA01000536.1,1,9714,6.20331e-05,137348967,0.877103
D.birchii,156593892,VNKA01005056.1,1,9712,6.20203e-05,137358679,0.877165
D.birchii,156593892,VNKA01007468.1,1,9699,6.19373e-05,137368378,0.877227
D.birchii,156593892,VNKA01003118.1,1,9698,6.19309e-05,137378076,0.877289
D.birchii,156593892,VNKA01003727.1,1,9695,6.19117e-05,137387771,0.877351
D.birchii,156593892,VNKA01001454.1,1,9673,6.17712e-05,137397444,0.877413
D.birchii,156593892,VNKA01007346.1,1,9654,6.16499e-05,137407098,0.877474
D.birchii,156593892,VNKA01001463.1,1,9650,6.16244e-05,137416748,0.877536
D.birchii,156593892,VNKA01000876.1,1,9643,6.15797e-05,137426391,0.877597
D.birchii,156593892,VNKA01005114.1,1,9619,6.14264e-05,137436010,0.877659
D.birchii,156593892,VNKA01000359.1,1,9619,6.14264e-05,137445629,0.87772
D.birchii,156593892,VNKA01006456.1,1,9615,6.14009e-05,137455244,0.877782
D.birchii,156593892,VNKA01002500.1,1,9615,6.14009e-05,137464859,0.877843
D.birchii,156593892,VNKA01005377.1,1,9610,6.13689e-05,137474469,0.877904
D.birchii,156593892,VNKA01000770.1,1,9606,6.13434e-05,137484075,0.877966
D.birchii,156593892,VNKA01002843.1,1,9603,6.13242e-05,137493678,0.878027
D.birchii,156593892,VNKA01001078.1,1,9600,6.13051e-05,137503278,0.878088
D.birchii,156593892,VNKA01001182.1,1,9598,6.12923e-05,137512876,0.87815
D.birchii,156593892,VNKA01002159.1,1,9590,6.12412e-05,137522466,0.878211
D.birchii,156593892,VNKA01001138.1,1,9577,6.11582e-05,137532043,0.878272
D.birchii,156593892,VNKA01004878.1,1,9575,6.11454e-05,137541618,0.878333
D.birchii,156593892,VNKA01004144.1,1,9565,6.10816e-05,137551183,0.878394
D.birchii,156593892,VNKA01007387.1,1,9562,6.10624e-05,137560745,0.878455
D.birchii,156593892,VNKA01002976.1,1,9560,6.10496e-05,137570305,0.878516
D.birchii,156593892,VNKA01003489.1,1,9547,6.09666e-05,137579852,0.878577
D.birchii,156593892,VNKA01006342.1,1,9543,6.09411e-05,137589395,0.878638
D.birchii,156593892,VNKA01007439.1,1,9542,6.09347e-05,137598937,0.878699
D.birchii,156593892,VNKA01004767.1,1,9526,6.08325e-05,137608463,0.87876
D.birchii,156593892,VNKA01002394.1,1,9524,6.08197e-05,137617987,0.878821
D.birchii,156593892,VNKA01002200.1,1,9499,6.06601e-05,137627486,0.878882
D.birchii,156593892,VNKA01001377.1,1,9492,6.06154e-05,137636978,0.878942
D.birchii,156593892,VNKA01000805.1,1,9491,6.0609e-05,137646469,0.879003
D.birchii,156593892,VNKA01005121.1,1,9485,6.05707e-05,137655954,0.879063
D.birchii,156593892,VNKA01002074.1,1,9484,6.05643e-05,137665438,0.879124
D.birchii,156593892,VNKA01007490.1,1,9482,6.05515e-05,137674920,0.879184
D.birchii,156593892,VNKA01007457.1,1,9478,6.0526e-05,137684398,0.879245
D.birchii,156593892,VNKA01005468.1,1,9465,6.0443e-05,137693863,0.879305
D.birchii,156593892,VNKA01000278.1,1,9462,6.04238e-05,137703325,0.879366
D.birchii,156593892,VNKA01001292.1,1,9458,6.03983e-05,137712783,0.879426
D.birchii,156593892,VNKA01006684.1,1,9455,6.03791e-05,137722238,0.879487
D.birchii,156593892,VNKA01004291.1,1,9449,6.03408e-05,137731687,0.879547
D.birchii,156593892,VNKA01004990.1,1,9444,6.03089e-05,137741131,0.879607
D.birchii,156593892,VNKA01005897.1,1,9416,6.01301e-05,137750547,0.879667
D.birchii,156593892,VNKA01000629.1,1,9416,6.01301e-05,137759963,0.879728
D.birchii,156593892,VNKA01006040.1,1,9407,6.00726e-05,137769370,0.879788
D.birchii,156593892,VNKA01003673.1,1,9399,6.00215e-05,137778769,0.879848
D.birchii,156593892,VNKA01005772.1,1,9380,5.99002e-05,137788149,0.879908
D.birchii,156593892,VNKA01007283.1,1,9358,5.97597e-05,137797507,0.879967
D.birchii,156593892,VNKA01003017.1,1,9358,5.97597e-05,137806865,0.880027
D.birchii,156593892,VNKA01005918.1,1,9357,5.97533e-05,137816222,0.880087
D.birchii,156593892,VNKA01003793.1,1,9356,5.97469e-05,137825578,0.880147
D.birchii,156593892,VNKA01004721.1,1,9348,5.96958e-05,137834926,0.880206
D.birchii,156593892,VNKA01007485.1,1,9344,5.96703e-05,137844270,0.880266
D.birchii,156593892,VNKA01005171.1,1,9343,5.96639e-05,137853613,0.880326
D.birchii,156593892,VNKA01003159.1,1,9320,5.9517e-05,137862933,0.880385
D.birchii,156593892,VNKA01006467.1,1,9318,5.95042e-05,137872251,0.880445
D.birchii,156593892,VNKA01006676.1,1,9306,5.94276e-05,137881557,0.880504
D.birchii,156593892,VNKA01004726.1,1,9300,5.93893e-05,137890857,0.880563
D.birchii,156593892,VNKA01005833.1,1,9293,5.93446e-05,137900150,0.880623
D.birchii,156593892,VNKA01000733.1,1,9276,5.9236e-05,137909426,0.880682
D.birchii,156593892,VNKA01007405.1,1,9266,5.91722e-05,137918692,0.880741
D.birchii,156593892,VNKA01000266.1,1,9264,5.91594e-05,137927956,0.8808
D.birchii,156593892,VNKA01001170.1,1,9254,5.90955e-05,137937210,0.880859
D.birchii,156593892,VNKA01000258.1,1,9252,5.90828e-05,137946462,0.880919
D.birchii,156593892,VNKA01004262.1,1,9250,5.907e-05,137955712,0.880978
D.birchii,156593892,VNKA01005081.1,1,9247,5.90508e-05,137964959,0.881037
D.birchii,156593892,VNKA01006929.1,1,9246,5.90444e-05,137974205,0.881096
D.birchii,156593892,VNKA01006377.1,1,9208,5.88018e-05,137983413,0.881155
D.birchii,156593892,VNKA01003460.1,1,9195,5.87188e-05,137992608,0.881213
D.birchii,156593892,VNKA01003799.1,1,9194,5.87124e-05,138001802,0.881272
D.birchii,156593892,VNKA01004381.1,1,9191,5.86932e-05,138010993,0.881331
D.birchii,156593892,VNKA01002430.1,1,9184,5.86485e-05,138020177,0.881389
D.birchii,156593892,VNKA01006175.1,1,9162,5.8508e-05,138029339,0.881448
D.birchii,156593892,VNKA01001332.1,1,9146,5.84059e-05,138038485,0.881506
D.birchii,156593892,VNKA01000554.1,1,9145,5.83995e-05,138047630,0.881565
D.birchii,156593892,VNKA01004466.1,1,9142,5.83803e-05,138056772,0.881623
D.birchii,156593892,VNKA01003689.1,1,9141,5.83739e-05,138065913,0.881681
D.birchii,156593892,VNKA01004636.1,1,9139,5.83612e-05,138075052,0.88174
D.birchii,156593892,VNKA01003157.1,1,9139,5.83612e-05,138084191,0.881798
D.birchii,156593892,VNKA01000922.1,1,9139,5.83612e-05,138093330,0.881856
D.birchii,156593892,VNKA01006562.1,1,9135,5.83356e-05,138102465,0.881915
D.birchii,156593892,VNKA01002981.1,1,9129,5.82973e-05,138111594,0.881973
D.birchii,156593892,VNKA01004512.1,1,9112,5.81887e-05,138120706,0.882031
D.birchii,156593892,VNKA01002160.1,1,9112,5.81887e-05,138129818,0.882089
D.birchii,156593892,VNKA01003918.1,1,9098,5.80993e-05,138138916,0.882148
D.birchii,156593892,VNKA01001969.1,1,9088,5.80355e-05,138148004,0.882206
D.birchii,156593892,VNKA01004693.1,1,9080,5.79844e-05,138157084,0.882264
D.birchii,156593892,VNKA01000508.1,1,9080,5.79844e-05,138166164,0.882322
D.birchii,156593892,VNKA01005686.1,1,9075,5.79525e-05,138175239,0.882379
D.birchii,156593892,VNKA01005322.1,1,9065,5.78886e-05,138184304,0.882437
D.birchii,156593892,VNKA01006864.1,1,9050,5.77928e-05,138193354,0.882495
D.birchii,156593892,VNKA01005545.1,1,9046,5.77673e-05,138202400,0.882553
D.birchii,156593892,VNKA01006856.1,1,9038,5.77162e-05,138211438,0.882611
D.birchii,156593892,VNKA01001839.1,1,9034,5.76906e-05,138220472,0.882668
D.birchii,156593892,VNKA01002807.1,1,9027,5.76459e-05,138229499,0.882726
D.birchii,156593892,VNKA01002344.1,1,9006,5.75118e-05,138238505,0.882784
D.birchii,156593892,VNKA01002702.1,1,8983,5.73649e-05,138247488,0.882841
D.birchii,156593892,VNKA01004737.1,1,8978,5.7333e-05,138256466,0.882898
D.birchii,156593892,VNKA01003912.1,1,8946,5.71287e-05,138265412,0.882955
D.birchii,156593892,VNKA01006470.1,1,8943,5.71095e-05,138274355,0.883012
D.birchii,156593892,VNKA01000009.1,1,8941,5.70967e-05,138283296,0.88307
D.birchii,156593892,VNKA01005174.1,1,8939,5.7084e-05,138292235,0.883127
D.birchii,156593892,VNKA01004187.1,1,8934,5.7052e-05,138301169,0.883184
D.birchii,156593892,VNKA01004379.1,1,8931,5.70329e-05,138310100,0.883241
D.birchii,156593892,VNKA01003413.1,1,8930,5.70265e-05,138319030,0.883298
D.birchii,156593892,VNKA01000503.1,1,8923,5.69818e-05,138327953,0.883355
D.birchii,156593892,VNKA01004369.1,1,8916,5.69371e-05,138336869,0.883412
D.birchii,156593892,VNKA01006938.1,1,8913,5.69179e-05,138345782,0.883469
D.birchii,156593892,VNKA01006212.1,1,8912,5.69115e-05,138354694,0.883525
D.birchii,156593892,VNKA01002314.1,1,8910,5.68988e-05,138363604,0.883582
D.birchii,156593892,VNKA01002923.1,1,8879,5.67008e-05,138372483,0.883639
D.birchii,156593892,VNKA01003063.1,1,8877,5.6688e-05,138381360,0.883696
D.birchii,156593892,VNKA01000740.1,1,8870,5.66433e-05,138390230,0.883752
D.birchii,156593892,VNKA01002595.1,1,8841,5.64581e-05,138399071,0.883809
D.birchii,156593892,VNKA01001120.1,1,8830,5.63879e-05,138407901,0.883865
D.birchii,156593892,VNKA01005734.1,1,8821,5.63304e-05,138416722,0.883922
D.birchii,156593892,VNKA01001676.1,1,8821,5.63304e-05,138425543,0.883978
D.birchii,156593892,VNKA01000745.1,1,8821,5.63304e-05,138434364,0.884034
D.birchii,156593892,VNKA01006049.1,1,8803,5.62155e-05,138443167,0.88409
D.birchii,156593892,VNKA01002898.1,1,8801,5.62027e-05,138451968,0.884147
D.birchii,156593892,VNKA01002671.1,1,8799,5.61899e-05,138460767,0.884203
D.birchii,156593892,VNKA01002147.1,1,8796,5.61708e-05,138469563,0.884259
D.birchii,156593892,VNKA01003644.1,1,8777,5.60494e-05,138478340,0.884315
D.birchii,156593892,VNKA01006247.1,1,8771,5.60111e-05,138487111,0.884371
D.birchii,156593892,VNKA01004754.1,1,8771,5.60111e-05,138495882,0.884427
D.birchii,156593892,VNKA01000890.1,1,8768,5.5992e-05,138504650,0.884483
D.birchii,156593892,VNKA01003913.1,1,8740,5.58132e-05,138513390,0.884539
D.birchii,156593892,VNKA01007001.1,1,8738,5.58004e-05,138522128,0.884595
D.birchii,156593892,VNKA01000096.1,1,8738,5.58004e-05,138530866,0.884651
D.birchii,156593892,VNKA01006319.1,1,8737,5.5794e-05,138539603,0.884706
D.birchii,156593892,VNKA01000861.1,1,8737,5.5794e-05,138548340,0.884762
D.birchii,156593892,VNKA01002468.1,1,8728,5.57365e-05,138557068,0.884818
D.birchii,156593892,VNKA01007344.1,1,8725,5.57174e-05,138565793,0.884874
D.birchii,156593892,VNKA01007018.1,1,8724,5.5711e-05,138574517,0.884929
D.birchii,156593892,VNKA01004822.1,1,8722,5.56982e-05,138583239,0.884985
D.birchii,156593892,VNKA01001952.1,1,8722,5.56982e-05,138591961,0.885041
D.birchii,156593892,VNKA01001131.1,1,8714,5.56471e-05,138600675,0.885096
D.birchii,156593892,VNKA01007509.1,1,8700,5.55577e-05,138609375,0.885152
D.birchii,156593892,VNKA01003595.1,1,8697,5.55386e-05,138618072,0.885207
D.birchii,156593892,VNKA01002837.1,1,8696,5.55322e-05,138626768,0.885263
D.birchii,156593892,VNKA01005320.1,1,8694,5.55194e-05,138635462,0.885318
D.birchii,156593892,VNKA01004570.1,1,8689,5.54875e-05,138644151,0.885374
D.birchii,156593892,VNKA01003784.1,1,8683,5.54492e-05,138652834,0.885429
D.birchii,156593892,VNKA01001671.1,1,8672,5.53789e-05,138661506,0.885485
D.birchii,156593892,VNKA01007129.1,1,8669,5.53598e-05,138670175,0.88554
D.birchii,156593892,VNKA01000001.1,1,8650,5.52384e-05,138678825,0.885595
D.birchii,156593892,VNKA01000870.1,1,8645,5.52065e-05,138687470,0.885651
D.birchii,156593892,VNKA01002677.1,1,8626,5.50852e-05,138696096,0.885706
D.birchii,156593892,VNKA01001191.1,1,8619,5.50405e-05,138704715,0.885761
D.birchii,156593892,VNKA01003636.1,1,8598,5.49064e-05,138713313,0.885816
D.birchii,156593892,VNKA01004774.1,1,8578,5.47786e-05,138721891,0.88587
D.birchii,156593892,VNKA01001868.1,1,8568,5.47148e-05,138730459,0.885925
D.birchii,156593892,VNKA01003708.1,1,8559,5.46573e-05,138739018,0.88598
D.birchii,156593892,VNKA01004891.1,1,8547,5.45807e-05,138747565,0.886034
D.birchii,156593892,VNKA01000626.1,1,8546,5.45743e-05,138756111,0.886089
D.birchii,156593892,VNKA01004425.1,1,8545,5.45679e-05,138764656,0.886143
D.birchii,156593892,VNKA01006411.1,1,8540,5.4536e-05,138773196,0.886198
D.birchii,156593892,VNKA01003064.1,1,8538,5.45232e-05,138781734,0.886253
D.birchii,156593892,VNKA01005140.1,1,8531,5.44785e-05,138790265,0.886307
D.birchii,156593892,VNKA01006561.1,1,8530,5.44721e-05,138798795,0.886361
D.birchii,156593892,VNKA01000677.1,1,8523,5.44274e-05,138807318,0.886416
D.birchii,156593892,VNKA01005685.1,1,8514,5.43699e-05,138815832,0.88647
D.birchii,156593892,VNKA01005354.1,1,8514,5.43699e-05,138824346,0.886525
D.birchii,156593892,VNKA01003897.1,1,8514,5.43699e-05,138832860,0.886579
D.birchii,156593892,VNKA01005877.1,1,8513,5.43636e-05,138841373,0.886633
D.birchii,156593892,VNKA01006198.1,1,8512,5.43572e-05,138849885,0.886688
D.birchii,156593892,VNKA01004404.1,1,8511,5.43508e-05,138858396,0.886742
D.birchii,156593892,VNKA01007323.1,1,8506,5.43188e-05,138866902,0.886796
D.birchii,156593892,VNKA01003826.1,1,8505,5.43125e-05,138875407,0.886851
D.birchii,156593892,VNKA01000119.1,1,8502,5.42933e-05,138883909,0.886905
D.birchii,156593892,VNKA01001560.1,1,8491,5.42231e-05,138892400,0.886959
D.birchii,156593892,VNKA01005878.1,1,8489,5.42103e-05,138900889,0.887013
D.birchii,156593892,VNKA01000265.1,1,8477,5.41337e-05,138909366,0.887068
D.birchii,156593892,VNKA01004625.1,1,8445,5.39293e-05,138917811,0.887122
D.birchii,156593892,VNKA01000978.1,1,8436,5.38718e-05,138926247,0.887175
D.birchii,156593892,VNKA01005720.1,1,8433,5.38527e-05,138934680,0.887229
D.birchii,156593892,VNKA01000030.1,1,8431,5.38399e-05,138943111,0.887283
D.birchii,156593892,VNKA01006777.1,1,8430,5.38335e-05,138951541,0.887337
D.birchii,156593892,VNKA01000412.1,1,8427,5.38144e-05,138959968,0.887391
D.birchii,156593892,VNKA01000164.1,1,8426,5.3808e-05,138968394,0.887445
D.birchii,156593892,VNKA01006602.1,1,8420,5.37697e-05,138976814,0.887498
D.birchii,156593892,VNKA01004191.1,1,8413,5.3725e-05,138985227,0.887552
D.birchii,156593892,VNKA01001140.1,1,8412,5.37186e-05,138993639,0.887606
D.birchii,156593892,VNKA01000579.1,1,8412,5.37186e-05,139002051,0.887659
D.birchii,156593892,VNKA01007087.1,1,8407,5.36866e-05,139010458,0.887713
D.birchii,156593892,VNKA01002163.1,1,8403,5.36611e-05,139018861,0.887767
D.birchii,156593892,VNKA01006239.1,1,8402,5.36547e-05,139027263,0.88782
D.birchii,156593892,VNKA01002121.1,1,8386,5.35525e-05,139035649,0.887874
D.birchii,156593892,VNKA01003909.1,1,8385,5.35461e-05,139044034,0.887928
D.birchii,156593892,VNKA01002796.1,1,8385,5.35461e-05,139052419,0.887981
D.birchii,156593892,VNKA01006555.1,1,8382,5.3527e-05,139060801,0.888035
D.birchii,156593892,VNKA01002836.1,1,8381,5.35206e-05,139069182,0.888088
D.birchii,156593892,VNKA01000231.1,1,8375,5.34823e-05,139077557,0.888142
D.birchii,156593892,VNKA01003086.1,1,8361,5.33929e-05,139085918,0.888195
D.birchii,156593892,VNKA01004103.1,1,8343,5.32779e-05,139094261,0.888248
D.birchii,156593892,VNKA01007539.1,1,8342,5.32716e-05,139102603,0.888302
D.birchii,156593892,VNKA01005101.1,1,8339,5.32524e-05,139110942,0.888355
D.birchii,156593892,VNKA01004119.1,1,8336,5.32332e-05,139119278,0.888408
D.birchii,156593892,VNKA01006058.1,1,8331,5.32013e-05,139127609,0.888461
D.birchii,156593892,VNKA01004845.1,1,8331,5.32013e-05,139135940,0.888514
D.birchii,156593892,VNKA01000022.1,1,8329,5.31885e-05,139144269,0.888568
D.birchii,156593892,VNKA01000738.1,1,8312,5.308e-05,139152581,0.888621
D.birchii,156593892,VNKA01002483.1,1,8308,5.30544e-05,139160889,0.888674
D.birchii,156593892,VNKA01002318.1,1,8302,5.30161e-05,139169191,0.888727
D.birchii,156593892,VNKA01004054.1,1,8299,5.2997e-05,139177490,0.88878
D.birchii,156593892,VNKA01002882.1,1,8289,5.29331e-05,139185779,0.888833
D.birchii,156593892,VNKA01003025.1,1,8277,5.28565e-05,139194056,0.888886
D.birchii,156593892,VNKA01000744.1,1,8263,5.27671e-05,139202319,0.888938
D.birchii,156593892,VNKA01003871.1,1,8261,5.27543e-05,139210580,0.888991
D.birchii,156593892,VNKA01000027.1,1,8257,5.27287e-05,139218837,0.889044
D.birchii,156593892,VNKA01007298.1,1,8255,5.2716e-05,139227092,0.889097
D.birchii,156593892,VNKA01007050.1,1,8254,5.27096e-05,139235346,0.889149
D.birchii,156593892,VNKA01005400.1,1,8250,5.2684e-05,139243596,0.889202
D.birchii,156593892,VNKA01005629.1,1,8245,5.26521e-05,139251841,0.889255
D.birchii,156593892,VNKA01005036.1,1,8245,5.26521e-05,139260086,0.889307
D.birchii,156593892,VNKA01003814.1,1,8243,5.26393e-05,139268329,0.88936
D.birchii,156593892,VNKA01001019.1,1,8229,5.25499e-05,139276558,0.889412
D.birchii,156593892,VNKA01005209.1,1,8228,5.25436e-05,139284786,0.889465
D.birchii,156593892,VNKA01007051.1,1,8227,5.25372e-05,139293013,0.889518
D.birchii,156593892,VNKA01000669.1,1,8219,5.24861e-05,139301232,0.88957
D.birchii,156593892,VNKA01006047.1,1,8211,5.2435e-05,139309443,0.889622
D.birchii,156593892,VNKA01001455.1,1,8193,5.232e-05,139317636,0.889675
D.birchii,156593892,VNKA01004893.1,1,8192,5.23137e-05,139325828,0.889727
D.birchii,156593892,VNKA01005836.1,1,8190,5.23009e-05,139334018,0.889779
D.birchii,156593892,VNKA01002756.1,1,8185,5.2269e-05,139342203,0.889832
D.birchii,156593892,VNKA01000926.1,1,8185,5.2269e-05,139350388,0.889884
D.birchii,156593892,VNKA01003257.1,1,8183,5.22562e-05,139358571,0.889936
D.birchii,156593892,VNKA01001927.1,1,8177,5.22179e-05,139366748,0.889988
D.birchii,156593892,VNKA01004890.1,1,8174,5.21987e-05,139374922,0.890041
D.birchii,156593892,VNKA01005730.1,1,8170,5.21732e-05,139383092,0.890093
D.birchii,156593892,VNKA01006661.1,1,8162,5.21221e-05,139391254,0.890145
D.birchii,156593892,VNKA01006085.1,1,8160,5.21093e-05,139399414,0.890197
D.birchii,156593892,VNKA01004316.1,1,8155,5.20774e-05,139407569,0.890249
D.birchii,156593892,VNKA01007538.1,1,8152,5.20582e-05,139415721,0.890301
D.birchii,156593892,VNKA01002230.1,1,8152,5.20582e-05,139423873,0.890353
D.birchii,156593892,VNKA01006892.1,1,8150,5.20455e-05,139432023,0.890405
D.birchii,156593892,VNKA01007546.1,1,8145,5.20135e-05,139440168,0.890457
D.birchii,156593892,VNKA01002228.1,1,8145,5.20135e-05,139448313,0.890509
D.birchii,156593892,VNKA01005568.1,1,8140,5.19816e-05,139456453,0.890561
D.birchii,156593892,VNKA01004888.1,1,8137,5.19624e-05,139464590,0.890613
D.birchii,156593892,VNKA01004190.1,1,8133,5.19369e-05,139472723,0.890665
D.birchii,156593892,VNKA01006322.1,1,8130,5.19177e-05,139480853,0.890717
D.birchii,156593892,VNKA01005642.1,1,8120,5.18539e-05,139488973,0.890769
D.birchii,156593892,VNKA01006234.1,1,8112,5.18028e-05,139497085,0.890821
D.birchii,156593892,VNKA01003199.1,1,8104,5.17517e-05,139505189,0.890872
D.birchii,156593892,VNKA01001398.1,1,8101,5.17325e-05,139513290,0.890924
D.birchii,156593892,VNKA01000792.1,1,8094,5.16878e-05,139521384,0.890976
D.birchii,156593892,VNKA01004651.1,1,8090,5.16623e-05,139529474,0.891028
D.birchii,156593892,VNKA01002295.1,1,8083,5.16176e-05,139537557,0.891079
D.birchii,156593892,VNKA01006083.1,1,8072,5.15473e-05,139545629,0.891131
D.birchii,156593892,VNKA01003069.1,1,8070,5.15346e-05,139553699,0.891182
D.birchii,156593892,VNKA01007140.1,1,8068,5.15218e-05,139561767,0.891234
D.birchii,156593892,VNKA01000193.1,1,8059,5.14643e-05,139569826,0.891285
D.birchii,156593892,VNKA01007305.1,1,8047,5.13877e-05,139577873,0.891337
D.birchii,156593892,VNKA01000751.1,1,8039,5.13366e-05,139585912,0.891388
D.birchii,156593892,VNKA01002536.1,1,8038,5.13302e-05,139593950,0.891439
D.birchii,156593892,VNKA01005598.1,1,8031,5.12855e-05,139601981,0.891491
D.birchii,156593892,VNKA01006254.1,1,8028,5.12664e-05,139610009,0.891542
D.birchii,156593892,VNKA01003543.1,1,8024,5.12408e-05,139618033,0.891593
D.birchii,156593892,VNKA01003425.1,1,8019,5.12089e-05,139626052,0.891644
D.birchii,156593892,VNKA01000760.1,1,8014,5.1177e-05,139634066,0.891695
D.birchii,156593892,VNKA01001950.1,1,8011,5.11578e-05,139642077,0.891747
D.birchii,156593892,VNKA01006588.1,1,7988,5.10109e-05,139650065,0.891798
D.birchii,156593892,VNKA01004660.1,1,7984,5.09854e-05,139658049,0.891849
D.birchii,156593892,VNKA01001341.1,1,7972,5.09088e-05,139666021,0.8919
D.birchii,156593892,VNKA01006349.1,1,7970,5.0896e-05,139673991,0.89195
D.birchii,156593892,VNKA01002465.1,1,7966,5.08704e-05,139681957,0.892001
D.birchii,156593892,VNKA01001623.1,1,7963,5.08513e-05,139689920,0.892052
D.birchii,156593892,VNKA01007340.1,1,7949,5.07619e-05,139697869,0.892103
D.birchii,156593892,VNKA01006454.1,1,7945,5.07363e-05,139705814,0.892154
D.birchii,156593892,VNKA01001922.1,1,7945,5.07363e-05,139713759,0.892204
D.birchii,156593892,VNKA01001333.1,1,7945,5.07363e-05,139721704,0.892255
D.birchii,156593892,VNKA01004843.1,1,7931,5.06469e-05,139729635,0.892306
D.birchii,156593892,VNKA01005433.1,1,7927,5.06214e-05,139737562,0.892356
D.birchii,156593892,VNKA01004024.1,1,7922,5.05895e-05,139745484,0.892407
D.birchii,156593892,VNKA01002219.1,1,7915,5.05448e-05,139753399,0.892458
D.birchii,156593892,VNKA01006114.1,1,7913,5.0532e-05,139761312,0.892508
D.birchii,156593892,VNKA01006875.1,1,7911,5.05192e-05,139769223,0.892559
D.birchii,156593892,VNKA01006227.1,1,7903,5.04681e-05,139777126,0.892609
D.birchii,156593892,VNKA01000042.1,1,7893,5.04043e-05,139785019,0.892659
D.birchii,156593892,VNKA01002913.1,1,7891,5.03915e-05,139792910,0.89271
D.birchii,156593892,VNKA01002551.1,1,7891,5.03915e-05,139800801,0.89276
D.birchii,156593892,VNKA01006302.1,1,7890,5.03851e-05,139808691,0.892811
D.birchii,156593892,VNKA01002273.1,1,7888,5.03723e-05,139816579,0.892861
D.birchii,156593892,VNKA01003187.1,1,7886,5.03596e-05,139824465,0.892911
D.birchii,156593892,VNKA01002667.1,1,7886,5.03596e-05,139832351,0.892962
D.birchii,156593892,VNKA01001694.1,1,7877,5.03021e-05,139840228,0.893012
D.birchii,156593892,VNKA01005953.1,1,7876,5.02957e-05,139848104,0.893062
D.birchii,156593892,VNKA01005631.1,1,7874,5.02829e-05,139855978,0.893113
D.birchii,156593892,VNKA01002027.1,1,7873,5.02765e-05,139863851,0.893163
D.birchii,156593892,VNKA01000537.1,1,7873,5.02765e-05,139871724,0.893213
D.birchii,156593892,VNKA01000354.1,1,7870,5.02574e-05,139879594,0.893263
D.birchii,156593892,VNKA01004638.1,1,7848,5.01169e-05,139887442,0.893314
D.birchii,156593892,VNKA01002090.1,1,7847,5.01105e-05,139895289,0.893364
D.birchii,156593892,VNKA01006835.1,1,7845,5.00977e-05,139903134,0.893414
D.birchii,156593892,VNKA01000979.1,1,7840,5.00658e-05,139910974,0.893464
D.birchii,156593892,VNKA01004023.1,1,7834,5.00275e-05,139918808,0.893514
D.birchii,156593892,VNKA01002010.1,1,7818,4.99253e-05,139926626,0.893564
D.birchii,156593892,VNKA01000527.1,1,7818,4.99253e-05,139934444,0.893614
D.birchii,156593892,VNKA01005286.1,1,7815,4.99062e-05,139942259,0.893664
D.birchii,156593892,VNKA01006125.1,1,7810,4.98742e-05,139950069,0.893713
D.birchii,156593892,VNKA01005391.1,1,7803,4.98295e-05,139957872,0.893763
D.birchii,156593892,VNKA01000597.1,1,7798,4.97976e-05,139965670,0.893813
D.birchii,156593892,VNKA01000260.1,1,7790,4.97465e-05,139973460,0.893863
D.birchii,156593892,VNKA01004772.1,1,7789,4.97401e-05,139981249,0.893913
D.birchii,156593892,VNKA01003720.1,1,7787,4.97274e-05,139989036,0.893962
D.birchii,156593892,VNKA01004661.1,1,7784,4.97082e-05,139996820,0.894012
D.birchii,156593892,VNKA01004766.1,1,7781,4.9689e-05,140004601,0.894062
D.birchii,156593892,VNKA01005527.1,1,7777,4.96635e-05,140012378,0.894111
D.birchii,156593892,VNKA01005389.1,1,7769,4.96124e-05,140020147,0.894161
D.birchii,156593892,VNKA01006533.1,1,7768,4.9606e-05,140027915,0.894211
D.birchii,156593892,VNKA01006516.1,1,7767,4.95996e-05,140035682,0.89426
D.birchii,156593892,VNKA01002153.1,1,7749,4.94847e-05,140043431,0.89431
D.birchii,156593892,VNKA01006626.1,1,7748,4.94783e-05,140051179,0.894359
D.birchii,156593892,VNKA01005680.1,1,7748,4.94783e-05,140058927,0.894409
D.birchii,156593892,VNKA01001160.1,1,7742,4.944e-05,140066669,0.894458
D.birchii,156593892,VNKA01004210.1,1,7732,4.93761e-05,140074401,0.894507
D.birchii,156593892,VNKA01001193.1,1,7721,4.93059e-05,140082122,0.894557
D.birchii,156593892,VNKA01001753.1,1,7718,4.92867e-05,140089840,0.894606
D.birchii,156593892,VNKA01005120.1,1,7712,4.92484e-05,140097552,0.894655
D.birchii,156593892,VNKA01000931.1,1,7710,4.92356e-05,140105262,0.894705
D.birchii,156593892,VNKA01000132.1,1,7705,4.92037e-05,140112967,0.894754
D.birchii,156593892,VNKA01006429.1,1,7704,4.91973e-05,140120671,0.894803
D.birchii,156593892,VNKA01002768.1,1,7699,4.91654e-05,140128370,0.894852
D.birchii,156593892,VNKA01004422.1,1,7683,4.90632e-05,140136053,0.894901
D.birchii,156593892,VNKA01003752.1,1,7678,4.90313e-05,140143731,0.89495
D.birchii,156593892,VNKA01001852.1,1,7673,4.89994e-05,140151404,0.894999
D.birchii,156593892,VNKA01002231.1,1,7663,4.89355e-05,140159067,0.895048
D.birchii,156593892,VNKA01001274.1,1,7659,4.891e-05,140166726,0.895097
D.birchii,156593892,VNKA01003872.1,1,7653,4.88716e-05,140174379,0.895146
D.birchii,156593892,VNKA01006421.1,1,7651,4.88589e-05,140182030,0.895195
D.birchii,156593892,VNKA01001064.1,1,7646,4.88269e-05,140189676,0.895244
D.birchii,156593892,VNKA01001099.1,1,7644,4.88142e-05,140197320,0.895292
D.birchii,156593892,VNKA01007053.1,1,7640,4.87886e-05,140204960,0.895341
D.birchii,156593892,VNKA01006579.1,1,7638,4.87758e-05,140212598,0.89539
D.birchii,156593892,VNKA01000964.1,1,7632,4.87375e-05,140220230,0.895439
D.birchii,156593892,VNKA01000938.1,1,7626,4.86992e-05,140227856,0.895487
D.birchii,156593892,VNKA01002268.1,1,7604,4.85587e-05,140235460,0.895536
D.birchii,156593892,VNKA01004153.1,1,7595,4.85013e-05,140243055,0.895584
D.birchii,156593892,VNKA01002654.1,1,7594,4.84949e-05,140250649,0.895633
D.birchii,156593892,VNKA01004697.1,1,7593,4.84885e-05,140258242,0.895681
D.birchii,156593892,VNKA01000424.1,1,7593,4.84885e-05,140265835,0.89573
D.birchii,156593892,VNKA01002723.1,1,7592,4.84821e-05,140273427,0.895778
D.birchii,156593892,VNKA01003624.1,1,7583,4.84246e-05,140281010,0.895827
D.birchii,156593892,VNKA01006656.1,1,7573,4.83608e-05,140288583,0.895875
D.birchii,156593892,VNKA01002799.1,1,7571,4.8348e-05,140296154,0.895924
D.birchii,156593892,VNKA01005874.1,1,7569,4.83352e-05,140303723,0.895972
D.birchii,156593892,VNKA01000401.1,1,7562,4.82905e-05,140311285,0.89602
D.birchii,156593892,VNKA01003640.1,1,7555,4.82458e-05,140318840,0.896068
D.birchii,156593892,VNKA01007062.1,1,7553,4.8233e-05,140326393,0.896117
D.birchii,156593892,VNKA01001714.1,1,7553,4.8233e-05,140333946,0.896165
D.birchii,156593892,VNKA01000075.1,1,7550,4.82139e-05,140341496,0.896213
D.birchii,156593892,VNKA01003529.1,1,7543,4.81692e-05,140349039,0.896261
D.birchii,156593892,VNKA01004831.1,1,7534,4.81117e-05,140356573,0.896309
D.birchii,156593892,VNKA01006253.1,1,7529,4.80798e-05,140364102,0.896357
D.birchii,156593892,VNKA01003059.1,1,7526,4.80606e-05,140371628,0.896406
D.birchii,156593892,VNKA01000869.1,1,7521,4.80287e-05,140379149,0.896454
D.birchii,156593892,VNKA01007427.1,1,7517,4.80031e-05,140386666,0.896502
D.birchii,156593892,VNKA01006344.1,1,7507,4.79393e-05,140394173,0.896549
D.birchii,156593892,VNKA01004563.1,1,7507,4.79393e-05,140401680,0.896597
D.birchii,156593892,VNKA01006956.1,1,7505,4.79265e-05,140409185,0.896645
D.birchii,156593892,VNKA01007371.1,1,7504,4.79201e-05,140416689,0.896693
D.birchii,156593892,VNKA01003272.1,1,7499,4.78882e-05,140424188,0.896741
D.birchii,156593892,VNKA01003487.1,1,7498,4.78818e-05,140431686,0.896789
D.birchii,156593892,VNKA01004290.1,1,7494,4.78563e-05,140439180,0.896837
D.birchii,156593892,VNKA01001744.1,1,7494,4.78563e-05,140446674,0.896885
D.birchii,156593892,VNKA01000028.1,1,7494,4.78563e-05,140454168,0.896933
D.birchii,156593892,VNKA01004656.1,1,7493,4.78499e-05,140461661,0.89698
D.birchii,156593892,VNKA01006103.1,1,7487,4.78116e-05,140469148,0.897028
D.birchii,156593892,VNKA01006147.1,1,7477,4.77477e-05,140476625,0.897076
D.birchii,156593892,VNKA01006397.1,1,7476,4.77413e-05,140484101,0.897124
D.birchii,156593892,VNKA01001134.1,1,7471,4.77094e-05,140491572,0.897171
D.birchii,156593892,VNKA01005738.1,1,7470,4.7703e-05,140499042,0.897219
D.birchii,156593892,VNKA01005281.1,1,7462,4.76519e-05,140506504,0.897267
D.birchii,156593892,VNKA01002871.1,1,7462,4.76519e-05,140513966,0.897314
D.birchii,156593892,VNKA01005881.1,1,7461,4.76455e-05,140521427,0.897362
D.birchii,156593892,VNKA01007415.1,1,7460,4.76392e-05,140528887,0.89741
D.birchii,156593892,VNKA01000724.1,1,7458,4.76264e-05,140536345,0.897457
D.birchii,156593892,VNKA01000628.1,1,7458,4.76264e-05,140543803,0.897505
D.birchii,156593892,VNKA01000920.1,1,7453,4.75944e-05,140551256,0.897553
D.birchii,156593892,VNKA01003840.1,1,7450,4.75753e-05,140558706,0.8976
D.birchii,156593892,VNKA01001767.1,1,7446,4.75497e-05,140566152,0.897648
D.birchii,156593892,VNKA01003721.1,1,7442,4.75242e-05,140573594,0.897695
D.birchii,156593892,VNKA01007255.1,1,7439,4.7505e-05,140581033,0.897743
D.birchii,156593892,VNKA01006465.1,1,7436,4.74859e-05,140588469,0.89779
D.birchii,156593892,VNKA01004808.1,1,7434,4.74731e-05,140595903,0.897838
D.birchii,156593892,VNKA01005227.1,1,7420,4.73837e-05,140603323,0.897885
D.birchii,156593892,VNKA01006481.1,1,7416,4.73582e-05,140610739,0.897932
D.birchii,156593892,VNKA01003943.1,1,7415,4.73518e-05,140618154,0.89798
D.birchii,156593892,VNKA01004829.1,1,7406,4.72943e-05,140625560,0.898027
D.birchii,156593892,VNKA01001516.1,1,7404,4.72815e-05,140632964,0.898074
D.birchii,156593892,VNKA01005401.1,1,7398,4.72432e-05,140640362,0.898122
D.birchii,156593892,VNKA01005488.1,1,7389,4.71857e-05,140647751,0.898169
D.birchii,156593892,VNKA01007165.1,1,7385,4.71602e-05,140655136,0.898216
D.birchii,156593892,VNKA01002114.1,1,7381,4.71347e-05,140662517,0.898263
D.birchii,156593892,VNKA01004430.1,1,7370,4.70644e-05,140669887,0.89831
D.birchii,156593892,VNKA01005219.1,1,7364,4.70261e-05,140677251,0.898357
D.birchii,156593892,VNKA01006931.1,1,7359,4.69942e-05,140684610,0.898404
D.birchii,156593892,VNKA01004914.1,1,7354,4.69622e-05,140691964,0.898451
D.birchii,156593892,VNKA01001848.1,1,7351,4.69431e-05,140699315,0.898498
D.birchii,156593892,VNKA01005733.1,1,7344,4.68984e-05,140706659,0.898545
D.birchii,156593892,VNKA01004900.1,1,7336,4.68473e-05,140713995,0.898592
D.birchii,156593892,VNKA01006315.1,1,7332,4.68217e-05,140721327,0.898639
D.birchii,156593892,VNKA01005674.1,1,7327,4.67898e-05,140728654,0.898685
D.birchii,156593892,VNKA01006483.1,1,7322,4.67579e-05,140735976,0.898732
D.birchii,156593892,VNKA01000810.1,1,7320,4.67451e-05,140743296,0.898779
D.birchii,156593892,VNKA01007550.1,1,7319,4.67387e-05,140750615,0.898826
D.birchii,156593892,VNKA01002879.1,1,7319,4.67387e-05,140757934,0.898872
D.birchii,156593892,VNKA01006613.1,1,7317,4.6726e-05,140765251,0.898919
D.birchii,156593892,VNKA01005034.1,1,7313,4.67004e-05,140772564,0.898966
D.birchii,156593892,VNKA01002925.1,1,7303,4.66366e-05,140779867,0.899013
D.birchii,156593892,VNKA01003701.1,1,7301,4.66238e-05,140787168,0.899059
D.birchii,156593892,VNKA01007523.1,1,7300,4.66174e-05,140794468,0.899106
D.birchii,156593892,VNKA01001350.1,1,7300,4.66174e-05,140801768,0.899152
D.birchii,156593892,VNKA01000521.1,1,7296,4.65919e-05,140809064,0.899199
D.birchii,156593892,VNKA01004690.1,1,7295,4.65855e-05,140816359,0.899246
D.birchii,156593892,VNKA01005242.1,1,7291,4.65599e-05,140823650,0.899292
D.birchii,156593892,VNKA01001373.1,1,7285,4.65216e-05,140830935,0.899339
D.birchii,156593892,VNKA01001327.1,1,7285,4.65216e-05,140838220,0.899385
D.birchii,156593892,VNKA01001786.1,1,7276,4.64641e-05,140845496,0.899432
D.birchii,156593892,VNKA01001444.1,1,7272,4.64386e-05,140852768,0.899478
D.birchii,156593892,VNKA01003859.1,1,7266,4.64003e-05,140860034,0.899524
D.birchii,156593892,VNKA01000943.1,1,7264,4.63875e-05,140867298,0.899571
D.birchii,156593892,VNKA01007071.1,1,7254,4.63236e-05,140874552,0.899617
D.birchii,156593892,VNKA01002798.1,1,7247,4.62789e-05,140881799,0.899663
D.birchii,156593892,VNKA01004559.1,1,7246,4.62726e-05,140889045,0.89971
D.birchii,156593892,VNKA01001322.1,1,7242,4.6247e-05,140896287,0.899756
D.birchii,156593892,VNKA01003989.1,1,7232,4.61832e-05,140903519,0.899802
D.birchii,156593892,VNKA01001337.1,1,7232,4.61832e-05,140910751,0.899848
D.birchii,156593892,VNKA01001699.1,1,7227,4.61512e-05,140917978,0.899894
D.birchii,156593892,VNKA01001067.1,1,7225,4.61385e-05,140925203,0.899941
D.birchii,156593892,VNKA01007273.1,1,7218,4.60938e-05,140932421,0.899987
D.birchii,156593892,VNKA01003693.1,1,7217,4.60874e-05,140939638,0.900033
D.birchii,156593892,VNKA01005920.1,1,7213,4.60618e-05,140946851,0.900079
D.birchii,156593892,VNKA01007414.1,1,7209,4.60363e-05,140954060,0.900125
D.birchii,156593892,VNKA01004182.1,1,7209,4.60363e-05,140961269,0.900171
D.birchii,156593892,VNKA01004872.1,1,7199,4.59724e-05,140968468,0.900217
D.birchii,156593892,VNKA01003478.1,1,7196,4.59533e-05,140975664,0.900263
D.birchii,156593892,VNKA01002582.1,1,7196,4.59533e-05,140982860,0.900309
D.birchii,156593892,VNKA01002022.1,1,7196,4.59533e-05,140990056,0.900355
D.birchii,156593892,VNKA01001203.1,1,7193,4.59341e-05,140997249,0.900401
D.birchii,156593892,VNKA01006731.1,1,7184,4.58766e-05,141004433,0.900447
D.birchii,156593892,VNKA01005599.1,1,7174,4.58128e-05,141011607,0.900492
D.birchii,156593892,VNKA01004504.1,1,7169,4.57808e-05,141018776,0.900538
D.birchii,156593892,VNKA01004894.1,1,7164,4.57489e-05,141025940,0.900584
D.birchii,156593892,VNKA01001070.1,1,7161,4.57298e-05,141033101,0.90063
D.birchii,156593892,VNKA01005506.1,1,7152,4.56723e-05,141040253,0.900675
D.birchii,156593892,VNKA01005342.1,1,7152,4.56723e-05,141047405,0.900721
D.birchii,156593892,VNKA01005793.1,1,7151,4.56659e-05,141054556,0.900767
D.birchii,156593892,VNKA01002113.1,1,7148,4.56467e-05,141061704,0.900812
D.birchii,156593892,VNKA01001920.1,1,7148,4.56467e-05,141068852,0.900858
D.birchii,156593892,VNKA01001320.1,1,7144,4.56212e-05,141075996,0.900904
D.birchii,156593892,VNKA01001096.1,1,7135,4.55637e-05,141083131,0.900949
D.birchii,156593892,VNKA01006061.1,1,7126,4.55062e-05,141090257,0.900995
D.birchii,156593892,VNKA01005360.1,1,7124,4.54935e-05,141097381,0.90104
D.birchii,156593892,VNKA01006923.1,1,7123,4.54871e-05,141104504,0.901086
D.birchii,156593892,VNKA01006244.1,1,7123,4.54871e-05,141111627,0.901131
D.birchii,156593892,VNKA01002428.1,1,7121,4.54743e-05,141118748,0.901177
D.birchii,156593892,VNKA01001370.1,1,7105,4.53721e-05,141125853,0.901222
D.birchii,156593892,VNKA01000416.1,1,7104,4.53658e-05,141132957,0.901267
D.birchii,156593892,VNKA01003406.1,1,7102,4.5353e-05,141140059,0.901313
D.birchii,156593892,VNKA01003039.1,1,7102,4.5353e-05,141147161,0.901358
D.birchii,156593892,VNKA01000620.1,1,7094,4.53019e-05,141154255,0.901403
D.birchii,156593892,VNKA01003892.1,1,7088,4.52636e-05,141161343,0.901449
D.birchii,156593892,VNKA01000210.1,1,7086,4.52508e-05,141168429,0.901494
D.birchii,156593892,VNKA01005817.1,1,7077,4.51933e-05,141175506,0.901539
D.birchii,156593892,VNKA01001907.1,1,7074,4.51742e-05,141182580,0.901584
D.birchii,156593892,VNKA01002986.1,1,7071,4.5155e-05,141189651,0.901629
D.birchii,156593892,VNKA01006299.1,1,7061,4.50912e-05,141196712,0.901674
D.birchii,156593892,VNKA01007529.1,1,7051,4.50273e-05,141203763,0.901719
D.birchii,156593892,VNKA01001416.1,1,7050,4.50209e-05,141210813,0.901765
D.birchii,156593892,VNKA01004185.1,1,7041,4.49634e-05,141217854,0.901809
D.birchii,156593892,VNKA01002525.1,1,7040,4.49571e-05,141224894,0.901854
D.birchii,156593892,VNKA01002082.1,1,7039,4.49507e-05,141231933,0.901899
D.birchii,156593892,VNKA01001817.1,1,7039,4.49507e-05,141238972,0.901944
D.birchii,156593892,VNKA01003441.1,1,7036,4.49315e-05,141246008,0.901989
D.birchii,156593892,VNKA01001331.1,1,7031,4.48996e-05,141253039,0.902034
D.birchii,156593892,VNKA01007143.1,1,7029,4.48868e-05,141260068,0.902079
D.birchii,156593892,VNKA01004370.1,1,7029,4.48868e-05,141267097,0.902124
D.birchii,156593892,VNKA01002730.1,1,7029,4.48868e-05,141274126,0.902169
D.birchii,156593892,VNKA01002348.1,1,7025,4.48613e-05,141281151,0.902214
D.birchii,156593892,VNKA01003245.1,1,7016,4.48038e-05,141288167,0.902258
D.birchii,156593892,VNKA01005601.1,1,7008,4.47527e-05,141295175,0.902303
D.birchii,156593892,VNKA01000939.1,1,7007,4.47463e-05,141302182,0.902348
D.birchii,156593892,VNKA01001045.1,1,7001,4.4708e-05,141309183,0.902393
D.birchii,156593892,VNKA01002659.1,1,7000,4.47016e-05,141316183,0.902437
D.birchii,156593892,VNKA01003763.1,1,6995,4.46697e-05,141323178,0.902482
D.birchii,156593892,VNKA01002503.1,1,6992,4.46505e-05,141330170,0.902527
D.birchii,156593892,VNKA01003850.1,1,6990,4.46378e-05,141337160,0.902571
D.birchii,156593892,VNKA01003694.1,1,6982,4.45867e-05,141344142,0.902616
D.birchii,156593892,VNKA01002833.1,1,6976,4.45484e-05,141351118,0.90266
D.birchii,156593892,VNKA01000002.1,1,6975,4.4542e-05,141358093,0.902705
D.birchii,156593892,VNKA01005450.1,1,6974,4.45356e-05,141365067,0.90275
D.birchii,156593892,VNKA01000262.1,1,6971,4.45164e-05,141372038,0.902794
D.birchii,156593892,VNKA01007043.1,1,6967,4.44909e-05,141379005,0.902839
D.birchii,156593892,VNKA01006649.1,1,6967,4.44909e-05,141385972,0.902883
D.birchii,156593892,VNKA01005919.1,1,6964,4.44717e-05,141392936,0.902928
D.birchii,156593892,VNKA01000798.1,1,6951,4.43887e-05,141399887,0.902972
D.birchii,156593892,VNKA01007192.1,1,6950,4.43823e-05,141406837,0.903016
D.birchii,156593892,VNKA01006767.1,1,6944,4.4344e-05,141413781,0.903061
D.birchii,156593892,VNKA01004212.1,1,6942,4.43312e-05,141420723,0.903105
D.birchii,156593892,VNKA01000904.1,1,6937,4.42993e-05,141427660,0.903149
D.birchii,156593892,VNKA01000847.1,1,6937,4.42993e-05,141434597,0.903194
D.birchii,156593892,VNKA01001052.1,1,6932,4.42674e-05,141441529,0.903238
D.birchii,156593892,VNKA01000033.1,1,6927,4.42354e-05,141448456,0.903282
D.birchii,156593892,VNKA01001726.1,1,6922,4.42035e-05,141455378,0.903326
D.birchii,156593892,VNKA01005086.1,1,6917,4.41716e-05,141462295,0.90337
D.birchii,156593892,VNKA01005055.1,1,6917,4.41716e-05,141469212,0.903415
D.birchii,156593892,VNKA01005951.1,1,6906,4.41013e-05,141476118,0.903459
D.birchii,156593892,VNKA01004293.1,1,6906,4.41013e-05,141483024,0.903503
D.birchii,156593892,VNKA01004141.1,1,6906,4.41013e-05,141489930,0.903547
D.birchii,156593892,VNKA01003805.1,1,6905,4.4095e-05,141496835,0.903591
D.birchii,156593892,VNKA01001974.1,1,6904,4.40886e-05,141503739,0.903635
D.birchii,156593892,VNKA01004179.1,1,6903,4.40822e-05,141510642,0.903679
D.birchii,156593892,VNKA01004830.1,1,6900,4.4063e-05,141517542,0.903723
D.birchii,156593892,VNKA01007138.1,1,6898,4.40502e-05,141524440,0.903767
D.birchii,156593892,VNKA01005645.1,1,6895,4.40311e-05,141531335,0.903811
D.birchii,156593892,VNKA01006883.1,1,6889,4.39928e-05,141538224,0.903855
D.birchii,156593892,VNKA01001692.1,1,6885,4.39672e-05,141545109,0.903899
D.birchii,156593892,VNKA01007329.1,1,6878,4.39225e-05,141551987,0.903943
D.birchii,156593892,VNKA01003316.1,1,6877,4.39161e-05,141558864,0.903987
D.birchii,156593892,VNKA01006518.1,1,6872,4.38842e-05,141565736,0.904031
D.birchii,156593892,VNKA01006395.1,1,6870,4.38714e-05,141572606,0.904075
D.birchii,156593892,VNKA01004446.1,1,6866,4.38459e-05,141579472,0.904119
D.birchii,156593892,VNKA01007158.1,1,6863,4.38267e-05,141586335,0.904163
D.birchii,156593892,VNKA01005608.1,1,6852,4.37565e-05,141593187,0.904206
D.birchii,156593892,VNKA01004691.1,1,6851,4.37501e-05,141600038,0.90425
D.birchii,156593892,VNKA01000934.1,1,6851,4.37501e-05,141606889,0.904294
D.birchii,156593892,VNKA01003242.1,1,6850,4.37437e-05,141613739,0.904338
D.birchii,156593892,VNKA01000773.1,1,6848,4.3731e-05,141620587,0.904381
D.birchii,156593892,VNKA01001575.1,1,6846,4.37182e-05,141627433,0.904425
D.birchii,156593892,VNKA01001410.1,1,6844,4.37054e-05,141634277,0.904469
D.birchii,156593892,VNKA01004696.1,1,6843,4.3699e-05,141641120,0.904512
D.birchii,156593892,VNKA01004634.1,1,6843,4.3699e-05,141647963,0.904556
D.birchii,156593892,VNKA01005038.1,1,6840,4.36799e-05,141654803,0.9046
D.birchii,156593892,VNKA01002834.1,1,6840,4.36799e-05,141661643,0.904643
D.birchii,156593892,VNKA01004667.1,1,6835,4.36479e-05,141668478,0.904687
D.birchii,156593892,VNKA01007191.1,1,6831,4.36224e-05,141675309,0.904731
D.birchii,156593892,VNKA01006847.1,1,6830,4.3616e-05,141682139,0.904774
D.birchii,156593892,VNKA01006874.1,1,6819,4.35458e-05,141688958,0.904818
D.birchii,156593892,VNKA01006606.1,1,6819,4.35458e-05,141695777,0.904861
D.birchii,156593892,VNKA01000063.1,1,6816,4.35266e-05,141702593,0.904905
D.birchii,156593892,VNKA01003186.1,1,6808,4.34755e-05,141709401,0.904948
D.birchii,156593892,VNKA01001663.1,1,6808,4.34755e-05,141716209,0.904992
D.birchii,156593892,VNKA01006388.1,1,6788,4.33478e-05,141722997,0.905035
D.birchii,156593892,VNKA01000259.1,1,6788,4.33478e-05,141729785,0.905079
D.birchii,156593892,VNKA01007422.1,1,6783,4.33159e-05,141736568,0.905122
D.birchii,156593892,VNKA01005023.1,1,6783,4.33159e-05,141743351,0.905165
D.birchii,156593892,VNKA01005894.1,1,6777,4.32776e-05,141750128,0.905209
D.birchii,156593892,VNKA01000971.1,1,6772,4.32456e-05,141756900,0.905252
D.birchii,156593892,VNKA01004352.1,1,6770,4.32328e-05,141763670,0.905295
D.birchii,156593892,VNKA01006771.1,1,6767,4.32137e-05,141770437,0.905338
D.birchii,156593892,VNKA01006250.1,1,6764,4.31945e-05,141777201,0.905381
D.birchii,156593892,VNKA01001579.1,1,6764,4.31945e-05,141783965,0.905425
D.birchii,156593892,VNKA01006320.1,1,6761,4.31754e-05,141790726,0.905468
D.birchii,156593892,VNKA01002152.1,1,6760,4.3169e-05,141797486,0.905511
D.birchii,156593892,VNKA01001169.1,1,6749,4.30987e-05,141804235,0.905554
D.birchii,156593892,VNKA01006149.1,1,6748,4.30924e-05,141810983,0.905597
D.birchii,156593892,VNKA01004603.1,1,6748,4.30924e-05,141817731,0.90564
D.birchii,156593892,VNKA01000264.1,1,6746,4.30796e-05,141824477,0.905683
D.birchii,156593892,VNKA01003178.1,1,6735,4.30093e-05,141831212,0.905726
D.birchii,156593892,VNKA01001662.1,1,6725,4.29455e-05,141837937,0.905769
D.birchii,156593892,VNKA01000942.1,1,6722,4.29263e-05,141844659,0.905812
D.birchii,156593892,VNKA01006057.1,1,6717,4.28944e-05,141851376,0.905855
D.birchii,156593892,VNKA01002288.1,1,6717,4.28944e-05,141858093,0.905898
D.birchii,156593892,VNKA01007156.1,1,6710,4.28497e-05,141864803,0.905941
D.birchii,156593892,VNKA01007277.1,1,6701,4.27922e-05,141871504,0.905984
D.birchii,156593892,VNKA01006185.1,1,6701,4.27922e-05,141878205,0.906026
D.birchii,156593892,VNKA01002056.1,1,6701,4.27922e-05,141884906,0.906069
D.birchii,156593892,VNKA01005235.1,1,6698,4.27731e-05,141891604,0.906112
D.birchii,156593892,VNKA01007243.1,1,6685,4.269e-05,141898289,0.906155
D.birchii,156593892,VNKA01005237.1,1,6683,4.26773e-05,141904972,0.906197
D.birchii,156593892,VNKA01004819.1,1,6683,4.26773e-05,141911655,0.90624
D.birchii,156593892,VNKA01000135.1,1,6674,4.26198e-05,141918329,0.906283
D.birchii,156593892,VNKA01002002.1,1,6669,4.25879e-05,141924998,0.906325
D.birchii,156593892,VNKA01005737.1,1,6659,4.2524e-05,141931657,0.906368
D.birchii,156593892,VNKA01007570.1,1,6657,4.25112e-05,141938314,0.90641
D.birchii,156593892,VNKA01005507.1,1,6656,4.25049e-05,141944970,0.906453
D.birchii,156593892,VNKA01000672.1,1,6656,4.25049e-05,141951626,0.906495
D.birchii,156593892,VNKA01001376.1,1,6651,4.24729e-05,141958277,0.906538
D.birchii,156593892,VNKA01007557.1,1,6650,4.24665e-05,141964927,0.90658
D.birchii,156593892,VNKA01000274.1,1,6649,4.24601e-05,141971576,0.906623
D.birchii,156593892,VNKA01006605.1,1,6648,4.24538e-05,141978224,0.906665
D.birchii,156593892,VNKA01003517.1,1,6644,4.24282e-05,141984868,0.906708
D.birchii,156593892,VNKA01001586.1,1,6631,4.23452e-05,141991499,0.90675
D.birchii,156593892,VNKA01006489.1,1,6630,4.23388e-05,141998129,0.906792
D.birchii,156593892,VNKA01003700.1,1,6617,4.22558e-05,142004746,0.906835
D.birchii,156593892,VNKA01006230.1,1,6615,4.2243e-05,142011361,0.906877
D.birchii,156593892,VNKA01005579.1,1,6613,4.22303e-05,142017974,0.906919
D.birchii,156593892,VNKA01004695.1,1,6606,4.21856e-05,142024580,0.906961
D.birchii,156593892,VNKA01004084.1,1,6600,4.21472e-05,142031180,0.907003
D.birchii,156593892,VNKA01003201.1,1,6598,4.21345e-05,142037778,0.907045
D.birchii,156593892,VNKA01005681.1,1,6597,4.21281e-05,142044375,0.907088
D.birchii,156593892,VNKA01003896.1,1,6588,4.20706e-05,142050963,0.90713
D.birchii,156593892,VNKA01004701.1,1,6582,4.20323e-05,142057545,0.907172
D.birchii,156593892,VNKA01005426.1,1,6581,4.20259e-05,142064126,0.907214
D.birchii,156593892,VNKA01004566.1,1,6581,4.20259e-05,142070707,0.907256
D.birchii,156593892,VNKA01000925.1,1,6578,4.20067e-05,142077285,0.907298
D.birchii,156593892,VNKA01000519.1,1,6570,4.19557e-05,142083855,0.90734
D.birchii,156593892,VNKA01003647.1,1,6569,4.19493e-05,142090424,0.907382
D.birchii,156593892,VNKA01000849.1,1,6565,4.19237e-05,142096989,0.907424
D.birchii,156593892,VNKA01005643.1,1,6559,4.18854e-05,142103548,0.907465
D.birchii,156593892,VNKA01001026.1,1,6555,4.18599e-05,142110103,0.907507
D.birchii,156593892,VNKA01001053.1,1,6550,4.18279e-05,142116653,0.907549
D.birchii,156593892,VNKA01002839.1,1,6548,4.18152e-05,142123201,0.907591
D.birchii,156593892,VNKA01007519.1,1,6546,4.18024e-05,142129747,0.907633
D.birchii,156593892,VNKA01005547.1,1,6546,4.18024e-05,142136293,0.907675
D.birchii,156593892,VNKA01004040.1,1,6544,4.17896e-05,142142837,0.907716
D.birchii,156593892,VNKA01000052.1,1,6544,4.17896e-05,142149381,0.907758
D.birchii,156593892,VNKA01005166.1,1,6543,4.17832e-05,142155924,0.9078
D.birchii,156593892,VNKA01007450.1,1,6541,4.17705e-05,142162465,0.907842
D.birchii,156593892,VNKA01005517.1,1,6540,4.17641e-05,142169005,0.907883
D.birchii,156593892,VNKA01002670.1,1,6529,4.16938e-05,142175534,0.907925
D.birchii,156593892,VNKA01006603.1,1,6524,4.16619e-05,142182058,0.907967
D.birchii,156593892,VNKA01002155.1,1,6520,4.16364e-05,142188578,0.908008
D.birchii,156593892,VNKA01004400.1,1,6504,4.15342e-05,142195082,0.90805
D.birchii,156593892,VNKA01004376.1,1,6503,4.15278e-05,142201585,0.908092
D.birchii,156593892,VNKA01006308.1,1,6501,4.1515e-05,142208086,0.908133
D.birchii,156593892,VNKA01005492.1,1,6498,4.14959e-05,142214584,0.908175
D.birchii,156593892,VNKA01004147.1,1,6495,4.14767e-05,142221079,0.908216
D.birchii,156593892,VNKA01001359.1,1,6492,4.14576e-05,142227571,0.908257
D.birchii,156593892,VNKA01004273.1,1,6490,4.14448e-05,142234061,0.908299
D.birchii,156593892,VNKA01006769.1,1,6479,4.13745e-05,142240540,0.90834
D.birchii,156593892,VNKA01000061.1,1,6477,4.13618e-05,142247017,0.908382
D.birchii,156593892,VNKA01002835.1,1,6473,4.13362e-05,142253490,0.908423
D.birchii,156593892,VNKA01001831.1,1,6470,4.13171e-05,142259960,0.908464
D.birchii,156593892,VNKA01006259.1,1,6464,4.12787e-05,142266424,0.908506
D.birchii,156593892,VNKA01001524.1,1,6463,4.12724e-05,142272887,0.908547
D.birchii,156593892,VNKA01003641.1,1,6461,4.12596e-05,142279348,0.908588
D.birchii,156593892,VNKA01005493.1,1,6460,4.12532e-05,142285808,0.908629
D.birchii,156593892,VNKA01005087.1,1,6455,4.12213e-05,142292263,0.908671
D.birchii,156593892,VNKA01000741.1,1,6445,4.11574e-05,142298708,0.908712
D.birchii,156593892,VNKA01001668.1,1,6439,4.11191e-05,142305147,0.908753
D.birchii,156593892,VNKA01004232.1,1,6437,4.11063e-05,142311584,0.908794
D.birchii,156593892,VNKA01002077.1,1,6436,4.10999e-05,142318020,0.908835
D.birchii,156593892,VNKA01006803.1,1,6432,4.10744e-05,142324452,0.908876
D.birchii,156593892,VNKA01004399.1,1,6432,4.10744e-05,142330884,0.908917
D.birchii,156593892,VNKA01002175.1,1,6424,4.10233e-05,142337308,0.908958
D.birchii,156593892,VNKA01004428.1,1,6417,4.09786e-05,142343725,0.908999
D.birchii,156593892,VNKA01007402.1,1,6408,4.09211e-05,142350133,0.90904
D.birchii,156593892,VNKA01005270.1,1,6405,4.0902e-05,142356538,0.909081
D.birchii,156593892,VNKA01007240.1,1,6392,4.0819e-05,142362930,0.909122
D.birchii,156593892,VNKA01006165.1,1,6392,4.0819e-05,142369322,0.909163
D.birchii,156593892,VNKA01001219.1,1,6391,4.08126e-05,142375713,0.909203
D.birchii,156593892,VNKA01002072.1,1,6387,4.0787e-05,142382100,0.909244
D.birchii,156593892,VNKA01002868.1,1,6379,4.07359e-05,142388479,0.909285
D.birchii,156593892,VNKA01005460.1,1,6377,4.07232e-05,142394856,0.909326
D.birchii,156593892,VNKA01005103.1,1,6373,4.06976e-05,142401229,0.909366
D.birchii,156593892,VNKA01003160.1,1,6364,4.06402e-05,142407593,0.909407
D.birchii,156593892,VNKA01004832.1,1,6351,4.05571e-05,142413944,0.909448
D.birchii,156593892,VNKA01002859.1,1,6347,4.05316e-05,142420291,0.909488
D.birchii,156593892,VNKA01002784.1,1,6346,4.05252e-05,142426637,0.909529
D.birchii,156593892,VNKA01001609.1,1,6331,4.04294e-05,142432968,0.909569
D.birchii,156593892,VNKA01003800.1,1,6326,4.03975e-05,142439294,0.90961
D.birchii,156593892,VNKA01003695.1,1,6326,4.03975e-05,142445620,0.90965
D.birchii,156593892,VNKA01000818.1,1,6325,4.03911e-05,142451945,0.90969
D.birchii,156593892,VNKA01000788.1,1,6325,4.03911e-05,142458270,0.909731
D.birchii,156593892,VNKA01001686.1,1,6315,4.03272e-05,142464585,0.909771
D.birchii,156593892,VNKA01001146.1,1,6314,4.03209e-05,142470899,0.909811
D.birchii,156593892,VNKA01002162.1,1,6310,4.02953e-05,142477209,0.909852
D.birchii,156593892,VNKA01007153.1,1,6309,4.02889e-05,142483518,0.909892
D.birchii,156593892,VNKA01005349.1,1,6309,4.02889e-05,142489827,0.909932
D.birchii,156593892,VNKA01007164.1,1,6305,4.02634e-05,142496132,0.909972
D.birchii,156593892,VNKA01001477.1,1,6298,4.02187e-05,142502430,0.910013
D.birchii,156593892,VNKA01006305.1,1,6288,4.01548e-05,142508718,0.910053
D.birchii,156593892,VNKA01004798.1,1,6286,4.01421e-05,142515004,0.910093
D.birchii,156593892,VNKA01005494.1,1,6279,4.00973e-05,142521283,0.910133
D.birchii,156593892,VNKA01001934.1,1,6278,4.0091e-05,142527561,0.910173
D.birchii,156593892,VNKA01001338.1,1,6275,4.00718e-05,142533836,0.910213
D.birchii,156593892,VNKA01002739.1,1,6272,4.00526e-05,142540108,0.910253
D.birchii,156593892,VNKA01007066.1,1,6269,4.00335e-05,142546377,0.910293
D.birchii,156593892,VNKA01006839.1,1,6268,4.00271e-05,142552645,0.910333
D.birchii,156593892,VNKA01003864.1,1,6266,4.00143e-05,142558911,0.910373
D.birchii,156593892,VNKA01003565.1,1,6262,3.99888e-05,142565173,0.910413
D.birchii,156593892,VNKA01002900.1,1,6262,3.99888e-05,142571435,0.910453
D.birchii,156593892,VNKA01002773.1,1,6255,3.99441e-05,142577690,0.910493
D.birchii,156593892,VNKA01002306.1,1,6253,3.99313e-05,142583943,0.910533
D.birchii,156593892,VNKA01004076.1,1,6252,3.99249e-05,142590195,0.910573
D.birchii,156593892,VNKA01005583.1,1,6248,3.98994e-05,142596443,0.910613
D.birchii,156593892,VNKA01004106.1,1,6238,3.98355e-05,142602681,0.910653
D.birchii,156593892,VNKA01007463.1,1,6234,3.981e-05,142608915,0.910693
D.birchii,156593892,VNKA01003149.1,1,6233,3.98036e-05,142615148,0.910733
D.birchii,156593892,VNKA01002299.1,1,6227,3.97653e-05,142621375,0.910772
D.birchii,156593892,VNKA01005280.1,1,6224,3.97461e-05,142627599,0.910812
D.birchii,156593892,VNKA01003470.1,1,6214,3.96823e-05,142633813,0.910852
D.birchii,156593892,VNKA01004684.1,1,6213,3.96759e-05,142640026,0.910891
D.birchii,156593892,VNKA01001300.1,1,6207,3.96376e-05,142646233,0.910931
D.birchii,156593892,VNKA01003562.1,1,6206,3.96312e-05,142652439,0.910971
D.birchii,156593892,VNKA01002033.1,1,6201,3.95992e-05,142658640,0.91101
D.birchii,156593892,VNKA01000886.1,1,6197,3.95737e-05,142664837,0.91105
D.birchii,156593892,VNKA01006895.1,1,6195,3.95609e-05,142671032,0.911089
D.birchii,156593892,VNKA01004732.1,1,6192,3.95418e-05,142677224,0.911129
D.birchii,156593892,VNKA01004884.1,1,6187,3.95098e-05,142683411,0.911168
D.birchii,156593892,VNKA01004776.1,1,6186,3.95035e-05,142689597,0.911208
D.birchii,156593892,VNKA01004650.1,1,6179,3.94588e-05,142695776,0.911247
D.birchii,156593892,VNKA01006760.1,1,6176,3.94396e-05,142701952,0.911287
D.birchii,156593892,VNKA01005948.1,1,6167,3.93821e-05,142708119,0.911326
D.birchii,156593892,VNKA01004056.1,1,6162,3.93502e-05,142714281,0.911366
D.birchii,156593892,VNKA01002513.1,1,6160,3.93374e-05,142720441,0.911405
D.birchii,156593892,VNKA01006545.1,1,6156,3.93119e-05,142726597,0.911444
D.birchii,156593892,VNKA01002011.1,1,6149,3.92672e-05,142732746,0.911483
D.birchii,156593892,VNKA01005864.1,1,6146,3.9248e-05,142738892,0.911523
D.birchii,156593892,VNKA01007223.1,1,6145,3.92416e-05,142745037,0.911562
D.birchii,156593892,VNKA01005145.1,1,6141,3.92161e-05,142751178,0.911601
D.birchii,156593892,VNKA01001425.1,1,6139,3.92033e-05,142757317,0.91164
D.birchii,156593892,VNKA01002564.1,1,6137,3.91905e-05,142763454,0.91168
D.birchii,156593892,VNKA01006199.1,1,6136,3.91842e-05,142769590,0.911719
D.birchii,156593892,VNKA01006256.1,1,6133,3.9165e-05,142775723,0.911758
D.birchii,156593892,VNKA01000883.1,1,6133,3.9165e-05,142781856,0.911797
D.birchii,156593892,VNKA01004041.1,1,6132,3.91586e-05,142787988,0.911836
D.birchii,156593892,VNKA01006674.1,1,6128,3.91331e-05,142794116,0.911875
D.birchii,156593892,VNKA01005410.1,1,6122,3.90948e-05,142800238,0.911914
D.birchii,156593892,VNKA01003881.1,1,6121,3.90884e-05,142806359,0.911954
D.birchii,156593892,VNKA01005648.1,1,6116,3.90564e-05,142812475,0.911993
D.birchii,156593892,VNKA01001354.1,1,6116,3.90564e-05,142818591,0.912032
D.birchii,156593892,VNKA01004188.1,1,6107,3.8999e-05,142824698,0.912071
D.birchii,156593892,VNKA01006122.1,1,6105,3.89862e-05,142830803,0.91211
D.birchii,156593892,VNKA01001048.1,1,6104,3.89798e-05,142836907,0.912149
D.birchii,156593892,VNKA01006827.1,1,6103,3.89734e-05,142843010,0.912188
D.birchii,156593892,VNKA01004883.1,1,6103,3.89734e-05,142849113,0.912227
D.birchii,156593892,VNKA01004074.1,1,6103,3.89734e-05,142855216,0.912266
D.birchii,156593892,VNKA01002681.1,1,6103,3.89734e-05,142861319,0.912305
D.birchii,156593892,VNKA01006902.1,1,6098,3.89415e-05,142867417,0.912343
D.birchii,156593892,VNKA01002527.1,1,6098,3.89415e-05,142873515,0.912382
D.birchii,156593892,VNKA01000592.1,1,6098,3.89415e-05,142879613,0.912421
D.birchii,156593892,VNKA01007559.1,1,6097,3.89351e-05,142885710,0.91246
D.birchii,156593892,VNKA01005059.1,1,6090,3.88904e-05,142891800,0.912499
D.birchii,156593892,VNKA01004189.1,1,6087,3.88712e-05,142897887,0.912538
D.birchii,156593892,VNKA01003755.1,1,6084,3.88521e-05,142903971,0.912577
D.birchii,156593892,VNKA01005736.1,1,6080,3.88265e-05,142910051,0.912616
D.birchii,156593892,VNKA01002762.1,1,6074,3.87882e-05,142916125,0.912655
D.birchii,156593892,VNKA01003787.1,1,6072,3.87755e-05,142922197,0.912693
D.birchii,156593892,VNKA01005963.1,1,6071,3.87691e-05,142928268,0.912732
D.birchii,156593892,VNKA01004957.1,1,6069,3.87563e-05,142934337,0.912771
D.birchii,156593892,VNKA01001324.1,1,6065,3.87308e-05,142940402,0.91281
D.birchii,156593892,VNKA01004069.1,1,6061,3.87052e-05,142946463,0.912848
D.birchii,156593892,VNKA01001995.1,1,6061,3.87052e-05,142952524,0.912887
D.birchii,156593892,VNKA01002895.1,1,6057,3.86797e-05,142958581,0.912926
D.birchii,156593892,VNKA01000623.1,1,6057,3.86797e-05,142964638,0.912964
D.birchii,156593892,VNKA01005604.1,1,6035,3.85392e-05,142970673,0.913003
D.birchii,156593892,VNKA01001576.1,1,6033,3.85264e-05,142976706,0.913041
D.birchii,156593892,VNKA01006565.1,1,6032,3.852e-05,142982738,0.91308
D.birchii,156593892,VNKA01000462.1,1,6029,3.85009e-05,142988767,0.913118
D.birchii,156593892,VNKA01007534.1,1,6027,3.84881e-05,142994794,0.913157
D.birchii,156593892,VNKA01007231.1,1,6027,3.84881e-05,143000821,0.913195
D.birchii,156593892,VNKA01000882.1,1,6025,3.84753e-05,143006846,0.913234
D.birchii,156593892,VNKA01007063.1,1,6020,3.84434e-05,143012866,0.913272
D.birchii,156593892,VNKA01004801.1,1,6019,3.8437e-05,143018885,0.913311
D.birchii,156593892,VNKA01003901.1,1,6014,3.84051e-05,143024899,0.913349
D.birchii,156593892,VNKA01006404.1,1,6013,3.83987e-05,143030912,0.913388
D.birchii,156593892,VNKA01006156.1,1,6013,3.83987e-05,143036925,0.913426
D.birchii,156593892,VNKA01005179.1,1,6000,3.83157e-05,143042925,0.913464
D.birchii,156593892,VNKA01003279.1,1,5994,3.82774e-05,143048919,0.913503
D.birchii,156593892,VNKA01007553.1,1,5992,3.82646e-05,143054911,0.913541
D.birchii,156593892,VNKA01006808.1,1,5988,3.8239e-05,143060899,0.913579
D.birchii,156593892,VNKA01004035.1,1,5986,3.82263e-05,143066885,0.913617
D.birchii,156593892,VNKA01003844.1,1,5983,3.82071e-05,143072868,0.913655
D.birchii,156593892,VNKA01002021.1,1,5982,3.82007e-05,143078850,0.913694
D.birchii,156593892,VNKA01006075.1,1,5980,3.8188e-05,143084830,0.913732
D.birchii,156593892,VNKA01003183.1,1,5975,3.8156e-05,143090805,0.91377
D.birchii,156593892,VNKA01003635.1,1,5972,3.81369e-05,143096777,0.913808
D.birchii,156593892,VNKA01002537.1,1,5972,3.81369e-05,143102749,0.913846
D.birchii,156593892,VNKA01004343.1,1,5971,3.81305e-05,143108720,0.913884
D.birchii,156593892,VNKA01001606.1,1,5970,3.81241e-05,143114690,0.913923
D.birchii,156593892,VNKA01000730.1,1,5970,3.81241e-05,143120660,0.913961
D.birchii,156593892,VNKA01007384.1,1,5965,3.80922e-05,143126625,0.913999
D.birchii,156593892,VNKA01000685.1,1,5962,3.8073e-05,143132587,0.914037
D.birchii,156593892,VNKA01002168.1,1,5959,3.80538e-05,143138546,0.914075
D.birchii,156593892,VNKA01001738.1,1,5958,3.80475e-05,143144504,0.914113
D.birchii,156593892,VNKA01003164.1,1,5957,3.80411e-05,143150461,0.914151
D.birchii,156593892,VNKA01007178.1,1,5956,3.80347e-05,143156417,0.914189
D.birchii,156593892,VNKA01007038.1,1,5950,3.79964e-05,143162367,0.914227
D.birchii,156593892,VNKA01006251.1,1,5945,3.79644e-05,143168312,0.914265
D.birchii,156593892,VNKA01006400.1,1,5942,3.79453e-05,143174254,0.914303
D.birchii,156593892,VNKA01004991.1,1,5940,3.79325e-05,143180194,0.914341
D.birchii,156593892,VNKA01003513.1,1,5940,3.79325e-05,143186134,0.914379
D.birchii,156593892,VNKA01007554.1,1,5933,3.78878e-05,143192067,0.914417
D.birchii,156593892,VNKA01006013.1,1,5932,3.78814e-05,143197999,0.914455
D.birchii,156593892,VNKA01003910.1,1,5932,3.78814e-05,143203931,0.914492
D.birchii,156593892,VNKA01001589.1,1,5927,3.78495e-05,143209858,0.91453
D.birchii,156593892,VNKA01000644.1,1,5925,3.78367e-05,143215783,0.914568
D.birchii,156593892,VNKA01004403.1,1,5922,3.78176e-05,143221705,0.914606
D.birchii,156593892,VNKA01002124.1,1,5919,3.77984e-05,143227624,0.914644
D.birchii,156593892,VNKA01007533.1,1,5915,3.77729e-05,143233539,0.914682
D.birchii,156593892,VNKA01000675.1,1,5909,3.77345e-05,143239448,0.914719
D.birchii,156593892,VNKA01003920.1,1,5901,3.76835e-05,143245349,0.914757
D.birchii,156593892,VNKA01000220.1,1,5899,3.76707e-05,143251248,0.914795
D.birchii,156593892,VNKA01005257.1,1,5896,3.76515e-05,143257144,0.914832
D.birchii,156593892,VNKA01001943.1,1,5890,3.76132e-05,143263034,0.91487
D.birchii,156593892,VNKA01003633.1,1,5887,3.75941e-05,143268921,0.914907
D.birchii,156593892,VNKA01006187.1,1,5880,3.75494e-05,143274801,0.914945
D.birchii,156593892,VNKA01004964.1,1,5880,3.75494e-05,143280681,0.914983
D.birchii,156593892,VNKA01000065.1,1,5880,3.75494e-05,143286561,0.91502
D.birchii,156593892,VNKA01005223.1,1,5873,3.75047e-05,143292434,0.915058
D.birchii,156593892,VNKA01000858.1,1,5864,3.74472e-05,143298298,0.915095
D.birchii,156593892,VNKA01004640.1,1,5863,3.74408e-05,143304161,0.915133
D.birchii,156593892,VNKA01004183.1,1,5863,3.74408e-05,143310024,0.91517
D.birchii,156593892,VNKA01000848.1,1,5862,3.74344e-05,143315886,0.915207
D.birchii,156593892,VNKA01001510.1,1,5861,3.7428e-05,143321747,0.915245
D.birchii,156593892,VNKA01000471.1,1,5861,3.7428e-05,143327608,0.915282
D.birchii,156593892,VNKA01004413.1,1,5853,3.73769e-05,143333461,0.91532
D.birchii,156593892,VNKA01005279.1,1,5851,3.73642e-05,143339312,0.915357
D.birchii,156593892,VNKA01005743.1,1,5849,3.73514e-05,143345161,0.915394
D.birchii,156593892,VNKA01003993.1,1,5845,3.73258e-05,143351006,0.915432
D.birchii,156593892,VNKA01005937.1,1,5842,3.73067e-05,143356848,0.915469
D.birchii,156593892,VNKA01002732.1,1,5842,3.73067e-05,143362690,0.915506
D.birchii,156593892,VNKA01001801.1,1,5840,3.72939e-05,143368530,0.915544
D.birchii,156593892,VNKA01002568.1,1,5832,3.72428e-05,143374362,0.915581
D.birchii,156593892,VNKA01004952.1,1,5824,3.71917e-05,143380186,0.915618
D.birchii,156593892,VNKA01003791.1,1,5821,3.71726e-05,143386007,0.915655
D.birchii,156593892,VNKA01003087.1,1,5810,3.71023e-05,143391817,0.915692
D.birchii,156593892,VNKA01005780.1,1,5801,3.70449e-05,143397618,0.915729
D.birchii,156593892,VNKA01005359.1,1,5798,3.70257e-05,143403416,0.915766
D.birchii,156593892,VNKA01006337.1,1,5796,3.70129e-05,143409212,0.915803
D.birchii,156593892,VNKA01006110.1,1,5794,3.70002e-05,143415006,0.91584
D.birchii,156593892,VNKA01000766.1,1,5794,3.70002e-05,143420800,0.915877
D.birchii,156593892,VNKA01002958.1,1,5791,3.6981e-05,143426591,0.915914
D.birchii,156593892,VNKA01003926.1,1,5790,3.69746e-05,143432381,0.915951
D.birchii,156593892,VNKA01006870.1,1,5787,3.69555e-05,143438168,0.915988
D.birchii,156593892,VNKA01003139.1,1,5787,3.69555e-05,143443955,0.916025
D.birchii,156593892,VNKA01002941.1,1,5785,3.69427e-05,143449740,0.916062
D.birchii,156593892,VNKA01001536.1,1,5782,3.69235e-05,143455522,0.916099
D.birchii,156593892,VNKA01003469.1,1,5781,3.69171e-05,143461303,0.916136
D.birchii,156593892,VNKA01002532.1,1,5778,3.6898e-05,143467081,0.916173
D.birchii,156593892,VNKA01001328.1,1,5777,3.68916e-05,143472858,0.91621
D.birchii,156593892,VNKA01002393.1,1,5775,3.68788e-05,143478633,0.916247
D.birchii,156593892,VNKA01004870.1,1,5771,3.68533e-05,143484404,0.916284
D.birchii,156593892,VNKA01006754.1,1,5765,3.6815e-05,143490169,0.91632
D.birchii,156593892,VNKA01004094.1,1,5761,3.67894e-05,143495930,0.916357
D.birchii,156593892,VNKA01003610.1,1,5755,3.67511e-05,143501685,0.916394
D.birchii,156593892,VNKA01006920.1,1,5754,3.67447e-05,143507439,0.916431
D.birchii,156593892,VNKA01007270.1,1,5750,3.67192e-05,143513189,0.916467
D.birchii,156593892,VNKA01001607.1,1,5735,3.66234e-05,143518924,0.916504
D.birchii,156593892,VNKA01001100.1,1,5732,3.66042e-05,143524656,0.916541
D.birchii,156593892,VNKA01001540.1,1,5729,3.65851e-05,143530385,0.916577
D.birchii,156593892,VNKA01003166.1,1,5727,3.65723e-05,143536112,0.916614
D.birchii,156593892,VNKA01000859.1,1,5726,3.65659e-05,143541838,0.91665
D.birchii,156593892,VNKA01007245.1,1,5719,3.65212e-05,143547557,0.916687
D.birchii,156593892,VNKA01002092.1,1,5715,3.64957e-05,143553272,0.916723
D.birchii,156593892,VNKA01004963.1,1,5714,3.64893e-05,143558986,0.91676
D.birchii,156593892,VNKA01000695.1,1,5713,3.64829e-05,143564699,0.916796
D.birchii,156593892,VNKA01001054.1,1,5709,3.64574e-05,143570408,0.916833
D.birchii,156593892,VNKA01006900.1,1,5708,3.6451e-05,143576116,0.916869
D.birchii,156593892,VNKA01000276.1,1,5706,3.64382e-05,143581822,0.916906
D.birchii,156593892,VNKA01003632.1,1,5705,3.64318e-05,143587527,0.916942
D.birchii,156593892,VNKA01004949.1,1,5702,3.64127e-05,143593229,0.916978
D.birchii,156593892,VNKA01002277.1,1,5698,3.63871e-05,143598927,0.917015
D.birchii,156593892,VNKA01002411.1,1,5697,3.63807e-05,143604624,0.917051
D.birchii,156593892,VNKA01006608.1,1,5693,3.63552e-05,143610317,0.917088
D.birchii,156593892,VNKA01001326.1,1,5690,3.6336e-05,143616007,0.917124
D.birchii,156593892,VNKA01005201.1,1,5689,3.63296e-05,143621696,0.91716
D.birchii,156593892,VNKA01003996.1,1,5686,3.63105e-05,143627382,0.917197
D.birchii,156593892,VNKA01002876.1,1,5686,3.63105e-05,143633068,0.917233
D.birchii,156593892,VNKA01003347.1,1,5682,3.62849e-05,143638750,0.917269
D.birchii,156593892,VNKA01006673.1,1,5679,3.62658e-05,143644429,0.917305
D.birchii,156593892,VNKA01001237.1,1,5676,3.62466e-05,143650105,0.917342
D.birchii,156593892,VNKA01005283.1,1,5675,3.62402e-05,143655780,0.917378
D.birchii,156593892,VNKA01006714.1,1,5674,3.62339e-05,143661454,0.917414
D.birchii,156593892,VNKA01006623.1,1,5671,3.62147e-05,143667125,0.91745
D.birchii,156593892,VNKA01006361.1,1,5669,3.62019e-05,143672794,0.917487
D.birchii,156593892,VNKA01003467.1,1,5665,3.61764e-05,143678459,0.917523
D.birchii,156593892,VNKA01005173.1,1,5662,3.61572e-05,143684121,0.917559
D.birchii,156593892,VNKA01003656.1,1,5659,3.61381e-05,143689780,0.917595
D.birchii,156593892,VNKA01000099.1,1,5658,3.61317e-05,143695438,0.917631
D.birchii,156593892,VNKA01001680.1,1,5654,3.61061e-05,143701092,0.917667
D.birchii,156593892,VNKA01006023.1,1,5647,3.60614e-05,143706739,0.917703
D.birchii,156593892,VNKA01002028.1,1,5637,3.59976e-05,143712376,0.917739
D.birchii,156593892,VNKA01002180.1,1,5635,3.59848e-05,143718011,0.917775
D.birchii,156593892,VNKA01007060.1,1,5634,3.59784e-05,143723645,0.917811
D.birchii,156593892,VNKA01005239.1,1,5634,3.59784e-05,143729279,0.917847
D.birchii,156593892,VNKA01003053.1,1,5633,3.5972e-05,143734912,0.917883
D.birchii,156593892,VNKA01000240.1,1,5632,3.59656e-05,143740544,0.917919
D.birchii,156593892,VNKA01002521.1,1,5625,3.59209e-05,143746169,0.917955
D.birchii,156593892,VNKA01005065.1,1,5622,3.59018e-05,143751791,0.917991
D.birchii,156593892,VNKA01002758.1,1,5622,3.59018e-05,143757413,0.918027
D.birchii,156593892,VNKA01002097.1,1,5617,3.58699e-05,143763030,0.918063
D.birchii,156593892,VNKA01000470.1,1,5616,3.58635e-05,143768646,0.918099
D.birchii,156593892,VNKA01005137.1,1,5614,3.58507e-05,143774260,0.918135
D.birchii,156593892,VNKA01000261.1,1,5613,3.58443e-05,143779873,0.91817
D.birchii,156593892,VNKA01002494.1,1,5611,3.58315e-05,143785484,0.918206
D.birchii,156593892,VNKA01005838.1,1,5610,3.58252e-05,143791094,0.918242
D.birchii,156593892,VNKA01002742.1,1,5610,3.58252e-05,143796704,0.918278
D.birchii,156593892,VNKA01003519.1,1,5604,3.57868e-05,143802308,0.918314
D.birchii,156593892,VNKA01001225.1,1,5600,3.57613e-05,143807908,0.918349
D.birchii,156593892,VNKA01007527.1,1,5598,3.57485e-05,143813506,0.918385
D.birchii,156593892,VNKA01003503.1,1,5597,3.57421e-05,143819103,0.918421
D.birchii,156593892,VNKA01004322.1,1,5593,3.57166e-05,143824696,0.918457
D.birchii,156593892,VNKA01007328.1,1,5591,3.57038e-05,143830287,0.918492
D.birchii,156593892,VNKA01005636.1,1,5586,3.56719e-05,143835873,0.918528
D.birchii,156593892,VNKA01000687.1,1,5583,3.56527e-05,143841456,0.918564
D.birchii,156593892,VNKA01007336.1,1,5580,3.56336e-05,143847036,0.918599
D.birchii,156593892,VNKA01006334.1,1,5580,3.56336e-05,143852616,0.918635
D.birchii,156593892,VNKA01007127.1,1,5577,3.56144e-05,143858193,0.918671
D.birchii,156593892,VNKA01006576.1,1,5576,3.5608e-05,143863769,0.918706
D.birchii,156593892,VNKA01004048.1,1,5569,3.55633e-05,143869338,0.918742
D.birchii,156593892,VNKA01003743.1,1,5569,3.55633e-05,143874907,0.918777
D.birchii,156593892,VNKA01005206.1,1,5561,3.55122e-05,143880468,0.918813
D.birchii,156593892,VNKA01005291.1,1,5560,3.55059e-05,143886028,0.918848
D.birchii,156593892,VNKA01004206.1,1,5553,3.54612e-05,143891581,0.918884
D.birchii,156593892,VNKA01001810.1,1,5553,3.54612e-05,143897134,0.918919
D.birchii,156593892,VNKA01001083.1,1,5550,3.5442e-05,143902684,0.918955
D.birchii,156593892,VNKA01003682.1,1,5547,3.54228e-05,143908231,0.91899
D.birchii,156593892,VNKA01000237.1,1,5547,3.54228e-05,143913778,0.919025
D.birchii,156593892,VNKA01002254.1,1,5546,3.54165e-05,143919324,0.919061
D.birchii,156593892,VNKA01006144.1,1,5545,3.54101e-05,143924869,0.919096
D.birchii,156593892,VNKA01002716.1,1,5544,3.54037e-05,143930413,0.919132
D.birchii,156593892,VNKA01006063.1,1,5538,3.53654e-05,143935951,0.919167
D.birchii,156593892,VNKA01002534.1,1,5535,3.53462e-05,143941486,0.919202
D.birchii,156593892,VNKA01007433.1,1,5533,3.53334e-05,143947019,0.919238
D.birchii,156593892,VNKA01001217.1,1,5532,3.5327e-05,143952551,0.919273
D.birchii,156593892,VNKA01001770.1,1,5531,3.53207e-05,143958082,0.919308
D.birchii,156593892,VNKA01001043.1,1,5526,3.52887e-05,143963608,0.919344
D.birchii,156593892,VNKA01002476.1,1,5515,3.52185e-05,143969123,0.919379
D.birchii,156593892,VNKA01003944.1,1,5513,3.52057e-05,143974636,0.919414
D.birchii,156593892,VNKA01002919.1,1,5512,3.51993e-05,143980148,0.919449
D.birchii,156593892,VNKA01007491.1,1,5511,3.51929e-05,143985659,0.919485
D.birchii,156593892,VNKA01006236.1,1,5510,3.51866e-05,143991169,0.91952
D.birchii,156593892,VNKA01003980.1,1,5509,3.51802e-05,143996678,0.919555
D.birchii,156593892,VNKA01003350.1,1,5506,3.5161e-05,144002184,0.91959
D.birchii,156593892,VNKA01000014.1,1,5502,3.51355e-05,144007686,0.919625
D.birchii,156593892,VNKA01007049.1,1,5500,3.51227e-05,144013186,0.91966
D.birchii,156593892,VNKA01004938.1,1,5497,3.51035e-05,144018683,0.919695
D.birchii,156593892,VNKA01001587.1,1,5489,3.50525e-05,144024172,0.91973
D.birchii,156593892,VNKA01004311.1,1,5480,3.4995e-05,144029652,0.919765
D.birchii,156593892,VNKA01003621.1,1,5479,3.49886e-05,144035131,0.9198
D.birchii,156593892,VNKA01003200.1,1,5474,3.49567e-05,144040605,0.919835
D.birchii,156593892,VNKA01005858.1,1,5472,3.49439e-05,144046077,0.91987
D.birchii,156593892,VNKA01004617.1,1,5470,3.49311e-05,144051547,0.919905
D.birchii,156593892,VNKA01007152.1,1,5466,3.49056e-05,144057013,0.91994
D.birchii,156593892,VNKA01006440.1,1,5465,3.48992e-05,144062478,0.919975
D.birchii,156593892,VNKA01000525.1,1,5465,3.48992e-05,144067943,0.92001
D.birchii,156593892,VNKA01000046.1,1,5462,3.488e-05,144073405,0.920045
D.birchii,156593892,VNKA01002178.1,1,5461,3.48736e-05,144078866,0.92008
D.birchii,156593892,VNKA01005048.1,1,5458,3.48545e-05,144084324,0.920115
D.birchii,156593892,VNKA01004241.1,1,5456,3.48417e-05,144089780,0.920149
D.birchii,156593892,VNKA01006098.1,1,5454,3.48289e-05,144095234,0.920184
D.birchii,156593892,VNKA01007564.1,1,5453,3.48226e-05,144100687,0.920219
D.birchii,156593892,VNKA01006951.1,1,5450,3.48034e-05,144106137,0.920254
D.birchii,156593892,VNKA01004688.1,1,5444,3.47651e-05,144111581,0.920289
D.birchii,156593892,VNKA01004372.1,1,5442,3.47523e-05,144117023,0.920323
D.birchii,156593892,VNKA01003112.1,1,5442,3.47523e-05,144122465,0.920358
D.birchii,156593892,VNKA01002424.1,1,5435,3.47076e-05,144127900,0.920393
D.birchii,156593892,VNKA01002752.1,1,5433,3.46948e-05,144133333,0.920428
D.birchii,156593892,VNKA01002115.1,1,5428,3.46629e-05,144138761,0.920462
D.birchii,156593892,VNKA01005336.1,1,5425,3.46438e-05,144144186,0.920497
D.birchii,156593892,VNKA01001696.1,1,5425,3.46438e-05,144149611,0.920532
D.birchii,156593892,VNKA01006393.1,1,5423,3.4631e-05,144155034,0.920566
D.birchii,156593892,VNKA01006282.1,1,5423,3.4631e-05,144160457,0.920601
D.birchii,156593892,VNKA01001386.1,1,5421,3.46182e-05,144165878,0.920635
D.birchii,156593892,VNKA01002915.1,1,5418,3.45991e-05,144171296,0.92067
D.birchii,156593892,VNKA01005486.1,1,5414,3.45735e-05,144176710,0.920705
D.birchii,156593892,VNKA01003168.1,1,5414,3.45735e-05,144182124,0.920739
D.birchii,156593892,VNKA01002456.1,1,5412,3.45607e-05,144187536,0.920774
D.birchii,156593892,VNKA01000729.1,1,5408,3.45352e-05,144192944,0.920808
D.birchii,156593892,VNKA01005236.1,1,5407,3.45288e-05,144198351,0.920843
D.birchii,156593892,VNKA01000484.1,1,5406,3.45224e-05,144203757,0.920877
D.birchii,156593892,VNKA01004308.1,1,5405,3.4516e-05,144209162,0.920912
D.birchii,156593892,VNKA01005093.1,1,5404,3.45096e-05,144214566,0.920946
D.birchii,156593892,VNKA01007282.1,1,5403,3.45033e-05,144219969,0.920981
D.birchii,156593892,VNKA01005406.1,1,5402,3.44969e-05,144225371,0.921015
D.birchii,156593892,VNKA01003098.1,1,5402,3.44969e-05,144230773,0.92105
D.birchii,156593892,VNKA01007318.1,1,5393,3.44394e-05,144236166,0.921084
D.birchii,156593892,VNKA01007560.1,1,5391,3.44266e-05,144241557,0.921119
D.birchii,156593892,VNKA01001639.1,1,5391,3.44266e-05,144246948,0.921153
D.birchii,156593892,VNKA01002705.1,1,5388,3.44075e-05,144252336,0.921188
D.birchii,156593892,VNKA01002301.1,1,5388,3.44075e-05,144257724,0.921222
D.birchii,156593892,VNKA01007159.1,1,5387,3.44011e-05,144263111,0.921256
D.birchii,156593892,VNKA01001357.1,1,5385,3.43883e-05,144268496,0.921291
D.birchii,156593892,VNKA01002533.1,1,5378,3.43436e-05,144273874,0.921325
D.birchii,156593892,VNKA01001621.1,1,5374,3.43181e-05,144279248,0.921359
D.birchii,156593892,VNKA01000214.1,1,5362,3.42414e-05,144284610,0.921394
D.birchii,156593892,VNKA01003435.1,1,5358,3.42159e-05,144289968,0.921428
D.birchii,156593892,VNKA01007367.1,1,5354,3.41904e-05,144295322,0.921462
D.birchii,156593892,VNKA01007408.1,1,5352,3.41776e-05,144300674,0.921496
D.birchii,156593892,VNKA01002556.1,1,5350,3.41648e-05,144306024,0.92153
D.birchii,156593892,VNKA01005284.1,1,5346,3.41393e-05,144311370,0.921564
D.birchii,156593892,VNKA01000976.1,1,5345,3.41329e-05,144316715,0.921599
D.birchii,156593892,VNKA01006358.1,1,5344,3.41265e-05,144322059,0.921633
D.birchii,156593892,VNKA01003560.1,1,5343,3.41201e-05,144327402,0.921667
D.birchii,156593892,VNKA01002226.1,1,5341,3.41073e-05,144332743,0.921701
D.birchii,156593892,VNKA01003143.1,1,5337,3.40818e-05,144338080,0.921735
D.birchii,156593892,VNKA01001148.1,1,5334,3.40626e-05,144343414,0.921769
D.birchii,156593892,VNKA01001214.1,1,5326,3.40115e-05,144348740,0.921803
D.birchii,156593892,VNKA01003209.1,1,5322,3.3986e-05,144354062,0.921837
D.birchii,156593892,VNKA01006313.1,1,5321,3.39796e-05,144359383,0.921871
D.birchii,156593892,VNKA01004846.1,1,5320,3.39732e-05,144364703,0.921905
D.birchii,156593892,VNKA01000043.1,1,5320,3.39732e-05,144370023,0.921939
D.birchii,156593892,VNKA01000668.1,1,5313,3.39285e-05,144375336,0.921973
D.birchii,156593892,VNKA01001135.1,1,5312,3.39221e-05,144380648,0.922007
D.birchii,156593892,VNKA01006460.1,1,5309,3.3903e-05,144385957,0.922041
D.birchii,156593892,VNKA01002015.1,1,5304,3.38711e-05,144391261,0.922075
D.birchii,156593892,VNKA01001702.1,1,5301,3.38519e-05,144396562,0.922109
D.birchii,156593892,VNKA01005728.1,1,5299,3.38391e-05,144401861,0.922142
D.birchii,156593892,VNKA01003107.1,1,5295,3.38136e-05,144407156,0.922176
D.birchii,156593892,VNKA01000889.1,1,5295,3.38136e-05,144412451,0.92221
D.birchii,156593892,VNKA01001762.1,1,5294,3.38072e-05,144417745,0.922244
D.birchii,156593892,VNKA01007397.1,1,5293,3.38008e-05,144423038,0.922278
D.birchii,156593892,VNKA01001534.1,1,5292,3.37944e-05,144428330,0.922311
D.birchii,156593892,VNKA01003195.1,1,5289,3.37753e-05,144433619,0.922345
D.birchii,156593892,VNKA01001199.1,1,5287,3.37625e-05,144438906,0.922379
D.birchii,156593892,VNKA01004441.1,1,5286,3.37561e-05,144444192,0.922413
D.birchii,156593892,VNKA01003606.1,1,5284,3.37433e-05,144449476,0.922446
D.birchii,156593892,VNKA01002489.1,1,5275,3.36859e-05,144454751,0.92248
D.birchii,156593892,VNKA01002007.1,1,5274,3.36795e-05,144460025,0.922514
D.birchii,156593892,VNKA01000795.1,1,5274,3.36795e-05,144465299,0.922547
D.birchii,156593892,VNKA01000163.1,1,5274,3.36795e-05,144470573,0.922581
D.birchii,156593892,VNKA01001854.1,1,5273,3.36731e-05,144475846,0.922615
D.birchii,156593892,VNKA01005134.1,1,5272,3.36667e-05,144481118,0.922648
D.birchii,156593892,VNKA01006167.1,1,5270,3.36539e-05,144486388,0.922682
D.birchii,156593892,VNKA01001277.1,1,5269,3.36475e-05,144491657,0.922716
D.birchii,156593892,VNKA01005098.1,1,5268,3.36412e-05,144496925,0.922749
D.birchii,156593892,VNKA01004424.1,1,5264,3.36156e-05,144502189,0.922783
D.birchii,156593892,VNKA01005906.1,1,5261,3.35965e-05,144507450,0.922817
D.birchii,156593892,VNKA01004386.1,1,5261,3.35965e-05,144512711,0.92285
D.birchii,156593892,VNKA01005614.1,1,5253,3.35454e-05,144517964,0.922884
D.birchii,156593892,VNKA01003251.1,1,5250,3.35262e-05,144523214,0.922917
D.birchii,156593892,VNKA01001678.1,1,5248,3.35134e-05,144528462,0.922951
D.birchii,156593892,VNKA01002255.1,1,5247,3.35071e-05,144533709,0.922984
D.birchii,156593892,VNKA01003985.1,1,5243,3.34815e-05,144538952,0.923018
D.birchii,156593892,VNKA01003012.1,1,5241,3.34687e-05,144544193,0.923051
D.birchii,156593892,VNKA01004956.1,1,5237,3.34432e-05,144549430,0.923085
D.birchii,156593892,VNKA01004295.1,1,5235,3.34304e-05,144554665,0.923118
D.birchii,156593892,VNKA01002238.1,1,5234,3.3424e-05,144559899,0.923152
D.birchii,156593892,VNKA01005610.1,1,5231,3.34049e-05,144565130,0.923185
D.birchii,156593892,VNKA01006987.1,1,5229,3.33921e-05,144570359,0.923218
D.birchii,156593892,VNKA01004390.1,1,5227,3.33793e-05,144575586,0.923252
D.birchii,156593892,VNKA01000676.1,1,5227,3.33793e-05,144580813,0.923285
D.birchii,156593892,VNKA01006279.1,1,5226,3.33729e-05,144586039,0.923319
D.birchii,156593892,VNKA01004242.1,1,5223,3.33538e-05,144591262,0.923352
D.birchii,156593892,VNKA01000406.1,1,5221,3.3341e-05,144596483,0.923385
D.birchii,156593892,VNKA01004375.1,1,5218,3.33219e-05,144601701,0.923419
D.birchii,156593892,VNKA01006982.1,1,5217,3.33155e-05,144606918,0.923452
D.birchii,156593892,VNKA01001158.1,1,5215,3.33027e-05,144612133,0.923485
D.birchii,156593892,VNKA01006461.1,1,5210,3.32708e-05,144617343,0.923518
D.birchii,156593892,VNKA01007493.1,1,5205,3.32388e-05,144622548,0.923552
D.birchii,156593892,VNKA01003545.1,1,5204,3.32325e-05,144627752,0.923585
D.birchii,156593892,VNKA01000746.1,1,5202,3.32197e-05,144632954,0.923618
D.birchii,156593892,VNKA01000282.1,1,5197,3.31878e-05,144638151,0.923651
D.birchii,156593892,VNKA01003206.1,1,5196,3.31814e-05,144643347,0.923684
D.birchii,156593892,VNKA01000418.1,1,5196,3.31814e-05,144648543,0.923718
D.birchii,156593892,VNKA01007014.1,1,5195,3.3175e-05,144653738,0.923751
D.birchii,156593892,VNKA01004811.1,1,5195,3.3175e-05,144658933,0.923784
D.birchii,156593892,VNKA01002802.1,1,5194,3.31686e-05,144664127,0.923817
D.birchii,156593892,VNKA01004919.1,1,5193,3.31622e-05,144669320,0.92385
D.birchii,156593892,VNKA01001627.1,1,5188,3.31303e-05,144674508,0.923883
D.birchii,156593892,VNKA01005752.1,1,5184,3.31047e-05,144679692,0.923917
D.birchii,156593892,VNKA01002329.1,1,5184,3.31047e-05,144684876,0.92395
D.birchii,156593892,VNKA01003056.1,1,5180,3.30792e-05,144690056,0.923983
D.birchii,156593892,VNKA01004550.1,1,5179,3.30728e-05,144695235,0.924016
D.birchii,156593892,VNKA01003252.1,1,5175,3.30473e-05,144700410,0.924049
D.birchii,156593892,VNKA01002957.1,1,5173,3.30345e-05,144705583,0.924082
D.birchii,156593892,VNKA01003189.1,1,5169,3.3009e-05,144710752,0.924115
D.birchii,156593892,VNKA01002014.1,1,5168,3.30026e-05,144715920,0.924148
D.birchii,156593892,VNKA01001544.1,1,5167,3.29962e-05,144721087,0.924181
D.birchii,156593892,VNKA01003684.1,1,5164,3.2977e-05,144726251,0.924214
D.birchii,156593892,VNKA01001443.1,1,5163,3.29706e-05,144731414,0.924247
D.birchii,156593892,VNKA01006316.1,1,5160,3.29515e-05,144736574,0.92428
D.birchii,156593892,VNKA01001415.1,1,5155,3.29195e-05,144741729,0.924313
D.birchii,156593892,VNKA01002351.1,1,5154,3.29132e-05,144746883,0.924346
D.birchii,156593892,VNKA01002549.1,1,5152,3.29004e-05,144752035,0.924379
D.birchii,156593892,VNKA01002172.1,1,5152,3.29004e-05,144757187,0.924411
D.birchii,156593892,VNKA01001046.1,1,5142,3.28365e-05,144762329,0.924444
D.birchii,156593892,VNKA01004966.1,1,5141,3.28301e-05,144767470,0.924477
D.birchii,156593892,VNKA01002567.1,1,5141,3.28301e-05,144772611,0.92451
D.birchii,156593892,VNKA01006901.1,1,5135,3.27918e-05,144777746,0.924543
D.birchii,156593892,VNKA01001461.1,1,5135,3.27918e-05,144782881,0.924576
D.birchii,156593892,VNKA01001491.1,1,5134,3.27854e-05,144788015,0.924608
D.birchii,156593892,VNKA01003816.1,1,5133,3.27791e-05,144793148,0.924641
D.birchii,156593892,VNKA01001393.1,1,5132,3.27727e-05,144798280,0.924674
D.birchii,156593892,VNKA01004368.1,1,5130,3.27599e-05,144803410,0.924707
D.birchii,156593892,VNKA01001103.1,1,5129,3.27535e-05,144808539,0.924739
D.birchii,156593892,VNKA01000483.1,1,5128,3.27471e-05,144813667,0.924772
D.birchii,156593892,VNKA01003876.1,1,5126,3.27344e-05,144818793,0.924805
D.birchii,156593892,VNKA01000495.1,1,5125,3.2728e-05,144823918,0.924838
D.birchii,156593892,VNKA01006663.1,1,5123,3.27152e-05,144829041,0.92487
D.birchii,156593892,VNKA01001459.1,1,5123,3.27152e-05,144834164,0.924903
D.birchii,156593892,VNKA01005647.1,1,5121,3.27024e-05,144839285,0.924936
D.birchii,156593892,VNKA01004444.1,1,5121,3.27024e-05,144844406,0.924968
D.birchii,156593892,VNKA01003052.1,1,5120,3.2696e-05,144849526,0.925001
D.birchii,156593892,VNKA01001683.1,1,5120,3.2696e-05,144854646,0.925034
D.birchii,156593892,VNKA01007325.1,1,5117,3.26769e-05,144859763,0.925066
D.birchii,156593892,VNKA01006762.1,1,5114,3.26577e-05,144864877,0.925099
D.birchii,156593892,VNKA01006567.1,1,5113,3.26513e-05,144869990,0.925132
D.birchii,156593892,VNKA01001438.1,1,5113,3.26513e-05,144875103,0.925164
D.birchii,156593892,VNKA01005220.1,1,5110,3.26322e-05,144880213,0.925197
D.birchii,156593892,VNKA01006162.1,1,5108,3.26194e-05,144885321,0.92523
D.birchii,156593892,VNKA01005288.1,1,5107,3.2613e-05,144890428,0.925262
D.birchii,156593892,VNKA01003184.1,1,5107,3.2613e-05,144895535,0.925295
D.birchii,156593892,VNKA01005952.1,1,5106,3.26066e-05,144900641,0.925328
D.birchii,156593892,VNKA01003525.1,1,5106,3.26066e-05,144905747,0.92536
D.birchii,156593892,VNKA01000115.1,1,5106,3.26066e-05,144910853,0.925393
D.birchii,156593892,VNKA01001842.1,1,5104,3.25939e-05,144915957,0.925425
D.birchii,156593892,VNKA01000281.1,1,5098,3.25555e-05,144921055,0.925458
D.birchii,156593892,VNKA01004477.1,1,5097,3.25492e-05,144926152,0.92549
D.birchii,156593892,VNKA01005213.1,1,5096,3.25428e-05,144931248,0.925523
D.birchii,156593892,VNKA01000712.1,1,5096,3.25428e-05,144936344,0.925556
D.birchii,156593892,VNKA01005412.1,1,5083,3.24598e-05,144941427,0.925588
D.birchii,156593892,VNKA01000610.1,1,5080,3.24406e-05,144946507,0.92562
D.birchii,156593892,VNKA01003259.1,1,5077,3.24214e-05,144951584,0.925653
D.birchii,156593892,VNKA01001298.1,1,5075,3.24087e-05,144956659,0.925685
D.birchii,156593892,VNKA01002544.1,1,5074,3.24023e-05,144961733,0.925718
D.birchii,156593892,VNKA01003392.1,1,5072,3.23895e-05,144966805,0.92575
D.birchii,156593892,VNKA01004355.1,1,5071,3.23831e-05,144971876,0.925782
D.birchii,156593892,VNKA01000518.1,1,5069,3.23704e-05,144976945,0.925815
D.birchii,156593892,VNKA01001840.1,1,5065,3.23448e-05,144982010,0.925847
D.birchii,156593892,VNKA01003407.1,1,5063,3.2332e-05,144987073,0.925879
D.birchii,156593892,VNKA01007020.1,1,5062,3.23257e-05,144992135,0.925912
D.birchii,156593892,VNKA01002421.1,1,5062,3.23257e-05,144997197,0.925944
D.birchii,156593892,VNKA01004445.1,1,5059,3.23065e-05,145002256,0.925976
D.birchii,156593892,VNKA01001044.1,1,5059,3.23065e-05,145007315,0.926009
D.birchii,156593892,VNKA01000903.1,1,5058,3.23001e-05,145012373,0.926041
D.birchii,156593892,VNKA01001405.1,1,5056,3.22873e-05,145017429,0.926073
D.birchii,156593892,VNKA01003282.1,1,5052,3.22618e-05,145022481,0.926106
D.birchii,156593892,VNKA01004438.1,1,5049,3.22426e-05,145027530,0.926138
D.birchii,156593892,VNKA01002878.1,1,5041,3.21915e-05,145032571,0.92617
D.birchii,156593892,VNKA01004328.1,1,5034,3.21468e-05,145037605,0.926202
D.birchii,156593892,VNKA01001515.1,1,5032,3.21341e-05,145042637,0.926234
D.birchii,156593892,VNKA01007445.1,1,5028,3.21085e-05,145047665,0.926266
D.birchii,156593892,VNKA01003757.1,1,5028,3.21085e-05,145052693,0.926299
D.birchii,156593892,VNKA01000747.1,1,5022,3.20702e-05,145057715,0.926331
D.birchii,156593892,VNKA01003672.1,1,5019,3.20511e-05,145062734,0.926363
D.birchii,156593892,VNKA01000047.1,1,5017,3.20383e-05,145067751,0.926395
D.birchii,156593892,VNKA01002426.1,1,5012,3.20064e-05,145072763,0.926427
D.birchii,156593892,VNKA01007382.1,1,5011,3.2e-05,145077774,0.926459
D.birchii,156593892,VNKA01004879.1,1,5003,3.19489e-05,145082777,0.926491
D.birchii,156593892,VNKA01003998.1,1,5001,3.19361e-05,145087778,0.926523
D.birchii,156593892,VNKA01000945.1,1,5001,3.19361e-05,145092779,0.926555
D.birchii,156593892,VNKA01006573.1,1,4999,3.19233e-05,145097778,0.926586
D.birchii,156593892,VNKA01001447.1,1,4998,3.1917e-05,145102776,0.926618
D.birchii,156593892,VNKA01002841.1,1,4997,3.19106e-05,145107773,0.92665
D.birchii,156593892,VNKA01000044.1,1,4994,3.18914e-05,145112767,0.926682
D.birchii,156593892,VNKA01006257.1,1,4993,3.1885e-05,145117760,0.926714
D.birchii,156593892,VNKA01001987.1,1,4993,3.1885e-05,145122753,0.926746
D.birchii,156593892,VNKA01006783.1,1,4987,3.18467e-05,145127740,0.926778
D.birchii,156593892,VNKA01007426.1,1,4985,3.18339e-05,145132725,0.92681
D.birchii,156593892,VNKA01006206.1,1,4982,3.18148e-05,145137707,0.926841
D.birchii,156593892,VNKA01005898.1,1,4982,3.18148e-05,145142689,0.926873
D.birchii,156593892,VNKA01004221.1,1,4982,3.18148e-05,145147671,0.926905
D.birchii,156593892,VNKA01007334.1,1,4981,3.18084e-05,145152652,0.926937
D.birchii,156593892,VNKA01000439.1,1,4979,3.17956e-05,145157631,0.926969
D.birchii,156593892,VNKA01005911.1,1,4978,3.17892e-05,145162609,0.927
D.birchii,156593892,VNKA01001835.1,1,4976,3.17765e-05,145167585,0.927032
D.birchii,156593892,VNKA01006898.1,1,4973,3.17573e-05,145172558,0.927064
D.birchii,156593892,VNKA01006792.1,1,4973,3.17573e-05,145177531,0.927096
D.birchii,156593892,VNKA01004145.1,1,4973,3.17573e-05,145182504,0.927128
D.birchii,156593892,VNKA01000150.1,1,4972,3.17509e-05,145187476,0.927159
D.birchii,156593892,VNKA01004053.1,1,4971,3.17445e-05,145192447,0.927191
D.birchii,156593892,VNKA01000122.1,1,4969,3.17318e-05,145197416,0.927223
D.birchii,156593892,VNKA01006745.1,1,4965,3.17062e-05,145202381,0.927254
D.birchii,156593892,VNKA01001369.1,1,4962,3.16871e-05,145207343,0.927286
D.birchii,156593892,VNKA01005105.1,1,4959,3.16679e-05,145212302,0.927318
D.birchii,156593892,VNKA01003681.1,1,4956,3.16487e-05,145217258,0.927349
D.birchii,156593892,VNKA01006232.1,1,4953,3.16296e-05,145222211,0.927381
D.birchii,156593892,VNKA01000409.1,1,4953,3.16296e-05,145227164,0.927413
D.birchii,156593892,VNKA01000791.1,1,4952,3.16232e-05,145232116,0.927444
D.birchii,156593892,VNKA01006505.1,1,4950,3.16104e-05,145237066,0.927476
D.birchii,156593892,VNKA01003302.1,1,4950,3.16104e-05,145242016,0.927508
D.birchii,156593892,VNKA01000907.1,1,4949,3.1604e-05,145246965,0.927539
D.birchii,156593892,VNKA01000877.1,1,4944,3.15721e-05,145251909,0.927571
D.birchii,156593892,VNKA01004345.1,1,4943,3.15657e-05,145256852,0.927602
D.birchii,156593892,VNKA01002863.1,1,4943,3.15657e-05,145261795,0.927634
D.birchii,156593892,VNKA01007425.1,1,4942,3.15593e-05,145266737,0.927665
D.birchii,156593892,VNKA01002350.1,1,4936,3.1521e-05,145271673,0.927697
D.birchii,156593892,VNKA01005273.1,1,4933,3.15019e-05,145276606,0.927728
D.birchii,156593892,VNKA01001523.1,1,4930,3.14827e-05,145281536,0.92776
D.birchii,156593892,VNKA01001361.1,1,4930,3.14827e-05,145286466,0.927791
D.birchii,156593892,VNKA01005520.1,1,4928,3.14699e-05,145291394,0.927823
D.birchii,156593892,VNKA01003395.1,1,4923,3.1438e-05,145296317,0.927854
D.birchii,156593892,VNKA01006014.1,1,4922,3.14316e-05,145301239,0.927886
D.birchii,156593892,VNKA01000161.1,1,4920,3.14188e-05,145306159,0.927917
D.birchii,156593892,VNKA01004820.1,1,4918,3.14061e-05,145311077,0.927949
D.birchii,156593892,VNKA01004218.1,1,4918,3.14061e-05,145315995,0.92798
D.birchii,156593892,VNKA01000896.1,1,4918,3.14061e-05,145320913,0.928011
D.birchii,156593892,VNKA01006290.1,1,4916,3.13933e-05,145325829,0.928043
D.birchii,156593892,VNKA01004313.1,1,4914,3.13805e-05,145330743,0.928074
D.birchii,156593892,VNKA01007241.1,1,4911,3.13614e-05,145335654,0.928106
D.birchii,156593892,VNKA01006463.1,1,4906,3.13294e-05,145340560,0.928137
D.birchii,156593892,VNKA01005022.1,1,4906,3.13294e-05,145345466,0.928168
D.birchii,156593892,VNKA01006351.1,1,4900,3.12911e-05,145350366,0.928199
D.birchii,156593892,VNKA01003974.1,1,4896,3.12656e-05,145355262,0.928231
D.birchii,156593892,VNKA01003687.1,1,4896,3.12656e-05,145360158,0.928262
D.birchii,156593892,VNKA01001832.1,1,4894,3.12528e-05,145365052,0.928293
D.birchii,156593892,VNKA01001178.1,1,4885,3.11953e-05,145369937,0.928324
D.birchii,156593892,VNKA01007370.1,1,4884,3.1189e-05,145374821,0.928356
D.birchii,156593892,VNKA01004275.1,1,4884,3.1189e-05,145379705,0.928387
D.birchii,156593892,VNKA01003880.1,1,4884,3.1189e-05,145384589,0.928418
D.birchii,156593892,VNKA01003449.1,1,4879,3.1157e-05,145389468,0.928449
D.birchii,156593892,VNKA01001514.1,1,4876,3.11379e-05,145394344,0.92848
D.birchii,156593892,VNKA01003883.1,1,4871,3.11059e-05,145399215,0.928511
D.birchii,156593892,VNKA01005274.1,1,4868,3.10868e-05,145404083,0.928542
D.birchii,156593892,VNKA01005899.1,1,4867,3.10804e-05,145408950,0.928574
D.birchii,156593892,VNKA01006678.1,1,4866,3.1074e-05,145413816,0.928605
D.birchii,156593892,VNKA01004694.1,1,4862,3.10485e-05,145418678,0.928636
D.birchii,156593892,VNKA01001150.1,1,4861,3.10421e-05,145423539,0.928667
D.birchii,156593892,VNKA01003877.1,1,4860,3.10357e-05,145428399,0.928698
D.birchii,156593892,VNKA01007312.1,1,4855,3.10038e-05,145433254,0.928729
D.birchii,156593892,VNKA01001914.1,1,4855,3.10038e-05,145438109,0.92876
D.birchii,156593892,VNKA01000960.1,1,4852,3.09846e-05,145442961,0.928791
D.birchii,156593892,VNKA01006457.1,1,4851,3.09782e-05,145447812,0.928822
D.birchii,156593892,VNKA01004905.1,1,4850,3.09718e-05,145452662,0.928853
D.birchii,156593892,VNKA01001673.1,1,4850,3.09718e-05,145457512,0.928884
D.birchii,156593892,VNKA01003991.1,1,4842,3.09207e-05,145462354,0.928915
D.birchii,156593892,VNKA01002699.1,1,4841,3.09144e-05,145467195,0.928946
D.birchii,156593892,VNKA01004782.1,1,4839,3.09016e-05,145472034,0.928976
D.birchii,156593892,VNKA01002682.1,1,4836,3.08824e-05,145476870,0.929007
D.birchii,156593892,VNKA01000547.1,1,4831,3.08505e-05,145481701,0.929038
D.birchii,156593892,VNKA01006241.1,1,4830,3.08441e-05,145486531,0.929069
D.birchii,156593892,VNKA01002991.1,1,4826,3.08186e-05,145491357,0.9291
D.birchii,156593892,VNKA01006086.1,1,4822,3.0793e-05,145496179,0.929131
D.birchii,156593892,VNKA01002886.1,1,4821,3.07866e-05,145501000,0.929161
D.birchii,156593892,VNKA01001351.1,1,4821,3.07866e-05,145505821,0.929192
D.birchii,156593892,VNKA01005444.1,1,4820,3.07803e-05,145510641,0.929223
D.birchii,156593892,VNKA01003140.1,1,4819,3.07739e-05,145515460,0.929254
D.birchii,156593892,VNKA01001222.1,1,4818,3.07675e-05,145520278,0.929285
D.birchii,156593892,VNKA01003409.1,1,4817,3.07611e-05,145525095,0.929315
D.birchii,156593892,VNKA01000217.1,1,4814,3.07419e-05,145529909,0.929346
D.birchii,156593892,VNKA01006168.1,1,4813,3.07356e-05,145534722,0.929377
D.birchii,156593892,VNKA01001994.1,1,4813,3.07356e-05,145539535,0.929407
D.birchii,156593892,VNKA01006492.1,1,4811,3.07228e-05,145544346,0.929438
D.birchii,156593892,VNKA01001976.1,1,4811,3.07228e-05,145549157,0.929469
D.birchii,156593892,VNKA01006954.1,1,4798,3.06398e-05,145553955,0.9295
D.birchii,156593892,VNKA01001816.1,1,4797,3.06334e-05,145558752,0.92953
D.birchii,156593892,VNKA01004992.1,1,4793,3.06078e-05,145563545,0.929561
D.birchii,156593892,VNKA01004226.1,1,4785,3.05567e-05,145568330,0.929591
D.birchii,156593892,VNKA01003205.1,1,4785,3.05567e-05,145573115,0.929622
D.birchii,156593892,VNKA01001505.1,1,4780,3.05248e-05,145577895,0.929652
D.birchii,156593892,VNKA01003011.1,1,4772,3.04737e-05,145582667,0.929683
D.birchii,156593892,VNKA01001303.1,1,4772,3.04737e-05,145587439,0.929713
D.birchii,156593892,VNKA01003243.1,1,4771,3.04673e-05,145592210,0.929744
D.birchii,156593892,VNKA01001507.1,1,4769,3.04546e-05,145596979,0.929774
D.birchii,156593892,VNKA01006161.1,1,4766,3.04354e-05,145601745,0.929805
D.birchii,156593892,VNKA01003558.1,1,4764,3.04226e-05,145606509,0.929835
D.birchii,156593892,VNKA01004050.1,1,4763,3.04163e-05,145611272,0.929866
D.birchii,156593892,VNKA01000137.1,1,4760,3.03971e-05,145616032,0.929896
D.birchii,156593892,VNKA01001164.1,1,4759,3.03907e-05,145620791,0.929926
D.birchii,156593892,VNKA01002013.1,1,4758,3.03843e-05,145625549,0.929957
D.birchii,156593892,VNKA01000814.1,1,4755,3.03652e-05,145630304,0.929987
D.birchii,156593892,VNKA01003680.1,1,4753,3.03524e-05,145635057,0.930017
D.birchii,156593892,VNKA01002360.1,1,4751,3.03396e-05,145639808,0.930048
D.birchii,156593892,VNKA01002414.1,1,4750,3.03332e-05,145644558,0.930078
D.birchii,156593892,VNKA01007368.1,1,4746,3.03077e-05,145649304,0.930108
D.birchii,156593892,VNKA01006008.1,1,4746,3.03077e-05,145654050,0.930139
D.birchii,156593892,VNKA01007385.1,1,4745,3.03013e-05,145658795,0.930169
D.birchii,156593892,VNKA01006543.1,1,4744,3.02949e-05,145663539,0.930199
D.birchii,156593892,VNKA01004243.1,1,4744,3.02949e-05,145668283,0.93023
D.birchii,156593892,VNKA01005326.1,1,4743,3.02885e-05,145673026,0.93026
D.birchii,156593892,VNKA01005324.1,1,4738,3.02566e-05,145677764,0.93029
D.birchii,156593892,VNKA01001186.1,1,4738,3.02566e-05,145682502,0.93032
D.birchii,156593892,VNKA01003775.1,1,4735,3.02375e-05,145687237,0.930351
D.birchii,156593892,VNKA01001766.1,1,4734,3.02311e-05,145691971,0.930381
D.birchii,156593892,VNKA01002229.1,1,4733,3.02247e-05,145696704,0.930411
D.birchii,156593892,VNKA01001433.1,1,4732,3.02183e-05,145701436,0.930441
D.birchii,156593892,VNKA01005127.1,1,4717,3.01225e-05,145706153,0.930471
D.birchii,156593892,VNKA01002852.1,1,4717,3.01225e-05,145710870,0.930502
D.birchii,156593892,VNKA01000852.1,1,4712,3.00906e-05,145715582,0.930532
D.birchii,156593892,VNKA01004676.1,1,4711,3.00842e-05,145720293,0.930562
D.birchii,156593892,VNKA01000201.1,1,4710,3.00778e-05,145725003,0.930592
D.birchii,156593892,VNKA01004305.1,1,4706,3.00523e-05,145729709,0.930622
D.birchii,156593892,VNKA01001763.1,1,4705,3.00459e-05,145734414,0.930652
D.birchii,156593892,VNKA01003439.1,1,4703,3.00331e-05,145739117,0.930682
D.birchii,156593892,VNKA01003007.1,1,4702,3.00267e-05,145743819,0.930712
D.birchii,156593892,VNKA01005669.1,1,4701,3.00203e-05,145748520,0.930742
D.birchii,156593892,VNKA01001981.1,1,4697,2.99948e-05,145753217,0.930772
D.birchii,156593892,VNKA01004086.1,1,4693,2.99692e-05,145757910,0.930802
D.birchii,156593892,VNKA01005278.1,1,4691,2.99565e-05,145762601,0.930832
D.birchii,156593892,VNKA01004348.1,1,4691,2.99565e-05,145767292,0.930862
D.birchii,156593892,VNKA01001867.1,1,4687,2.99309e-05,145771979,0.930892
D.birchii,156593892,VNKA01003939.1,1,4682,2.9899e-05,145776661,0.930922
D.birchii,156593892,VNKA01004700.1,1,4680,2.98862e-05,145781341,0.930952
D.birchii,156593892,VNKA01004052.1,1,4680,2.98862e-05,145786021,0.930982
D.birchii,156593892,VNKA01000912.1,1,4678,2.98735e-05,145790699,0.931011
D.birchii,156593892,VNKA01006668.1,1,4677,2.98671e-05,145795376,0.931041
D.birchii,156593892,VNKA01004217.1,1,4676,2.98607e-05,145800052,0.931071
D.birchii,156593892,VNKA01000819.1,1,4675,2.98543e-05,145804727,0.931101
D.birchii,156593892,VNKA01005282.1,1,4668,2.98096e-05,145809395,0.931131
D.birchii,156593892,VNKA01003410.1,1,4667,2.98032e-05,145814062,0.931161
D.birchii,156593892,VNKA01006980.1,1,4666,2.97968e-05,145818728,0.93119
D.birchii,156593892,VNKA01000076.1,1,4665,2.97904e-05,145823393,0.93122
D.birchii,156593892,VNKA01000160.1,1,4663,2.97777e-05,145828056,0.93125
D.birchii,156593892,VNKA01005619.1,1,4662,2.97713e-05,145832718,0.93128
D.birchii,156593892,VNKA01005515.1,1,4659,2.97521e-05,145837377,0.931309
D.birchii,156593892,VNKA01005699.1,1,4656,2.9733e-05,145842033,0.931339
D.birchii,156593892,VNKA01002285.1,1,4655,2.97266e-05,145846688,0.931369
D.birchii,156593892,VNKA01006502.1,1,4654,2.97202e-05,145851342,0.931399
D.birchii,156593892,VNKA01004937.1,1,4650,2.96946e-05,145855992,0.931428
D.birchii,156593892,VNKA01000486.1,1,4649,2.96883e-05,145860641,0.931458
D.birchii,156593892,VNKA01007085.1,1,4647,2.96755e-05,145865288,0.931488
D.birchii,156593892,VNKA01007258.1,1,4646,2.96691e-05,145869934,0.931517
D.birchii,156593892,VNKA01004885.1,1,4643,2.96499e-05,145874577,0.931547
D.birchii,156593892,VNKA01006383.1,1,4641,2.96372e-05,145879218,0.931577
D.birchii,156593892,VNKA01000312.1,1,4641,2.96372e-05,145883859,0.931606
D.birchii,156593892,VNKA01000929.1,1,4640,2.96308e-05,145888499,0.931636
D.birchii,156593892,VNKA01000066.1,1,4640,2.96308e-05,145893139,0.931666
D.birchii,156593892,VNKA01003965.1,1,4639,2.96244e-05,145897778,0.931695
D.birchii,156593892,VNKA01003530.1,1,4639,2.96244e-05,145902417,0.931725
D.birchii,156593892,VNKA01002769.1,1,4639,2.96244e-05,145907056,0.931754
D.birchii,156593892,VNKA01004659.1,1,4635,2.95989e-05,145911691,0.931784
D.birchii,156593892,VNKA01006540.1,1,4632,2.95797e-05,145916323,0.931814
D.birchii,156593892,VNKA01001712.1,1,4629,2.95605e-05,145920952,0.931843
D.birchii,156593892,VNKA01001397.1,1,4629,2.95605e-05,145925581,0.931873
D.birchii,156593892,VNKA01003618.1,1,4623,2.95222e-05,145930204,0.931902
D.birchii,156593892,VNKA01004581.1,1,4622,2.95158e-05,145934826,0.931932
D.birchii,156593892,VNKA01002149.1,1,4620,2.95031e-05,145939446,0.931961
D.birchii,156593892,VNKA01001590.1,1,4615,2.94711e-05,145944061,0.931991
D.birchii,156593892,VNKA01003274.1,1,4609,2.94328e-05,145948670,0.93202
D.birchii,156593892,VNKA01007530.1,1,4607,2.942e-05,145953277,0.93205
D.birchii,156593892,VNKA01006255.1,1,4606,2.94137e-05,145957883,0.932079
D.birchii,156593892,VNKA01002639.1,1,4602,2.93881e-05,145962485,0.932108
D.birchii,156593892,VNKA01006758.1,1,4601,2.93817e-05,145967086,0.932138
D.birchii,156593892,VNKA01004875.1,1,4601,2.93817e-05,145971687,0.932167
D.birchii,156593892,VNKA01006884.1,1,4598,2.93626e-05,145976285,0.932197
D.birchii,156593892,VNKA01007009.1,1,4593,2.93306e-05,145980878,0.932226
D.birchii,156593892,VNKA01004627.1,1,4591,2.93179e-05,145985469,0.932255
D.birchii,156593892,VNKA01000211.1,1,4583,2.92668e-05,145990052,0.932284
D.birchii,156593892,VNKA01002480.1,1,4582,2.92604e-05,145994634,0.932314
D.birchii,156593892,VNKA01001047.1,1,4581,2.9254e-05,145999215,0.932343
D.birchii,156593892,VNKA01001021.1,1,4581,2.9254e-05,146003796,0.932372
D.birchii,156593892,VNKA01007084.1,1,4579,2.92412e-05,146008375,0.932401
D.birchii,156593892,VNKA01000017.1,1,4577,2.92285e-05,146012952,0.932431
D.birchii,156593892,VNKA01005716.1,1,4574,2.92093e-05,146017526,0.93246
D.birchii,156593892,VNKA01006359.1,1,4572,2.91965e-05,146022098,0.932489
D.birchii,156593892,VNKA01005949.1,1,4571,2.91902e-05,146026669,0.932518
D.birchii,156593892,VNKA01002171.1,1,4571,2.91902e-05,146031240,0.932547
D.birchii,156593892,VNKA01000567.1,1,4564,2.91455e-05,146035804,0.932577
D.birchii,156593892,VNKA01004948.1,1,4561,2.91263e-05,146040365,0.932606
D.birchii,156593892,VNKA01004427.1,1,4556,2.90944e-05,146044921,0.932635
D.birchii,156593892,VNKA01005139.1,1,4554,2.90816e-05,146049475,0.932664
D.birchii,156593892,VNKA01004993.1,1,4553,2.90752e-05,146054028,0.932693
D.birchii,156593892,VNKA01001127.1,1,4550,2.90561e-05,146058578,0.932722
D.birchii,156593892,VNKA01001089.1,1,4549,2.90497e-05,146063127,0.932751
D.birchii,156593892,VNKA01004623.1,1,4548,2.90433e-05,146067675,0.93278
D.birchii,156593892,VNKA01004026.1,1,4539,2.89858e-05,146072214,0.932809
D.birchii,156593892,VNKA01001122.1,1,4538,2.89794e-05,146076752,0.932838
D.birchii,156593892,VNKA01001818.1,1,4535,2.89603e-05,146081287,0.932867
D.birchii,156593892,VNKA01005276.1,1,4534,2.89539e-05,146085821,0.932896
D.birchii,156593892,VNKA01001592.1,1,4531,2.89347e-05,146090352,0.932925
D.birchii,156593892,VNKA01006409.1,1,4528,2.89156e-05,146094880,0.932954
D.birchii,156593892,VNKA01001813.1,1,4528,2.89156e-05,146099408,0.932983
D.birchii,156593892,VNKA01006285.1,1,4527,2.89092e-05,146103935,0.933012
D.birchii,156593892,VNKA01000353.1,1,4527,2.89092e-05,146108462,0.933041
D.birchii,156593892,VNKA01003500.1,1,4525,2.88964e-05,146112987,0.93307
D.birchii,156593892,VNKA01006325.1,1,4524,2.889e-05,146117511,0.933098
D.birchii,156593892,VNKA01002257.1,1,4524,2.889e-05,146122035,0.933127
D.birchii,156593892,VNKA01004649.1,1,4523,2.88836e-05,146126558,0.933156
D.birchii,156593892,VNKA01002954.1,1,4520,2.88645e-05,146131078,0.933185
D.birchii,156593892,VNKA01002526.1,1,4520,2.88645e-05,146135598,0.933214
D.birchii,156593892,VNKA01000780.1,1,4519,2.88581e-05,146140117,0.933243
D.birchii,156593892,VNKA01003594.1,1,4518,2.88517e-05,146144635,0.933272
D.birchii,156593892,VNKA01000863.1,1,4518,2.88517e-05,146149153,0.9333
D.birchii,156593892,VNKA01006169.1,1,4517,2.88453e-05,146153670,0.933329
D.birchii,156593892,VNKA01007289.1,1,4516,2.88389e-05,146158186,0.933358
D.birchii,156593892,VNKA01001305.1,1,4516,2.88389e-05,146162702,0.933387
D.birchii,156593892,VNKA01006961.1,1,4514,2.88262e-05,146167216,0.933416
D.birchii,156593892,VNKA01001163.1,1,4512,2.88134e-05,146171728,0.933445
D.birchii,156593892,VNKA01000229.1,1,4506,2.87751e-05,146176234,0.933473
D.birchii,156593892,VNKA01005067.1,1,4505,2.87687e-05,146180739,0.933502
D.birchii,156593892,VNKA01003089.1,1,4500,2.87368e-05,146185239,0.933531
D.birchii,156593892,VNKA01002379.1,1,4500,2.87368e-05,146189739,0.93356
D.birchii,156593892,VNKA01002040.1,1,4498,2.8724e-05,146194237,0.933588
D.birchii,156593892,VNKA01000862.1,1,4498,2.8724e-05,146198735,0.933617
D.birchii,156593892,VNKA01004580.1,1,4493,2.86921e-05,146203228,0.933646
D.birchii,156593892,VNKA01001533.1,1,4493,2.86921e-05,146207721,0.933674
D.birchii,156593892,VNKA01003895.1,1,4486,2.86473e-05,146212207,0.933703
D.birchii,156593892,VNKA01003084.1,1,4486,2.86473e-05,146216693,0.933732
D.birchii,156593892,VNKA01005218.1,1,4484,2.86346e-05,146221177,0.93376
D.birchii,156593892,VNKA01007061.1,1,4482,2.86218e-05,146225659,0.933789
D.birchii,156593892,VNKA01005042.1,1,4482,2.86218e-05,146230141,0.933818
D.birchii,156593892,VNKA01002206.1,1,4477,2.85899e-05,146234618,0.933846
D.birchii,156593892,VNKA01003584.1,1,4475,2.85771e-05,146239093,0.933875
D.birchii,156593892,VNKA01002400.1,1,4475,2.85771e-05,146243568,0.933903
D.birchii,156593892,VNKA01005260.1,1,4474,2.85707e-05,146248042,0.933932
D.birchii,156593892,VNKA01005070.1,1,4468,2.85324e-05,146252510,0.933961
D.birchii,156593892,VNKA01003717.1,1,4461,2.84877e-05,146256971,0.933989
D.birchii,156593892,VNKA01003233.1,1,4461,2.84877e-05,146261432,0.934017
D.birchii,156593892,VNKA01002854.1,1,4459,2.84749e-05,146265891,0.934046
D.birchii,156593892,VNKA01007157.1,1,4457,2.84622e-05,146270348,0.934074
D.birchii,156593892,VNKA01002236.1,1,4457,2.84622e-05,146274805,0.934103
D.birchii,156593892,VNKA01000257.1,1,4455,2.84494e-05,146279260,0.934131
D.birchii,156593892,VNKA01000936.1,1,4451,2.84238e-05,146283711,0.93416
D.birchii,156593892,VNKA01007188.1,1,4443,2.83728e-05,146288154,0.934188
D.birchii,156593892,VNKA01006924.1,1,4443,2.83728e-05,146292597,0.934216
D.birchii,156593892,VNKA01004216.1,1,4442,2.83664e-05,146297039,0.934245
D.birchii,156593892,VNKA01001201.1,1,4439,2.83472e-05,146301478,0.934273
D.birchii,156593892,VNKA01001857.1,1,4437,2.83344e-05,146305915,0.934302
D.birchii,156593892,VNKA01001677.1,1,4436,2.83281e-05,146310351,0.93433
D.birchii,156593892,VNKA01000492.1,1,4435,2.83217e-05,146314786,0.934358
D.birchii,156593892,VNKA01006666.1,1,4431,2.82961e-05,146319217,0.934386
D.birchii,156593892,VNKA01005191.1,1,4430,2.82897e-05,146323647,0.934415
D.birchii,156593892,VNKA01004276.1,1,4429,2.82834e-05,146328076,0.934443
D.birchii,156593892,VNKA01000106.1,1,4429,2.82834e-05,146332505,0.934471
D.birchii,156593892,VNKA01000764.1,1,4426,2.82642e-05,146336931,0.9345
D.birchii,156593892,VNKA01001558.1,1,4425,2.82578e-05,146341356,0.934528
D.birchii,156593892,VNKA01000316.1,1,4424,2.82514e-05,146345780,0.934556
D.birchii,156593892,VNKA01004257.1,1,4419,2.82195e-05,146350199,0.934584
D.birchii,156593892,VNKA01007383.1,1,4417,2.82067e-05,146354616,0.934613
D.birchii,156593892,VNKA01000057.1,1,4417,2.82067e-05,146359033,0.934641
D.birchii,156593892,VNKA01003349.1,1,4414,2.81876e-05,146363447,0.934669
D.birchii,156593892,VNKA01004118.1,1,4413,2.81812e-05,146367860,0.934697
D.birchii,156593892,VNKA01000116.1,1,4413,2.81812e-05,146372273,0.934725
D.birchii,156593892,VNKA01004459.1,1,4412,2.81748e-05,146376685,0.934753
D.birchii,156593892,VNKA01003566.1,1,4412,2.81748e-05,146381097,0.934782
D.birchii,156593892,VNKA01004365.1,1,4411,2.81684e-05,146385508,0.93481
D.birchii,156593892,VNKA01004398.1,1,4410,2.8162e-05,146389918,0.934838
D.birchii,156593892,VNKA01002626.1,1,4408,2.81492e-05,146394326,0.934866
D.birchii,156593892,VNKA01005405.1,1,4406,2.81365e-05,146398732,0.934894
D.birchii,156593892,VNKA01006314.1,1,4405,2.81301e-05,146403137,0.934922
D.birchii,156593892,VNKA01006539.1,1,4403,2.81173e-05,146407540,0.934951
D.birchii,156593892,VNKA01003099.1,1,4402,2.81109e-05,146411942,0.934979
D.birchii,156593892,VNKA01002220.1,1,4399,2.80918e-05,146416341,0.935007
D.birchii,156593892,VNKA01000566.1,1,4395,2.80662e-05,146420736,0.935035
D.birchii,156593892,VNKA01007333.1,1,4390,2.80343e-05,146425126,0.935063
D.birchii,156593892,VNKA01004848.1,1,4386,2.80088e-05,146429512,0.935091
D.birchii,156593892,VNKA01006252.1,1,4385,2.80024e-05,146433897,0.935119
D.birchii,156593892,VNKA01004195.1,1,4384,2.7996e-05,146438281,0.935147
D.birchii,156593892,VNKA01007512.1,1,4383,2.79896e-05,146442664,0.935175
D.birchii,156593892,VNKA01001156.1,1,4383,2.79896e-05,146447047,0.935203
D.birchii,156593892,VNKA01005021.1,1,4379,2.79641e-05,146451426,0.935231
D.birchii,156593892,VNKA01002005.1,1,4377,2.79513e-05,146455803,0.935259
D.birchii,156593892,VNKA01006289.1,1,4371,2.7913e-05,146460174,0.935287
D.birchii,156593892,VNKA01007285.1,1,4370,2.79066e-05,146464544,0.935315
D.birchii,156593892,VNKA01005135.1,1,4366,2.7881e-05,146468910,0.935342
D.birchii,156593892,VNKA01005025.1,1,4365,2.78747e-05,146473275,0.93537
D.birchii,156593892,VNKA01004437.1,1,4364,2.78683e-05,146477639,0.935398
D.birchii,156593892,VNKA01004983.1,1,4361,2.78491e-05,146482000,0.935426
D.birchii,156593892,VNKA01006916.1,1,4359,2.78363e-05,146486359,0.935454
D.birchii,156593892,VNKA01006450.1,1,4358,2.78299e-05,146490717,0.935482
D.birchii,156593892,VNKA01005650.1,1,4355,2.78108e-05,146495072,0.935509
D.birchii,156593892,VNKA01000284.1,1,4351,2.77852e-05,146499423,0.935537
D.birchii,156593892,VNKA01006209.1,1,4349,2.77725e-05,146503772,0.935565
D.birchii,156593892,VNKA01003963.1,1,4347,2.77597e-05,146508119,0.935593
D.birchii,156593892,VNKA01000436.1,1,4347,2.77597e-05,146512466,0.935621
D.birchii,156593892,VNKA01000146.1,1,4347,2.77597e-05,146516813,0.935648
D.birchii,156593892,VNKA01007116.1,1,4346,2.77533e-05,146521159,0.935676
D.birchii,156593892,VNKA01006838.1,1,4346,2.77533e-05,146525505,0.935704
D.birchii,156593892,VNKA01005366.1,1,4344,2.77405e-05,146529849,0.935732
D.birchii,156593892,VNKA01002733.1,1,4342,2.77278e-05,146534191,0.935759
D.birchii,156593892,VNKA01003136.1,1,4336,2.76895e-05,146538527,0.935787
D.birchii,156593892,VNKA01001402.1,1,4336,2.76895e-05,146542863,0.935815
D.birchii,156593892,VNKA01006544.1,1,4334,2.76767e-05,146547197,0.935842
D.birchii,156593892,VNKA01000019.1,1,4323,2.76064e-05,146551520,0.93587
D.birchii,156593892,VNKA01002712.1,1,4322,2.76001e-05,146555842,0.935898
D.birchii,156593892,VNKA01006939.1,1,4319,2.75809e-05,146560161,0.935925
D.birchii,156593892,VNKA01003173.1,1,4319,2.75809e-05,146564480,0.935953
D.birchii,156593892,VNKA01005204.1,1,4317,2.75681e-05,146568797,0.93598
D.birchii,156593892,VNKA01004986.1,1,4313,2.75426e-05,146573110,0.936008
D.birchii,156593892,VNKA01006445.1,1,4311,2.75298e-05,146577421,0.936035
D.birchii,156593892,VNKA01006496.1,1,4308,2.75107e-05,146581729,0.936063
D.birchii,156593892,VNKA01002931.1,1,4308,2.75107e-05,146586037,0.93609
D.birchii,156593892,VNKA01005020.1,1,4306,2.74979e-05,146590343,0.936118
D.birchii,156593892,VNKA01006078.1,1,4305,2.74915e-05,146594648,0.936145
D.birchii,156593892,VNKA01002347.1,1,4297,2.74404e-05,146598945,0.936173
D.birchii,156593892,VNKA01001688.1,1,4297,2.74404e-05,146603242,0.9362
D.birchii,156593892,VNKA01001000.1,1,4294,2.74212e-05,146607536,0.936228
D.birchii,156593892,VNKA01005908.1,1,4287,2.73765e-05,146611823,0.936255
D.birchii,156593892,VNKA01004850.1,1,4283,2.7351e-05,146616106,0.936282
D.birchii,156593892,VNKA01006508.1,1,4282,2.73446e-05,146620388,0.93631
D.birchii,156593892,VNKA01003353.1,1,4280,2.73318e-05,146624668,0.936337
D.birchii,156593892,VNKA01001176.1,1,4279,2.73255e-05,146628947,0.936364
D.birchii,156593892,VNKA01003363.1,1,4278,2.73191e-05,146633225,0.936392
D.birchii,156593892,VNKA01001161.1,1,4278,2.73191e-05,146637503,0.936419
D.birchii,156593892,VNKA01002857.1,1,4276,2.73063e-05,146641779,0.936446
D.birchii,156593892,VNKA01006000.1,1,4273,2.72871e-05,146646052,0.936474
D.birchii,156593892,VNKA01005742.1,1,4273,2.72871e-05,146650325,0.936501
D.birchii,156593892,VNKA01000165.1,1,4273,2.72871e-05,146654598,0.936528
D.birchii,156593892,VNKA01004731.1,1,4270,2.7268e-05,146658868,0.936555
D.birchii,156593892,VNKA01001841.1,1,4270,2.7268e-05,146663138,0.936583
D.birchii,156593892,VNKA01001740.1,1,4260,2.72041e-05,146667398,0.93661
D.birchii,156593892,VNKA01007556.1,1,4258,2.71914e-05,146671656,0.936637
D.birchii,156593892,VNKA01005248.1,1,4256,2.71786e-05,146675912,0.936664
D.birchii,156593892,VNKA01006473.1,1,4250,2.71403e-05,146680162,0.936691
D.birchii,156593892,VNKA01000205.1,1,4249,2.71339e-05,146684411,0.936719
D.birchii,156593892,VNKA01003911.1,1,4247,2.71211e-05,146688658,0.936746
D.birchii,156593892,VNKA01001137.1,1,4246,2.71147e-05,146692904,0.936773
D.birchii,156593892,VNKA01006967.1,1,4245,2.71083e-05,146697149,0.9368
D.birchii,156593892,VNKA01000243.1,1,4243,2.70956e-05,146701392,0.936827
D.birchii,156593892,VNKA01003207.1,1,4239,2.707e-05,146705631,0.936854
D.birchii,156593892,VNKA01003271.1,1,4235,2.70445e-05,146709866,0.936881
D.birchii,156593892,VNKA01001403.1,1,4235,2.70445e-05,146714101,0.936908
D.birchii,156593892,VNKA01004315.1,1,4234,2.70381e-05,146718335,0.936935
D.birchii,156593892,VNKA01005016.1,1,4233,2.70317e-05,146722568,0.936962
D.birchii,156593892,VNKA01002714.1,1,4232,2.70253e-05,146726800,0.936989
D.birchii,156593892,VNKA01001859.1,1,4226,2.6987e-05,146731026,0.937016
D.birchii,156593892,VNKA01003556.1,1,4223,2.69678e-05,146735249,0.937043
D.birchii,156593892,VNKA01001290.1,1,4223,2.69678e-05,146739472,0.93707
D.birchii,156593892,VNKA01004958.1,1,4221,2.69551e-05,146743693,0.937097
D.birchii,156593892,VNKA01006406.1,1,4219,2.69423e-05,146747912,0.937124
D.birchii,156593892,VNKA01006178.1,1,4219,2.69423e-05,146752131,0.937151
D.birchii,156593892,VNKA01001953.1,1,4219,2.69423e-05,146756350,0.937178
D.birchii,156593892,VNKA01007286.1,1,4217,2.69295e-05,146760567,0.937205
D.birchii,156593892,VNKA01000209.1,1,4217,2.69295e-05,146764784,0.937232
D.birchii,156593892,VNKA01001411.1,1,4216,2.69231e-05,146769000,0.937259
D.birchii,156593892,VNKA01001890.1,1,4214,2.69104e-05,146773214,0.937286
D.birchii,156593892,VNKA01004787.1,1,4210,2.68848e-05,146777424,0.937313
D.birchii,156593892,VNKA01005762.1,1,4207,2.68657e-05,146781631,0.937339
D.birchii,156593892,VNKA01004416.1,1,4206,2.68593e-05,146785837,0.937366
D.birchii,156593892,VNKA01005523.1,1,4197,2.68018e-05,146790034,0.937393
D.birchii,156593892,VNKA01002065.1,1,4195,2.6789e-05,146794229,0.93742
D.birchii,156593892,VNKA01006912.1,1,4194,2.67827e-05,146798423,0.937447
D.birchii,156593892,VNKA01000714.1,1,4194,2.67827e-05,146802617,0.937473
D.birchii,156593892,VNKA01005035.1,1,4192,2.67699e-05,146806809,0.9375
D.birchii,156593892,VNKA01005317.1,1,4190,2.67571e-05,146810999,0.937527
D.birchii,156593892,VNKA01001870.1,1,4189,2.67507e-05,146815188,0.937554
D.birchii,156593892,VNKA01007128.1,1,4188,2.67443e-05,146819376,0.93758
D.birchii,156593892,VNKA01004298.1,1,4183,2.67124e-05,146823559,0.937607
D.birchii,156593892,VNKA01002540.1,1,4183,2.67124e-05,146827742,0.937634
D.birchii,156593892,VNKA01006550.1,1,4181,2.66996e-05,146831923,0.937661
D.birchii,156593892,VNKA01007008.1,1,4180,2.66933e-05,146836103,0.937687
D.birchii,156593892,VNKA01005396.1,1,4174,2.66549e-05,146840277,0.937714
D.birchii,156593892,VNKA01005200.1,1,4174,2.66549e-05,146844451,0.937741
D.birchii,156593892,VNKA01002760.1,1,4173,2.66485e-05,146848624,0.937767
D.birchii,156593892,VNKA01003843.1,1,4171,2.66358e-05,146852795,0.937794
D.birchii,156593892,VNKA01006932.1,1,4165,2.65975e-05,146856960,0.93782
D.birchii,156593892,VNKA01001251.1,1,4164,2.65911e-05,146861124,0.937847
D.birchii,156593892,VNKA01005950.1,1,4156,2.654e-05,146865280,0.937874
D.birchii,156593892,VNKA01007510.1,1,4154,2.65272e-05,146869434,0.9379
D.birchii,156593892,VNKA01006701.1,1,4154,2.65272e-05,146873588,0.937927
D.birchii,156593892,VNKA01000212.1,1,4154,2.65272e-05,146877742,0.937953
D.birchii,156593892,VNKA01004687.1,1,4153,2.65208e-05,146881895,0.93798
D.birchii,156593892,VNKA01001930.1,1,4153,2.65208e-05,146886048,0.938006
D.birchii,156593892,VNKA01002937.1,1,4152,2.65144e-05,146890200,0.938033
D.birchii,156593892,VNKA01003794.1,1,4151,2.65081e-05,146894351,0.938059
D.birchii,156593892,VNKA01001110.1,1,4149,2.64953e-05,146898500,0.938086
D.birchii,156593892,VNKA01005992.1,1,4148,2.64889e-05,146902648,0.938112
D.birchii,156593892,VNKA01004203.1,1,4144,2.64634e-05,146906792,0.938139
D.birchii,156593892,VNKA01002116.1,1,4144,2.64634e-05,146910936,0.938165
D.birchii,156593892,VNKA01002166.1,1,4142,2.64506e-05,146915078,0.938192
D.birchii,156593892,VNKA01006761.1,1,4139,2.64314e-05,146919217,0.938218
D.birchii,156593892,VNKA01001520.1,1,4138,2.6425e-05,146923355,0.938244
D.birchii,156593892,VNKA01001556.1,1,4136,2.64123e-05,146927491,0.938271
D.birchii,156593892,VNKA01004601.1,1,4133,2.63931e-05,146931624,0.938297
D.birchii,156593892,VNKA01000404.1,1,4133,2.63931e-05,146935757,0.938324
D.birchii,156593892,VNKA01006064.1,1,4131,2.63803e-05,146939888,0.93835
D.birchii,156593892,VNKA01004423.1,1,4131,2.63803e-05,146944019,0.938376
D.birchii,156593892,VNKA01001690.1,1,4125,2.6342e-05,146948144,0.938403
D.birchii,156593892,VNKA01003323.1,1,4123,2.63293e-05,146952267,0.938429
D.birchii,156593892,VNKA01003978.1,1,4122,2.63229e-05,146956389,0.938455
D.birchii,156593892,VNKA01005459.1,1,4119,2.63037e-05,146960508,0.938482
D.birchii,156593892,VNKA01006390.1,1,4118,2.62973e-05,146964626,0.938508
D.birchii,156593892,VNKA01001391.1,1,4117,2.62909e-05,146968743,0.938534
D.birchii,156593892,VNKA01004962.1,1,4115,2.62782e-05,146972858,0.938561
D.birchii,156593892,VNKA01001133.1,1,4111,2.62526e-05,146976969,0.938587
D.birchii,156593892,VNKA01004150.1,1,4110,2.62462e-05,146981079,0.938613
D.birchii,156593892,VNKA01004626.1,1,4107,2.62271e-05,146985186,0.938639
D.birchii,156593892,VNKA01005518.1,1,4106,2.62207e-05,146989292,0.938666
D.birchii,156593892,VNKA01002179.1,1,4104,2.62079e-05,146993396,0.938692
D.birchii,156593892,VNKA01002008.1,1,4104,2.62079e-05,146997500,0.938718
D.birchii,156593892,VNKA01006006.1,1,4103,2.62015e-05,147001603,0.938744
D.birchii,156593892,VNKA01000130.1,1,4101,2.61888e-05,147005704,0.93877
D.birchii,156593892,VNKA01007237.1,1,4098,2.61696e-05,147009802,0.938797
D.birchii,156593892,VNKA01002825.1,1,4096,2.61568e-05,147013898,0.938823
D.birchii,156593892,VNKA01003837.1,1,4094,2.61441e-05,147017992,0.938849
D.birchii,156593892,VNKA01006332.1,1,4093,2.61377e-05,147022085,0.938875
D.birchii,156593892,VNKA01001784.1,1,4092,2.61313e-05,147026177,0.938901
D.birchii,156593892,VNKA01004049.1,1,4090,2.61185e-05,147030267,0.938927
D.birchii,156593892,VNKA01002741.1,1,4089,2.61121e-05,147034356,0.938953
D.birchii,156593892,VNKA01005272.1,1,4084,2.60802e-05,147038440,0.938979
D.birchii,156593892,VNKA01002243.1,1,4083,2.60738e-05,147042523,0.939005
D.birchii,156593892,VNKA01005808.1,1,4082,2.60674e-05,147046605,0.939032
D.birchii,156593892,VNKA01001901.1,1,4077,2.60355e-05,147050682,0.939058
D.birchii,156593892,VNKA01003746.1,1,4075,2.60227e-05,147054757,0.939084
D.birchii,156593892,VNKA01006062.1,1,4074,2.60163e-05,147058831,0.93911
D.birchii,156593892,VNKA01001248.1,1,4074,2.60163e-05,147062905,0.939136
D.birchii,156593892,VNKA01000524.1,1,4074,2.60163e-05,147066979,0.939162
D.birchii,156593892,VNKA01005333.1,1,4072,2.60036e-05,147071051,0.939188
D.birchii,156593892,VNKA01004250.1,1,4072,2.60036e-05,147075123,0.939214
D.birchii,156593892,VNKA01001865.1,1,4070,2.59908e-05,147079193,0.93924
D.birchii,156593892,VNKA01002038.1,1,4068,2.5978e-05,147083261,0.939266
D.birchii,156593892,VNKA01005369.1,1,4067,2.59716e-05,147087328,0.939292
D.birchii,156593892,VNKA01002577.1,1,4065,2.59589e-05,147091393,0.939318
D.birchii,156593892,VNKA01001737.1,1,4065,2.59589e-05,147095458,0.939344
D.birchii,156593892,VNKA01003608.1,1,4062,2.59397e-05,147099520,0.939369
D.birchii,156593892,VNKA01007361.1,1,4061,2.59333e-05,147103581,0.939395
D.birchii,156593892,VNKA01000272.1,1,4060,2.59269e-05,147107641,0.939421
D.birchii,156593892,VNKA01006238.1,1,4059,2.59206e-05,147111700,0.939447
D.birchii,156593892,VNKA01006090.1,1,4058,2.59142e-05,147115758,0.939473
D.birchii,156593892,VNKA01001707.1,1,4058,2.59142e-05,147119816,0.939499
D.birchii,156593892,VNKA01004310.1,1,4056,2.59014e-05,147123872,0.939525
D.birchii,156593892,VNKA01001674.1,1,4052,2.58758e-05,147127924,0.939551
D.birchii,156593892,VNKA01002505.1,1,4047,2.58439e-05,147131971,0.939577
D.birchii,156593892,VNKA01002441.1,1,4045,2.58311e-05,147136016,0.939603
D.birchii,156593892,VNKA01001634.1,1,4044,2.58248e-05,147140060,0.939628
D.birchii,156593892,VNKA01001486.1,1,4040,2.57992e-05,147144100,0.939654
D.birchii,156593892,VNKA01002855.1,1,4038,2.57864e-05,147148138,0.93968
D.birchii,156593892,VNKA01007136.1,1,4034,2.57609e-05,147152172,0.939706
D.birchii,156593892,VNKA01000072.1,1,4033,2.57545e-05,147156205,0.939731
D.birchii,156593892,VNKA01006494.1,1,4029,2.5729e-05,147160234,0.939757
D.birchii,156593892,VNKA01006140.1,1,4029,2.5729e-05,147164263,0.939783
D.birchii,156593892,VNKA01004407.1,1,4029,2.5729e-05,147168292,0.939809
D.birchii,156593892,VNKA01004354.1,1,4028,2.57226e-05,147172320,0.939834
D.birchii,156593892,VNKA01003339.1,1,4027,2.57162e-05,147176347,0.93986
D.birchii,156593892,VNKA01001685.1,1,4027,2.57162e-05,147180374,0.939886
D.birchii,156593892,VNKA01005446.1,1,4024,2.5697e-05,147184398,0.939911
D.birchii,156593892,VNKA01002218.1,1,4024,2.5697e-05,147188422,0.939937
D.birchii,156593892,VNKA01001334.1,1,4024,2.5697e-05,147192446,0.939963
D.birchii,156593892,VNKA01006968.1,1,4023,2.56907e-05,147196469,0.939989
D.birchii,156593892,VNKA01000513.1,1,4023,2.56907e-05,147200492,0.940014
D.birchii,156593892,VNKA01007058.1,1,4022,2.56843e-05,147204514,0.94004
D.birchii,156593892,VNKA01003992.1,1,4022,2.56843e-05,147208536,0.940066
D.birchii,156593892,VNKA01003904.1,1,4020,2.56715e-05,147212556,0.940091
D.birchii,156593892,VNKA01002382.1,1,4018,2.56587e-05,147216574,0.940117
D.birchii,156593892,VNKA01002644.1,1,4017,2.56523e-05,147220591,0.940143
D.birchii,156593892,VNKA01000517.1,1,4014,2.56332e-05,147224605,0.940168
D.birchii,156593892,VNKA01007515.1,1,4011,2.5614e-05,147228616,0.940194
D.birchii,156593892,VNKA01004960.1,1,4010,2.56076e-05,147232626,0.940219
D.birchii,156593892,VNKA01006171.1,1,4008,2.55949e-05,147236634,0.940245
D.birchii,156593892,VNKA01002212.1,1,4008,2.55949e-05,147240642,0.940271
D.birchii,156593892,VNKA01001896.1,1,4006,2.55821e-05,147244648,0.940296
D.birchii,156593892,VNKA01006527.1,1,4005,2.55757e-05,147248653,0.940322
D.birchii,156593892,VNKA01000321.1,1,4005,2.55757e-05,147252658,0.940347
D.birchii,156593892,VNKA01000194.1,1,4004,2.55693e-05,147256662,0.940373
D.birchii,156593892,VNKA01007482.1,1,4001,2.55502e-05,147260663,0.940399
D.birchii,156593892,VNKA01004809.1,1,4000,2.55438e-05,147264663,0.940424
D.birchii,156593892,VNKA01002673.1,1,3999,2.55374e-05,147268662,0.94045
D.birchii,156593892,VNKA01002517.1,1,3995,2.55119e-05,147272657,0.940475
D.birchii,156593892,VNKA01006477.1,1,3994,2.55055e-05,147276651,0.940501
D.birchii,156593892,VNKA01001681.1,1,3992,2.54927e-05,147280643,0.940526
D.birchii,156593892,VNKA01005563.1,1,3991,2.54863e-05,147284634,0.940552
D.birchii,156593892,VNKA01006386.1,1,3990,2.54799e-05,147288624,0.940577
D.birchii,156593892,VNKA01004805.1,1,3990,2.54799e-05,147292614,0.940603
D.birchii,156593892,VNKA01004079.1,1,3987,2.54608e-05,147296601,0.940628
D.birchii,156593892,VNKA01000366.1,1,3986,2.54544e-05,147300587,0.940653
D.birchii,156593892,VNKA01001063.1,1,3985,2.5448e-05,147304572,0.940679
D.birchii,156593892,VNKA01004569.1,1,3984,2.54416e-05,147308556,0.940704
D.birchii,156593892,VNKA01000461.1,1,3983,2.54352e-05,147312539,0.94073
D.birchii,156593892,VNKA01002884.1,1,3981,2.54224e-05,147316520,0.940755
D.birchii,156593892,VNKA01001306.1,1,3980,2.54161e-05,147320500,0.940781
D.birchii,156593892,VNKA01000490.1,1,3980,2.54161e-05,147324480,0.940806
D.birchii,156593892,VNKA01002146.1,1,3979,2.54097e-05,147328459,0.940831
D.birchii,156593892,VNKA01004261.1,1,3976,2.53905e-05,147332435,0.940857
D.birchii,156593892,VNKA01000403.1,1,3976,2.53905e-05,147336411,0.940882
D.birchii,156593892,VNKA01003696.1,1,3974,2.53777e-05,147340385,0.940908
D.birchii,156593892,VNKA01002128.1,1,3974,2.53777e-05,147344359,0.940933
D.birchii,156593892,VNKA01001042.1,1,3974,2.53777e-05,147348333,0.940958
D.birchii,156593892,VNKA01007436.1,1,3969,2.53458e-05,147352302,0.940984
D.birchii,156593892,VNKA01006794.1,1,3968,2.53394e-05,147356270,0.941009
D.birchii,156593892,VNKA01006590.1,1,3968,2.53394e-05,147360238,0.941034
D.birchii,156593892,VNKA01006084.1,1,3967,2.5333e-05,147364205,0.94106
D.birchii,156593892,VNKA01004799.1,1,3967,2.5333e-05,147368172,0.941085
D.birchii,156593892,VNKA01000485.1,1,3965,2.53203e-05,147372137,0.94111
D.birchii,156593892,VNKA01001775.1,1,3963,2.53075e-05,147376100,0.941136
D.birchii,156593892,VNKA01001301.1,1,3962,2.53011e-05,147380062,0.941161
D.birchii,156593892,VNKA01004997.1,1,3958,2.52756e-05,147384020,0.941186
D.birchii,156593892,VNKA01002363.1,1,3958,2.52756e-05,147387978,0.941212
D.birchii,156593892,VNKA01000985.1,1,3958,2.52756e-05,147391936,0.941237
D.birchii,156593892,VNKA01002928.1,1,3957,2.52692e-05,147395893,0.941262
D.birchii,156593892,VNKA01000662.1,1,3957,2.52692e-05,147399850,0.941287
D.birchii,156593892,VNKA01006880.1,1,3956,2.52628e-05,147403806,0.941313
D.birchii,156593892,VNKA01004237.1,1,3953,2.52436e-05,147407759,0.941338
D.birchii,156593892,VNKA01003211.1,1,3952,2.52373e-05,147411711,0.941363
D.birchii,156593892,VNKA01002120.1,1,3951,2.52309e-05,147415662,0.941388
D.birchii,156593892,VNKA01004456.1,1,3950,2.52245e-05,147419612,0.941414
D.birchii,156593892,VNKA01004336.1,1,3950,2.52245e-05,147423562,0.941439
D.birchii,156593892,VNKA01004177.1,1,3950,2.52245e-05,147427512,0.941464
D.birchii,156593892,VNKA01002117.1,1,3947,2.52053e-05,147431459,0.941489
D.birchii,156593892,VNKA01006410.1,1,3942,2.51734e-05,147435401,0.941514
D.birchii,156593892,VNKA01003507.1,1,3942,2.51734e-05,147439343,0.94154
D.birchii,156593892,VNKA01006807.1,1,3940,2.51606e-05,147443283,0.941565
D.birchii,156593892,VNKA01002770.1,1,3940,2.51606e-05,147447223,0.94159
D.birchii,156593892,VNKA01004926.1,1,3934,2.51223e-05,147451157,0.941615
D.birchii,156593892,VNKA01000515.1,1,3934,2.51223e-05,147455091,0.94164
D.birchii,156593892,VNKA01004175.1,1,3932,2.51095e-05,147459023,0.941665
D.birchii,156593892,VNKA01000134.1,1,3929,2.50904e-05,147462952,0.94169
D.birchii,156593892,VNKA01000012.1,1,3927,2.50776e-05,147466879,0.941715
D.birchii,156593892,VNKA01004539.1,1,3923,2.50521e-05,147470802,0.94174
D.birchii,156593892,VNKA01006106.1,1,3917,2.50137e-05,147474719,0.941765
D.birchii,156593892,VNKA01004371.1,1,3916,2.50074e-05,147478635,0.94179
D.birchii,156593892,VNKA01000968.1,1,3916,2.50074e-05,147482551,0.941815
D.birchii,156593892,VNKA01007281.1,1,3915,2.5001e-05,147486466,0.94184
D.birchii,156593892,VNKA01004285.1,1,3915,2.5001e-05,147490381,0.941865
D.birchii,156593892,VNKA01000539.1,1,3909,2.49627e-05,147494290,0.94189
D.birchii,156593892,VNKA01000767.1,1,3904,2.49307e-05,147498194,0.941915
D.birchii,156593892,VNKA01001375.1,1,3903,2.49243e-05,147502097,0.94194
D.birchii,156593892,VNKA01001704.1,1,3901,2.49116e-05,147505998,0.941965
D.birchii,156593892,VNKA01000021.1,1,3901,2.49116e-05,147509899,0.94199
D.birchii,156593892,VNKA01005514.1,1,3898,2.48924e-05,147513797,0.942015
D.birchii,156593892,VNKA01003097.1,1,3896,2.48796e-05,147517693,0.94204
D.birchii,156593892,VNKA01007528.1,1,3893,2.48605e-05,147521586,0.942065
D.birchii,156593892,VNKA01003706.1,1,3890,2.48413e-05,147525476,0.94209
D.birchii,156593892,VNKA01003857.1,1,3888,2.48286e-05,147529364,0.942114
D.birchii,156593892,VNKA01001074.1,1,3888,2.48286e-05,147533252,0.942139
D.birchii,156593892,VNKA01005132.1,1,3887,2.48222e-05,147537139,0.942164
D.birchii,156593892,VNKA01002165.1,1,3887,2.48222e-05,147541026,0.942189
D.birchii,156593892,VNKA01000998.1,1,3887,2.48222e-05,147544913,0.942214
D.birchii,156593892,VNKA01001783.1,1,3884,2.4803e-05,147548797,0.942239
D.birchii,156593892,VNKA01005108.1,1,3883,2.47966e-05,147552680,0.942263
D.birchii,156593892,VNKA01003419.1,1,3881,2.47839e-05,147556561,0.942288
D.birchii,156593892,VNKA01001094.1,1,3881,2.47839e-05,147560442,0.942313
D.birchii,156593892,VNKA01000277.1,1,3881,2.47839e-05,147564323,0.942338
D.birchii,156593892,VNKA01002861.1,1,3880,2.47775e-05,147568203,0.942362
D.birchii,156593892,VNKA01006733.1,1,3877,2.47583e-05,147572080,0.942387
D.birchii,156593892,VNKA01001599.1,1,3872,2.47264e-05,147575952,0.942412
D.birchii,156593892,VNKA01000868.1,1,3871,2.472e-05,147579823,0.942437
D.birchii,156593892,VNKA01005479.1,1,3870,2.47136e-05,147583693,0.942461
D.birchii,156593892,VNKA01004015.1,1,3870,2.47136e-05,147587563,0.942486
D.birchii,156593892,VNKA01004652.1,1,3868,2.47008e-05,147591431,0.942511
D.birchii,156593892,VNKA01004493.1,1,3864,2.46753e-05,147595295,0.942535
D.birchii,156593892,VNKA01007134.1,1,3861,2.46561e-05,147599156,0.94256
D.birchii,156593892,VNKA01000246.1,1,3861,2.46561e-05,147603017,0.942585
D.birchii,156593892,VNKA01003679.1,1,3859,2.46434e-05,147606876,0.942609
D.birchii,156593892,VNKA01003333.1,1,3859,2.46434e-05,147610735,0.942634
D.birchii,156593892,VNKA01001718.1,1,3857,2.46306e-05,147614592,0.942659
D.birchii,156593892,VNKA01005935.1,1,3855,2.46178e-05,147618447,0.942683
D.birchii,156593892,VNKA01007524.1,1,3854,2.46114e-05,147622301,0.942708
D.birchii,156593892,VNKA01007484.1,1,3854,2.46114e-05,147626155,0.942733
D.birchii,156593892,VNKA01006645.1,1,3853,2.4605e-05,147630008,0.942757
D.birchii,156593892,VNKA01001157.1,1,3852,2.45987e-05,147633860,0.942782
D.birchii,156593892,VNKA01005175.1,1,3850,2.45859e-05,147637710,0.942806
D.birchii,156593892,VNKA01003946.1,1,3850,2.45859e-05,147641560,0.942831
D.birchii,156593892,VNKA01001371.1,1,3849,2.45795e-05,147645409,0.942855
D.birchii,156593892,VNKA01002140.1,1,3848,2.45731e-05,147649257,0.94288
D.birchii,156593892,VNKA01002083.1,1,3845,2.4554e-05,147653102,0.942905
D.birchii,156593892,VNKA01001339.1,1,3845,2.4554e-05,147656947,0.942929
D.birchii,156593892,VNKA01004391.1,1,3843,2.45412e-05,147660790,0.942954
D.birchii,156593892,VNKA01002300.1,1,3842,2.45348e-05,147664632,0.942978
D.birchii,156593892,VNKA01002636.1,1,3839,2.45156e-05,147668471,0.943003
D.birchii,156593892,VNKA01005250.1,1,3838,2.45093e-05,147672309,0.943027
D.birchii,156593892,VNKA01004244.1,1,3837,2.45029e-05,147676146,0.943052
D.birchii,156593892,VNKA01001566.1,1,3835,2.44901e-05,147679981,0.943076
D.birchii,156593892,VNKA01001304.1,1,3835,2.44901e-05,147683816,0.943101
D.birchii,156593892,VNKA01001964.1,1,3834,2.44837e-05,147687650,0.943125
D.birchii,156593892,VNKA01000632.1,1,3834,2.44837e-05,147691484,0.94315
D.birchii,156593892,VNKA01004727.1,1,3829,2.44518e-05,147695313,0.943174
D.birchii,156593892,VNKA01001296.1,1,3829,2.44518e-05,147699142,0.943199
D.birchii,156593892,VNKA01006498.1,1,3827,2.4439e-05,147702969,0.943223
D.birchii,156593892,VNKA01003626.1,1,3827,2.4439e-05,147706796,0.943247
D.birchii,156593892,VNKA01000509.1,1,3826,2.44326e-05,147710622,0.943272
D.birchii,156593892,VNKA01003328.1,1,3825,2.44262e-05,147714447,0.943296
D.birchii,156593892,VNKA01006524.1,1,3824,2.44199e-05,147718271,0.943321
D.birchii,156593892,VNKA01000408.1,1,3824,2.44199e-05,147722095,0.943345
D.birchii,156593892,VNKA01003796.1,1,3819,2.43879e-05,147725914,0.94337
D.birchii,156593892,VNKA01004473.1,1,3813,2.43496e-05,147729727,0.943394
D.birchii,156593892,VNKA01003042.1,1,3810,2.43305e-05,147733537,0.943418
D.birchii,156593892,VNKA01001439.1,1,3808,2.43177e-05,147737345,0.943443
D.birchii,156593892,VNKA01006378.1,1,3805,2.42985e-05,147741150,0.943467
D.birchii,156593892,VNKA01002078.1,1,3805,2.42985e-05,147744955,0.943491
D.birchii,156593892,VNKA01007201.1,1,3804,2.42921e-05,147748759,0.943515
D.birchii,156593892,VNKA01003219.1,1,3802,2.42794e-05,147752561,0.94354
D.birchii,156593892,VNKA01001984.1,1,3802,2.42794e-05,147756363,0.943564
D.birchii,156593892,VNKA01006597.1,1,3799,2.42602e-05,147760162,0.943588
D.birchii,156593892,VNKA01004366.1,1,3796,2.4241e-05,147763958,0.943613
D.birchii,156593892,VNKA01007319.1,1,3795,2.42347e-05,147767753,0.943637
D.birchii,156593892,VNKA01007236.1,1,3795,2.42347e-05,147771548,0.943661
D.birchii,156593892,VNKA01001095.1,1,3793,2.42219e-05,147775341,0.943685
D.birchii,156593892,VNKA01005885.1,1,3791,2.42091e-05,147779132,0.943709
D.birchii,156593892,VNKA01002947.1,1,3788,2.419e-05,147782920,0.943734
D.birchii,156593892,VNKA01006159.1,1,3787,2.41836e-05,147786707,0.943758
D.birchii,156593892,VNKA01003421.1,1,3787,2.41836e-05,147790494,0.943782
D.birchii,156593892,VNKA01000691.1,1,3782,2.41516e-05,147794276,0.943806
D.birchii,156593892,VNKA01000159.1,1,3782,2.41516e-05,147798058,0.94383
D.birchii,156593892,VNKA01007304.1,1,3777,2.41197e-05,147801835,0.943854
D.birchii,156593892,VNKA01004432.1,1,3777,2.41197e-05,147805612,0.943879
D.birchii,156593892,VNKA01000437.1,1,3777,2.41197e-05,147809389,0.943903
D.birchii,156593892,VNKA01005277.1,1,3775,2.41069e-05,147813164,0.943927
D.birchii,156593892,VNKA01003429.1,1,3772,2.40878e-05,147816936,0.943951
D.birchii,156593892,VNKA01004236.1,1,3770,2.4075e-05,147820706,0.943975
D.birchii,156593892,VNKA01002364.1,1,3769,2.40686e-05,147824475,0.943999
D.birchii,156593892,VNKA01004025.1,1,3767,2.40559e-05,147828242,0.944023
D.birchii,156593892,VNKA01000921.1,1,3767,2.40559e-05,147832009,0.944047
D.birchii,156593892,VNKA01003686.1,1,3766,2.40495e-05,147835775,0.944071
D.birchii,156593892,VNKA01005602.1,1,3765,2.40431e-05,147839540,0.944095
D.birchii,156593892,VNKA01000438.1,1,3764,2.40367e-05,147843304,0.944119
D.birchii,156593892,VNKA01004324.1,1,3761,2.40175e-05,147847065,0.944143
D.birchii,156593892,VNKA01006633.1,1,3759,2.40048e-05,147850824,0.944167
D.birchii,156593892,VNKA01004725.1,1,3759,2.40048e-05,147854583,0.944191
D.birchii,156593892,VNKA01002170.1,1,3755,2.39792e-05,147858338,0.944215
D.birchii,156593892,VNKA01006020.1,1,3754,2.39728e-05,147862092,0.944239
D.birchii,156593892,VNKA01001155.1,1,3754,2.39728e-05,147865846,0.944263
D.birchii,156593892,VNKA01005367.1,1,3753,2.39665e-05,147869599,0.944287
D.birchii,156593892,VNKA01002646.1,1,3753,2.39665e-05,147873352,0.944311
D.birchii,156593892,VNKA01004249.1,1,3752,2.39601e-05,147877104,0.944335
D.birchii,156593892,VNKA01003863.1,1,3752,2.39601e-05,147880856,0.944359
D.birchii,156593892,VNKA01006260.1,1,3751,2.39537e-05,147884607,0.944383
D.birchii,156593892,VNKA01004901.1,1,3750,2.39473e-05,147888357,0.944407
D.birchii,156593892,VNKA01000768.1,1,3750,2.39473e-05,147892107,0.944431
D.birchii,156593892,VNKA01000041.1,1,3750,2.39473e-05,147895857,0.944455
D.birchii,156593892,VNKA01003739.1,1,3749,2.39409e-05,147899606,0.944479
D.birchii,156593892,VNKA01002145.1,1,3749,2.39409e-05,147903355,0.944503
D.birchii,156593892,VNKA01001462.1,1,3748,2.39345e-05,147907103,0.944527
D.birchii,156593892,VNKA01000060.1,1,3745,2.39154e-05,147910848,0.944551
D.birchii,156593892,VNKA01001363.1,1,3744,2.3909e-05,147914592,0.944574
D.birchii,156593892,VNKA01006940.1,1,3743,2.39026e-05,147918335,0.944598
D.birchii,156593892,VNKA01007123.1,1,3741,2.38898e-05,147922076,0.944622
D.birchii,156593892,VNKA01000123.1,1,3739,2.3877e-05,147925815,0.944646
D.birchii,156593892,VNKA01002346.1,1,3738,2.38707e-05,147929553,0.94467
D.birchii,156593892,VNKA01007314.1,1,3737,2.38643e-05,147933290,0.944694
D.birchii,156593892,VNKA01004205.1,1,3737,2.38643e-05,147937027,0.944718
D.birchii,156593892,VNKA01004861.1,1,3736,2.38579e-05,147940763,0.944742
D.birchii,156593892,VNKA01002553.1,1,3732,2.38323e-05,147944495,0.944765
D.birchii,156593892,VNKA01001195.1,1,3732,2.38323e-05,147948227,0.944789
D.birchii,156593892,VNKA01000725.1,1,3732,2.38323e-05,147951959,0.944813
D.birchii,156593892,VNKA01002267.1,1,3728,2.38068e-05,147955687,0.944837
D.birchii,156593892,VNKA01005622.1,1,3727,2.38004e-05,147959414,0.944861
D.birchii,156593892,VNKA01005097.1,1,3727,2.38004e-05,147963141,0.944884
D.birchii,156593892,VNKA01004201.1,1,3726,2.3794e-05,147966867,0.944908
D.birchii,156593892,VNKA01000758.1,1,3724,2.37813e-05,147970591,0.944932
D.birchii,156593892,VNKA01000290.1,1,3722,2.37685e-05,147974313,0.944956
D.birchii,156593892,VNKA01007171.1,1,3720,2.37557e-05,147978033,0.94498
D.birchii,156593892,VNKA01002969.1,1,3720,2.37557e-05,147981753,0.945003
D.birchii,156593892,VNKA01004988.1,1,3718,2.37429e-05,147985471,0.945027
D.birchii,156593892,VNKA01000050.1,1,3716,2.37302e-05,147989187,0.945051
D.birchii,156593892,VNKA01006749.1,1,3713,2.3711e-05,147992900,0.945075
D.birchii,156593892,VNKA01001374.1,1,3713,2.3711e-05,147996613,0.945098
D.birchii,156593892,VNKA01006391.1,1,3712,2.37046e-05,148000325,0.945122
D.birchii,156593892,VNKA01001472.1,1,3711,2.36982e-05,148004036,0.945146
D.birchii,156593892,VNKA01001701.1,1,3710,2.36919e-05,148007746,0.945169
D.birchii,156593892,VNKA01000073.1,1,3710,2.36919e-05,148011456,0.945193
D.birchii,156593892,VNKA01006630.1,1,3708,2.36791e-05,148015164,0.945217
D.birchii,156593892,VNKA01005625.1,1,3708,2.36791e-05,148018872,0.94524
D.birchii,156593892,VNKA01002561.1,1,3706,2.36663e-05,148022578,0.945264
D.birchii,156593892,VNKA01000588.1,1,3704,2.36535e-05,148026282,0.945288
D.birchii,156593892,VNKA01005091.1,1,3701,2.36344e-05,148029983,0.945311
D.birchii,156593892,VNKA01002161.1,1,3699,2.36216e-05,148033682,0.945335
D.birchii,156593892,VNKA01007460.1,1,3695,2.35961e-05,148037377,0.945359
D.birchii,156593892,VNKA01001238.1,1,3695,2.35961e-05,148041072,0.945382
D.birchii,156593892,VNKA01006530.1,1,3693,2.35833e-05,148044765,0.945406
D.birchii,156593892,VNKA01002139.1,1,3692,2.35769e-05,148048457,0.945429
D.birchii,156593892,VNKA01002370.1,1,3691,2.35705e-05,148052148,0.945453
D.birchii,156593892,VNKA01005344.1,1,3689,2.35578e-05,148055837,0.945476
D.birchii,156593892,VNKA01003604.1,1,3688,2.35514e-05,148059525,0.9455
D.birchii,156593892,VNKA01000038.1,1,3688,2.35514e-05,148063213,0.945524
D.birchii,156593892,VNKA01001040.1,1,3687,2.3545e-05,148066900,0.945547
D.birchii,156593892,VNKA01003734.1,1,3686,2.35386e-05,148070586,0.945571
D.birchii,156593892,VNKA01000449.1,1,3685,2.35322e-05,148074271,0.945594
D.birchii,156593892,VNKA01004475.1,1,3683,2.35194e-05,148077954,0.945618
D.birchii,156593892,VNKA01002150.1,1,3680,2.35003e-05,148081634,0.945641
D.birchii,156593892,VNKA01002154.1,1,3678,2.34875e-05,148085312,0.945665
D.birchii,156593892,VNKA01007120.1,1,3675,2.34683e-05,148088987,0.945688
D.birchii,156593892,VNKA01002850.1,1,3675,2.34683e-05,148092662,0.945712
D.birchii,156593892,VNKA01004813.1,1,3674,2.3462e-05,148096336,0.945735
D.birchii,156593892,VNKA01007268.1,1,3673,2.34556e-05,148100009,0.945759
D.birchii,156593892,VNKA01000104.1,1,3672,2.34492e-05,148103681,0.945782
D.birchii,156593892,VNKA01001179.1,1,3669,2.343e-05,148107350,0.945805
D.birchii,156593892,VNKA01005028.1,1,3668,2.34236e-05,148111018,0.945829
D.birchii,156593892,VNKA01002602.1,1,3668,2.34236e-05,148114686,0.945852
D.birchii,156593892,VNKA01004816.1,1,3666,2.34109e-05,148118352,0.945876
D.birchii,156593892,VNKA01002118.1,1,3666,2.34109e-05,148122018,0.945899
D.birchii,156593892,VNKA01001050.1,1,3666,2.34109e-05,148125684,0.945922
D.birchii,156593892,VNKA01002570.1,1,3662,2.33853e-05,148129346,0.945946
D.birchii,156593892,VNKA01003917.1,1,3660,2.33726e-05,148133006,0.945969
D.birchii,156593892,VNKA01005029.1,1,3659,2.33662e-05,148136665,0.945993
D.birchii,156593892,VNKA01005216.1,1,3655,2.33406e-05,148140320,0.946016
D.birchii,156593892,VNKA01000504.1,1,3654,2.33342e-05,148143974,0.946039
D.birchii,156593892,VNKA01005352.1,1,3653,2.33279e-05,148147627,0.946063
D.birchii,156593892,VNKA01003197.1,1,3652,2.33215e-05,148151279,0.946086
D.birchii,156593892,VNKA01002765.1,1,3647,2.32895e-05,148154926,0.946109
D.birchii,156593892,VNKA01000857.1,1,3646,2.32832e-05,148158572,0.946133
D.birchii,156593892,VNKA01005193.1,1,3645,2.32768e-05,148162217,0.946156
D.birchii,156593892,VNKA01002903.1,1,3644,2.32704e-05,148165861,0.946179
D.birchii,156593892,VNKA01004844.1,1,3643,2.3264e-05,148169504,0.946202
D.birchii,156593892,VNKA01001007.1,1,3643,2.3264e-05,148173147,0.946226
D.birchii,156593892,VNKA01007537.1,1,3642,2.32576e-05,148176789,0.946249
D.birchii,156593892,VNKA01005628.1,1,3641,2.32512e-05,148180430,0.946272
D.birchii,156593892,VNKA01001653.1,1,3640,2.32448e-05,148184070,0.946295
D.birchii,156593892,VNKA01004314.1,1,3638,2.32321e-05,148187708,0.946319
D.birchii,156593892,VNKA01004705.1,1,3637,2.32257e-05,148191345,0.946342
D.birchii,156593892,VNKA01005457.1,1,3636,2.32193e-05,148194981,0.946365
D.birchii,156593892,VNKA01002073.1,1,3636,2.32193e-05,148198617,0.946388
D.birchii,156593892,VNKA01001037.1,1,3632,2.31938e-05,148202249,0.946411
D.birchii,156593892,VNKA01001312.1,1,3629,2.31746e-05,148205878,0.946435
D.birchii,156593892,VNKA01007269.1,1,3626,2.31554e-05,148209504,0.946458
D.birchii,156593892,VNKA01005501.1,1,3624,2.31427e-05,148213128,0.946481
D.birchii,156593892,VNKA01005384.1,1,3623,2.31363e-05,148216751,0.946504
D.birchii,156593892,VNKA01005934.1,1,3622,2.31299e-05,148220373,0.946527
D.birchii,156593892,VNKA01000522.1,1,3622,2.31299e-05,148223995,0.94655
D.birchii,156593892,VNKA01000095.1,1,3622,2.31299e-05,148227617,0.946573
D.birchii,156593892,VNKA01006800.1,1,3621,2.31235e-05,148231238,0.946597
D.birchii,156593892,VNKA01005776.1,1,3618,2.31043e-05,148234856,0.94662
D.birchii,156593892,VNKA01003730.1,1,3618,2.31043e-05,148238474,0.946643
D.birchii,156593892,VNKA01006644.1,1,3615,2.30852e-05,148242089,0.946666
D.birchii,156593892,VNKA01005571.1,1,3612,2.3066e-05,148245701,0.946689
D.birchii,156593892,VNKA01004972.1,1,3612,2.3066e-05,148249313,0.946712
D.birchii,156593892,VNKA01004515.1,1,3612,2.3066e-05,148252925,0.946735
D.birchii,156593892,VNKA01002373.1,1,3611,2.30596e-05,148256536,0.946758
D.birchii,156593892,VNKA01006809.1,1,3610,2.30533e-05,148260146,0.946781
D.birchii,156593892,VNKA01003330.1,1,3610,2.30533e-05,148263756,0.946804
D.birchii,156593892,VNKA01006416.1,1,3609,2.30469e-05,148267365,0.946827
D.birchii,156593892,VNKA01004309.1,1,3605,2.30213e-05,148270970,0.94685
D.birchii,156593892,VNKA01002761.1,1,3604,2.30149e-05,148274574,0.946873
D.birchii,156593892,VNKA01004959.1,1,3601,2.29958e-05,148278175,0.946896
D.birchii,156593892,VNKA01004018.1,1,3601,2.29958e-05,148281776,0.946919
D.birchii,156593892,VNKA01000068.1,1,3600,2.29894e-05,148285376,0.946942
D.birchii,156593892,VNKA01004923.1,1,3598,2.29766e-05,148288974,0.946965
D.birchii,156593892,VNKA01005909.1,1,3595,2.29575e-05,148292569,0.946988
D.birchii,156593892,VNKA01004917.1,1,3593,2.29447e-05,148296162,0.947011
D.birchii,156593892,VNKA01006926.1,1,3592,2.29383e-05,148299754,0.947034
D.birchii,156593892,VNKA01004817.1,1,3592,2.29383e-05,148303346,0.947057
D.birchii,156593892,VNKA01007224.1,1,3591,2.29319e-05,148306937,0.94708
D.birchii,156593892,VNKA01004228.1,1,3590,2.29255e-05,148310527,0.947103
D.birchii,156593892,VNKA01003961.1,1,3589,2.29192e-05,148314116,0.947126
D.birchii,156593892,VNKA01003155.1,1,3589,2.29192e-05,148317705,0.947149
D.birchii,156593892,VNKA01000054.1,1,3589,2.29192e-05,148321294,0.947172
D.birchii,156593892,VNKA01006464.1,1,3587,2.29064e-05,148324881,0.947195
D.birchii,156593892,VNKA01004129.1,1,3587,2.29064e-05,148328468,0.947217
D.birchii,156593892,VNKA01002826.1,1,3587,2.29064e-05,148332055,0.94724
D.birchii,156593892,VNKA01007182.1,1,3585,2.28936e-05,148335640,0.947263
D.birchii,156593892,VNKA01005889.1,1,3585,2.28936e-05,148339225,0.947286
D.birchii,156593892,VNKA01003578.1,1,3584,2.28872e-05,148342809,0.947309
D.birchii,156593892,VNKA01004857.1,1,3583,2.28808e-05,148346392,0.947332
D.birchii,156593892,VNKA01005362.1,1,3582,2.28745e-05,148349974,0.947355
D.birchii,156593892,VNKA01004146.1,1,3581,2.28681e-05,148353555,0.947378
D.birchii,156593892,VNKA01000156.1,1,3578,2.28489e-05,148357133,0.947401
D.birchii,156593892,VNKA01003995.1,1,3577,2.28425e-05,148360710,0.947423
D.birchii,156593892,VNKA01001409.1,1,3575,2.28298e-05,148364285,0.947446
D.birchii,156593892,VNKA01001874.1,1,3574,2.28234e-05,148367859,0.947469
D.birchii,156593892,VNKA01003994.1,1,3572,2.28106e-05,148371431,0.947492
D.birchii,156593892,VNKA01006515.1,1,3571,2.28042e-05,148375002,0.947515
D.birchii,156593892,VNKA01002557.1,1,3565,2.27659e-05,148378567,0.947537
D.birchii,156593892,VNKA01006474.1,1,3562,2.27467e-05,148382129,0.94756
D.birchii,156593892,VNKA01004658.1,1,3562,2.27467e-05,148385691,0.947583
D.birchii,156593892,VNKA01002823.1,1,3562,2.27467e-05,148389253,0.947606
D.birchii,156593892,VNKA01004043.1,1,3560,2.2734e-05,148392813,0.947628
D.birchii,156593892,VNKA01006501.1,1,3558,2.27212e-05,148396371,0.947651
D.birchii,156593892,VNKA01002596.1,1,3555,2.2702e-05,148399926,0.947674
D.birchii,156593892,VNKA01002423.1,1,3555,2.2702e-05,148403481,0.947696
D.birchii,156593892,VNKA01006774.1,1,3554,2.26956e-05,148407035,0.947719
D.birchii,156593892,VNKA01005341.1,1,3550,2.26701e-05,148410585,0.947742
D.birchii,156593892,VNKA01006028.1,1,3549,2.26637e-05,148414134,0.947765
D.birchii,156593892,VNKA01003902.1,1,3549,2.26637e-05,148417683,0.947787
D.birchii,156593892,VNKA01000997.1,1,3547,2.26509e-05,148421230,0.94781
D.birchii,156593892,VNKA01004797.1,1,3546,2.26446e-05,148424776,0.947832
D.birchii,156593892,VNKA01001325.1,1,3546,2.26446e-05,148428322,0.947855
D.birchii,156593892,VNKA01007381.1,1,3545,2.26382e-05,148431867,0.947878
D.birchii,156593892,VNKA01002560.1,1,3543,2.26254e-05,148435410,0.9479
D.birchii,156593892,VNKA01000913.1,1,3543,2.26254e-05,148438953,0.947923
D.birchii,156593892,VNKA01003893.1,1,3538,2.25935e-05,148442491,0.947946
D.birchii,156593892,VNKA01002929.1,1,3538,2.25935e-05,148446029,0.947968
D.birchii,156593892,VNKA01002282.1,1,3537,2.25871e-05,148449566,0.947991
D.birchii,156593892,VNKA01002545.1,1,3536,2.25807e-05,148453102,0.948013
D.birchii,156593892,VNKA01005857.1,1,3535,2.25743e-05,148456637,0.948036
D.birchii,156593892,VNKA01003931.1,1,3535,2.25743e-05,148460172,0.948059
D.birchii,156593892,VNKA01004925.1,1,3533,2.25615e-05,148463705,0.948081
D.birchii,156593892,VNKA01005749.1,1,3532,2.25552e-05,148467237,0.948104
D.birchii,156593892,VNKA01006216.1,1,3530,2.25424e-05,148470767,0.948126
D.birchii,156593892,VNKA01003327.1,1,3530,2.25424e-05,148474297,0.948149
D.birchii,156593892,VNKA01003191.1,1,3529,2.2536e-05,148477826,0.948171
D.birchii,156593892,VNKA01003972.1,1,3526,2.25168e-05,148481352,0.948194
D.birchii,156593892,VNKA01005346.1,1,3525,2.25105e-05,148484877,0.948216
D.birchii,156593892,VNKA01001353.1,1,3523,2.24977e-05,148488400,0.948239
D.birchii,156593892,VNKA01006278.1,1,3520,2.24785e-05,148491920,0.948261
D.birchii,156593892,VNKA01006568.1,1,3518,2.24658e-05,148495438,0.948284
D.birchii,156593892,VNKA01004031.1,1,3516,2.2453e-05,148498954,0.948306
D.birchii,156593892,VNKA01002425.1,1,3516,2.2453e-05,148502470,0.948329
D.birchii,156593892,VNKA01003176.1,1,3510,2.24147e-05,148505980,0.948351
D.birchii,156593892,VNKA01005570.1,1,3509,2.24083e-05,148509489,0.948373
D.birchii,156593892,VNKA01003966.1,1,3509,2.24083e-05,148512998,0.948396
D.birchii,156593892,VNKA01001299.1,1,3508,2.24019e-05,148516506,0.948418
D.birchii,156593892,VNKA01000364.1,1,3508,2.24019e-05,148520014,0.948441
D.birchii,156593892,VNKA01004317.1,1,3504,2.23764e-05,148523518,0.948463
D.birchii,156593892,VNKA01007114.1,1,3501,2.23572e-05,148527019,0.948485
D.birchii,156593892,VNKA01002169.1,1,3501,2.23572e-05,148530520,0.948508
D.birchii,156593892,VNKA01000846.1,1,3499,2.23444e-05,148534019,0.94853
D.birchii,156593892,VNKA01006356.1,1,3498,2.2338e-05,148537517,0.948552
D.birchii,156593892,VNKA01001175.1,1,3496,2.23253e-05,148541013,0.948575
D.birchii,156593892,VNKA01003505.1,1,3495,2.23189e-05,148544508,0.948597
D.birchii,156593892,VNKA01006355.1,1,3492,2.22997e-05,148548000,0.948619
D.birchii,156593892,VNKA01001814.1,1,3492,2.22997e-05,148551492,0.948642
D.birchii,156593892,VNKA01006107.1,1,3489,2.22806e-05,148554981,0.948664
D.birchii,156593892,VNKA01002209.1,1,3489,2.22806e-05,148558470,0.948686
D.birchii,156593892,VNKA01006225.1,1,3485,2.2255e-05,148561955,0.948708
D.birchii,156593892,VNKA01003919.1,1,3485,2.2255e-05,148565440,0.948731
D.birchii,156593892,VNKA01003416.1,1,3483,2.22422e-05,148568923,0.948753
D.birchii,156593892,VNKA01006921.1,1,3481,2.22295e-05,148572404,0.948775
D.birchii,156593892,VNKA01001330.1,1,3481,2.22295e-05,148575885,0.948797
D.birchii,156593892,VNKA01001039.1,1,3480,2.22231e-05,148579365,0.94882
D.birchii,156593892,VNKA01004017.1,1,3479,2.22167e-05,148582844,0.948842
D.birchii,156593892,VNKA01000056.1,1,3474,2.21848e-05,148586318,0.948864
D.birchii,156593892,VNKA01006220.1,1,3473,2.21784e-05,148589791,0.948886
D.birchii,156593892,VNKA01000601.1,1,3470,2.21592e-05,148593261,0.948908
D.birchii,156593892,VNKA01001055.1,1,3468,2.21465e-05,148596729,0.948931
D.birchii,156593892,VNKA01000349.1,1,3466,2.21337e-05,148600195,0.948953
D.birchii,156593892,VNKA01006321.1,1,3465,2.21273e-05,148603660,0.948975
D.birchii,156593892,VNKA01001294.1,1,3464,2.21209e-05,148607124,0.948997
D.birchii,156593892,VNKA01004358.1,1,3463,2.21145e-05,148610587,0.949019
D.birchii,156593892,VNKA01001928.1,1,3462,2.21081e-05,148614049,0.949041
D.birchii,156593892,VNKA01005337.1,1,3459,2.2089e-05,148617508,0.949063
D.birchii,156593892,VNKA01004852.1,1,3458,2.20826e-05,148620966,0.949085
D.birchii,156593892,VNKA01003269.1,1,3458,2.20826e-05,148624424,0.949107
D.birchii,156593892,VNKA01000583.1,1,3456,2.20698e-05,148627880,0.949129
D.birchii,156593892,VNKA01006715.1,1,3455,2.20634e-05,148631335,0.949152
D.birchii,156593892,VNKA01004472.1,1,3454,2.20571e-05,148634789,0.949174
D.birchii,156593892,VNKA01006277.1,1,3452,2.20443e-05,148638241,0.949196
D.birchii,156593892,VNKA01001192.1,1,3452,2.20443e-05,148641693,0.949218
D.birchii,156593892,VNKA01006215.1,1,3449,2.20251e-05,148645142,0.94924
D.birchii,156593892,VNKA01004833.1,1,3448,2.20187e-05,148648590,0.949262
D.birchii,156593892,VNKA01003890.1,1,3443,2.19868e-05,148652033,0.949284
D.birchii,156593892,VNKA01003984.1,1,3441,2.1974e-05,148655474,0.949306
D.birchii,156593892,VNKA01002240.1,1,3439,2.19613e-05,148658913,0.949328
D.birchii,156593892,VNKA01002385.1,1,3438,2.19549e-05,148662351,0.94935
D.birchii,156593892,VNKA01000678.1,1,3438,2.19549e-05,148665789,0.949372
D.birchii,156593892,VNKA01002457.1,1,3436,2.19421e-05,148669225,0.949394
D.birchii,156593892,VNKA01007295.1,1,3432,2.19166e-05,148672657,0.949415
D.birchii,156593892,VNKA01002920.1,1,3430,2.19038e-05,148676087,0.949437
D.birchii,156593892,VNKA01001378.1,1,3429,2.18974e-05,148679516,0.949459
D.birchii,156593892,VNKA01002211.1,1,3427,2.18846e-05,148682943,0.949481
D.birchii,156593892,VNKA01000489.1,1,3427,2.18846e-05,148686370,0.949503
D.birchii,156593892,VNKA01000356.1,1,3427,2.18846e-05,148689797,0.949525
D.birchii,156593892,VNKA01007248.1,1,3426,2.18782e-05,148693223,0.949547
D.birchii,156593892,VNKA01004342.1,1,3425,2.18719e-05,148696648,0.949569
D.birchii,156593892,VNKA01007141.1,1,3423,2.18591e-05,148700071,0.94959
D.birchii,156593892,VNKA01000878.1,1,3423,2.18591e-05,148703494,0.949612
D.birchii,156593892,VNKA01003426.1,1,3420,2.18399e-05,148706914,0.949634
D.birchii,156593892,VNKA01006523.1,1,3419,2.18335e-05,148710333,0.949656
D.birchii,156593892,VNKA01002676.1,1,3418,2.18272e-05,148713751,0.949678
D.birchii,156593892,VNKA01003555.1,1,3417,2.18208e-05,148717168,0.9497
D.birchii,156593892,VNKA01005577.1,1,3409,2.17697e-05,148720577,0.949721
D.birchii,156593892,VNKA01004596.1,1,3409,2.17697e-05,148723986,0.949743
D.birchii,156593892,VNKA01006804.1,1,3406,2.17505e-05,148727392,0.949765
D.birchii,156593892,VNKA01001420.1,1,3406,2.17505e-05,148730798,0.949787
D.birchii,156593892,VNKA01000109.1,1,3406,2.17505e-05,148734204,0.949808
D.birchii,156593892,VNKA01000067.1,1,3406,2.17505e-05,148737610,0.94983
D.birchii,156593892,VNKA01005386.1,1,3402,2.1725e-05,148741012,0.949852
D.birchii,156593892,VNKA01000520.1,1,3401,2.17186e-05,148744413,0.949874
D.birchii,156593892,VNKA01005932.1,1,3400,2.17122e-05,148747813,0.949895
D.birchii,156593892,VNKA01001804.1,1,3400,2.17122e-05,148751213,0.949917
D.birchii,156593892,VNKA01003838.1,1,3397,2.16931e-05,148754610,0.949939
D.birchii,156593892,VNKA01003301.1,1,3397,2.16931e-05,148758007,0.94996
D.birchii,156593892,VNKA01004543.1,1,3395,2.16803e-05,148761402,0.949982
D.birchii,156593892,VNKA01005871.1,1,3394,2.16739e-05,148764796,0.950004
D.birchii,156593892,VNKA01003894.1,1,3394,2.16739e-05,148768190,0.950025
D.birchii,156593892,VNKA01001732.1,1,3394,2.16739e-05,148771584,0.950047
D.birchii,156593892,VNKA01000965.1,1,3394,2.16739e-05,148774978,0.950069
D.birchii,156593892,VNKA01002729.1,1,3393,2.16675e-05,148778371,0.950091
D.birchii,156593892,VNKA01006170.1,1,3390,2.16484e-05,148781761,0.950112
D.birchii,156593892,VNKA01002651.1,1,3385,2.16164e-05,148785146,0.950134
D.birchii,156593892,VNKA01006710.1,1,3380,2.15845e-05,148788526,0.950155
D.birchii,156593892,VNKA01001136.1,1,3378,2.15717e-05,148791904,0.950177
D.birchii,156593892,VNKA01004239.1,1,3377,2.15653e-05,148795281,0.950198
D.birchii,156593892,VNKA01004412.1,1,3376,2.1559e-05,148798657,0.95022
D.birchii,156593892,VNKA01002471.1,1,3375,2.15526e-05,148802032,0.950242
D.birchii,156593892,VNKA01000143.1,1,3375,2.15526e-05,148805407,0.950263
D.birchii,156593892,VNKA01000064.1,1,3375,2.15526e-05,148808782,0.950285
D.birchii,156593892,VNKA01003015.1,1,3371,2.1527e-05,148812153,0.950306
D.birchii,156593892,VNKA01005943.1,1,3370,2.15206e-05,148815523,0.950328
D.birchii,156593892,VNKA01004578.1,1,3369,2.15142e-05,148818892,0.950349
D.birchii,156593892,VNKA01000303.1,1,3367,2.15015e-05,148822259,0.950371
D.birchii,156593892,VNKA01002289.1,1,3361,2.14632e-05,148825620,0.950392
D.birchii,156593892,VNKA01002697.1,1,3359,2.14504e-05,148828979,0.950414
D.birchii,156593892,VNKA01000292.1,1,3359,2.14504e-05,148832338,0.950435
D.birchii,156593892,VNKA01004199.1,1,3357,2.14376e-05,148835695,0.950457
D.birchii,156593892,VNKA01007558.1,1,3355,2.14248e-05,148839050,0.950478
D.birchii,156593892,VNKA01004955.1,1,3355,2.14248e-05,148842405,0.950499
D.birchii,156593892,VNKA01003874.1,1,3355,2.14248e-05,148845760,0.950521
D.birchii,156593892,VNKA01000529.1,1,3355,2.14248e-05,148849115,0.950542
D.birchii,156593892,VNKA01001442.1,1,3354,2.14185e-05,148852469,0.950564
D.birchii,156593892,VNKA01007088.1,1,3352,2.14057e-05,148855821,0.950585
D.birchii,156593892,VNKA01000545.1,1,3352,2.14057e-05,148859173,0.950607
D.birchii,156593892,VNKA01002383.1,1,3351,2.13993e-05,148862524,0.950628
D.birchii,156593892,VNKA01001741.1,1,3351,2.13993e-05,148865875,0.950649
D.birchii,156593892,VNKA01003146.1,1,3350,2.13929e-05,148869225,0.950671
D.birchii,156593892,VNKA01001760.1,1,3350,2.13929e-05,148872575,0.950692
D.birchii,156593892,VNKA01001563.1,1,3348,2.13801e-05,148875923,0.950713
D.birchii,156593892,VNKA01001503.1,1,3348,2.13801e-05,148879271,0.950735
D.birchii,156593892,VNKA01005018.1,1,3347,2.13738e-05,148882618,0.950756
D.birchii,156593892,VNKA01004922.1,1,3347,2.13738e-05,148885965,0.950778
D.birchii,156593892,VNKA01003263.1,1,3345,2.1361e-05,148889310,0.950799
D.birchii,156593892,VNKA01002130.1,1,3345,2.1361e-05,148892655,0.95082
D.birchii,156593892,VNKA01003726.1,1,3343,2.13482e-05,148895998,0.950842
D.birchii,156593892,VNKA01001727.1,1,3341,2.13354e-05,148899339,0.950863
D.birchii,156593892,VNKA01000053.1,1,3341,2.13354e-05,148902680,0.950884
D.birchii,156593892,VNKA01007090.1,1,3340,2.13291e-05,148906020,0.950906
D.birchii,156593892,VNKA01000478.1,1,3339,2.13227e-05,148909359,0.950927
D.birchii,156593892,VNKA01000275.1,1,3338,2.13163e-05,148912697,0.950948
D.birchii,156593892,VNKA01005696.1,1,3336,2.13035e-05,148916033,0.95097
D.birchii,156593892,VNKA01004194.1,1,3336,2.13035e-05,148919369,0.950991
D.birchii,156593892,VNKA01002340.1,1,3336,2.13035e-05,148922705,0.951012
D.birchii,156593892,VNKA01004125.1,1,3334,2.12907e-05,148926039,0.951034
D.birchii,156593892,VNKA01000915.1,1,3327,2.1246e-05,148929366,0.951055
D.birchii,156593892,VNKA01000301.1,1,3327,2.1246e-05,148932693,0.951076
D.birchii,156593892,VNKA01002204.1,1,3326,2.12397e-05,148936019,0.951097
D.birchii,156593892,VNKA01005633.1,1,3324,2.12269e-05,148939343,0.951118
D.birchii,156593892,VNKA01006379.1,1,3322,2.12141e-05,148942665,0.95114
D.birchii,156593892,VNKA01004498.1,1,3322,2.12141e-05,148945987,0.951161
D.birchii,156593892,VNKA01003867.1,1,3321,2.12077e-05,148949308,0.951182
D.birchii,156593892,VNKA01001153.1,1,3319,2.1195e-05,148952627,0.951203
D.birchii,156593892,VNKA01005128.1,1,3316,2.11758e-05,148955943,0.951224
D.birchii,156593892,VNKA01006716.1,1,3315,2.11694e-05,148959258,0.951246
D.birchii,156593892,VNKA01005296.1,1,3315,2.11694e-05,148962573,0.951267
D.birchii,156593892,VNKA01002812.1,1,3315,2.11694e-05,148965888,0.951288
D.birchii,156593892,VNKA01000157.1,1,3313,2.11566e-05,148969201,0.951309
D.birchii,156593892,VNKA01005670.1,1,3312,2.11503e-05,148972513,0.95133
D.birchii,156593892,VNKA01006697.1,1,3311,2.11439e-05,148975824,0.951351
D.birchii,156593892,VNKA01000996.1,1,3311,2.11439e-05,148979135,0.951373
D.birchii,156593892,VNKA01007144.1,1,3310,2.11375e-05,148982445,0.951394
D.birchii,156593892,VNKA01003532.1,1,3308,2.11247e-05,148985753,0.951415
D.birchii,156593892,VNKA01001093.1,1,3308,2.11247e-05,148989061,0.951436
D.birchii,156593892,VNKA01005334.1,1,3307,2.11183e-05,148992368,0.951457
D.birchii,156593892,VNKA01001582.1,1,3307,2.11183e-05,148995675,0.951478
D.birchii,156593892,VNKA01003212.1,1,3302,2.10864e-05,148998977,0.951499
D.birchii,156593892,VNKA01006726.1,1,3301,2.108e-05,149002278,0.95152
D.birchii,156593892,VNKA01005922.1,1,3300,2.10736e-05,149005578,0.951541
D.birchii,156593892,VNKA01001297.1,1,3296,2.10481e-05,149008874,0.951562
D.birchii,156593892,VNKA01001349.1,1,3295,2.10417e-05,149012169,0.951584
D.birchii,156593892,VNKA01001051.1,1,3295,2.10417e-05,149015464,0.951605
D.birchii,156593892,VNKA01005482.1,1,3293,2.10289e-05,149018757,0.951626
D.birchii,156593892,VNKA01006446.1,1,3292,2.10225e-05,149022049,0.951647
D.birchii,156593892,VNKA01006123.1,1,3290,2.10098e-05,149025339,0.951668
D.birchii,156593892,VNKA01004599.1,1,3286,2.09842e-05,149028625,0.951689
D.birchii,156593892,VNKA01006866.1,1,3285,2.09778e-05,149031910,0.95171
D.birchii,156593892,VNKA01004458.1,1,3285,2.09778e-05,149035195,0.951731
D.birchii,156593892,VNKA01002849.1,1,3285,2.09778e-05,149038480,0.951752
D.birchii,156593892,VNKA01001009.1,1,3282,2.09587e-05,149041762,0.951773
D.birchii,156593892,VNKA01003340.1,1,3280,2.09459e-05,149045042,0.951793
D.birchii,156593892,VNKA01003477.1,1,3277,2.09267e-05,149048319,0.951814
D.birchii,156593892,VNKA01004724.1,1,3274,2.09076e-05,149051593,0.951835
D.birchii,156593892,VNKA01004297.1,1,3273,2.09012e-05,149054866,0.951856
D.birchii,156593892,VNKA01002075.1,1,3273,2.09012e-05,149058139,0.951877
D.birchii,156593892,VNKA01000865.1,1,3273,2.09012e-05,149061412,0.951898
D.birchii,156593892,VNKA01002642.1,1,3272,2.08948e-05,149064684,0.951919
D.birchii,156593892,VNKA01004954.1,1,3270,2.0882e-05,149067954,0.95194
D.birchii,156593892,VNKA01001631.1,1,3270,2.0882e-05,149071224,0.951961
D.birchii,156593892,VNKA01003317.1,1,3269,2.08757e-05,149074493,0.951982
D.birchii,156593892,VNKA01000812.1,1,3269,2.08757e-05,149077762,0.952002
D.birchii,156593892,VNKA01007290.1,1,3268,2.08693e-05,149081030,0.952023
D.birchii,156593892,VNKA01006519.1,1,3265,2.08501e-05,149084295,0.952044
D.birchii,156593892,VNKA01004979.1,1,3264,2.08437e-05,149087559,0.952065
D.birchii,156593892,VNKA01000603.1,1,3264,2.08437e-05,149090823,0.952086
D.birchii,156593892,VNKA01005726.1,1,3263,2.08373e-05,149094086,0.952107
D.birchii,156593892,VNKA01006348.1,1,3259,2.08118e-05,149097345,0.952127
D.birchii,156593892,VNKA01006653.1,1,3256,2.07926e-05,149100601,0.952148
D.birchii,156593892,VNKA01001591.1,1,3254,2.07799e-05,149103855,0.952169
D.birchii,156593892,VNKA01003982.1,1,3252,2.07671e-05,149107107,0.95219
D.birchii,156593892,VNKA01002612.1,1,3252,2.07671e-05,149110359,0.952211
D.birchii,156593892,VNKA01007356.1,1,3251,2.07607e-05,149113610,0.952231
D.birchii,156593892,VNKA01005407.1,1,3251,2.07607e-05,149116861,0.952252
D.birchii,156593892,VNKA01003037.1,1,3251,2.07607e-05,149120112,0.952273
D.birchii,156593892,VNKA01004081.1,1,3246,2.07288e-05,149123358,0.952294
D.birchii,156593892,VNKA01000887.1,1,3246,2.07288e-05,149126604,0.952314
D.birchii,156593892,VNKA01005308.1,1,3245,2.07224e-05,149129849,0.952335
D.birchii,156593892,VNKA01002808.1,1,3245,2.07224e-05,149133094,0.952356
D.birchii,156593892,VNKA01002386.1,1,3245,2.07224e-05,149136339,0.952376
D.birchii,156593892,VNKA01002071.1,1,3244,2.0716e-05,149139583,0.952397
D.birchii,156593892,VNKA01006088.1,1,3243,2.07096e-05,149142826,0.952418
D.birchii,156593892,VNKA01006844.1,1,3241,2.06968e-05,149146067,0.952439
D.birchii,156593892,VNKA01007327.1,1,3239,2.06841e-05,149149306,0.952459
D.birchii,156593892,VNKA01002085.1,1,3238,2.06777e-05,149152544,0.95248
D.birchii,156593892,VNKA01000647.1,1,3238,2.06777e-05,149155782,0.952501
D.birchii,156593892,VNKA01003531.1,1,3237,2.06713e-05,149159019,0.952521
D.birchii,156593892,VNKA01001565.1,1,3234,2.06521e-05,149162253,0.952542
D.birchii,156593892,VNKA01004090.1,1,3230,2.06266e-05,149165483,0.952563
D.birchii,156593892,VNKA01001891.1,1,3230,2.06266e-05,149168713,0.952583
D.birchii,156593892,VNKA01002962.1,1,3226,2.06011e-05,149171939,0.952604
D.birchii,156593892,VNKA01003222.1,1,3224,2.05883e-05,149175163,0.952624
D.birchii,156593892,VNKA01004128.1,1,3222,2.05755e-05,149178385,0.952645
D.birchii,156593892,VNKA01004434.1,1,3218,2.055e-05,149181603,0.952666
D.birchii,156593892,VNKA01002019.1,1,3217,2.05436e-05,149184820,0.952686
D.birchii,156593892,VNKA01002334.1,1,3216,2.05372e-05,149188036,0.952707
D.birchii,156593892,VNKA01002822.1,1,3211,2.05053e-05,149191247,0.952727
D.birchii,156593892,VNKA01006966.1,1,3208,2.04861e-05,149194455,0.952748
D.birchii,156593892,VNKA01002592.1,1,3208,2.04861e-05,149197663,0.952768
D.birchii,156593892,VNKA01002332.1,1,3208,2.04861e-05,149200871,0.952789
D.birchii,156593892,VNKA01005314.1,1,3206,2.04733e-05,149204077,0.952809
D.birchii,156593892,VNKA01001358.1,1,3206,2.04733e-05,149207283,0.95283
D.birchii,156593892,VNKA01005941.1,1,3205,2.0467e-05,149210488,0.95285
D.birchii,156593892,VNKA01004605.1,1,3204,2.04606e-05,149213692,0.95287
D.birchii,156593892,VNKA01006027.1,1,3203,2.04542e-05,149216895,0.952891
D.birchii,156593892,VNKA01002283.1,1,3201,2.04414e-05,149220096,0.952911
D.birchii,156593892,VNKA01004686.1,1,3198,2.04223e-05,149223294,0.952932
D.birchii,156593892,VNKA01001478.1,1,3198,2.04223e-05,149226492,0.952952
D.birchii,156593892,VNKA01003922.1,1,3197,2.04159e-05,149229689,0.952973
D.birchii,156593892,VNKA01004876.1,1,3196,2.04095e-05,149232885,0.952993
D.birchii,156593892,VNKA01000871.1,1,3196,2.04095e-05,149236081,0.953013
D.birchii,156593892,VNKA01003226.1,1,3195,2.04031e-05,149239276,0.953034
D.birchii,156593892,VNKA01004750.1,1,3193,2.03903e-05,149242469,0.953054
D.birchii,156593892,VNKA01005606.1,1,3192,2.03839e-05,149245661,0.953075
D.birchii,156593892,VNKA01005907.1,1,3191,2.03776e-05,149248852,0.953095
D.birchii,156593892,VNKA01005258.1,1,3191,2.03776e-05,149252043,0.953115
D.birchii,156593892,VNKA01005641.1,1,3190,2.03712e-05,149255233,0.953136
D.birchii,156593892,VNKA01005355.1,1,3178,2.02945e-05,149258411,0.953156
D.birchii,156593892,VNKA01003924.1,1,3178,2.02945e-05,149261589,0.953176
D.birchii,156593892,VNKA01002880.1,1,3178,2.02945e-05,149264767,0.953197
D.birchii,156593892,VNKA01005662.1,1,3174,2.0269e-05,149267941,0.953217
D.birchii,156593892,VNKA01000542.1,1,3174,2.0269e-05,149271115,0.953237
D.birchii,156593892,VNKA01000162.1,1,3173,2.02626e-05,149274288,0.953257
D.birchii,156593892,VNKA01002333.1,1,3172,2.02562e-05,149277460,0.953278
D.birchii,156593892,VNKA01006402.1,1,3168,2.02307e-05,149280628,0.953298
D.birchii,156593892,VNKA01005916.1,1,3165,2.02115e-05,149283793,0.953318
D.birchii,156593892,VNKA01004264.1,1,3164,2.02051e-05,149286957,0.953338
D.birchii,156593892,VNKA01001679.1,1,3163,2.01987e-05,149290120,0.953359
D.birchii,156593892,VNKA01003869.1,1,3161,2.0186e-05,149293281,0.953379
D.birchii,156593892,VNKA01003522.1,1,3159,2.01732e-05,149296440,0.953399
D.birchii,156593892,VNKA01000841.1,1,3159,2.01732e-05,149299599,0.953419
D.birchii,156593892,VNKA01004116.1,1,3157,2.01604e-05,149302756,0.953439
D.birchii,156593892,VNKA01002215.1,1,3157,2.01604e-05,149305913,0.953459
D.birchii,156593892,VNKA01007021.1,1,3156,2.0154e-05,149309069,0.95348
D.birchii,156593892,VNKA01006407.1,1,3155,2.01477e-05,149312224,0.9535
D.birchii,156593892,VNKA01003145.1,1,3154,2.01413e-05,149315378,0.95352
D.birchii,156593892,VNKA01007002.1,1,3152,2.01285e-05,149318530,0.95354
D.birchii,156593892,VNKA01003761.1,1,3152,2.01285e-05,149321682,0.95356
D.birchii,156593892,VNKA01002566.1,1,3151,2.01221e-05,149324833,0.95358
D.birchii,156593892,VNKA01000167.1,1,3150,2.01157e-05,149327983,0.9536
D.birchii,156593892,VNKA01001383.1,1,3149,2.01093e-05,149331132,0.95362
D.birchii,156593892,VNKA01002631.1,1,3148,2.0103e-05,149334280,0.953641
D.birchii,156593892,VNKA01007271.1,1,3146,2.00902e-05,149337426,0.953661
D.birchii,156593892,VNKA01006059.1,1,3145,2.00838e-05,149340571,0.953681
D.birchii,156593892,VNKA01005496.1,1,3142,2.00646e-05,149343713,0.953701
D.birchii,156593892,VNKA01006381.1,1,3141,2.00583e-05,149346854,0.953721
D.birchii,156593892,VNKA01002384.1,1,3141,2.00583e-05,149349995,0.953741
D.birchii,156593892,VNKA01001645.1,1,3138,2.00391e-05,149353133,0.953761
D.birchii,156593892,VNKA01000322.1,1,3137,2.00327e-05,149356270,0.953781
D.birchii,156593892,VNKA01001183.1,1,3136,2.00263e-05,149359406,0.953801
D.birchii,156593892,VNKA01005031.1,1,3135,2.00199e-05,149362541,0.953821
D.birchii,156593892,VNKA01001194.1,1,3135,2.00199e-05,149365676,0.953841
D.birchii,156593892,VNKA01002972.1,1,3134,2.00136e-05,149368810,0.953861
D.birchii,156593892,VNKA01001476.1,1,3133,2.00072e-05,149371943,0.953881
D.birchii,156593892,VNKA01000327.1,1,3133,2.00072e-05,149375076,0.953901
D.birchii,156593892,VNKA01001314.1,1,3132,2.00008e-05,149378208,0.953921
D.birchii,156593892,VNKA01006070.1,1,3131,1.99944e-05,149381339,0.953941
D.birchii,156593892,VNKA01005269.1,1,3128,1.99752e-05,149384467,0.953961
D.birchii,156593892,VNKA01004157.1,1,3127,1.99689e-05,149387594,0.953981
D.birchii,156593892,VNKA01006099.1,1,3125,1.99561e-05,149390719,0.954001
D.birchii,156593892,VNKA01000338.1,1,3123,1.99433e-05,149393842,0.954021
D.birchii,156593892,VNKA01005611.1,1,3121,1.99305e-05,149396963,0.954041
D.birchii,156593892,VNKA01003286.1,1,3121,1.99305e-05,149400084,0.954061
D.birchii,156593892,VNKA01002186.1,1,3121,1.99305e-05,149403205,0.954081
D.birchii,156593892,VNKA01001460.1,1,3121,1.99305e-05,149406326,0.954101
D.birchii,156593892,VNKA01007315.1,1,3120,1.99241e-05,149409446,0.954121
D.birchii,156593892,VNKA01003147.1,1,3120,1.99241e-05,149412566,0.95414
D.birchii,156593892,VNKA01001310.1,1,3120,1.99241e-05,149415686,0.95416
D.birchii,156593892,VNKA01004639.1,1,3118,1.99114e-05,149418804,0.95418
D.birchii,156593892,VNKA01002451.1,1,3118,1.99114e-05,149421922,0.9542
D.birchii,156593892,VNKA01000658.1,1,3116,1.98986e-05,149425038,0.95422
D.birchii,156593892,VNKA01005167.1,1,3115,1.98922e-05,149428153,0.95424
D.birchii,156593892,VNKA01003405.1,1,3115,1.98922e-05,149431268,0.95426
D.birchii,156593892,VNKA01001038.1,1,3115,1.98922e-05,149434383,0.95428
D.birchii,156593892,VNKA01000736.1,1,3115,1.98922e-05,149437498,0.9543
D.birchii,156593892,VNKA01004019.1,1,3114,1.98858e-05,149440612,0.95432
D.birchii,156593892,VNKA01007444.1,1,3113,1.98794e-05,149443725,0.954339
D.birchii,156593892,VNKA01003355.1,1,3113,1.98794e-05,149446838,0.954359
D.birchii,156593892,VNKA01004741.1,1,3112,1.98731e-05,149449950,0.954379
D.birchii,156593892,VNKA01001073.1,1,3112,1.98731e-05,149453062,0.954399
D.birchii,156593892,VNKA01000026.1,1,3112,1.98731e-05,149456174,0.954419
D.birchii,156593892,VNKA01007151.1,1,3111,1.98667e-05,149459285,0.954439
D.birchii,156593892,VNKA01006592.1,1,3111,1.98667e-05,149462396,0.954459
D.birchii,156593892,VNKA01001996.1,1,3109,1.98539e-05,149465505,0.954479
D.birchii,156593892,VNKA01005917.1,1,3105,1.98284e-05,149468610,0.954498
D.birchii,156593892,VNKA01001757.1,1,3105,1.98284e-05,149471715,0.954518
D.birchii,156593892,VNKA01002338.1,1,3104,1.9822e-05,149474819,0.954538
D.birchii,156593892,VNKA01004812.1,1,3103,1.98156e-05,149477922,0.954558
D.birchii,156593892,VNKA01003463.1,1,3103,1.98156e-05,149481025,0.954578
D.birchii,156593892,VNKA01002584.1,1,3101,1.98028e-05,149484126,0.954597
D.birchii,156593892,VNKA01006038.1,1,3100,1.97964e-05,149487226,0.954617
D.birchii,156593892,VNKA01004863.1,1,3099,1.979e-05,149490325,0.954637
D.birchii,156593892,VNKA01003725.1,1,3099,1.979e-05,149493424,0.954657
D.birchii,156593892,VNKA01002968.1,1,3098,1.97837e-05,149496522,0.954677
D.birchii,156593892,VNKA01001247.1,1,3098,1.97837e-05,149499620,0.954696
D.birchii,156593892,VNKA01003216.1,1,3096,1.97709e-05,149502716,0.954716
D.birchii,156593892,VNKA01002736.1,1,3094,1.97581e-05,149505810,0.954736
D.birchii,156593892,VNKA01003041.1,1,3093,1.97517e-05,149508903,0.954756
D.birchii,156593892,VNKA01002637.1,1,3093,1.97517e-05,149511996,0.954775
D.birchii,156593892,VNKA01007324.1,1,3090,1.97326e-05,149515086,0.954795
D.birchii,156593892,VNKA01005797.1,1,3090,1.97326e-05,149518176,0.954815
D.birchii,156593892,VNKA01004909.1,1,3090,1.97326e-05,149521266,0.954835
D.birchii,156593892,VNKA01007080.1,1,3088,1.97198e-05,149524354,0.954854
D.birchii,156593892,VNKA01007070.1,1,3086,1.9707e-05,149527440,0.954874
D.birchii,156593892,VNKA01005259.1,1,3086,1.9707e-05,149530526,0.954894
D.birchii,156593892,VNKA01001992.1,1,3085,1.97006e-05,149533611,0.954913
D.birchii,156593892,VNKA01000224.1,1,3083,1.96879e-05,149536694,0.954933
D.birchii,156593892,VNKA01004950.1,1,3082,1.96815e-05,149539776,0.954953
D.birchii,156593892,VNKA01002985.1,1,3082,1.96815e-05,149542858,0.954972
D.birchii,156593892,VNKA01002315.1,1,3082,1.96815e-05,149545940,0.954992
D.birchii,156593892,VNKA01001919.1,1,3082,1.96815e-05,149549022,0.955012
D.birchii,156593892,VNKA01003253.1,1,3078,1.96559e-05,149552100,0.955032
D.birchii,156593892,VNKA01000352.1,1,3078,1.96559e-05,149555178,0.955051
D.birchii,156593892,VNKA01000735.1,1,3077,1.96496e-05,149558255,0.955071
D.birchii,156593892,VNKA01001796.1,1,3076,1.96432e-05,149561331,0.95509
D.birchii,156593892,VNKA01001348.1,1,3075,1.96368e-05,149564406,0.95511
D.birchii,156593892,VNKA01006655.1,1,3074,1.96304e-05,149567480,0.95513
D.birchii,156593892,VNKA01006593.1,1,3074,1.96304e-05,149570554,0.955149
D.birchii,156593892,VNKA01003303.1,1,3074,1.96304e-05,149573628,0.955169
D.birchii,156593892,VNKA01001336.1,1,3073,1.9624e-05,149576701,0.955189
D.birchii,156593892,VNKA01000296.1,1,3073,1.9624e-05,149579774,0.955208
D.birchii,156593892,VNKA01007532.1,1,3071,1.96112e-05,149582845,0.955228
D.birchii,156593892,VNKA01004653.1,1,3071,1.96112e-05,149585916,0.955247
D.birchii,156593892,VNKA01005663.1,1,3070,1.96049e-05,149588986,0.955267
D.birchii,156593892,VNKA01002987.1,1,3070,1.96049e-05,149592056,0.955287
D.birchii,156593892,VNKA01006071.1,1,3069,1.95985e-05,149595125,0.955306
D.birchii,156593892,VNKA01002528.1,1,3067,1.95857e-05,149598192,0.955326
D.birchii,156593892,VNKA01000793.1,1,3067,1.95857e-05,149601259,0.955345
D.birchii,156593892,VNKA01004363.1,1,3066,1.95793e-05,149604325,0.955365
D.birchii,156593892,VNKA01003587.1,1,3066,1.95793e-05,149607391,0.955385
D.birchii,156593892,VNKA01000797.1,1,3066,1.95793e-05,149610457,0.955404
D.birchii,156593892,VNKA01005153.1,1,3061,1.95474e-05,149613518,0.955424
D.birchii,156593892,VNKA01007374.1,1,3060,1.9541e-05,149616578,0.955443
D.birchii,156593892,VNKA01004730.1,1,3059,1.95346e-05,149619637,0.955463
D.birchii,156593892,VNKA01004030.1,1,3056,1.95154e-05,149622693,0.955482
D.birchii,156593892,VNKA01002904.1,1,3056,1.95154e-05,149625749,0.955502
D.birchii,156593892,VNKA01000472.1,1,3056,1.95154e-05,149628805,0.955521
D.birchii,156593892,VNKA01006126.1,1,3055,1.95091e-05,149631860,0.955541
D.birchii,156593892,VNKA01001733.1,1,3055,1.95091e-05,149634915,0.95556
D.birchii,156593892,VNKA01001159.1,1,3054,1.95027e-05,149637969,0.95558
D.birchii,156593892,VNKA01005422.1,1,3052,1.94899e-05,149641021,0.955599
D.birchii,156593892,VNKA01003930.1,1,3052,1.94899e-05,149644073,0.955619
D.birchii,156593892,VNKA01006922.1,1,3051,1.94835e-05,149647124,0.955638
D.birchii,156593892,VNKA01006486.1,1,3051,1.94835e-05,149650175,0.955658
D.birchii,156593892,VNKA01005590.1,1,3049,1.94707e-05,149653224,0.955677
D.birchii,156593892,VNKA01002294.1,1,3049,1.94707e-05,149656273,0.955697
D.birchii,156593892,VNKA01001932.1,1,3048,1.94644e-05,149659321,0.955716
D.birchii,156593892,VNKA01006128.1,1,3046,1.94516e-05,149662367,0.955736
D.birchii,156593892,VNKA01004840.1,1,3046,1.94516e-05,149665413,0.955755
D.birchii,156593892,VNKA01004443.1,1,3046,1.94516e-05,149668459,0.955775
D.birchii,156593892,VNKA01003018.1,1,3046,1.94516e-05,149671505,0.955794
D.birchii,156593892,VNKA01004502.1,1,3044,1.94388e-05,149674549,0.955813
D.birchii,156593892,VNKA01005290.1,1,3043,1.94324e-05,149677592,0.955833
D.birchii,156593892,VNKA01005959.1,1,3042,1.9426e-05,149680634,0.955852
D.birchii,156593892,VNKA01001600.1,1,3039,1.94069e-05,149683673,0.955872
D.birchii,156593892,VNKA01005489.1,1,3038,1.94005e-05,149686711,0.955891
D.birchii,156593892,VNKA01002853.1,1,3038,1.94005e-05,149689749,0.955911
D.birchii,156593892,VNKA01000088.1,1,3038,1.94005e-05,149692787,0.95593
D.birchii,156593892,VNKA01006130.1,1,3037,1.93941e-05,149695824,0.955949
D.birchii,156593892,VNKA01006129.1,1,3037,1.93941e-05,149698861,0.955969
D.birchii,156593892,VNKA01005063.1,1,3037,1.93941e-05,149701898,0.955988
D.birchii,156593892,VNKA01007024.1,1,3036,1.93877e-05,149704934,0.956007
D.birchii,156593892,VNKA01002303.1,1,3035,1.93813e-05,149707969,0.956027
D.birchii,156593892,VNKA01006311.1,1,3033,1.93686e-05,149711002,0.956046
D.birchii,156593892,VNKA01005803.1,1,3032,1.93622e-05,149714034,0.956066
D.birchii,156593892,VNKA01004245.1,1,3032,1.93622e-05,149717066,0.956085
D.birchii,156593892,VNKA01005510.1,1,3031,1.93558e-05,149720097,0.956104
D.birchii,156593892,VNKA01000097.1,1,3031,1.93558e-05,149723128,0.956124
D.birchii,156593892,VNKA01006468.1,1,3030,1.93494e-05,149726158,0.956143
D.birchii,156593892,VNKA01005582.1,1,3030,1.93494e-05,149729188,0.956162
D.birchii,156593892,VNKA01005115.1,1,3030,1.93494e-05,149732218,0.956182
D.birchii,156593892,VNKA01000287.1,1,3029,1.9343e-05,149735247,0.956201
D.birchii,156593892,VNKA01006132.1,1,3028,1.93366e-05,149738275,0.95622
D.birchii,156593892,VNKA01006131.1,1,3028,1.93366e-05,149741303,0.95624
D.birchii,156593892,VNKA01005521.1,1,3028,1.93366e-05,149744331,0.956259
D.birchii,156593892,VNKA01000606.1,1,3028,1.93366e-05,149747359,0.956278
D.birchii,156593892,VNKA01000100.1,1,3027,1.93303e-05,149750386,0.956298
D.birchii,156593892,VNKA01002492.1,1,3026,1.93239e-05,149753412,0.956317
D.birchii,156593892,VNKA01002135.1,1,3025,1.93175e-05,149756437,0.956336
D.birchii,156593892,VNKA01000378.1,1,3025,1.93175e-05,149759462,0.956356
D.birchii,156593892,VNKA01004973.1,1,3024,1.93111e-05,149762486,0.956375
D.birchii,156593892,VNKA01000989.1,1,3024,1.93111e-05,149765510,0.956394
D.birchii,156593892,VNKA01006984.1,1,3023,1.93047e-05,149768533,0.956414
D.birchii,156593892,VNKA01006133.1,1,3023,1.93047e-05,149771556,0.956433
D.birchii,156593892,VNKA01005794.1,1,3023,1.93047e-05,149774579,0.956452
D.birchii,156593892,VNKA01000474.1,1,3023,1.93047e-05,149777602,0.956472
D.birchii,156593892,VNKA01003215.1,1,3022,1.92983e-05,149780624,0.956491
D.birchii,156593892,VNKA01001898.1,1,3022,1.92983e-05,149783646,0.95651
D.birchii,156593892,VNKA01005673.1,1,3021,1.92919e-05,149786667,0.956529
D.birchii,156593892,VNKA01003553.1,1,3021,1.92919e-05,149789688,0.956549
D.birchii,156593892,VNKA01006124.1,1,3019,1.92792e-05,149792707,0.956568
D.birchii,156593892,VNKA01007259.1,1,3018,1.92728e-05,149795725,0.956587
D.birchii,156593892,VNKA01003399.1,1,3014,1.92472e-05,149798739,0.956607
D.birchii,156593892,VNKA01002185.1,1,3014,1.92472e-05,149801753,0.956626
D.birchii,156593892,VNKA01005172.1,1,3013,1.92409e-05,149804766,0.956645
D.birchii,156593892,VNKA01001196.1,1,3013,1.92409e-05,149807779,0.956664
D.birchii,156593892,VNKA01006687.1,1,3010,1.92217e-05,149810789,0.956683
D.birchii,156593892,VNKA01007219.1,1,3008,1.92089e-05,149813797,0.956703
D.birchii,156593892,VNKA01004045.1,1,3008,1.92089e-05,149816805,0.956722
D.birchii,156593892,VNKA01006719.1,1,3005,1.91898e-05,149819810,0.956741
D.birchii,156593892,VNKA01002181.1,1,3005,1.91898e-05,149822815,0.95676
D.birchii,156593892,VNKA01001355.1,1,3005,1.91898e-05,149825820,0.956779
D.birchii,156593892,VNKA01003076.1,1,3000,1.91578e-05,149828820,0.956799
D.birchii,156593892,VNKA01005266.1,1,2999,1.91514e-05,149831819,0.956818
D.birchii,156593892,VNKA01001800.1,1,2999,1.91514e-05,149834818,0.956837
D.birchii,156593892,VNKA01005203.1,1,2998,1.91451e-05,149837816,0.956856
D.birchii,156593892,VNKA01000982.1,1,2998,1.91451e-05,149840814,0.956875
D.birchii,156593892,VNKA01004294.1,1,2996,1.91323e-05,149843810,0.956894
D.birchii,156593892,VNKA01002184.1,1,2996,1.91323e-05,149846806,0.956913
D.birchii,156593892,VNKA01004951.1,1,2995,1.91259e-05,149849801,0.956933
D.birchii,156593892,VNKA01005187.1,1,2994,1.91195e-05,149852795,0.956952
D.birchii,156593892,VNKA01007555.1,1,2993,1.91131e-05,149855788,0.956971
D.birchii,156593892,VNKA01002680.1,1,2992,1.91067e-05,149858780,0.95699
D.birchii,156593892,VNKA01001863.1,1,2992,1.91067e-05,149861772,0.957009
D.birchii,156593892,VNKA01005371.1,1,2988,1.90812e-05,149864760,0.957028
D.birchii,156593892,VNKA01001086.1,1,2988,1.90812e-05,149867748,0.957047
D.birchii,156593892,VNKA01006318.1,1,2986,1.90684e-05,149870734,0.957066
D.birchii,156593892,VNKA01002190.1,1,2986,1.90684e-05,149873720,0.957085
D.birchii,156593892,VNKA01002183.1,1,2986,1.90684e-05,149876706,0.957104
D.birchii,156593892,VNKA01005910.1,1,2985,1.9062e-05,149879691,0.957123
D.birchii,156593892,VNKA01006801.1,1,2984,1.90557e-05,149882675,0.957143
D.birchii,156593892,VNKA01006718.1,1,2983,1.90493e-05,149885658,0.957162
D.birchii,156593892,VNKA01003148.1,1,2982,1.90429e-05,149888640,0.957181
D.birchii,156593892,VNKA01001931.1,1,2981,1.90365e-05,149891621,0.9572
D.birchii,156593892,VNKA01001244.1,1,2980,1.90301e-05,149894601,0.957219
D.birchii,156593892,VNKA01004921.1,1,2978,1.90173e-05,149897579,0.957238
D.birchii,156593892,VNKA01001308.1,1,2978,1.90173e-05,149900557,0.957257
D.birchii,156593892,VNKA01006491.1,1,2977,1.9011e-05,149903534,0.957276
D.birchii,156593892,VNKA01001612.1,1,2977,1.9011e-05,149906511,0.957295
D.birchii,156593892,VNKA01005771.1,1,2976,1.90046e-05,149909487,0.957314
D.birchii,156593892,VNKA01003096.1,1,2975,1.89982e-05,149912462,0.957333
D.birchii,156593892,VNKA01007274.1,1,2974,1.89918e-05,149915436,0.957352
D.birchii,156593892,VNKA01005382.1,1,2972,1.8979e-05,149918408,0.957371
D.birchii,156593892,VNKA01005148.1,1,2972,1.8979e-05,149921380,0.95739
D.birchii,156593892,VNKA01000833.1,1,2972,1.8979e-05,149924352,0.957409
D.birchii,156593892,VNKA01006018.1,1,2970,1.89663e-05,149927322,0.957428
D.birchii,156593892,VNKA01004021.1,1,2967,1.89471e-05,149930289,0.957447
D.birchii,156593892,VNKA01007420.1,1,2966,1.89407e-05,149933255,0.957466
D.birchii,156593892,VNKA01006382.1,1,2962,1.89152e-05,149936217,0.957484
D.birchii,156593892,VNKA01006380.1,1,2961,1.89088e-05,149939178,0.957503
D.birchii,156593892,VNKA01003048.1,1,2961,1.89088e-05,149942139,0.957522
D.birchii,156593892,VNKA01006341.1,1,2960,1.89024e-05,149945099,0.957541
D.birchii,156593892,VNKA01000457.1,1,2960,1.89024e-05,149948059,0.95756
D.birchii,156593892,VNKA01004989.1,1,2959,1.8896e-05,149951018,0.957579
D.birchii,156593892,VNKA01003983.1,1,2957,1.88832e-05,149953975,0.957598
D.birchii,156593892,VNKA01007093.1,1,2955,1.88705e-05,149956930,0.957617
D.birchii,156593892,VNKA01004615.1,1,2955,1.88705e-05,149959885,0.957636
D.birchii,156593892,VNKA01002743.1,1,2954,1.88641e-05,149962839,0.957654
D.birchii,156593892,VNKA01003009.1,1,2951,1.88449e-05,149965790,0.957673
D.birchii,156593892,VNKA01002997.1,1,2950,1.88385e-05,149968740,0.957692
D.birchii,156593892,VNKA01002276.1,1,2948,1.88258e-05,149971688,0.957711
D.birchii,156593892,VNKA01004542.1,1,2947,1.88194e-05,149974635,0.95773
D.birchii,156593892,VNKA01001991.1,1,2947,1.88194e-05,149977582,0.957749
D.birchii,156593892,VNKA01002241.1,1,2946,1.8813e-05,149980528,0.957767
D.birchii,156593892,VNKA01001790.1,1,2946,1.8813e-05,149983474,0.957786
D.birchii,156593892,VNKA01001949.1,1,2945,1.88066e-05,149986419,0.957805
D.birchii,156593892,VNKA01001189.1,1,2945,1.88066e-05,149989364,0.957824
D.birchii,156593892,VNKA01004500.1,1,2944,1.88002e-05,149992308,0.957843
D.birchii,156593892,VNKA01005851.1,1,2942,1.87875e-05,149995250,0.957861
D.birchii,156593892,VNKA01000585.1,1,2941,1.87811e-05,149998191,0.95788
D.birchii,156593892,VNKA01005351.1,1,2939,1.87683e-05,150001130,0.957899
D.birchii,156593892,VNKA01001610.1,1,2939,1.87683e-05,150004069,0.957918
D.birchii,156593892,VNKA01005652.1,1,2934,1.87364e-05,150007003,0.957936
D.birchii,156593892,VNKA01004678.1,1,2934,1.87364e-05,150009937,0.957955
D.birchii,156593892,VNKA01001749.1,1,2934,1.87364e-05,150012871,0.957974
D.birchii,156593892,VNKA01002630.1,1,2932,1.87236e-05,150015803,0.957993
D.birchii,156593892,VNKA01000684.1,1,2932,1.87236e-05,150018735,0.958011
D.birchii,156593892,VNKA01007025.1,1,2931,1.87172e-05,150021666,0.95803
D.birchii,156593892,VNKA01002223.1,1,2930,1.87108e-05,150024596,0.958049
D.birchii,156593892,VNKA01002402.1,1,2929,1.87044e-05,150027525,0.958068
D.birchii,156593892,VNKA01001335.1,1,2929,1.87044e-05,150030454,0.958086
D.birchii,156593892,VNKA01000448.1,1,2928,1.8698e-05,150033382,0.958105
D.birchii,156593892,VNKA01005404.1,1,2926,1.86853e-05,150036308,0.958124
D.birchii,156593892,VNKA01004794.1,1,2926,1.86853e-05,150039234,0.958142
D.birchii,156593892,VNKA01006194.1,1,2925,1.86789e-05,150042159,0.958161
D.birchii,156593892,VNKA01004394.1,1,2922,1.86597e-05,150045081,0.95818
D.birchii,156593892,VNKA01004095.1,1,2920,1.8647e-05,150048001,0.958198
D.birchii,156593892,VNKA01002516.1,1,2920,1.8647e-05,150050921,0.958217
D.birchii,156593892,VNKA01001034.1,1,2918,1.86342e-05,150053839,0.958236
D.birchii,156593892,VNKA01006992.1,1,2917,1.86278e-05,150056756,0.958254
D.birchii,156593892,VNKA01002086.1,1,2915,1.8615e-05,150059671,0.958273
D.birchii,156593892,VNKA01007220.1,1,2914,1.86086e-05,150062585,0.958291
D.birchii,156593892,VNKA01005849.1,1,2914,1.86086e-05,150065499,0.95831
D.birchii,156593892,VNKA01001921.1,1,2913,1.86023e-05,150068412,0.958329
D.birchii,156593892,VNKA01001307.1,1,2909,1.85767e-05,150071321,0.958347
D.birchii,156593892,VNKA01005133.1,1,2907,1.85639e-05,150074228,0.958366
D.birchii,156593892,VNKA01005841.1,1,2906,1.85576e-05,150077134,0.958384
D.birchii,156593892,VNKA01002779.1,1,2906,1.85576e-05,150080040,0.958403
D.birchii,156593892,VNKA01000491.1,1,2904,1.85448e-05,150082944,0.958421
D.birchii,156593892,VNKA01001458.1,1,2903,1.85384e-05,150085847,0.95844
D.birchii,156593892,VNKA01003190.1,1,2901,1.85256e-05,150088748,0.958459
D.birchii,156593892,VNKA01000854.1,1,2900,1.85192e-05,150091648,0.958477
D.birchii,156593892,VNKA01005265.1,1,2899,1.85129e-05,150094547,0.958496
D.birchii,156593892,VNKA01000283.1,1,2899,1.85129e-05,150097446,0.958514
D.birchii,156593892,VNKA01007438.1,1,2898,1.85065e-05,150100344,0.958533
D.birchii,156593892,VNKA01006770.1,1,2898,1.85065e-05,150103242,0.958551
D.birchii,156593892,VNKA01005246.1,1,2894,1.84809e-05,150106136,0.95857
D.birchii,156593892,VNKA01002207.1,1,2893,1.84745e-05,150109029,0.958588
D.birchii,156593892,VNKA01000853.1,1,2892,1.84682e-05,150111921,0.958606
D.birchii,156593892,VNKA01007409.1,1,2891,1.84618e-05,150114812,0.958625
D.birchii,156593892,VNKA01004008.1,1,2891,1.84618e-05,150117703,0.958643
D.birchii,156593892,VNKA01003153.1,1,2891,1.84618e-05,150120594,0.958662
D.birchii,156593892,VNKA01005612.1,1,2885,1.84235e-05,150123479,0.95868
D.birchii,156593892,VNKA01002559.1,1,2885,1.84235e-05,150126364,0.958699
D.birchii,156593892,VNKA01000215.1,1,2885,1.84235e-05,150129249,0.958717
D.birchii,156593892,VNKA01007501.1,1,2884,1.84171e-05,150132133,0.958736
D.birchii,156593892,VNKA01005051.1,1,2883,1.84107e-05,150135016,0.958754
D.birchii,156593892,VNKA01005255.1,1,2882,1.84043e-05,150137898,0.958772
D.birchii,156593892,VNKA01001979.1,1,2882,1.84043e-05,150140780,0.958791
D.birchii,156593892,VNKA01000059.1,1,2882,1.84043e-05,150143662,0.958809
D.birchii,156593892,VNKA01006705.1,1,2880,1.83915e-05,150146542,0.958828
D.birchii,156593892,VNKA01006067.1,1,2879,1.83851e-05,150149421,0.958846
D.birchii,156593892,VNKA01007076.1,1,2878,1.83788e-05,150152299,0.958864
D.birchii,156593892,VNKA01000999.1,1,2878,1.83788e-05,150155177,0.958883
D.birchii,156593892,VNKA01001703.1,1,2876,1.8366e-05,150158053,0.958901
D.birchii,156593892,VNKA01006485.1,1,2875,1.83596e-05,150160928,0.958919
D.birchii,156593892,VNKA01003759.1,1,2875,1.83596e-05,150163803,0.958938
D.birchii,156593892,VNKA01002990.1,1,2875,1.83596e-05,150166678,0.958956
D.birchii,156593892,VNKA01001780.1,1,2873,1.83468e-05,150169551,0.958975
D.birchii,156593892,VNKA01000098.1,1,2872,1.83404e-05,150172423,0.958993
D.birchii,156593892,VNKA01003741.1,1,2871,1.8334e-05,150175294,0.959011
D.birchii,156593892,VNKA01002261.1,1,2871,1.8334e-05,150178165,0.95903
D.birchii,156593892,VNKA01004604.1,1,2870,1.83277e-05,150181035,0.959048
D.birchii,156593892,VNKA01004367.1,1,2870,1.83277e-05,150183905,0.959066
D.birchii,156593892,VNKA01004029.1,1,2870,1.83277e-05,150186775,0.959085
D.birchii,156593892,VNKA01005879.1,1,2869,1.83213e-05,150189644,0.959103
D.birchii,156593892,VNKA01001755.1,1,2868,1.83149e-05,150192512,0.959121
D.birchii,156593892,VNKA01005750.1,1,2866,1.83021e-05,150195378,0.959139
D.birchii,156593892,VNKA01000888.1,1,2866,1.83021e-05,150198244,0.959158
D.birchii,156593892,VNKA01004198.1,1,2865,1.82957e-05,150201109,0.959176
D.birchii,156593892,VNKA01004269.1,1,2864,1.82893e-05,150203973,0.959194
D.birchii,156593892,VNKA01007146.1,1,2861,1.82702e-05,150206834,0.959213
D.birchii,156593892,VNKA01002221.1,1,2861,1.82702e-05,150209695,0.959231
D.birchii,156593892,VNKA01006181.1,1,2860,1.82638e-05,150212555,0.959249
D.birchii,156593892,VNKA01006692.1,1,2858,1.8251e-05,150215413,0.959267
D.birchii,156593892,VNKA01003492.1,1,2858,1.8251e-05,150218271,0.959286
D.birchii,156593892,VNKA01001111.1,1,2858,1.8251e-05,150221129,0.959304
D.birchii,156593892,VNKA01004470.1,1,2857,1.82446e-05,150223986,0.959322
D.birchii,156593892,VNKA01006681.1,1,2856,1.82383e-05,150226842,0.95934
D.birchii,156593892,VNKA01006387.1,1,2856,1.82383e-05,150229698,0.959359
D.birchii,156593892,VNKA01007183.1,1,2855,1.82319e-05,150232553,0.959377
D.birchii,156593892,VNKA01000329.1,1,2848,1.81872e-05,150235401,0.959395
D.birchii,156593892,VNKA01007275.1,1,2846,1.81744e-05,150238247,0.959413
D.birchii,156593892,VNKA01000688.1,1,2846,1.81744e-05,150241093,0.959431
D.birchii,156593892,VNKA01003733.1,1,2845,1.8168e-05,150243938,0.95945
D.birchii,156593892,VNKA01000590.1,1,2844,1.81616e-05,150246782,0.959468
D.birchii,156593892,VNKA01006935.1,1,2843,1.81552e-05,150249625,0.959486
D.birchii,156593892,VNKA01005315.1,1,2843,1.81552e-05,150252468,0.959504
D.birchii,156593892,VNKA01002144.1,1,2843,1.81552e-05,150255311,0.959522
D.birchii,156593892,VNKA01006111.1,1,2841,1.81425e-05,150258152,0.95954
D.birchii,156593892,VNKA01007369.1,1,2840,1.81361e-05,150260992,0.959558
D.birchii,156593892,VNKA01000176.1,1,2837,1.81169e-05,150263829,0.959577
D.birchii,156593892,VNKA01001323.1,1,2835,1.81042e-05,150266664,0.959595
D.birchii,156593892,VNKA01006459.1,1,2833,1.80914e-05,150269497,0.959613
D.birchii,156593892,VNKA01004513.1,1,2833,1.80914e-05,150272330,0.959631
D.birchii,156593892,VNKA01001538.1,1,2833,1.80914e-05,150275163,0.959649
D.birchii,156593892,VNKA01001432.1,1,2833,1.80914e-05,150277996,0.959667
D.birchii,156593892,VNKA01001723.1,1,2832,1.8085e-05,150280828,0.959685
D.birchii,156593892,VNKA01005852.1,1,2830,1.80722e-05,150283658,0.959703
D.birchii,156593892,VNKA01007531.1,1,2829,1.80658e-05,150286487,0.959721
D.birchii,156593892,VNKA01002460.1,1,2829,1.80658e-05,150289316,0.959739
D.birchii,156593892,VNKA01001041.1,1,2828,1.80595e-05,150292144,0.959757
D.birchii,156593892,VNKA01005068.1,1,2827,1.80531e-05,150294971,0.959775
D.birchii,156593892,VNKA01004011.1,1,2824,1.80339e-05,150297795,0.959793
D.birchii,156593892,VNKA01003623.1,1,2822,1.80211e-05,150300617,0.959811
D.birchii,156593892,VNKA01003000.1,1,2820,1.80084e-05,150303437,0.959829
D.birchii,156593892,VNKA01003433.1,1,2819,1.8002e-05,150306256,0.959848
D.birchii,156593892,VNKA01004149.1,1,2818,1.79956e-05,150309074,0.959865
D.birchii,156593892,VNKA01001061.1,1,2818,1.79956e-05,150311892,0.959883
D.birchii,156593892,VNKA01006384.1,1,2817,1.79892e-05,150314709,0.959901
D.birchii,156593892,VNKA01004761.1,1,2817,1.79892e-05,150317526,0.959919
D.birchii,156593892,VNKA01002173.1,1,2816,1.79828e-05,150320342,0.959937
D.birchii,156593892,VNKA01001112.1,1,2816,1.79828e-05,150323158,0.959955
D.birchii,156593892,VNKA01005007.1,1,2815,1.79764e-05,150325973,0.959973
D.birchii,156593892,VNKA01002260.1,1,2815,1.79764e-05,150328788,0.959991
D.birchii,156593892,VNKA01004810.1,1,2814,1.797e-05,150331602,0.960009
D.birchii,156593892,VNKA01007507.1,1,2813,1.79637e-05,150334415,0.960027
D.birchii,156593892,VNKA01001798.1,1,2813,1.79637e-05,150337228,0.960045
D.birchii,156593892,VNKA01007145.1,1,2809,1.79381e-05,150340037,0.960063
D.birchii,156593892,VNKA01007055.1,1,2809,1.79381e-05,150342846,0.960081
D.birchii,156593892,VNKA01005010.1,1,2809,1.79381e-05,150345655,0.960099
D.birchii,156593892,VNKA01000315.1,1,2809,1.79381e-05,150348464,0.960117
D.birchii,156593892,VNKA01005182.1,1,2808,1.79317e-05,150351272,0.960135
D.birchii,156593892,VNKA01004744.1,1,2808,1.79317e-05,150354080,0.960153
D.birchii,156593892,VNKA01000694.1,1,2808,1.79317e-05,150356888,0.960171
D.birchii,156593892,VNKA01000789.1,1,2807,1.79253e-05,150359695,0.960189
D.birchii,156593892,VNKA01006997.1,1,2806,1.7919e-05,150362501,0.960207
D.birchii,156593892,VNKA01001525.1,1,2805,1.79126e-05,150365306,0.960225
D.birchii,156593892,VNKA01005264.1,1,2803,1.78998e-05,150368109,0.960242
D.birchii,156593892,VNKA01000422.1,1,2802,1.78934e-05,150370911,0.96026
D.birchii,156593892,VNKA01004160.1,1,2800,1.78806e-05,150373711,0.960278
D.birchii,156593892,VNKA01000811.1,1,2800,1.78806e-05,150376511,0.960296
D.birchii,156593892,VNKA01005766.1,1,2797,1.78615e-05,150379308,0.960314
D.birchii,156593892,VNKA01003986.1,1,2796,1.78551e-05,150382104,0.960332
D.birchii,156593892,VNKA01002367.1,1,2796,1.78551e-05,150384900,0.96035
D.birchii,156593892,VNKA01006969.1,1,2794,1.78423e-05,150387694,0.960368
D.birchii,156593892,VNKA01005888.1,1,2794,1.78423e-05,150390488,0.960385
D.birchii,156593892,VNKA01001602.1,1,2792,1.78296e-05,150393280,0.960403
D.birchii,156593892,VNKA01000199.1,1,2792,1.78296e-05,150396072,0.960421
D.birchii,156593892,VNKA01001754.1,1,2791,1.78232e-05,150398863,0.960439
D.birchii,156593892,VNKA01006700.1,1,2790,1.78168e-05,150401653,0.960457
D.birchii,156593892,VNKA01005853.1,1,2789,1.78104e-05,150404442,0.960475
D.birchii,156593892,VNKA01002491.1,1,2789,1.78104e-05,150407231,0.960492
D.birchii,156593892,VNKA01006345.1,1,2788,1.7804e-05,150410019,0.96051
D.birchii,156593892,VNKA01005856.1,1,2788,1.7804e-05,150412807,0.960528
D.birchii,156593892,VNKA01004102.1,1,2788,1.7804e-05,150415595,0.960546
D.birchii,156593892,VNKA01003540.1,1,2788,1.7804e-05,150418383,0.960564
D.birchii,156593892,VNKA01003004.1,1,2788,1.7804e-05,150421171,0.960581
D.birchii,156593892,VNKA01007234.1,1,2787,1.77976e-05,150423958,0.960599
D.birchii,156593892,VNKA01007006.1,1,2787,1.77976e-05,150426745,0.960617
D.birchii,156593892,VNKA01006859.1,1,2787,1.77976e-05,150429532,0.960635
D.birchii,156593892,VNKA01003057.1,1,2786,1.77912e-05,150432318,0.960653
D.birchii,156593892,VNKA01007027.1,1,2784,1.77785e-05,150435102,0.96067
D.birchii,156593892,VNKA01004506.1,1,2780,1.77529e-05,150437882,0.960688
D.birchii,156593892,VNKA01004296.1,1,2779,1.77465e-05,150440661,0.960706
D.birchii,156593892,VNKA01000609.1,1,2779,1.77465e-05,150443440,0.960724
D.birchii,156593892,VNKA01005693.1,1,2776,1.77274e-05,150446216,0.960741
D.birchii,156593892,VNKA01003832.1,1,2776,1.77274e-05,150448992,0.960759
D.birchii,156593892,VNKA01006594.1,1,2774,1.77146e-05,150451766,0.960777
D.birchii,156593892,VNKA01005843.1,1,2773,1.77082e-05,150454539,0.960794
D.birchii,156593892,VNKA01000772.1,1,2773,1.77082e-05,150457312,0.960812
D.birchii,156593892,VNKA01001313.1,1,2771,1.76955e-05,150460083,0.96083
D.birchii,156593892,VNKA01004985.1,1,2769,1.76827e-05,150462852,0.960848
D.birchii,156593892,VNKA01004577.1,1,2769,1.76827e-05,150465621,0.960865
D.birchii,156593892,VNKA01004560.1,1,2769,1.76827e-05,150468390,0.960883
D.birchii,156593892,VNKA01004764.1,1,2768,1.76763e-05,150471158,0.960901
D.birchii,156593892,VNKA01004784.1,1,2767,1.76699e-05,150473925,0.960918
D.birchii,156593892,VNKA01005722.1,1,2766,1.76635e-05,150476691,0.960936
D.birchii,156593892,VNKA01004455.1,1,2766,1.76635e-05,150479457,0.960954
D.birchii,156593892,VNKA01007177.1,1,2765,1.76571e-05,150482222,0.960971
D.birchii,156593892,VNKA01000051.1,1,2765,1.76571e-05,150484987,0.960989
D.birchii,156593892,VNKA01006903.1,1,2764,1.76508e-05,150487751,0.961007
D.birchii,156593892,VNKA01002335.1,1,2762,1.7638e-05,150490513,0.961024
D.birchii,156593892,VNKA01001271.1,1,2761,1.76316e-05,150493274,0.961042
D.birchii,156593892,VNKA01003617.1,1,2759,1.76188e-05,150496033,0.961059
D.birchii,156593892,VNKA01002520.1,1,2758,1.76124e-05,150498791,0.961077
D.birchii,156593892,VNKA01007395.1,1,2757,1.76061e-05,150501548,0.961095
D.birchii,156593892,VNKA01006338.1,1,2756,1.75997e-05,150504304,0.961112
D.birchii,156593892,VNKA01003820.1,1,2756,1.75997e-05,150507060,0.96113
D.birchii,156593892,VNKA01006148.1,1,2755,1.75933e-05,150509815,0.961147
D.birchii,156593892,VNKA01007511.1,1,2754,1.75869e-05,150512569,0.961165
D.birchii,156593892,VNKA01006763.1,1,2753,1.75805e-05,150515322,0.961183
D.birchii,156593892,VNKA01003923.1,1,2752,1.75741e-05,150518074,0.9612
D.birchii,156593892,VNKA01000141.1,1,2752,1.75741e-05,150520826,0.961218
D.birchii,156593892,VNKA01002177.1,1,2748,1.75486e-05,150523574,0.961235
D.birchii,156593892,VNKA01005088.1,1,2747,1.75422e-05,150526321,0.961253
D.birchii,156593892,VNKA01006195.1,1,2746,1.75358e-05,150529067,0.96127
D.birchii,156593892,VNKA01005256.1,1,2746,1.75358e-05,150531813,0.961288
D.birchii,156593892,VNKA01004202.1,1,2746,1.75358e-05,150534559,0.961305
D.birchii,156593892,VNKA01001276.1,1,2746,1.75358e-05,150537305,0.961323
D.birchii,156593892,VNKA01007257.1,1,2745,1.75294e-05,150540050,0.96134
D.birchii,156593892,VNKA01004600.1,1,2745,1.75294e-05,150542795,0.961358
D.birchii,156593892,VNKA01007390.1,1,2744,1.7523e-05,150545539,0.961376
D.birchii,156593892,VNKA01001772.1,1,2744,1.7523e-05,150548283,0.961393
D.birchii,156593892,VNKA01001517.1,1,2744,1.7523e-05,150551027,0.961411
D.birchii,156593892,VNKA01001227.1,1,2743,1.75166e-05,150553770,0.961428
D.birchii,156593892,VNKA01007253.1,1,2742,1.75103e-05,150556512,0.961446
D.birchii,156593892,VNKA01007540.1,1,2741,1.75039e-05,150559253,0.961463
D.birchii,156593892,VNKA01005402.1,1,2741,1.75039e-05,150561994,0.961481
D.birchii,156593892,VNKA01003158.1,1,2741,1.75039e-05,150564735,0.961498
D.birchii,156593892,VNKA01005884.1,1,2740,1.74975e-05,150567475,0.961516
D.birchii,156593892,VNKA01003142.1,1,2736,1.74719e-05,150570211,0.961533
D.birchii,156593892,VNKA01002337.1,1,2736,1.74719e-05,150572947,0.961551
D.birchii,156593892,VNKA01004699.1,1,2735,1.74656e-05,150575682,0.961568
D.birchii,156593892,VNKA01005131.1,1,2734,1.74592e-05,150578416,0.961586
D.birchii,156593892,VNKA01004994.1,1,2733,1.74528e-05,150581149,0.961603
D.birchii,156593892,VNKA01002389.1,1,2733,1.74528e-05,150583882,0.96162
D.birchii,156593892,VNKA01006095.1,1,2729,1.74272e-05,150586611,0.961638
D.birchii,156593892,VNKA01003683.1,1,2729,1.74272e-05,150589340,0.961655
D.birchii,156593892,VNKA01004510.1,1,2720,1.73698e-05,150592060,0.961673
D.birchii,156593892,VNKA01003619.1,1,2720,1.73698e-05,150594780,0.96169
D.birchii,156593892,VNKA01005569.1,1,2717,1.73506e-05,150597497,0.961707
D.birchii,156593892,VNKA01004978.1,1,2715,1.73378e-05,150600212,0.961725
D.birchii,156593892,VNKA01007162.1,1,2713,1.73251e-05,150602925,0.961742
D.birchii,156593892,VNKA01006373.1,1,2713,1.73251e-05,150605638,0.961759
D.birchii,156593892,VNKA01007435.1,1,2712,1.73187e-05,150608350,0.961777
D.birchii,156593892,VNKA01006541.1,1,2712,1.73187e-05,150611062,0.961794
D.birchii,156593892,VNKA01006443.1,1,2712,1.73187e-05,150613774,0.961811
D.birchii,156593892,VNKA01003329.1,1,2712,1.73187e-05,150616486,0.961829
D.birchii,156593892,VNKA01000680.1,1,2712,1.73187e-05,150619198,0.961846
D.birchii,156593892,VNKA01006904.1,1,2711,1.73123e-05,150621909,0.961863
D.birchii,156593892,VNKA01003622.1,1,2711,1.73123e-05,150624620,0.961881
D.birchii,156593892,VNKA01007313.1,1,2710,1.73059e-05,150627330,0.961898
D.birchii,156593892,VNKA01002669.1,1,2710,1.73059e-05,150630040,0.961915
D.birchii,156593892,VNKA01005249.1,1,2709,1.72995e-05,150632749,0.961932
D.birchii,156593892,VNKA01005289.1,1,2708,1.72931e-05,150635457,0.96195
D.birchii,156593892,VNKA01002694.1,1,2708,1.72931e-05,150638165,0.961967
D.birchii,156593892,VNKA01001895.1,1,2707,1.72868e-05,150640872,0.961984
D.birchii,156593892,VNKA01000514.1,1,2707,1.72868e-05,150643579,0.962002
D.birchii,156593892,VNKA01006248.1,1,2706,1.72804e-05,150646285,0.962019
D.birchii,156593892,VNKA01003239.1,1,2706,1.72804e-05,150648991,0.962036
D.birchii,156593892,VNKA01000777.1,1,2706,1.72804e-05,150651697,0.962053
D.birchii,156593892,VNKA01000750.1,1,2706,1.72804e-05,150654403,0.962071
D.birchii,156593892,VNKA01003523.1,1,2705,1.7274e-05,150657108,0.962088
D.birchii,156593892,VNKA01005197.1,1,2704,1.72676e-05,150659812,0.962105
D.birchii,156593892,VNKA01001959.1,1,2703,1.72612e-05,150662515,0.962123
D.birchii,156593892,VNKA01003807.1,1,2702,1.72548e-05,150665217,0.96214
D.birchii,156593892,VNKA01002298.1,1,2702,1.72548e-05,150667919,0.962157
D.birchii,156593892,VNKA01000101.1,1,2701,1.72484e-05,150670620,0.962174
D.birchii,156593892,VNKA01005704.1,1,2700,1.72421e-05,150673320,0.962192
D.birchii,156593892,VNKA01004806.1,1,2698,1.72293e-05,150676018,0.962209
D.birchii,156593892,VNKA01003266.1,1,2698,1.72293e-05,150678716,0.962226
D.birchii,156593892,VNKA01007205.1,1,2696,1.72165e-05,150681412,0.962243
D.birchii,156593892,VNKA01001880.1,1,2695,1.72101e-05,150684107,0.96226
D.birchii,156593892,VNKA01007264.1,1,2694,1.72037e-05,150686801,0.962278
D.birchii,156593892,VNKA01003300.1,1,2694,1.72037e-05,150689495,0.962295
D.birchii,156593892,VNKA01005605.1,1,2693,1.71974e-05,150692188,0.962312
D.birchii,156593892,VNKA01000273.1,1,2691,1.71846e-05,150694879,0.962329
D.birchii,156593892,VNKA01004594.1,1,2689,1.71718e-05,150697568,0.962346
D.birchii,156593892,VNKA01002800.1,1,2689,1.71718e-05,150700257,0.962364
D.birchii,156593892,VNKA01000289.1,1,2689,1.71718e-05,150702946,0.962381
D.birchii,156593892,VNKA01001629.1,1,2687,1.7159e-05,150705633,0.962398
D.birchii,156593892,VNKA01002087.1,1,2684,1.71399e-05,150708317,0.962415
D.birchii,156593892,VNKA01001781.1,1,2683,1.71335e-05,150711000,0.962432
D.birchii,156593892,VNKA01001229.1,1,2683,1.71335e-05,150713683,0.962449
D.birchii,156593892,VNKA01000460.1,1,2683,1.71335e-05,150716366,0.962466
D.birchii,156593892,VNKA01001761.1,1,2682,1.71271e-05,150719048,0.962484
D.birchii,156593892,VNKA01005478.1,1,2681,1.71207e-05,150721729,0.962501
D.birchii,156593892,VNKA01002813.1,1,2681,1.71207e-05,150724410,0.962518
D.birchii,156593892,VNKA01002555.1,1,2681,1.71207e-05,150727091,0.962535
D.birchii,156593892,VNKA01001002.1,1,2681,1.71207e-05,150729772,0.962552
D.birchii,156593892,VNKA01002341.1,1,2680,1.71143e-05,150732452,0.962569
D.birchii,156593892,VNKA01006182.1,1,2679,1.71079e-05,150735131,0.962586
D.birchii,156593892,VNKA01005676.1,1,2679,1.71079e-05,150737810,0.962603
D.birchii,156593892,VNKA01001972.1,1,2679,1.71079e-05,150740489,0.96262
D.birchii,156593892,VNKA01000204.1,1,2679,1.71079e-05,150743168,0.962638
D.birchii,156593892,VNKA01005903.1,1,2678,1.71016e-05,150745846,0.962655
D.birchii,156593892,VNKA01002992.1,1,2678,1.71016e-05,150748524,0.962672
D.birchii,156593892,VNKA01004280.1,1,2677,1.70952e-05,150751201,0.962689
D.birchii,156593892,VNKA01003699.1,1,2673,1.70696e-05,150753874,0.962706
D.birchii,156593892,VNKA01004107.1,1,2669,1.70441e-05,150756543,0.962723
D.birchii,156593892,VNKA01007517.1,1,2666,1.70249e-05,150759209,0.96274
D.birchii,156593892,VNKA01003277.1,1,2666,1.70249e-05,150761875,0.962757
D.birchii,156593892,VNKA01006163.1,1,2665,1.70185e-05,150764540,0.962774
D.birchii,156593892,VNKA01003367.1,1,2665,1.70185e-05,150767205,0.962791
D.birchii,156593892,VNKA01007135.1,1,2664,1.70122e-05,150769869,0.962808
D.birchii,156593892,VNKA01000128.1,1,2664,1.70122e-05,150772533,0.962825
D.birchii,156593892,VNKA01007465.1,1,2663,1.70058e-05,150775196,0.962842
D.birchii,156593892,VNKA01000374.1,1,2663,1.70058e-05,150777859,0.962859
D.birchii,156593892,VNKA01002515.1,1,2661,1.6993e-05,150780520,0.962876
D.birchii,156593892,VNKA01004537.1,1,2659,1.69802e-05,150783179,0.962893
D.birchii,156593892,VNKA01002718.1,1,2659,1.69802e-05,150785838,0.96291
D.birchii,156593892,VNKA01002558.1,1,2659,1.69802e-05,150788497,0.962927
D.birchii,156593892,VNKA01000779.1,1,2658,1.69738e-05,150791155,0.962944
D.birchii,156593892,VNKA01003091.1,1,2656,1.69611e-05,150793811,0.962961
D.birchii,156593892,VNKA01004442.1,1,2655,1.69547e-05,150796466,0.962978
D.birchii,156593892,VNKA01005613.1,1,2654,1.69483e-05,150799120,0.962995
D.birchii,156593892,VNKA01000851.1,1,2654,1.69483e-05,150801774,0.963012
D.birchii,156593892,VNKA01004896.1,1,2653,1.69419e-05,150804427,0.963029
D.birchii,156593892,VNKA01001906.1,1,2653,1.69419e-05,150807080,0.963046
D.birchii,156593892,VNKA01005212.1,1,2652,1.69355e-05,150809732,0.963063
D.birchii,156593892,VNKA01004718.1,1,2652,1.69355e-05,150812384,0.96308
D.birchii,156593892,VNKA01001585.1,1,2652,1.69355e-05,150815036,0.963097
D.birchii,156593892,VNKA01003875.1,1,2651,1.69291e-05,150817687,0.963113
D.birchii,156593892,VNKA01007013.1,1,2650,1.69228e-05,150820337,0.96313
D.birchii,156593892,VNKA01001904.1,1,2650,1.69228e-05,150822987,0.963147
D.birchii,156593892,VNKA01002304.1,1,2648,1.691e-05,150825635,0.963164
D.birchii,156593892,VNKA01001200.1,1,2648,1.691e-05,150828283,0.963181
D.birchii,156593892,VNKA01003811.1,1,2647,1.69036e-05,150830930,0.963198
D.birchii,156593892,VNKA01001751.1,1,2647,1.69036e-05,150833577,0.963215
D.birchii,156593892,VNKA01007355.1,1,2646,1.68972e-05,150836223,0.963232
D.birchii,156593892,VNKA01005683.1,1,2645,1.68908e-05,150838868,0.963249
D.birchii,156593892,VNKA01004520.1,1,2645,1.68908e-05,150841513,0.963266
D.birchii,156593892,VNKA01000070.1,1,2644,1.68844e-05,150844157,0.963283
D.birchii,156593892,VNKA01004567.1,1,2643,1.68781e-05,150846800,0.963299
D.birchii,156593892,VNKA01001643.1,1,2642,1.68717e-05,150849442,0.963316
D.birchii,156593892,VNKA01007337.1,1,2641,1.68653e-05,150852083,0.963333
D.birchii,156593892,VNKA01007044.1,1,2640,1.68589e-05,150854723,0.96335
D.birchii,156593892,VNKA01005184.1,1,2637,1.68397e-05,150857360,0.963367
D.birchii,156593892,VNKA01005741.1,1,2636,1.68334e-05,150859996,0.963384
D.birchii,156593892,VNKA01005702.1,1,2635,1.6827e-05,150862631,0.9634
D.birchii,156593892,VNKA01006357.1,1,2633,1.68142e-05,150865264,0.963417
D.birchii,156593892,VNKA01007309.1,1,2631,1.68014e-05,150867895,0.963434
D.birchii,156593892,VNKA01005441.1,1,2630,1.6795e-05,150870525,0.963451
D.birchii,156593892,VNKA01005616.1,1,2629,1.67886e-05,150873154,0.963468
D.birchii,156593892,VNKA01004501.1,1,2629,1.67886e-05,150875783,0.963484
D.birchii,156593892,VNKA01003311.1,1,2628,1.67823e-05,150878411,0.963501
D.birchii,156593892,VNKA01001929.1,1,2628,1.67823e-05,150881039,0.963518
D.birchii,156593892,VNKA01007207.1,1,2627,1.67759e-05,150883666,0.963535
D.birchii,156593892,VNKA01007455.1,1,2626,1.67695e-05,150886292,0.963552
D.birchii,156593892,VNKA01004419.1,1,2625,1.67631e-05,150888917,0.963568
D.birchii,156593892,VNKA01004207.1,1,2625,1.67631e-05,150891542,0.963585
D.birchii,156593892,VNKA01002438.1,1,2625,1.67631e-05,150894167,0.963602
D.birchii,156593892,VNKA01000083.1,1,2625,1.67631e-05,150896792,0.963619
D.birchii,156593892,VNKA01006012.1,1,2624,1.67567e-05,150899416,0.963635
D.birchii,156593892,VNKA01000062.1,1,2623,1.67503e-05,150902039,0.963652
D.birchii,156593892,VNKA01006205.1,1,2621,1.67376e-05,150904660,0.963669
D.birchii,156593892,VNKA01002455.1,1,2621,1.67376e-05,150907281,0.963686
D.birchii,156593892,VNKA01004393.1,1,2620,1.67312e-05,150909901,0.963702
D.birchii,156593892,VNKA01001724.1,1,2620,1.67312e-05,150912521,0.963719
D.birchii,156593892,VNKA01000280.1,1,2620,1.67312e-05,150915141,0.963736
D.birchii,156593892,VNKA01006832.1,1,2618,1.67184e-05,150917759,0.963753
D.birchii,156593892,VNKA01005425.1,1,2616,1.67056e-05,150920375,0.963769
D.birchii,156593892,VNKA01000923.1,1,2616,1.67056e-05,150922991,0.963786
D.birchii,156593892,VNKA01004009.1,1,2615,1.66992e-05,150925606,0.963803
D.birchii,156593892,VNKA01001682.1,1,2615,1.66992e-05,150928221,0.963819
D.birchii,156593892,VNKA01001407.1,1,2615,1.66992e-05,150930836,0.963836
D.birchii,156593892,VNKA01000007.1,1,2615,1.66992e-05,150933451,0.963853
D.birchii,156593892,VNKA01005473.1,1,2613,1.66865e-05,150936064,0.963869
D.birchii,156593892,VNKA01007299.1,1,2612,1.66801e-05,150938676,0.963886
D.birchii,156593892,VNKA01006806.1,1,2611,1.66737e-05,150941287,0.963903
D.birchii,156593892,VNKA01005725.1,1,2611,1.66737e-05,150943898,0.963919
D.birchii,156593892,VNKA01000190.1,1,2611,1.66737e-05,150946509,0.963936
D.birchii,156593892,VNKA01006353.1,1,2610,1.66673e-05,150949119,0.963953
D.birchii,156593892,VNKA01006750.1,1,2609,1.66609e-05,150951728,0.963969
D.birchii,156593892,VNKA01005528.1,1,2609,1.66609e-05,150954337,0.963986
D.birchii,156593892,VNKA01004873.1,1,2609,1.66609e-05,150956946,0.964003
D.birchii,156593892,VNKA01001881.1,1,2609,1.66609e-05,150959555,0.964019
D.birchii,156593892,VNKA01005974.1,1,2608,1.66545e-05,150962163,0.964036
D.birchii,156593892,VNKA01005971.1,1,2608,1.66545e-05,150964771,0.964053
D.birchii,156593892,VNKA01005500.1,1,2607,1.66482e-05,150967378,0.964069
D.birchii,156593892,VNKA01004396.1,1,2607,1.66482e-05,150969985,0.964086
D.birchii,156593892,VNKA01004417.1,1,2606,1.66418e-05,150972591,0.964103
D.birchii,156593892,VNKA01000451.1,1,2605,1.66354e-05,150975196,0.964119
D.birchii,156593892,VNKA01003299.1,1,2604,1.6629e-05,150977800,0.964136
D.birchii,156593892,VNKA01001596.1,1,2603,1.66226e-05,150980403,0.964153
D.birchii,156593892,VNKA01006834.1,1,2602,1.66162e-05,150983005,0.964169
D.birchii,156593892,VNKA01004619.1,1,2602,1.66162e-05,150985607,0.964186
D.birchii,156593892,VNKA01005372.1,1,2601,1.66098e-05,150988208,0.964202
D.birchii,156593892,VNKA01005578.1,1,2599,1.65971e-05,150990807,0.964219
D.birchii,156593892,VNKA01003045.1,1,2598,1.65907e-05,150993405,0.964236
D.birchii,156593892,VNKA01006925.1,1,2597,1.65843e-05,150996002,0.964252
D.birchii,156593892,VNKA01007247.1,1,2596,1.65779e-05,150998598,0.964269
D.birchii,156593892,VNKA01003570.1,1,2595,1.65715e-05,151001193,0.964285
D.birchii,156593892,VNKA01003977.1,1,2593,1.65588e-05,151003786,0.964302
D.birchii,156593892,VNKA01003109.1,1,2592,1.65524e-05,151006378,0.964318
D.birchii,156593892,VNKA01002473.1,1,2591,1.6546e-05,151008969,0.964335
D.birchii,156593892,VNKA01004208.1,1,2590,1.65396e-05,151011559,0.964352
D.birchii,156593892,VNKA01002353.1,1,2590,1.65396e-05,151014149,0.964368
D.birchii,156593892,VNKA01004471.1,1,2588,1.65268e-05,151016737,0.964385
D.birchii,156593892,VNKA01003254.1,1,2588,1.65268e-05,151019325,0.964401
D.birchii,156593892,VNKA01002820.1,1,2588,1.65268e-05,151021913,0.964418
D.birchii,156593892,VNKA01002734.1,1,2588,1.65268e-05,151024501,0.964434
D.birchii,156593892,VNKA01006522.1,1,2587,1.65204e-05,151027088,0.964451
D.birchii,156593892,VNKA01004104.1,1,2587,1.65204e-05,151029675,0.964467
D.birchii,156593892,VNKA01001578.1,1,2586,1.65141e-05,151032261,0.964484
D.birchii,156593892,VNKA01000488.1,1,2586,1.65141e-05,151034847,0.9645
D.birchii,156593892,VNKA01005119.1,1,2585,1.65077e-05,151037432,0.964517
D.birchii,156593892,VNKA01004089.1,1,2585,1.65077e-05,151040017,0.964533
D.birchii,156593892,VNKA01004044.1,1,2582,1.64885e-05,151042599,0.96455
D.birchii,156593892,VNKA01002601.1,1,2582,1.64885e-05,151045181,0.964566
D.birchii,156593892,VNKA01004635.1,1,2581,1.64821e-05,151047762,0.964583
D.birchii,156593892,VNKA01002719.1,1,2581,1.64821e-05,151050343,0.964599
D.birchii,156593892,VNKA01006823.1,1,2580,1.64757e-05,151052923,0.964616
D.birchii,156593892,VNKA01006408.1,1,2579,1.64694e-05,151055502,0.964632
D.birchii,156593892,VNKA01002398.1,1,2579,1.64694e-05,151058081,0.964649
D.birchii,156593892,VNKA01006776.1,1,2578,1.6463e-05,151060659,0.964665
D.birchii,156593892,VNKA01003095.1,1,2578,1.6463e-05,151063237,0.964682
D.birchii,156593892,VNKA01002563.1,1,2578,1.6463e-05,151065815,0.964698
D.birchii,156593892,VNKA01000370.1,1,2577,1.64566e-05,151068392,0.964714
D.birchii,156593892,VNKA01007212.1,1,2575,1.64438e-05,151070967,0.964731
D.birchii,156593892,VNKA01000232.1,1,2575,1.64438e-05,151073542,0.964747
D.birchii,156593892,VNKA01001087.1,1,2573,1.6431e-05,151076115,0.964764
D.birchii,156593892,VNKA01007488.1,1,2572,1.64247e-05,151078687,0.96478
D.birchii,156593892,VNKA01005904.1,1,2571,1.64183e-05,151081258,0.964797
D.birchii,156593892,VNKA01002678.1,1,2571,1.64183e-05,151083829,0.964813
D.birchii,156593892,VNKA01004642.1,1,2570,1.64119e-05,151086399,0.964829
D.birchii,156593892,VNKA01002380.1,1,2570,1.64119e-05,151088969,0.964846
D.birchii,156593892,VNKA01007194.1,1,2569,1.64055e-05,151091538,0.964862
D.birchii,156593892,VNKA01001085.1,1,2569,1.64055e-05,151094107,0.964879
D.birchii,156593892,VNKA01001031.1,1,2569,1.64055e-05,151096676,0.964895
D.birchii,156593892,VNKA01006671.1,1,2567,1.63927e-05,151099243,0.964911
D.birchii,156593892,VNKA01001734.1,1,2565,1.63799e-05,151101808,0.964928
D.birchii,156593892,VNKA01007500.1,1,2564,1.63736e-05,151104372,0.964944
D.birchii,156593892,VNKA01003010.1,1,2563,1.63672e-05,151106935,0.964961
D.birchii,156593892,VNKA01006176.1,1,2561,1.63544e-05,151109496,0.964977
D.birchii,156593892,VNKA01002689.1,1,2561,1.63544e-05,151112057,0.964993
D.birchii,156593892,VNKA01002024.1,1,2561,1.63544e-05,151114618,0.96501
D.birchii,156593892,VNKA01003574.1,1,2560,1.6348e-05,151117178,0.965026
D.birchii,156593892,VNKA01002674.1,1,2559,1.63416e-05,151119737,0.965042
D.birchii,156593892,VNKA01006495.1,1,2558,1.63352e-05,151122295,0.965059
D.birchii,156593892,VNKA01006675.1,1,2557,1.63289e-05,151124852,0.965075
D.birchii,156593892,VNKA01004945.1,1,2557,1.63289e-05,151127409,0.965091
D.birchii,156593892,VNKA01000036.1,1,2556,1.63225e-05,151129965,0.965108
D.birchii,156593892,VNKA01006599.1,1,2554,1.63097e-05,151132519,0.965124
D.birchii,156593892,VNKA01005439.1,1,2554,1.63097e-05,151135073,0.96514
D.birchii,156593892,VNKA01005944.1,1,2551,1.62905e-05,151137624,0.965157
D.birchii,156593892,VNKA01000371.1,1,2550,1.62842e-05,151140174,0.965173
D.birchii,156593892,VNKA01002100.1,1,2549,1.62778e-05,151142723,0.965189
D.birchii,156593892,VNKA01002814.1,1,2548,1.62714e-05,151145271,0.965205
D.birchii,156593892,VNKA01004924.1,1,2547,1.6265e-05,151147818,0.965222
D.birchii,156593892,VNKA01004215.1,1,2547,1.6265e-05,151150365,0.965238
D.birchii,156593892,VNKA01000839.1,1,2547,1.6265e-05,151152912,0.965254
D.birchii,156593892,VNKA01005747.1,1,2546,1.62586e-05,151155458,0.96527
D.birchii,156593892,VNKA01004647.1,1,2545,1.62522e-05,151158003,0.965287
D.birchii,156593892,VNKA01006872.1,1,2543,1.62395e-05,151160546,0.965303
D.birchii,156593892,VNKA01005106.1,1,2543,1.62395e-05,151163089,0.965319
D.birchii,156593892,VNKA01000328.1,1,2543,1.62395e-05,151165632,0.965335
D.birchii,156593892,VNKA01001115.1,1,2540,1.62203e-05,151168172,0.965352
D.birchii,156593892,VNKA01000802.1,1,2540,1.62203e-05,151170712,0.965368
D.birchii,156593892,VNKA01004720.1,1,2539,1.62139e-05,151173251,0.965384
D.birchii,156593892,VNKA01002628.1,1,2539,1.62139e-05,151175790,0.9654
D.birchii,156593892,VNKA01001379.1,1,2539,1.62139e-05,151178329,0.965417
D.birchii,156593892,VNKA01005125.1,1,2537,1.62011e-05,151180866,0.965433
D.birchii,156593892,VNKA01000452.1,1,2536,1.61948e-05,151183402,0.965449
D.birchii,156593892,VNKA01003163.1,1,2535,1.61884e-05,151185937,0.965465
D.birchii,156593892,VNKA01000864.1,1,2534,1.6182e-05,151188471,0.965481
D.birchii,156593892,VNKA01007232.1,1,2532,1.61692e-05,151191003,0.965497
D.birchii,156593892,VNKA01001611.1,1,2532,1.61692e-05,151193535,0.965514
D.birchii,156593892,VNKA01003225.1,1,2530,1.61564e-05,151196065,0.96553
D.birchii,156593892,VNKA01006857.1,1,2529,1.61501e-05,151198594,0.965546
D.birchii,156593892,VNKA01004630.1,1,2527,1.61373e-05,151201121,0.965562
D.birchii,156593892,VNKA01004093.1,1,2526,1.61309e-05,151203647,0.965578
D.birchii,156593892,VNKA01006292.1,1,2524,1.61181e-05,151206171,0.965594
D.birchii,156593892,VNKA01004028.1,1,2524,1.61181e-05,151208695,0.96561
D.birchii,156593892,VNKA01000459.1,1,2524,1.61181e-05,151211219,0.965627
D.birchii,156593892,VNKA01005262.1,1,2523,1.61117e-05,151213742,0.965643
D.birchii,156593892,VNKA01002192.1,1,2523,1.61117e-05,151216265,0.965659
D.birchii,156593892,VNKA01002214.1,1,2522,1.61054e-05,151218787,0.965675
D.birchii,156593892,VNKA01005535.1,1,2520,1.60926e-05,151221307,0.965691
D.birchii,156593892,VNKA01002287.1,1,2520,1.60926e-05,151223827,0.965707
D.birchii,156593892,VNKA01000832.1,1,2520,1.60926e-05,151226347,0.965723
D.birchii,156593892,VNKA01006154.1,1,2519,1.60862e-05,151228866,0.965739
D.birchii,156593892,VNKA01005532.1,1,2519,1.60862e-05,151231385,0.965755
D.birchii,156593892,VNKA01003751.1,1,2519,1.60862e-05,151233904,0.965771
D.birchii,156593892,VNKA01004467.1,1,2518,1.60798e-05,151236422,0.965787
D.birchii,156593892,VNKA01005755.1,1,2516,1.6067e-05,151238938,0.965804
D.birchii,156593892,VNKA01001651.1,1,2513,1.60479e-05,151241451,0.96582
D.birchii,156593892,VNKA01007358.1,1,2511,1.60351e-05,151243962,0.965836
D.birchii,156593892,VNKA01006772.1,1,2511,1.60351e-05,151246473,0.965852
D.birchii,156593892,VNKA01002381.1,1,2511,1.60351e-05,151248984,0.965868
D.birchii,156593892,VNKA01004595.1,1,2510,1.60287e-05,151251494,0.965884
D.birchii,156593892,VNKA01007443.1,1,2509,1.60223e-05,151254003,0.9659
D.birchii,156593892,VNKA01005287.1,1,2507,1.60096e-05,151256510,0.965916
D.birchii,156593892,VNKA01004373.1,1,2506,1.60032e-05,151259016,0.965932
D.birchii,156593892,VNKA01003256.1,1,2504,1.59904e-05,151261520,0.965948
D.birchii,156593892,VNKA01006546.1,1,2503,1.5984e-05,151264023,0.965964
D.birchii,156593892,VNKA01001647.1,1,2502,1.59776e-05,151266525,0.96598
D.birchii,156593892,VNKA01006528.1,1,2499,1.59585e-05,151269024,0.965996
D.birchii,156593892,VNKA01005168.1,1,2499,1.59585e-05,151271523,0.966012
D.birchii,156593892,VNKA01003571.1,1,2499,1.59585e-05,151274022,0.966028
D.birchii,156593892,VNKA01002751.1,1,2499,1.59585e-05,151276521,0.966044
D.birchii,156593892,VNKA01000286.1,1,2499,1.59585e-05,151279020,0.96606
D.birchii,156593892,VNKA01002378.1,1,2498,1.59521e-05,151281518,0.966075
D.birchii,156593892,VNKA01000405.1,1,2498,1.59521e-05,151284016,0.966091
D.birchii,156593892,VNKA01002174.1,1,2497,1.59457e-05,151286513,0.966107
D.birchii,156593892,VNKA01005040.1,1,2496,1.59393e-05,151289009,0.966123
D.birchii,156593892,VNKA01007184.1,1,2495,1.59329e-05,151291504,0.966139
D.birchii,156593892,VNKA01002017.1,1,2494,1.59265e-05,151293998,0.966155
D.birchii,156593892,VNKA01004818.1,1,2493,1.59202e-05,151296491,0.966171
D.birchii,156593892,VNKA01006203.1,1,2492,1.59138e-05,151298983,0.966187
D.birchii,156593892,VNKA01001909.1,1,2492,1.59138e-05,151301475,0.966203
D.birchii,156593892,VNKA01001309.1,1,2491,1.59074e-05,151303966,0.966219
D.birchii,156593892,VNKA01000838.1,1,2490,1.5901e-05,151306456,0.966235
D.birchii,156593892,VNKA01000820.1,1,2490,1.5901e-05,151308946,0.966251
D.birchii,156593892,VNKA01007310.1,1,2489,1.58946e-05,151311435,0.966267
D.birchii,156593892,VNKA01002615.1,1,2487,1.58818e-05,151313922,0.966282
D.birchii,156593892,VNKA01006686.1,1,2485,1.58691e-05,151316407,0.966298
D.birchii,156593892,VNKA01005798.1,1,2485,1.58691e-05,151318892,0.966314
D.birchii,156593892,VNKA01000784.1,1,2485,1.58691e-05,151321377,0.96633
D.birchii,156593892,VNKA01003607.1,1,2484,1.58627e-05,151323861,0.966346
D.birchii,156593892,VNKA01004036.1,1,2482,1.58499e-05,151326343,0.966362
D.birchii,156593892,VNKA01002387.1,1,2482,1.58499e-05,151328825,0.966378
D.birchii,156593892,VNKA01002134.1,1,2481,1.58435e-05,151331306,0.966393
D.birchii,156593892,VNKA01000834.1,1,2480,1.58371e-05,151333786,0.966409
D.birchii,156593892,VNKA01001347.1,1,2479,1.58308e-05,151336265,0.966425
D.birchii,156593892,VNKA01000226.1,1,2478,1.58244e-05,151338743,0.966441
D.birchii,156593892,VNKA01005774.1,1,2477,1.5818e-05,151341220,0.966457
D.birchii,156593892,VNKA01001168.1,1,2476,1.58116e-05,151343696,0.966473
D.birchii,156593892,VNKA01003625.1,1,2474,1.57988e-05,151346170,0.966488
D.birchii,156593892,VNKA01003649.1,1,2473,1.57924e-05,151348643,0.966504
D.birchii,156593892,VNKA01003034.1,1,2473,1.57924e-05,151351116,0.96652
D.birchii,156593892,VNKA01001583.1,1,2473,1.57924e-05,151353589,0.966536
D.birchii,156593892,VNKA01001130.1,1,2473,1.57924e-05,151356062,0.966552
D.birchii,156593892,VNKA01006080.1,1,2472,1.57861e-05,151358534,0.966567
D.birchii,156593892,VNKA01005163.1,1,2471,1.57797e-05,151361005,0.966583
D.birchii,156593892,VNKA01002490.1,1,2471,1.57797e-05,151363476,0.966599
D.birchii,156593892,VNKA01000195.1,1,2471,1.57797e-05,151365947,0.966615
D.birchii,156593892,VNKA01002328.1,1,2470,1.57733e-05,151368417,0.96663
D.birchii,156593892,VNKA01007350.1,1,2469,1.57669e-05,151370886,0.966646
D.birchii,156593892,VNKA01006048.1,1,2469,1.57669e-05,151373355,0.966662
D.birchii,156593892,VNKA01005309.1,1,2469,1.57669e-05,151375824,0.966678
D.birchii,156593892,VNKA01000297.1,1,2469,1.57669e-05,151378293,0.966693
D.birchii,156593892,VNKA01004051.1,1,2468,1.57605e-05,151380761,0.966709
D.birchii,156593892,VNKA01003486.1,1,2467,1.57541e-05,151383228,0.966725
D.birchii,156593892,VNKA01002292.1,1,2467,1.57541e-05,151385695,0.966741
D.birchii,156593892,VNKA01006281.1,1,2466,1.57477e-05,151388161,0.966756
D.birchii,156593892,VNKA01002495.1,1,2466,1.57477e-05,151390627,0.966772
D.birchii,156593892,VNKA01001963.1,1,2466,1.57477e-05,151393093,0.966788
D.birchii,156593892,VNKA01001812.1,1,2466,1.57477e-05,151395559,0.966804
D.birchii,156593892,VNKA01001518.1,1,2466,1.57477e-05,151398025,0.966819
D.birchii,156593892,VNKA01000944.1,1,2464,1.5735e-05,151400489,0.966835
D.birchii,156593892,VNKA01005767.1,1,2463,1.57286e-05,151402952,0.966851
D.birchii,156593892,VNKA01005923.1,1,2461,1.57158e-05,151405413,0.966867
D.birchii,156593892,VNKA01006097.1,1,2460,1.57094e-05,151407873,0.966882
D.birchii,156593892,VNKA01004409.1,1,2459,1.5703e-05,151410332,0.966898
D.birchii,156593892,VNKA01002049.1,1,2459,1.5703e-05,151412791,0.966914
D.birchii,156593892,VNKA01006385.1,1,2457,1.56903e-05,151415248,0.966929
D.birchii,156593892,VNKA01004388.1,1,2457,1.56903e-05,151417705,0.966945
D.birchii,156593892,VNKA01005960.1,1,2456,1.56839e-05,151420161,0.966961
D.birchii,156593892,VNKA01004910.1,1,2456,1.56839e-05,151422617,0.966977
D.birchii,156593892,VNKA01003630.1,1,2456,1.56839e-05,151425073,0.966992
D.birchii,156593892,VNKA01000332.1,1,2456,1.56839e-05,151427529,0.967008
D.birchii,156593892,VNKA01005188.1,1,2455,1.56775e-05,151429984,0.967024
D.birchii,156593892,VNKA01002611.1,1,2453,1.56647e-05,151432437,0.967039
D.birchii,156593892,VNKA01001756.1,1,2451,1.5652e-05,151434888,0.967055
D.birchii,156593892,VNKA01000986.1,1,2448,1.56328e-05,151437336,0.967071
D.birchii,156593892,VNKA01006836.1,1,2447,1.56264e-05,151439783,0.967086
D.birchii,156593892,VNKA01005398.1,1,2447,1.56264e-05,151442230,0.967102
D.birchii,156593892,VNKA01003929.1,1,2447,1.56264e-05,151444677,0.967117
D.birchii,156593892,VNKA01004159.1,1,2446,1.562e-05,151447123,0.967133
D.birchii,156593892,VNKA01002842.1,1,2446,1.562e-05,151449569,0.967149
D.birchii,156593892,VNKA01006399.1,1,2445,1.56136e-05,151452014,0.967164
D.birchii,156593892,VNKA01004815.1,1,2445,1.56136e-05,151454459,0.96718
D.birchii,156593892,VNKA01000568.1,1,2445,1.56136e-05,151456904,0.967195
D.birchii,156593892,VNKA01000497.1,1,2445,1.56136e-05,151459349,0.967211
D.birchii,156593892,VNKA01007186.1,1,2444,1.56072e-05,151461793,0.967227
D.birchii,156593892,VNKA01005072.1,1,2444,1.56072e-05,151464237,0.967242
D.birchii,156593892,VNKA01000358.1,1,2443,1.56009e-05,151466680,0.967258
D.birchii,156593892,VNKA01005719.1,1,2442,1.55945e-05,151469122,0.967274
D.birchii,156593892,VNKA01007272.1,1,2440,1.55817e-05,151471562,0.967289
D.birchii,156593892,VNKA01005345.1,1,2440,1.55817e-05,151474002,0.967305
D.birchii,156593892,VNKA01003773.1,1,2440,1.55817e-05,151476442,0.96732
D.birchii,156593892,VNKA01000169.1,1,2440,1.55817e-05,151478882,0.967336
D.birchii,156593892,VNKA01006401.1,1,2439,1.55753e-05,151481321,0.967351
D.birchii,156593892,VNKA01001028.1,1,2439,1.55753e-05,151483760,0.967367
D.birchii,156593892,VNKA01001018.1,1,2439,1.55753e-05,151486199,0.967383
D.birchii,156593892,VNKA01003964.1,1,2437,1.55625e-05,151488636,0.967398
D.birchii,156593892,VNKA01002406.1,1,2437,1.55625e-05,151491073,0.967414
D.birchii,156593892,VNKA01007147.1,1,2436,1.55562e-05,151493509,0.967429
D.birchii,156593892,VNKA01004648.1,1,2436,1.55562e-05,151495945,0.967445
D.birchii,156593892,VNKA01007472.1,1,2434,1.55434e-05,151498379,0.96746
D.birchii,156593892,VNKA01005987.1,1,2434,1.55434e-05,151500813,0.967476
D.birchii,156593892,VNKA01000748.1,1,2433,1.5537e-05,151503246,0.967491
D.birchii,156593892,VNKA01000410.1,1,2433,1.5537e-05,151505679,0.967507
D.birchii,156593892,VNKA01002856.1,1,2432,1.55306e-05,151508111,0.967522
D.birchii,156593892,VNKA01002706.1,1,2432,1.55306e-05,151510543,0.967538
D.birchii,156593892,VNKA01002291.1,1,2432,1.55306e-05,151512975,0.967554
D.birchii,156593892,VNKA01000844.1,1,2431,1.55242e-05,151515406,0.967569
D.birchii,156593892,VNKA01000709.1,1,2430,1.55178e-05,151517836,0.967585
D.birchii,156593892,VNKA01007068.1,1,2429,1.55115e-05,151520265,0.9676
D.birchii,156593892,VNKA01006986.1,1,2428,1.55051e-05,151522693,0.967616
D.birchii,156593892,VNKA01001448.1,1,2428,1.55051e-05,151525121,0.967631
D.birchii,156593892,VNKA01000872.1,1,2428,1.55051e-05,151527549,0.967647
D.birchii,156593892,VNKA01003802.1,1,2427,1.54987e-05,151529976,0.967662
D.birchii,156593892,VNKA01004012.1,1,2426,1.54923e-05,151532402,0.967678
D.birchii,156593892,VNKA01005739.1,1,2425,1.54859e-05,151534827,0.967693
D.birchii,156593892,VNKA01004213.1,1,2425,1.54859e-05,151537252,0.967709
D.birchii,156593892,VNKA01003905.1,1,2423,1.54731e-05,151539675,0.967724
D.birchii,156593892,VNKA01004306.1,1,2422,1.54668e-05,151542097,0.96774
D.birchii,156593892,VNKA01003368.1,1,2422,1.54668e-05,151544519,0.967755
D.birchii,156593892,VNKA01003620.1,1,2421,1.54604e-05,151546940,0.96777
D.birchii,156593892,VNKA01007039.1,1,2420,1.5454e-05,151549360,0.967786
D.birchii,156593892,VNKA01003162.1,1,2420,1.5454e-05,151551780,0.967801
D.birchii,156593892,VNKA01001888.1,1,2418,1.54412e-05,151554198,0.967817
D.birchii,156593892,VNKA01007477.1,1,2416,1.54284e-05,151556614,0.967832
D.birchii,156593892,VNKA01002707.1,1,2416,1.54284e-05,151559030,0.967848
D.birchii,156593892,VNKA01006755.1,1,2415,1.54221e-05,151561445,0.967863
D.birchii,156593892,VNKA01004489.1,1,2412,1.54029e-05,151563857,0.967878
D.birchii,156593892,VNKA01006843.1,1,2411,1.53965e-05,151566268,0.967894
D.birchii,156593892,VNKA01001644.1,1,2411,1.53965e-05,151568679,0.967909
D.birchii,156593892,VNKA01005305.1,1,2410,1.53901e-05,151571089,0.967925
D.birchii,156593892,VNKA01003842.1,1,2410,1.53901e-05,151573499,0.96794
D.birchii,156593892,VNKA01006218.1,1,2409,1.53837e-05,151575908,0.967955
D.birchii,156593892,VNKA01001557.1,1,2409,1.53837e-05,151578317,0.967971
D.birchii,156593892,VNKA01007505.1,1,2407,1.5371e-05,151580724,0.967986
D.birchii,156593892,VNKA01002844.1,1,2407,1.5371e-05,151583131,0.968002
D.birchii,156593892,VNKA01006030.1,1,2406,1.53646e-05,151585537,0.968017
D.birchii,156593892,VNKA01005376.1,1,2406,1.53646e-05,151587943,0.968032
D.birchii,156593892,VNKA01003736.1,1,2406,1.53646e-05,151590349,0.968048
D.birchii,156593892,VNKA01005301.1,1,2405,1.53582e-05,151592754,0.968063
D.birchii,156593892,VNKA01001637.1,1,2405,1.53582e-05,151595159,0.968078
D.birchii,156593892,VNKA01007016.1,1,2404,1.53518e-05,151597563,0.968094
D.birchii,156593892,VNKA01005452.1,1,2404,1.53518e-05,151599967,0.968109
D.birchii,156593892,VNKA01003550.1,1,2404,1.53518e-05,151602371,0.968124
D.birchii,156593892,VNKA01002914.1,1,2404,1.53518e-05,151604775,0.96814
D.birchii,156593892,VNKA01005942.1,1,2403,1.53454e-05,151607178,0.968155
D.birchii,156593892,VNKA01001577.1,1,2403,1.53454e-05,151609581,0.96817
D.birchii,156593892,VNKA01005873.1,1,2402,1.5339e-05,151611983,0.968186
D.birchii,156593892,VNKA01005138.1,1,2402,1.5339e-05,151614385,0.968201
D.birchii,156593892,VNKA01004755.1,1,2401,1.53327e-05,151616786,0.968216
D.birchii,156593892,VNKA01003664.1,1,2401,1.53327e-05,151619187,0.968232
D.birchii,156593892,VNKA01002067.1,1,2401,1.53327e-05,151621588,0.968247
D.birchii,156593892,VNKA01005832.1,1,2400,1.53263e-05,151623988,0.968262
D.birchii,156593892,VNKA01003586.1,1,2400,1.53263e-05,151626388,0.968278
D.birchii,156593892,VNKA01001188.1,1,2400,1.53263e-05,151628788,0.968293
D.birchii,156593892,VNKA01001005.1,1,2400,1.53263e-05,151631188,0.968308
D.birchii,156593892,VNKA01000538.1,1,2400,1.53263e-05,151633588,0.968324
D.birchii,156593892,VNKA01006350.1,1,2399,1.53199e-05,151635987,0.968339
D.birchii,156593892,VNKA01001466.1,1,2399,1.53199e-05,151638386,0.968354
D.birchii,156593892,VNKA01003370.1,1,2398,1.53135e-05,151640784,0.96837
D.birchii,156593892,VNKA01001705.1,1,2398,1.53135e-05,151643182,0.968385
D.birchii,156593892,VNKA01003288.1,1,2397,1.53071e-05,151645579,0.9684
D.birchii,156593892,VNKA01000698.1,1,2397,1.53071e-05,151647976,0.968416
D.birchii,156593892,VNKA01001496.1,1,2396,1.53007e-05,151650372,0.968431
D.birchii,156593892,VNKA01006658.1,1,2395,1.52943e-05,151652767,0.968446
D.birchii,156593892,VNKA01006542.1,1,2395,1.52943e-05,151655162,0.968462
D.birchii,156593892,VNKA01003524.1,1,2395,1.52943e-05,151657557,0.968477
D.birchii,156593892,VNKA01002119.1,1,2395,1.52943e-05,151659952,0.968492
D.birchii,156593892,VNKA01004708.1,1,2394,1.5288e-05,151662346,0.968507
D.birchii,156593892,VNKA01003822.1,1,2393,1.52816e-05,151664739,0.968523
D.birchii,156593892,VNKA01005519.1,1,2392,1.52752e-05,151667131,0.968538
D.birchii,156593892,VNKA01002840.1,1,2392,1.52752e-05,151669523,0.968553
D.birchii,156593892,VNKA01007122.1,1,2391,1.52688e-05,151671914,0.968569
D.birchii,156593892,VNKA01004760.1,1,2391,1.52688e-05,151674305,0.968584
D.birchii,156593892,VNKA01000540.1,1,2391,1.52688e-05,151676696,0.968599
D.birchii,156593892,VNKA01006462.1,1,2389,1.5256e-05,151679085,0.968614
D.birchii,156593892,VNKA01005390.1,1,2389,1.5256e-05,151681474,0.96863
D.birchii,156593892,VNKA01001011.1,1,2389,1.5256e-05,151683863,0.968645
D.birchii,156593892,VNKA01000713.1,1,2389,1.5256e-05,151686252,0.96866
D.birchii,156593892,VNKA01004101.1,1,2388,1.52496e-05,151688640,0.968675
D.birchii,156593892,VNKA01003101.1,1,2388,1.52496e-05,151691028,0.968691
D.birchii,156593892,VNKA01006729.1,1,2387,1.52433e-05,151693415,0.968706
D.birchii,156593892,VNKA01005475.1,1,2387,1.52433e-05,151695802,0.968721
D.birchii,156593892,VNKA01000994.1,1,2387,1.52433e-05,151698189,0.968736
D.birchii,156593892,VNKA01003031.1,1,2385,1.52305e-05,151700574,0.968752
D.birchii,156593892,VNKA01001457.1,1,2385,1.52305e-05,151702959,0.968767
D.birchii,156593892,VNKA01003049.1,1,2384,1.52241e-05,151705343,0.968782
D.birchii,156593892,VNKA01006177.1,1,2382,1.52113e-05,151707725,0.968797
D.birchii,156593892,VNKA01004859.1,1,2382,1.52113e-05,151710107,0.968812
D.birchii,156593892,VNKA01006723.1,1,2381,1.52049e-05,151712488,0.968828
D.birchii,156593892,VNKA01003319.1,1,2381,1.52049e-05,151714869,0.968843
D.birchii,156593892,VNKA01006665.1,1,2380,1.51985e-05,151717249,0.968858
D.birchii,156593892,VNKA01002786.1,1,2379,1.51922e-05,151719628,0.968873
D.birchii,156593892,VNKA01001905.1,1,2377,1.51794e-05,151722005,0.968888
D.birchii,156593892,VNKA01006981.1,1,2376,1.5173e-05,151724381,0.968904
D.birchii,156593892,VNKA01001955.1,1,2376,1.5173e-05,151726757,0.968919
D.birchii,156593892,VNKA01001777.1,1,2375,1.51666e-05,151729132,0.968934
D.birchii,156593892,VNKA01007566.1,1,2374,1.51602e-05,151731506,0.968949
D.birchii,156593892,VNKA01003040.1,1,2374,1.51602e-05,151733880,0.968964
D.birchii,156593892,VNKA01005429.1,1,2373,1.51538e-05,151736253,0.968979
D.birchii,156593892,VNKA01005682.1,1,2372,1.51475e-05,151738625,0.968995
D.birchii,156593892,VNKA01002345.1,1,2372,1.51475e-05,151740997,0.96901
D.birchii,156593892,VNKA01001710.1,1,2372,1.51475e-05,151743369,0.969025
D.birchii,156593892,VNKA01001262.1,1,2371,1.51411e-05,151745740,0.96904
D.birchii,156593892,VNKA01007547.1,1,2369,1.51283e-05,151748109,0.969055
D.birchii,156593892,VNKA01001830.1,1,2369,1.51283e-05,151750478,0.96907
D.birchii,156593892,VNKA01005672.1,1,2368,1.51219e-05,151752846,0.969085
D.birchii,156593892,VNKA01005393.1,1,2368,1.51219e-05,151755214,0.9691
D.birchii,156593892,VNKA01006860.1,1,2367,1.51155e-05,151757581,0.969116
D.birchii,156593892,VNKA01002062.1,1,2367,1.51155e-05,151759948,0.969131
D.birchii,156593892,VNKA01004508.1,1,2366,1.51091e-05,151762314,0.969146
D.birchii,156593892,VNKA01003798.1,1,2366,1.51091e-05,151764680,0.969161
D.birchii,156593892,VNKA01002308.1,1,2366,1.51091e-05,151767046,0.969176
D.birchii,156593892,VNKA01007278.1,1,2365,1.51028e-05,151769411,0.969191
D.birchii,156593892,VNKA01000816.1,1,2364,1.50964e-05,151771775,0.969206
D.birchii,156593892,VNKA01006520.1,1,2363,1.509e-05,151774138,0.969221
D.birchii,156593892,VNKA01000898.1,1,2363,1.509e-05,151776501,0.969236
D.birchii,156593892,VNKA01005667.1,1,2362,1.50836e-05,151778863,0.969251
D.birchii,156593892,VNKA01005057.1,1,2362,1.50836e-05,151781225,0.969267
D.birchii,156593892,VNKA01004033.1,1,2362,1.50836e-05,151783587,0.969282
D.birchii,156593892,VNKA01004511.1,1,2361,1.50772e-05,151785948,0.969297
D.birchii,156593892,VNKA01003629.1,1,2361,1.50772e-05,151788309,0.969312
D.birchii,156593892,VNKA01000191.1,1,2361,1.50772e-05,151790670,0.969327
D.birchii,156593892,VNKA01003667.1,1,2359,1.50644e-05,151793029,0.969342
D.birchii,156593892,VNKA01005561.1,1,2357,1.50517e-05,151795386,0.969357
D.birchii,156593892,VNKA01004307.1,1,2357,1.50517e-05,151797743,0.969372
D.birchii,156593892,VNKA01000476.1,1,2357,1.50517e-05,151800100,0.969387
D.birchii,156593892,VNKA01001912.1,1,2356,1.50453e-05,151802456,0.969402
D.birchii,156593892,VNKA01001698.1,1,2356,1.50453e-05,151804812,0.969417
D.birchii,156593892,VNKA01003451.1,1,2355,1.50389e-05,151807167,0.969432
D.birchii,156593892,VNKA01001345.1,1,2355,1.50389e-05,151809522,0.969447
D.birchii,156593892,VNKA01003735.1,1,2354,1.50325e-05,151811876,0.969462
D.birchii,156593892,VNKA01001779.1,1,2354,1.50325e-05,151814230,0.969477
D.birchii,156593892,VNKA01005485.1,1,2352,1.50197e-05,151816582,0.969492
D.birchii,156593892,VNKA01007137.1,1,2351,1.50134e-05,151818933,0.969507
D.birchii,156593892,VNKA01006585.1,1,2351,1.50134e-05,151821284,0.969522
D.birchii,156593892,VNKA01001344.1,1,2351,1.50134e-05,151823635,0.969537
D.birchii,156593892,VNKA01002372.1,1,2350,1.5007e-05,151825985,0.969552
D.birchii,156593892,VNKA01005254.1,1,2349,1.50006e-05,151828334,0.969567
D.birchii,156593892,VNKA01002054.1,1,2348,1.49942e-05,151830682,0.969582
D.birchii,156593892,VNKA01000340.1,1,2348,1.49942e-05,151833030,0.969597
D.birchii,156593892,VNKA01000333.1,1,2347,1.49878e-05,151835377,0.969612
D.birchii,156593892,VNKA01002225.1,1,2345,1.4975e-05,151837722,0.969627
D.birchii,156593892,VNKA01000048.1,1,2345,1.4975e-05,151840067,0.969642
D.birchii,156593892,VNKA01000908.1,1,2344,1.49687e-05,151842411,0.969657
D.birchii,156593892,VNKA01002720.1,1,2341,1.49495e-05,151844752,0.969672
D.birchii,156593892,VNKA01007094.1,1,2340,1.49431e-05,151847092,0.969687
D.birchii,156593892,VNKA01005251.1,1,2340,1.49431e-05,151849432,0.969702
D.birchii,156593892,VNKA01001787.1,1,2340,1.49431e-05,151851772,0.969717
D.birchii,156593892,VNKA01005252.1,1,2339,1.49367e-05,151854111,0.969732
D.birchii,156593892,VNKA01006466.1,1,2338,1.49303e-05,151856449,0.969747
D.birchii,156593892,VNKA01003019.1,1,2338,1.49303e-05,151858787,0.969762
D.birchii,156593892,VNKA01001725.1,1,2338,1.49303e-05,151861125,0.969777
D.birchii,156593892,VNKA01002310.1,1,2337,1.4924e-05,151863462,0.969792
D.birchii,156593892,VNKA01006246.1,1,2335,1.49112e-05,151865797,0.969807
D.birchii,156593892,VNKA01005464.1,1,2333,1.48984e-05,151868130,0.969822
D.birchii,156593892,VNKA01003678.1,1,2332,1.4892e-05,151870462,0.969836
D.birchii,156593892,VNKA01002948.1,1,2332,1.4892e-05,151872794,0.969851
D.birchii,156593892,VNKA01000320.1,1,2332,1.4892e-05,151875126,0.969866
D.birchii,156593892,VNKA01001166.1,1,2331,1.48856e-05,151877457,0.969881
D.birchii,156593892,VNKA01006867.1,1,2329,1.48729e-05,151879786,0.969896
D.birchii,156593892,VNKA01005294.1,1,2329,1.48729e-05,151882115,0.969911
D.birchii,156593892,VNKA01006724.1,1,2328,1.48665e-05,151884443,0.969926
D.birchii,156593892,VNKA01005003.1,1,2328,1.48665e-05,151886771,0.969941
D.birchii,156593892,VNKA01006739.1,1,2326,1.48537e-05,151889097,0.969955
D.birchii,156593892,VNKA01006538.1,1,2326,1.48537e-05,151891423,0.96997
D.birchii,156593892,VNKA01007543.1,1,2324,1.48409e-05,151893747,0.969985
D.birchii,156593892,VNKA01006910.1,1,2324,1.48409e-05,151896071,0.97
D.birchii,156593892,VNKA01006614.1,1,2324,1.48409e-05,151898395,0.970015
D.birchii,156593892,VNKA01003356.1,1,2323,1.48346e-05,151900718,0.97003
D.birchii,156593892,VNKA01000144.1,1,2323,1.48346e-05,151903041,0.970044
D.birchii,156593892,VNKA01005533.1,1,2322,1.48282e-05,151905363,0.970059
D.birchii,156593892,VNKA01004788.1,1,2322,1.48282e-05,151907685,0.970074
D.birchii,156593892,VNKA01003592.1,1,2322,1.48282e-05,151910007,0.970089
D.birchii,156593892,VNKA01000008.1,1,2322,1.48282e-05,151912329,0.970104
D.birchii,156593892,VNKA01007004.1,1,2319,1.4809e-05,151914648,0.970119
D.birchii,156593892,VNKA01004664.1,1,2319,1.4809e-05,151916967,0.970133
D.birchii,156593892,VNKA01002616.1,1,2319,1.4809e-05,151919286,0.970148
D.birchii,156593892,VNKA01001768.1,1,2319,1.4809e-05,151921605,0.970163
D.birchii,156593892,VNKA01007347.1,1,2318,1.48026e-05,151923923,0.970178
D.birchii,156593892,VNKA01003788.1,1,2318,1.48026e-05,151926241,0.970193
D.birchii,156593892,VNKA01002791.1,1,2317,1.47962e-05,151928558,0.970207
D.birchii,156593892,VNKA01002222.1,1,2317,1.47962e-05,151930875,0.970222
D.birchii,156593892,VNKA01004108.1,1,2316,1.47898e-05,151933191,0.970237
D.birchii,156593892,VNKA01001401.1,1,2316,1.47898e-05,151935507,0.970252
D.birchii,156593892,VNKA01006720.1,1,2315,1.47835e-05,151937822,0.970267
D.birchii,156593892,VNKA01004574.1,1,2315,1.47835e-05,151940137,0.970281
D.birchii,156593892,VNKA01003289.1,1,2315,1.47835e-05,151942452,0.970296
D.birchii,156593892,VNKA01001649.1,1,2315,1.47835e-05,151944767,0.970311
D.birchii,156593892,VNKA01000314.1,1,2314,1.47771e-05,151947081,0.970326
D.birchii,156593892,VNKA01006868.1,1,2313,1.47707e-05,151949394,0.97034
D.birchii,156593892,VNKA01005640.1,1,2313,1.47707e-05,151951707,0.970355
D.birchii,156593892,VNKA01003490.1,1,2310,1.47515e-05,151954017,0.97037
D.birchii,156593892,VNKA01000299.1,1,2310,1.47515e-05,151956327,0.970385
D.birchii,156593892,VNKA01006420.1,1,2308,1.47388e-05,151958635,0.9704
D.birchii,156593892,VNKA01005839.1,1,2307,1.47324e-05,151960942,0.970414
D.birchii,156593892,VNKA01001924.1,1,2307,1.47324e-05,151963249,0.970429
D.birchii,156593892,VNKA01002182.1,1,2306,1.4726e-05,151965555,0.970444
D.birchii,156593892,VNKA01007545.1,1,2305,1.47196e-05,151967860,0.970458
D.birchii,156593892,VNKA01006896.1,1,2305,1.47196e-05,151970165,0.970473
D.birchii,156593892,VNKA01002432.1,1,2304,1.47132e-05,151972469,0.970488
D.birchii,156593892,VNKA01002397.1,1,2304,1.47132e-05,151974773,0.970503
D.birchii,156593892,VNKA01005541.1,1,2303,1.47068e-05,151977076,0.970517
D.birchii,156593892,VNKA01005356.1,1,2303,1.47068e-05,151979379,0.970532
D.birchii,156593892,VNKA01006709.1,1,2302,1.47004e-05,151981681,0.970547
D.birchii,156593892,VNKA01002224.1,1,2302,1.47004e-05,151983983,0.970561
D.birchii,156593892,VNKA01002176.1,1,2302,1.47004e-05,151986285,0.970576
D.birchii,156593892,VNKA01004977.1,1,2301,1.46941e-05,151988586,0.970591
D.birchii,156593892,VNKA01002126.1,1,2301,1.46941e-05,151990887,0.970605
D.birchii,156593892,VNKA01005744.1,1,2300,1.46877e-05,151993187,0.97062
D.birchii,156593892,VNKA01007056.1,1,2299,1.46813e-05,151995486,0.970635
D.birchii,156593892,VNKA01003296.1,1,2299,1.46813e-05,151997785,0.97065
D.birchii,156593892,VNKA01007125.1,1,2298,1.46749e-05,152000083,0.970664
D.birchii,156593892,VNKA01006500.1,1,2298,1.46749e-05,152002381,0.970679
D.birchii,156593892,VNKA01005421.1,1,2298,1.46749e-05,152004679,0.970694
D.birchii,156593892,VNKA01006584.1,1,2297,1.46685e-05,152006976,0.970708
D.birchii,156593892,VNKA01000881.1,1,2297,1.46685e-05,152009273,0.970723
D.birchii,156593892,VNKA01006591.1,1,2296,1.46621e-05,152011569,0.970738
D.birchii,156593892,VNKA01001023.1,1,2295,1.46557e-05,152013864,0.970752
D.birchii,156593892,VNKA01004780.1,1,2294,1.46494e-05,152016158,0.970767
D.birchii,156593892,VNKA01002059.1,1,2294,1.46494e-05,152018452,0.970781
D.birchii,156593892,VNKA01002216.1,1,2292,1.46366e-05,152020744,0.970796
D.birchii,156593892,VNKA01005378.1,1,2291,1.46302e-05,152023035,0.970811
D.birchii,156593892,VNKA01003541.1,1,2291,1.46302e-05,152025326,0.970825
D.birchii,156593892,VNKA01004632.1,1,2290,1.46238e-05,152027616,0.97084
D.birchii,156593892,VNKA01002979.1,1,2290,1.46238e-05,152029906,0.970855
D.birchii,156593892,VNKA01001422.1,1,2290,1.46238e-05,152032196,0.970869
D.birchii,156593892,VNKA01000734.1,1,2290,1.46238e-05,152034486,0.970884
D.birchii,156593892,VNKA01006127.1,1,2289,1.46174e-05,152036775,0.970899
D.birchii,156593892,VNKA01000572.1,1,2286,1.45983e-05,152039061,0.970913
D.birchii,156593892,VNKA01006928.1,1,2285,1.45919e-05,152041346,0.970928
D.birchii,156593892,VNKA01003950.1,1,2285,1.45919e-05,152043631,0.970942
D.birchii,156593892,VNKA01003628.1,1,2283,1.45791e-05,152045914,0.970957
D.birchii,156593892,VNKA01007357.1,1,2282,1.45727e-05,152048196,0.970971
D.birchii,156593892,VNKA01007280.1,1,2282,1.45727e-05,152050478,0.970986
D.birchii,156593892,VNKA01004469.1,1,2281,1.45663e-05,152052759,0.971001
D.birchii,156593892,VNKA01004378.1,1,2280,1.456e-05,152055039,0.971015
D.birchii,156593892,VNKA01000377.1,1,2280,1.456e-05,152057319,0.97103
D.birchii,156593892,VNKA01001152.1,1,2279,1.45536e-05,152059598,0.971044
D.birchii,156593892,VNKA01000120.1,1,2278,1.45472e-05,152061876,0.971059
D.birchii,156593892,VNKA01002506.1,1,2277,1.45408e-05,152064153,0.971073
D.birchii,156593892,VNKA01002865.1,1,2276,1.45344e-05,152066429,0.971088
D.birchii,156593892,VNKA01002504.1,1,2276,1.45344e-05,152068705,0.971102
D.birchii,156593892,VNKA01000574.1,1,2276,1.45344e-05,152070981,0.971117
D.birchii,156593892,VNKA01007040.1,1,2275,1.4528e-05,152073256,0.971131
D.birchii,156593892,VNKA01006525.1,1,2275,1.4528e-05,152075531,0.971146
D.birchii,156593892,VNKA01002477.1,1,2275,1.4528e-05,152077806,0.971161
D.birchii,156593892,VNKA01002001.1,1,2275,1.4528e-05,152080081,0.971175
D.birchii,156593892,VNKA01001497.1,1,2274,1.45216e-05,152082355,0.97119
D.birchii,156593892,VNKA01005597.1,1,2273,1.45153e-05,152084628,0.971204
D.birchii,156593892,VNKA01003024.1,1,2272,1.45089e-05,152086900,0.971219
D.birchii,156593892,VNKA01005751.1,1,2271,1.45025e-05,152089171,0.971233
D.birchii,156593892,VNKA01004176.1,1,2271,1.45025e-05,152091442,0.971248
D.birchii,156593892,VNKA01000420.1,1,2270,1.44961e-05,152093712,0.971262
D.birchii,156593892,VNKA01005564.1,1,2269,1.44897e-05,152095981,0.971277
D.birchii,156593892,VNKA01006991.1,1,2268,1.44833e-05,152098249,0.971291
D.birchii,156593892,VNKA01006317.1,1,2266,1.44706e-05,152100515,0.971306
D.birchii,156593892,VNKA01004034.1,1,2266,1.44706e-05,152102781,0.97132
D.birchii,156593892,VNKA01007568.1,1,2265,1.44642e-05,152105046,0.971334
D.birchii,156593892,VNKA01006741.1,1,2265,1.44642e-05,152107311,0.971349
D.birchii,156593892,VNKA01001721.1,1,2265,1.44642e-05,152109576,0.971363
D.birchii,156593892,VNKA01005840.1,1,2264,1.44578e-05,152111840,0.971378
D.birchii,156593892,VNKA01003797.1,1,2264,1.44578e-05,152114104,0.971392
D.birchii,156593892,VNKA01000084.1,1,2264,1.44578e-05,152116368,0.971407
D.birchii,156593892,VNKA01006753.1,1,2263,1.44514e-05,152118631,0.971421
D.birchii,156593892,VNKA01000992.1,1,2263,1.44514e-05,152120894,0.971436
D.birchii,156593892,VNKA01000693.1,1,2263,1.44514e-05,152123157,0.97145
D.birchii,156593892,VNKA01003740.1,1,2262,1.4445e-05,152125419,0.971465
D.birchii,156593892,VNKA01002875.1,1,2261,1.44386e-05,152127680,0.971479
D.birchii,156593892,VNKA01002994.1,1,2260,1.44322e-05,152129940,0.971493
D.birchii,156593892,VNKA01001562.1,1,2260,1.44322e-05,152132200,0.971508
D.birchii,156593892,VNKA01006273.1,1,2259,1.44259e-05,152134459,0.971522
D.birchii,156593892,VNKA01005096.1,1,2258,1.44195e-05,152136717,0.971537
D.birchii,156593892,VNKA01004323.1,1,2256,1.44067e-05,152138973,0.971551
D.birchii,156593892,VNKA01000831.1,1,2256,1.44067e-05,152141229,0.971566
D.birchii,156593892,VNKA01001628.1,1,2255,1.44003e-05,152143484,0.97158
D.birchii,156593892,VNKA01005176.1,1,2254,1.43939e-05,152145738,0.971594
D.birchii,156593892,VNKA01006112.1,1,2253,1.43875e-05,152147991,0.971609
D.birchii,156593892,VNKA01003134.1,1,2253,1.43875e-05,152150244,0.971623
D.birchii,156593892,VNKA01002881.1,1,2252,1.43811e-05,152152496,0.971637
D.birchii,156593892,VNKA01001713.1,1,2252,1.43811e-05,152154748,0.971652
D.birchii,156593892,VNKA01007399.1,1,2250,1.43684e-05,152156998,0.971666
D.birchii,156593892,VNKA01006842.1,1,2250,1.43684e-05,152159248,0.971681
D.birchii,156593892,VNKA01006894.1,1,2249,1.4362e-05,152161497,0.971695
D.birchii,156593892,VNKA01004335.1,1,2249,1.4362e-05,152163746,0.971709
D.birchii,156593892,VNKA01003754.1,1,2249,1.4362e-05,152165995,0.971724
D.birchii,156593892,VNKA01004668.1,1,2248,1.43556e-05,152168243,0.971738
D.birchii,156593892,VNKA01002621.1,1,2248,1.43556e-05,152170491,0.971752
D.birchii,156593892,VNKA01003638.1,1,2247,1.43492e-05,152172738,0.971767
D.birchii,156593892,VNKA01001479.1,1,2247,1.43492e-05,152174985,0.971781
D.birchii,156593892,VNKA01006840.1,1,2246,1.43428e-05,152177231,0.971795
D.birchii,156593892,VNKA01006634.1,1,2246,1.43428e-05,152179477,0.97181
D.birchii,156593892,VNKA01005543.1,1,2244,1.43301e-05,152181721,0.971824
D.birchii,156593892,VNKA01004706.1,1,2244,1.43301e-05,152183965,0.971838
D.birchii,156593892,VNKA01002084.1,1,2244,1.43301e-05,152186209,0.971853
D.birchii,156593892,VNKA01001648.1,1,2244,1.43301e-05,152188453,0.971867
D.birchii,156593892,VNKA01000637.1,1,2244,1.43301e-05,152190697,0.971881
D.birchii,156593892,VNKA01000351.1,1,2244,1.43301e-05,152192941,0.971896
D.birchii,156593892,VNKA01006779.1,1,2242,1.43173e-05,152195183,0.97191
D.birchii,156593892,VNKA01002737.1,1,2242,1.43173e-05,152197425,0.971924
D.birchii,156593892,VNKA01006583.1,1,2240,1.43045e-05,152199665,0.971939
D.birchii,156593892,VNKA01004821.1,1,2240,1.43045e-05,152201905,0.971953
D.birchii,156593892,VNKA01002722.1,1,2239,1.42981e-05,152204144,0.971967
D.birchii,156593892,VNKA01005866.1,1,2238,1.42917e-05,152206382,0.971982
D.birchii,156593892,VNKA01005299.1,1,2238,1.42917e-05,152208620,0.971996
D.birchii,156593892,VNKA01005198.1,1,2238,1.42917e-05,152210858,0.97201
D.birchii,156593892,VNKA01001441.1,1,2237,1.42854e-05,152213095,0.972024
D.birchii,156593892,VNKA01001356.1,1,2237,1.42854e-05,152215332,0.972039
D.birchii,156593892,VNKA01001144.1,1,2237,1.42854e-05,152217569,0.972053
D.birchii,156593892,VNKA01000704.1,1,2237,1.42854e-05,152219806,0.972067
D.birchii,156593892,VNKA01002342.1,1,2236,1.4279e-05,152222042,0.972082
D.birchii,156593892,VNKA01005061.1,1,2235,1.42726e-05,152224277,0.972096
D.birchii,156593892,VNKA01006642.1,1,2234,1.42662e-05,152226511,0.97211
D.birchii,156593892,VNKA01002280.1,1,2234,1.42662e-05,152228745,0.972124
D.birchii,156593892,VNKA01002037.1,1,2234,1.42662e-05,152230979,0.972139
D.birchii,156593892,VNKA01000884.1,1,2233,1.42598e-05,152233212,0.972153
D.birchii,156593892,VNKA01005945.1,1,2232,1.42534e-05,152235444,0.972167
D.birchii,156593892,VNKA01003873.1,1,2231,1.4247e-05,152237675,0.972181
D.birchii,156593892,VNKA01000910.1,1,2231,1.4247e-05,152239906,0.972196
D.birchii,156593892,VNKA01000502.1,1,2231,1.4247e-05,152242137,0.97221
D.birchii,156593892,VNKA01002076.1,1,2230,1.42407e-05,152244367,0.972224
D.birchii,156593892,VNKA01001605.1,1,2230,1.42407e-05,152246597,0.972238
D.birchii,156593892,VNKA01001116.1,1,2230,1.42407e-05,152248827,0.972253
D.birchii,156593892,VNKA01006266.1,1,2229,1.42343e-05,152251056,0.972267
D.birchii,156593892,VNKA01003705.1,1,2229,1.42343e-05,152253285,0.972281
D.birchii,156593892,VNKA01002964.1,1,2229,1.42343e-05,152255514,0.972295
D.birchii,156593892,VNKA01001998.1,1,2229,1.42343e-05,152257743,0.97231
D.birchii,156593892,VNKA01001071.1,1,2229,1.42343e-05,152259972,0.972324
D.birchii,156593892,VNKA01000843.1,1,2229,1.42343e-05,152262201,0.972338
D.birchii,156593892,VNKA01004360.1,1,2228,1.42279e-05,152264429,0.972352
D.birchii,156593892,VNKA01000972.1,1,2228,1.42279e-05,152266657,0.972367
D.birchii,156593892,VNKA01000181.1,1,2228,1.42279e-05,152268885,0.972381
D.birchii,156593892,VNKA01007392.1,1,2226,1.42151e-05,152271111,0.972395
D.birchii,156593892,VNKA01005753.1,1,2226,1.42151e-05,152273337,0.972409
D.birchii,156593892,VNKA01007015.1,1,2225,1.42087e-05,152275562,0.972423
D.birchii,156593892,VNKA01003493.1,1,2225,1.42087e-05,152277787,0.972438
D.birchii,156593892,VNKA01003044.1,1,2225,1.42087e-05,152280012,0.972452
D.birchii,156593892,VNKA01002507.1,1,2225,1.42087e-05,152282237,0.972466
D.birchii,156593892,VNKA01003002.1,1,2223,1.4196e-05,152284460,0.97248
D.birchii,156593892,VNKA01001977.1,1,2223,1.4196e-05,152286683,0.972494
D.birchii,156593892,VNKA01000803.1,1,2222,1.41896e-05,152288905,0.972509
D.birchii,156593892,VNKA01003094.1,1,2221,1.41832e-05,152291126,0.972523
D.birchii,156593892,VNKA01005850.1,1,2219,1.41704e-05,152293345,0.972537
D.birchii,156593892,VNKA01004299.1,1,2219,1.41704e-05,152295564,0.972551
D.birchii,156593892,VNKA01003653.1,1,2219,1.41704e-05,152297783,0.972565
D.birchii,156593892,VNKA01001709.1,1,2219,1.41704e-05,152300002,0.972579
D.birchii,156593892,VNKA01001453.1,1,2219,1.41704e-05,152302221,0.972594
D.birchii,156593892,VNKA01000635.1,1,2219,1.41704e-05,152304440,0.972608
D.birchii,156593892,VNKA01001584.1,1,2218,1.4164e-05,152306658,0.972622
D.birchii,156593892,VNKA01005180.1,1,2217,1.41576e-05,152308875,0.972636
D.birchii,156593892,VNKA01000742.1,1,2217,1.41576e-05,152311092,0.97265
D.birchii,156593892,VNKA01007452.1,1,2216,1.41513e-05,152313308,0.972664
D.birchii,156593892,VNKA01004214.1,1,2216,1.41513e-05,152315524,0.972679
D.birchii,156593892,VNKA01003358.1,1,2216,1.41513e-05,152317740,0.972693
D.birchii,156593892,VNKA01002896.1,1,2216,1.41513e-05,152319956,0.972707
D.birchii,156593892,VNKA01003988.1,1,2214,1.41385e-05,152322170,0.972721
D.birchii,156593892,VNKA01002598.1,1,2212,1.41257e-05,152324382,0.972735
D.birchii,156593892,VNKA01002530.1,1,2212,1.41257e-05,152326594,0.972749
D.birchii,156593892,VNKA01006479.1,1,2211,1.41193e-05,152328805,0.972763
D.birchii,156593892,VNKA01002632.1,1,2211,1.41193e-05,152331016,0.972778
D.birchii,156593892,VNKA01001234.1,1,2211,1.41193e-05,152333227,0.972792
D.birchii,156593892,VNKA01000948.1,1,2211,1.41193e-05,152335438,0.972806
D.birchii,156593892,VNKA01006717.1,1,2210,1.41129e-05,152337648,0.97282
D.birchii,156593892,VNKA01006082.1,1,2210,1.41129e-05,152339858,0.972834
D.birchii,156593892,VNKA01006265.1,1,2209,1.41066e-05,152342067,0.972848
D.birchii,156593892,VNKA01002658.1,1,2209,1.41066e-05,152344276,0.972862
D.birchii,156593892,VNKA01004698.1,1,2207,1.40938e-05,152346483,0.972876
D.birchii,156593892,VNKA01004211.1,1,2206,1.40874e-05,152348689,0.97289
D.birchii,156593892,VNKA01000830.1,1,2206,1.40874e-05,152350895,0.972904
D.birchii,156593892,VNKA01002419.1,1,2204,1.40746e-05,152353099,0.972919
D.birchii,156593892,VNKA01000087.1,1,2204,1.40746e-05,152355303,0.972933
D.birchii,156593892,VNKA01006869.1,1,2203,1.40682e-05,152357506,0.972947
D.birchii,156593892,VNKA01003082.1,1,2202,1.40619e-05,152359708,0.972961
D.birchii,156593892,VNKA01002747.1,1,2201,1.40555e-05,152361909,0.972975
D.birchii,156593892,VNKA01002690.1,1,2201,1.40555e-05,152364110,0.972989
D.birchii,156593892,VNKA01000395.1,1,2201,1.40555e-05,152366311,0.973003
D.birchii,156593892,VNKA01005522.1,1,2200,1.40491e-05,152368511,0.973017
D.birchii,156593892,VNKA01002589.1,1,2199,1.40427e-05,152370710,0.973031
D.birchii,156593892,VNKA01000233.1,1,2199,1.40427e-05,152372909,0.973045
D.birchii,156593892,VNKA01001630.1,1,2198,1.40363e-05,152375107,0.973059
D.birchii,156593892,VNKA01002188.1,1,2197,1.40299e-05,152377304,0.973073
D.birchii,156593892,VNKA01006612.1,1,2196,1.40235e-05,152379500,0.973087
D.birchii,156593892,VNKA01004224.1,1,2196,1.40235e-05,152381696,0.973101
D.birchii,156593892,VNKA01000975.1,1,2195,1.40171e-05,152383891,0.973115
D.birchii,156593892,VNKA01005931.1,1,2194,1.40108e-05,152386085,0.973129
D.birchii,156593892,VNKA01004133.1,1,2194,1.40108e-05,152388279,0.973143
D.birchii,156593892,VNKA01005816.1,1,2193,1.40044e-05,152390472,0.973157
D.birchii,156593892,VNKA01004836.1,1,2193,1.40044e-05,152392665,0.973171
D.birchii,156593892,VNKA01004117.1,1,2193,1.40044e-05,152394858,0.973185
D.birchii,156593892,VNKA01000447.1,1,2193,1.40044e-05,152397051,0.973199
D.birchii,156593892,VNKA01006703.1,1,2192,1.3998e-05,152399243,0.973213
D.birchii,156593892,VNKA01005536.1,1,2192,1.3998e-05,152401435,0.973227
D.birchii,156593892,VNKA01004013.1,1,2192,1.3998e-05,152403627,0.973241
D.birchii,156593892,VNKA01001902.1,1,2191,1.39916e-05,152405818,0.973255
D.birchii,156593892,VNKA01000112.1,1,2191,1.39916e-05,152408009,0.973269
D.birchii,156593892,VNKA01002143.1,1,2190,1.39852e-05,152410199,0.973283
D.birchii,156593892,VNKA01003888.1,1,2189,1.39788e-05,152412388,0.973297
D.birchii,156593892,VNKA01001968.1,1,2189,1.39788e-05,152414577,0.973311
D.birchii,156593892,VNKA01001588.1,1,2189,1.39788e-05,152416766,0.973325
D.birchii,156593892,VNKA01005368.1,1,2188,1.39724e-05,152418954,0.973339
D.birchii,156593892,VNKA01003712.1,1,2188,1.39724e-05,152421142,0.973353
D.birchii,156593892,VNKA01002864.1,1,2188,1.39724e-05,152423330,0.973367
D.birchii,156593892,VNKA01000769.1,1,2187,1.39661e-05,152425517,0.973381
D.birchii,156593892,VNKA01002045.1,1,2186,1.39597e-05,152427703,0.973395
D.birchii,156593892,VNKA01001522.1,1,2186,1.39597e-05,152429889,0.973409
D.birchii,156593892,VNKA01002362.1,1,2185,1.39533e-05,152432074,0.973423
D.birchii,156593892,VNKA01002848.1,1,2184,1.39469e-05,152434258,0.973437
D.birchii,156593892,VNKA01000828.1,1,2184,1.39469e-05,152436442,0.973451
D.birchii,156593892,VNKA01000679.1,1,2184,1.39469e-05,152438626,0.973465
D.birchii,156593892,VNKA01006499.1,1,2183,1.39405e-05,152440809,0.973479
D.birchii,156593892,VNKA01004329.1,1,2183,1.39405e-05,152442992,0.973493
D.birchii,156593892,VNKA01002233.1,1,2183,1.39405e-05,152445175,0.973507
D.birchii,156593892,VNKA01005490.1,1,2181,1.39277e-05,152447356,0.97352
D.birchii,156593892,VNKA01005773.1,1,2180,1.39214e-05,152449536,0.973534
D.birchii,156593892,VNKA01004039.1,1,2180,1.39214e-05,152451716,0.973548
D.birchii,156593892,VNKA01003484.1,1,2180,1.39214e-05,152453896,0.973562
D.birchii,156593892,VNKA01000957.1,1,2179,1.3915e-05,152456075,0.973576
D.birchii,156593892,VNKA01000357.1,1,2179,1.3915e-05,152458254,0.97359
D.birchii,156593892,VNKA01001434.1,1,2178,1.39086e-05,152460432,0.973604
D.birchii,156593892,VNKA01004418.1,1,2175,1.38894e-05,152462607,0.973618
D.birchii,156593892,VNKA01003103.1,1,2175,1.38894e-05,152464782,0.973632
D.birchii,156593892,VNKA01001729.1,1,2174,1.3883e-05,152466956,0.973646
D.birchii,156593892,VNKA01007230.1,1,2173,1.38767e-05,152469129,0.973659
D.birchii,156593892,VNKA01000133.1,1,2173,1.38767e-05,152471302,0.973673
D.birchii,156593892,VNKA01005335.1,1,2172,1.38703e-05,152473474,0.973687
D.birchii,156593892,VNKA01003223.1,1,2171,1.38639e-05,152475645,0.973701
D.birchii,156593892,VNKA01000207.1,1,2171,1.38639e-05,152477816,0.973715
D.birchii,156593892,VNKA01004377.1,1,2170,1.38575e-05,152479986,0.973729
D.birchii,156593892,VNKA01004111.1,1,2170,1.38575e-05,152482156,0.973743
D.birchii,156593892,VNKA01002164.1,1,2170,1.38575e-05,152484326,0.973757
D.birchii,156593892,VNKA01000336.1,1,2168,1.38447e-05,152486494,0.97377
D.birchii,156593892,VNKA01006725.1,1,2167,1.38383e-05,152488661,0.973784
D.birchii,156593892,VNKA01003637.1,1,2167,1.38383e-05,152490828,0.973798
D.birchii,156593892,VNKA01001440.1,1,2167,1.38383e-05,152492995,0.973812
D.birchii,156593892,VNKA01001174.1,1,2165,1.38256e-05,152495160,0.973826
D.birchii,156593892,VNKA01000835.1,1,2165,1.38256e-05,152497325,0.97384
D.birchii,156593892,VNKA01006287.1,1,2164,1.38192e-05,152499489,0.973853
D.birchii,156593892,VNKA01005880.1,1,2164,1.38192e-05,152501653,0.973867
D.birchii,156593892,VNKA01002452.1,1,2164,1.38192e-05,152503817,0.973881
D.birchii,156593892,VNKA01005761.1,1,2161,1.38e-05,152505978,0.973895
D.birchii,156593892,VNKA01004728.1,1,2161,1.38e-05,152508139,0.973909
D.birchii,156593892,VNKA01002573.1,1,2161,1.38e-05,152510300,0.973922
D.birchii,156593892,VNKA01004757.1,1,2160,1.37936e-05,152512460,0.973936
D.birchii,156593892,VNKA01000511.1,1,2160,1.37936e-05,152514620,0.97395
D.birchii,156593892,VNKA01001484.1,1,2159,1.37873e-05,152516779,0.973964
D.birchii,156593892,VNKA01001088.1,1,2158,1.37809e-05,152518937,0.973978
D.birchii,156593892,VNKA01006286.1,1,2157,1.37745e-05,152521094,0.973991
D.birchii,156593892,VNKA01005826.1,1,2157,1.37745e-05,152523251,0.974005
D.birchii,156593892,VNKA01001426.1,1,2156,1.37681e-05,152525407,0.974019
D.birchii,156593892,VNKA01006785.1,1,2155,1.37617e-05,152527562,0.974033
D.birchii,156593892,VNKA01006578.1,1,2155,1.37617e-05,152529717,0.974046
D.birchii,156593892,VNKA01006183.1,1,2155,1.37617e-05,152531872,0.97406
D.birchii,156593892,VNKA01004364.1,1,2155,1.37617e-05,152534027,0.974074
D.birchii,156593892,VNKA01003013.1,1,2155,1.37617e-05,152536182,0.974088
D.birchii,156593892,VNKA01001844.1,1,2155,1.37617e-05,152538337,0.974101
D.birchii,156593892,VNKA01003804.1,1,2154,1.37553e-05,152540491,0.974115
D.birchii,156593892,VNKA01004841.1,1,2153,1.37489e-05,152542644,0.974129
D.birchii,156593892,VNKA01004707.1,1,2153,1.37489e-05,152544797,0.974143
D.birchii,156593892,VNKA01004421.1,1,2153,1.37489e-05,152546950,0.974156
D.birchii,156593892,VNKA01002142.1,1,2153,1.37489e-05,152549103,0.97417
D.birchii,156593892,VNKA01001764.1,1,2152,1.37426e-05,152551255,0.974184
D.birchii,156593892,VNKA01000121.1,1,2152,1.37426e-05,152553407,0.974198
D.birchii,156593892,VNKA01006424.1,1,2150,1.37298e-05,152555557,0.974211
D.birchii,156593892,VNKA01005822.1,1,2150,1.37298e-05,152557707,0.974225
D.birchii,156593892,VNKA01003782.1,1,2150,1.37298e-05,152559857,0.974239
D.birchii,156593892,VNKA01002125.1,1,2150,1.37298e-05,152562007,0.974253
D.birchii,156593892,VNKA01000612.1,1,2150,1.37298e-05,152564157,0.974266
D.birchii,156593892,VNKA01006744.1,1,2149,1.37234e-05,152566306,0.97428
D.birchii,156593892,VNKA01006702.1,1,2148,1.3717e-05,152568454,0.974294
D.birchii,156593892,VNKA01002508.1,1,2148,1.3717e-05,152570602,0.974307
D.birchii,156593892,VNKA01005434.1,1,2146,1.37042e-05,152572748,0.974321
D.birchii,156593892,VNKA01001235.1,1,2146,1.37042e-05,152574894,0.974335
D.birchii,156593892,VNKA01005727.1,1,2145,1.36979e-05,152577039,0.974349
D.birchii,156593892,VNKA01005311.1,1,2144,1.36915e-05,152579183,0.974362
D.birchii,156593892,VNKA01001121.1,1,2144,1.36915e-05,152581327,0.974376
D.birchii,156593892,VNKA01000367.1,1,2143,1.36851e-05,152583470,0.97439
D.birchii,156593892,VNKA01007081.1,1,2142,1.36787e-05,152585612,0.974403
D.birchii,156593892,VNKA01007502.1,1,2141,1.36723e-05,152587753,0.974417
D.birchii,156593892,VNKA01006197.1,1,2140,1.36659e-05,152589893,0.974431
D.birchii,156593892,VNKA01004234.1,1,2139,1.36595e-05,152592032,0.974444
D.birchii,156593892,VNKA01000293.1,1,2139,1.36595e-05,152594171,0.974458
D.birchii,156593892,VNKA01003268.1,1,2138,1.36532e-05,152596309,0.974472
D.birchii,156593892,VNKA01002395.1,1,2138,1.36532e-05,152598447,0.974485
D.birchii,156593892,VNKA01000617.1,1,2138,1.36532e-05,152600585,0.974499
D.birchii,156593892,VNKA01005828.1,1,2137,1.36468e-05,152602722,0.974513
D.birchii,156593892,VNKA01002365.1,1,2137,1.36468e-05,152604859,0.974526
D.birchii,156593892,VNKA01006191.1,1,2136,1.36404e-05,152606995,0.97454
D.birchii,156593892,VNKA01006033.1,1,2136,1.36404e-05,152609131,0.974554
D.birchii,156593892,VNKA01005679.1,1,2136,1.36404e-05,152611267,0.974567
D.birchii,156593892,VNKA01006837.1,1,2135,1.3634e-05,152613402,0.974581
D.birchii,156593892,VNKA01006693.1,1,2135,1.3634e-05,152615537,0.974594
D.birchii,156593892,VNKA01005649.1,1,2135,1.3634e-05,152617672,0.974608
D.birchii,156593892,VNKA01005004.1,1,2135,1.3634e-05,152619807,0.974622
D.birchii,156593892,VNKA01003868.1,1,2134,1.36276e-05,152621941,0.974635
D.birchii,156593892,VNKA01002663.1,1,2134,1.36276e-05,152624075,0.974649
D.birchii,156593892,VNKA01003879.1,1,2133,1.36212e-05,152626208,0.974663
D.birchii,156593892,VNKA01003753.1,1,2133,1.36212e-05,152628341,0.974676
D.birchii,156593892,VNKA01000024.1,1,2133,1.36212e-05,152630474,0.97469
D.birchii,156593892,VNKA01003027.1,1,2132,1.36148e-05,152632606,0.974703
D.birchii,156593892,VNKA01003238.1,1,2131,1.36084e-05,152634737,0.974717
D.birchii,156593892,VNKA01000646.1,1,2130,1.36021e-05,152636867,0.974731
D.birchii,156593892,VNKA01001198.1,1,2129,1.35957e-05,152638996,0.974744
D.birchii,156593892,VNKA01007003.1,1,2128,1.35893e-05,152641124,0.974758
D.birchii,156593892,VNKA01002797.1,1,2128,1.35893e-05,152643252,0.974771
D.birchii,156593892,VNKA01003194.1,1,2127,1.35829e-05,152645379,0.974785
D.birchii,156593892,VNKA01001242.1,1,2127,1.35829e-05,152647506,0.974799
D.birchii,156593892,VNKA01005024.1,1,2125,1.35701e-05,152649631,0.974812
D.birchii,156593892,VNKA01005769.1,1,2124,1.35637e-05,152651755,0.974826
D.birchii,156593892,VNKA01002977.1,1,2121,1.35446e-05,152653876,0.974839
D.birchii,156593892,VNKA01001892.1,1,2120,1.35382e-05,152655996,0.974853
D.birchii,156593892,VNKA01005829.1,1,2119,1.35318e-05,152658115,0.974866
D.birchii,156593892,VNKA01004851.1,1,2119,1.35318e-05,152660234,0.97488
D.birchii,156593892,VNKA01004528.1,1,2119,1.35318e-05,152662353,0.974893
D.birchii,156593892,VNKA01004240.1,1,2119,1.35318e-05,152664472,0.974907
D.birchii,156593892,VNKA01002237.1,1,2119,1.35318e-05,152666591,0.97492
D.birchii,156593892,VNKA01001249.1,1,2119,1.35318e-05,152668710,0.974934
D.birchii,156593892,VNKA01002819.1,1,2118,1.35254e-05,152670828,0.974948
D.birchii,156593892,VNKA01003547.1,1,2116,1.35127e-05,152672944,0.974961
D.birchii,156593892,VNKA01005810.1,1,2115,1.35063e-05,152675059,0.974975
D.birchii,156593892,VNKA01004136.1,1,2115,1.35063e-05,152677174,0.974988
D.birchii,156593892,VNKA01006740.1,1,2114,1.34999e-05,152679288,0.975002
D.birchii,156593892,VNKA01005353.1,1,2114,1.34999e-05,152681402,0.975015
D.birchii,156593892,VNKA01006738.1,1,2113,1.34935e-05,152683515,0.975029
D.birchii,156593892,VNKA01002080.1,1,2113,1.34935e-05,152685628,0.975042
D.birchii,156593892,VNKA01000467.1,1,2111,1.34807e-05,152687739,0.975056
D.birchii,156593892,VNKA01006451.1,1,2110,1.34743e-05,152689849,0.975069
D.birchii,156593892,VNKA01005855.1,1,2110,1.34743e-05,152691959,0.975082
D.birchii,156593892,VNKA01006072.1,1,2108,1.34616e-05,152694067,0.975096
D.birchii,156593892,VNKA01002846.1,1,2107,1.34552e-05,152696174,0.975109
D.birchii,156593892,VNKA01002885.1,1,2106,1.34488e-05,152698280,0.975123
D.birchii,156593892,VNKA01005703.1,1,2105,1.34424e-05,152700385,0.975136
D.birchii,156593892,VNKA01002620.1,1,2105,1.34424e-05,152702490,0.97515
D.birchii,156593892,VNKA01006957.1,1,2104,1.3436e-05,152704594,0.975163
D.birchii,156593892,VNKA01004006.1,1,2104,1.3436e-05,152706698,0.975177
D.birchii,156593892,VNKA01001084.1,1,2104,1.3436e-05,152708802,0.97519
D.birchii,156593892,VNKA01005692.1,1,2103,1.34296e-05,152710905,0.975203
D.birchii,156593892,VNKA01003108.1,1,2103,1.34296e-05,152713008,0.975217
D.birchii,156593892,VNKA01000049.1,1,2102,1.34233e-05,152715110,0.97523
D.birchii,156593892,VNKA01006833.1,1,2100,1.34105e-05,152717210,0.975244
D.birchii,156593892,VNKA01006695.1,1,2100,1.34105e-05,152719310,0.975257
D.birchii,156593892,VNKA01002326.1,1,2098,1.33977e-05,152721408,0.975271
D.birchii,156593892,VNKA01000279.1,1,2098,1.33977e-05,152723506,0.975284
D.birchii,156593892,VNKA01002053.1,1,2097,1.33913e-05,152725603,0.975297
D.birchii,156593892,VNKA01006193.1,1,2096,1.33849e-05,152727699,0.975311
D.birchii,156593892,VNKA01005214.1,1,2096,1.33849e-05,152729795,0.975324
D.birchii,156593892,VNKA01002235.1,1,2096,1.33849e-05,152731891,0.975337
D.birchii,156593892,VNKA01005525.1,1,2095,1.33786e-05,152733986,0.975351
D.birchii,156593892,VNKA01003035.1,1,2095,1.33786e-05,152736081,0.975364
D.birchii,156593892,VNKA01000074.1,1,2095,1.33786e-05,152738176,0.975378
D.birchii,156593892,VNKA01000980.1,1,2092,1.33594e-05,152740268,0.975391
D.birchii,156593892,VNKA01000754.1,1,2092,1.33594e-05,152742360,0.975404
D.birchii,156593892,VNKA01000591.1,1,2092,1.33594e-05,152744452,0.975418
D.birchii,156593892,VNKA01001876.1,1,2091,1.3353e-05,152746543,0.975431
D.birchii,156593892,VNKA01006009.1,1,2090,1.33466e-05,152748633,0.975444
D.birchii,156593892,VNKA01002873.1,1,2090,1.33466e-05,152750723,0.975458
D.birchii,156593892,VNKA01003823.1,1,2089,1.33402e-05,152752812,0.975471
D.birchii,156593892,VNKA01001716.1,1,2089,1.33402e-05,152754901,0.975484
D.birchii,156593892,VNKA01006751.1,1,2088,1.33339e-05,152756989,0.975498
D.birchii,156593892,VNKA01006113.1,1,2088,1.33339e-05,152759077,0.975511
D.birchii,156593892,VNKA01007254.1,1,2087,1.33275e-05,152761164,0.975524
D.birchii,156593892,VNKA01004673.1,1,2087,1.33275e-05,152763251,0.975538
D.birchii,156593892,VNKA01006879.1,1,2086,1.33211e-05,152765337,0.975551
D.birchii,156593892,VNKA01000919.1,1,2086,1.33211e-05,152767423,0.975564
D.birchii,156593892,VNKA01004975.1,1,2084,1.33083e-05,152769507,0.975578
D.birchii,156593892,VNKA01004055.1,1,2084,1.33083e-05,152771591,0.975591
D.birchii,156593892,VNKA01006696.1,1,2083,1.33019e-05,152773674,0.975604
D.birchii,156593892,VNKA01003627.1,1,2083,1.33019e-05,152775757,0.975618
D.birchii,156593892,VNKA01005298.1,1,2078,1.327e-05,152777835,0.975631
D.birchii,156593892,VNKA01002247.1,1,2078,1.327e-05,152779913,0.975644
D.birchii,156593892,VNKA01006425.1,1,2077,1.32636e-05,152781990,0.975657
D.birchii,156593892,VNKA01006706.1,1,2076,1.32572e-05,152784066,0.975671
D.birchii,156593892,VNKA01002469.1,1,2073,1.32381e-05,152786139,0.975684
D.birchii,156593892,VNKA01001080.1,1,2073,1.32381e-05,152788212,0.975697
D.birchii,156593892,VNKA01002905.1,1,2072,1.32317e-05,152790284,0.97571
D.birchii,156593892,VNKA01006734.1,1,2071,1.32253e-05,152792355,0.975724
D.birchii,156593892,VNKA01003528.1,1,2071,1.32253e-05,152794426,0.975737
D.birchii,156593892,VNKA01007404.1,1,2070,1.32189e-05,152796496,0.97575
D.birchii,156593892,VNKA01003789.1,1,2070,1.32189e-05,152798566,0.975763
D.birchii,156593892,VNKA01003660.1,1,2070,1.32189e-05,152800636,0.975776
D.birchii,156593892,VNKA01006863.1,1,2069,1.32125e-05,152802705,0.97579
D.birchii,156593892,VNKA01002959.1,1,2069,1.32125e-05,152804774,0.975803
D.birchii,156593892,VNKA01002474.1,1,2069,1.32125e-05,152806843,0.975816
D.birchii,156593892,VNKA01001266.1,1,2069,1.32125e-05,152808912,0.975829
D.birchii,156593892,VNKA01007092.1,1,2068,1.32061e-05,152810980,0.975843
D.birchii,156593892,VNKA01002597.1,1,2066,1.31934e-05,152813046,0.975856
D.birchii,156593892,VNKA01001785.1,1,2066,1.31934e-05,152815112,0.975869
D.birchii,156593892,VNKA01000873.1,1,2066,1.31934e-05,152817178,0.975882
D.birchii,156593892,VNKA01007359.1,1,2065,1.3187e-05,152819243,0.975895
D.birchii,156593892,VNKA01007228.1,1,2064,1.31806e-05,152821307,0.975908
D.birchii,156593892,VNKA01002679.1,1,2063,1.31742e-05,152823370,0.975922
D.birchii,156593892,VNKA01003749.1,1,2062,1.31678e-05,152825432,0.975935
D.birchii,156593892,VNKA01007499.1,1,2060,1.3155e-05,152827492,0.975948
D.birchii,156593892,VNKA01006683.1,1,2060,1.3155e-05,152829552,0.975961
D.birchii,156593892,VNKA01004223.1,1,2060,1.3155e-05,152831612,0.975974
D.birchii,156593892,VNKA01004858.1,1,2058,1.31423e-05,152833670,0.975987
D.birchii,156593892,VNKA01007394.1,1,2057,1.31359e-05,152835727,0.976001
D.birchii,156593892,VNKA01006015.1,1,2057,1.31359e-05,152837784,0.976014
D.birchii,156593892,VNKA01005954.1,1,2057,1.31359e-05,152839841,0.976027
D.birchii,156593892,VNKA01005804.1,1,2057,1.31359e-05,152841898,0.97604
D.birchii,156593892,VNKA01002454.1,1,2057,1.31359e-05,152843955,0.976053
D.birchii,156593892,VNKA01002522.1,1,2056,1.31295e-05,152846011,0.976066
D.birchii,156593892,VNKA01002016.1,1,2056,1.31295e-05,152848067,0.976079
D.birchii,156593892,VNKA01001504.1,1,2056,1.31295e-05,152850123,0.976092
D.birchii,156593892,VNKA01000717.1,1,2056,1.31295e-05,152852179,0.976106
D.birchii,156593892,VNKA01002463.1,1,2055,1.31231e-05,152854234,0.976119
D.birchii,156593892,VNKA01005074.1,1,2054,1.31167e-05,152856288,0.976132
D.birchii,156593892,VNKA01001597.1,1,2054,1.31167e-05,152858342,0.976145
D.birchii,156593892,VNKA01001231.1,1,2054,1.31167e-05,152860396,0.976158
D.birchii,156593892,VNKA01000313.1,1,2054,1.31167e-05,152862450,0.976171
D.birchii,156593892,VNKA01005565.1,1,2053,1.31103e-05,152864503,0.976184
D.birchii,156593892,VNKA01000173.1,1,2053,1.31103e-05,152866556,0.976197
D.birchii,156593892,VNKA01005867.1,1,2052,1.3104e-05,152868608,0.976211
D.birchii,156593892,VNKA01007075.1,1,2051,1.30976e-05,152870659,0.976224
D.birchii,156593892,VNKA01004583.1,1,2051,1.30976e-05,152872710,0.976237
D.birchii,156593892,VNKA01001535.1,1,2051,1.30976e-05,152874761,0.97625
D.birchii,156593892,VNKA01006327.1,1,2050,1.30912e-05,152876811,0.976263
D.birchii,156593892,VNKA01000715.1,1,2049,1.30848e-05,152878860,0.976276
D.birchii,156593892,VNKA01006472.1,1,2048,1.30784e-05,152880908,0.976289
D.birchii,156593892,VNKA01005245.1,1,2048,1.30784e-05,152882956,0.976302
D.birchii,156593892,VNKA01003577.1,1,2048,1.30784e-05,152885004,0.976315
D.birchii,156593892,VNKA01002422.1,1,2048,1.30784e-05,152887052,0.976328
D.birchii,156593892,VNKA01001899.1,1,2048,1.30784e-05,152889100,0.976341
D.birchii,156593892,VNKA01005757.1,1,2046,1.30656e-05,152891146,0.976354
D.birchii,156593892,VNKA01004781.1,1,2046,1.30656e-05,152893192,0.976368
D.birchii,156593892,VNKA01007391.1,1,2045,1.30593e-05,152895237,0.976381
D.birchii,156593892,VNKA01004387.1,1,2045,1.30593e-05,152897282,0.976394
D.birchii,156593892,VNKA01001594.1,1,2045,1.30593e-05,152899327,0.976407
D.birchii,156593892,VNKA01002821.1,1,2044,1.30529e-05,152901371,0.97642
D.birchii,156593892,VNKA01000331.1,1,2044,1.30529e-05,152903415,0.976433
D.birchii,156593892,VNKA01006323.1,1,2043,1.30465e-05,152905458,0.976446
D.birchii,156593892,VNKA01007429.1,1,2042,1.30401e-05,152907500,0.976459
D.birchii,156593892,VNKA01006596.1,1,2042,1.30401e-05,152909542,0.976472
D.birchii,156593892,VNKA01002336.1,1,2042,1.30401e-05,152911584,0.976485
D.birchii,156593892,VNKA01000236.1,1,2042,1.30401e-05,152913626,0.976498
D.birchii,156593892,VNKA01004953.1,1,2041,1.30337e-05,152915667,0.976511
D.birchii,156593892,VNKA01003141.1,1,2038,1.30146e-05,152917705,0.976524
D.birchii,156593892,VNKA01001092.1,1,2038,1.30146e-05,152919743,0.976537
D.birchii,156593892,VNKA01005123.1,1,2037,1.30082e-05,152921780,0.97655
D.birchii,156593892,VNKA01002189.1,1,2037,1.30082e-05,152923817,0.976563
D.birchii,156593892,VNKA01001412.1,1,2037,1.30082e-05,152925854,0.976576
D.birchii,156593892,VNKA01004105.1,1,2035,1.29954e-05,152927889,0.976589
D.birchii,156593892,VNKA01003900.1,1,2035,1.29954e-05,152929924,0.976602
D.birchii,156593892,VNKA01003631.1,1,2034,1.2989e-05,152931958,0.976615
D.birchii,156593892,VNKA01001990.1,1,2034,1.2989e-05,152933992,0.976628
D.birchii,156593892,VNKA01000466.1,1,2034,1.2989e-05,152936026,0.976641
D.birchii,156593892,VNKA01005854.1,1,2031,1.29699e-05,152938057,0.976654
D.birchii,156593892,VNKA01001032.1,1,2031,1.29699e-05,152940088,0.976667
D.birchii,156593892,VNKA01006036.1,1,2030,1.29635e-05,152942118,0.97668
D.birchii,156593892,VNKA01005095.1,1,2030,1.29635e-05,152944148,0.976693
D.birchii,156593892,VNKA01004582.1,1,2030,1.29635e-05,152946178,0.976706
D.birchii,156593892,VNKA01006303.1,1,2029,1.29571e-05,152948207,0.976719
D.birchii,156593892,VNKA01000375.1,1,2029,1.29571e-05,152950236,0.976732
D.birchii,156593892,VNKA01005160.1,1,2028,1.29507e-05,152952264,0.976745
D.birchii,156593892,VNKA01000879.1,1,2028,1.29507e-05,152954292,0.976758
D.birchii,156593892,VNKA01007276.1,1,2027,1.29443e-05,152956319,0.976771
D.birchii,156593892,VNKA01002909.1,1,2026,1.29379e-05,152958345,0.976784
D.birchii,156593892,VNKA01001250.1,1,2026,1.29379e-05,152960371,0.976797
D.birchii,156593892,VNKA01005842.1,1,2024,1.29252e-05,152962395,0.976809
D.birchii,156593892,VNKA01004277.1,1,2024,1.29252e-05,152964419,0.976822
D.birchii,156593892,VNKA01003941.1,1,2024,1.29252e-05,152966443,0.976835
D.birchii,156593892,VNKA01002766.1,1,2023,1.29188e-05,152968466,0.976848
D.birchii,156593892,VNKA01007086.1,1,2022,1.29124e-05,152970488,0.976861
D.birchii,156593892,VNKA01002897.1,1,2022,1.29124e-05,152972510,0.976874
D.birchii,156593892,VNKA01006810.1,1,2021,1.2906e-05,152974531,0.976887
D.birchii,156593892,VNKA01001404.1,1,2021,1.2906e-05,152976552,0.9769
D.birchii,156593892,VNKA01005972.1,1,2020,1.28996e-05,152978572,0.976913
D.birchii,156593892,VNKA01002891.1,1,2020,1.28996e-05,152980592,0.976926
D.birchii,156593892,VNKA01001925.1,1,2019,1.28932e-05,152982611,0.976939
D.birchii,156593892,VNKA01001421.1,1,2019,1.28932e-05,152984630,0.976951
D.birchii,156593892,VNKA01002264.1,1,2018,1.28868e-05,152986648,0.976964
D.birchii,156593892,VNKA01002213.1,1,2018,1.28868e-05,152988666,0.976977
D.birchii,156593892,VNKA01000624.1,1,2018,1.28868e-05,152990684,0.97699
D.birchii,156593892,VNKA01003527.1,1,2016,1.28741e-05,152992700,0.977003
D.birchii,156593892,VNKA01000145.1,1,2016,1.28741e-05,152994716,0.977016
D.birchii,156593892,VNKA01006974.1,1,2014,1.28613e-05,152996730,0.977029
D.birchii,156593892,VNKA01006222.1,1,2014,1.28613e-05,152998744,0.977042
D.birchii,156593892,VNKA01007131.1,1,2013,1.28549e-05,153000757,0.977054
D.birchii,156593892,VNKA01000425.1,1,2013,1.28549e-05,153002770,0.977067
D.birchii,156593892,VNKA01002029.1,1,2012,1.28485e-05,153004782,0.97708
D.birchii,156593892,VNKA01007536.1,1,2011,1.28421e-05,153006793,0.977093
D.birchii,156593892,VNKA01004742.1,1,2011,1.28421e-05,153008804,0.977106
D.birchii,156593892,VNKA01003714.1,1,2010,1.28357e-05,153010814,0.977119
D.birchii,156593892,VNKA01002248.1,1,2010,1.28357e-05,153012824,0.977131
D.birchii,156593892,VNKA01001077.1,1,2010,1.28357e-05,153014834,0.977144
D.birchii,156593892,VNKA01004505.1,1,2009,1.28294e-05,153016843,0.977157
D.birchii,156593892,VNKA01003308.1,1,2009,1.28294e-05,153018852,0.97717
D.birchii,156593892,VNKA01007473.1,1,2008,1.2823e-05,153020860,0.977183
D.birchii,156593892,VNKA01005997.1,1,2008,1.2823e-05,153022868,0.977196
D.birchii,156593892,VNKA01003276.1,1,2007,1.28166e-05,153024875,0.977208
D.birchii,156593892,VNKA01001172.1,1,2007,1.28166e-05,153026882,0.977221
D.birchii,156593892,VNKA01005886.1,1,2006,1.28102e-05,153028888,0.977234
D.birchii,156593892,VNKA01006732.1,1,2004,1.27974e-05,153030892,0.977247
D.birchii,156593892,VNKA01004533.1,1,2004,1.27974e-05,153032896,0.97726
D.birchii,156593892,VNKA01002091.1,1,2004,1.27974e-05,153034900,0.977272
D.birchii,156593892,VNKA01006947.1,1,2003,1.2791e-05,153036903,0.977285
D.birchii,156593892,VNKA01006790.1,1,2003,1.2791e-05,153038906,0.977298
D.birchii,156593892,VNKA01005530.1,1,2002,1.27847e-05,153040908,0.977311
D.birchii,156593892,VNKA01002971.1,1,2002,1.27847e-05,153042910,0.977324
D.birchii,156593892,VNKA01006575.1,1,2001,1.27783e-05,153044911,0.977336
D.birchii,156593892,VNKA01006050.1,1,2001,1.27783e-05,153046912,0.977349
D.birchii,156593892,VNKA01004564.1,1,2001,1.27783e-05,153048913,0.977362
D.birchii,156593892,VNKA01003785.1,1,2000,1.27719e-05,153050913,0.977375
D.birchii,156593892,VNKA01001797.1,1,2000,1.27719e-05,153052913,0.977388
D.birchii,156593892,VNKA01001396.1,1,2000,1.27719e-05,153054913,0.9774
D.birchii,156593892,VNKA01006044.1,1,1999,1.27655e-05,153056912,0.977413
D.birchii,156593892,VNKA01004633.1,1,1999,1.27655e-05,153058911,0.977426
D.birchii,156593892,VNKA01004631.1,1,1998,1.27591e-05,153060909,0.977439
D.birchii,156593892,VNKA01003987.1,1,1998,1.27591e-05,153062907,0.977451
D.birchii,156593892,VNKA01000326.1,1,1996,1.27463e-05,153064903,0.977464
D.birchii,156593892,VNKA01000093.1,1,1996,1.27463e-05,153066899,0.977477
D.birchii,156593892,VNKA01006712.1,1,1995,1.274e-05,153068894,0.97749
D.birchii,156593892,VNKA01004655.1,1,1995,1.274e-05,153070889,0.977502
D.birchii,156593892,VNKA01000706.1,1,1995,1.274e-05,153072884,0.977515
D.birchii,156593892,VNKA01000092.1,1,1995,1.274e-05,153074879,0.977528
D.birchii,156593892,VNKA01002641.1,1,1994,1.27336e-05,153076873,0.977541
D.birchii,156593892,VNKA01002404.1,1,1994,1.27336e-05,153078867,0.977553
D.birchii,156593892,VNKA01000407.1,1,1994,1.27336e-05,153080861,0.977566
D.birchii,156593892,VNKA01007401.1,1,1993,1.27272e-05,153082854,0.977579
D.birchii,156593892,VNKA01002815.1,1,1993,1.27272e-05,153084847,0.977591
D.birchii,156593892,VNKA01007095.1,1,1992,1.27208e-05,153086839,0.977604
D.birchii,156593892,VNKA01000208.1,1,1992,1.27208e-05,153088831,0.977617
D.birchii,156593892,VNKA01005562.1,1,1991,1.27144e-05,153090822,0.97763
D.birchii,156593892,VNKA01006150.1,1,1990,1.2708e-05,153092812,0.977642
D.birchii,156593892,VNKA01007226.1,1,1989,1.27016e-05,153094801,0.977655
D.birchii,156593892,VNKA01004538.1,1,1989,1.27016e-05,153096790,0.977668
D.birchii,156593892,VNKA01002809.1,1,1989,1.27016e-05,153098779,0.97768
D.birchii,156593892,VNKA01001569.1,1,1989,1.27016e-05,153100768,0.977693
D.birchii,156593892,VNKA01000935.1,1,1989,1.27016e-05,153102757,0.977706
D.birchii,156593892,VNKA01000949.1,1,1988,1.26953e-05,153104745,0.977718
D.birchii,156593892,VNKA01002956.1,1,1985,1.26761e-05,153106730,0.977731
D.birchii,156593892,VNKA01001580.1,1,1985,1.26761e-05,153108715,0.977744
D.birchii,156593892,VNKA01001451.1,1,1985,1.26761e-05,153110700,0.977757
D.birchii,156593892,VNKA01000737.1,1,1985,1.26761e-05,153112685,0.977769
D.birchii,156593892,VNKA01001243.1,1,1984,1.26697e-05,153114669,0.977782
D.birchii,156593892,VNKA01006157.1,1,1983,1.26633e-05,153116652,0.977795
D.birchii,156593892,VNKA01003338.1,1,1982,1.26569e-05,153118634,0.977807
D.birchii,156593892,VNKA01002586.1,1,1982,1.26569e-05,153120616,0.97782
D.birchii,156593892,VNKA01000189.1,1,1982,1.26569e-05,153122598,0.977833
D.birchii,156593892,VNKA01006294.1,1,1981,1.26506e-05,153124579,0.977845
D.birchii,156593892,VNKA01003661.1,1,1981,1.26506e-05,153126560,0.977858
D.birchii,156593892,VNKA01001985.1,1,1981,1.26506e-05,153128541,0.97787
D.birchii,156593892,VNKA01000967.1,1,1981,1.26506e-05,153130522,0.977883
D.birchii,156593892,VNKA01005302.1,1,1980,1.26442e-05,153132502,0.977896
D.birchii,156593892,VNKA01003548.1,1,1980,1.26442e-05,153134482,0.977908
D.birchii,156593892,VNKA01002293.1,1,1980,1.26442e-05,153136462,0.977921
D.birchii,156593892,VNKA01001509.1,1,1980,1.26442e-05,153138442,0.977934
D.birchii,156593892,VNKA01007363.1,1,1979,1.26378e-05,153140421,0.977946
D.birchii,156593892,VNKA01007549.1,1,1978,1.26314e-05,153142399,0.977959
D.birchii,156593892,VNKA01007496.1,1,1977,1.2625e-05,153144376,0.977972
D.birchii,156593892,VNKA01005151.1,1,1977,1.2625e-05,153146353,0.977984
D.birchii,156593892,VNKA01004270.1,1,1975,1.26122e-05,153148328,0.977997
D.birchii,156593892,VNKA01003506.1,1,1975,1.26122e-05,153150303,0.978009
D.birchii,156593892,VNKA01003105.1,1,1975,1.26122e-05,153152278,0.978022
D.birchii,156593892,VNKA01003430.1,1,1974,1.26059e-05,153154252,0.978035
D.birchii,156593892,VNKA01002618.1,1,1974,1.26059e-05,153156226,0.978047
D.birchii,156593892,VNKA01002069.1,1,1974,1.26059e-05,153158200,0.97806
D.birchii,156593892,VNKA01007495.1,1,1973,1.25995e-05,153160173,0.978072
D.birchii,156593892,VNKA01006261.1,1,1973,1.25995e-05,153162146,0.978085
D.birchii,156593892,VNKA01002687.1,1,1973,1.25995e-05,153164119,0.978098
D.birchii,156593892,VNKA01003250.1,1,1972,1.25931e-05,153166091,0.97811
D.birchii,156593892,VNKA01001223.1,1,1972,1.25931e-05,153168063,0.978123
D.birchii,156593892,VNKA01000142.1,1,1972,1.25931e-05,153170035,0.978135
D.birchii,156593892,VNKA01006347.1,1,1970,1.25803e-05,153172005,0.978148
D.birchii,156593892,VNKA01003447.1,1,1970,1.25803e-05,153173975,0.978161
D.birchii,156593892,VNKA01003400.1,1,1970,1.25803e-05,153175945,0.978173
D.birchii,156593892,VNKA01003394.1,1,1969,1.25739e-05,153177914,0.978186
D.birchii,156593892,VNKA01003038.1,1,1969,1.25739e-05,153179883,0.978198
D.birchii,156593892,VNKA01000962.1,1,1969,1.25739e-05,153181852,0.978211
D.birchii,156593892,VNKA01005383.1,1,1968,1.25675e-05,153183820,0.978223
D.birchii,156593892,VNKA01004722.1,1,1968,1.25675e-05,153185788,0.978236
D.birchii,156593892,VNKA01000731.1,1,1967,1.25612e-05,153187755,0.978249
D.birchii,156593892,VNKA01006680.1,1,1965,1.25484e-05,153189720,0.978261
D.birchii,156593892,VNKA01004389.1,1,1965,1.25484e-05,153191685,0.978274
D.birchii,156593892,VNKA01003777.1,1,1965,1.25484e-05,153193650,0.978286
D.birchii,156593892,VNKA01005116.1,1,1963,1.25356e-05,153195613,0.978299
D.birchii,156593892,VNKA01002311.1,1,1961,1.25228e-05,153197574,0.978311
D.birchii,156593892,VNKA01000549.1,1,1961,1.25228e-05,153199535,0.978324
D.birchii,156593892,VNKA01002552.1,1,1960,1.25165e-05,153201495,0.978336
D.birchii,156593892,VNKA01007541.1,1,1958,1.25037e-05,153203453,0.978349
D.birchii,156593892,VNKA01006742.1,1,1958,1.25037e-05,153205411,0.978361
D.birchii,156593892,VNKA01003581.1,1,1958,1.25037e-05,153207369,0.978374
D.birchii,156593892,VNKA01003819.1,1,1957,1.24973e-05,153209326,0.978386
D.birchii,156593892,VNKA01003070.1,1,1956,1.24909e-05,153211282,0.978399
D.birchii,156593892,VNKA01001372.1,1,1956,1.24909e-05,153213238,0.978411
D.birchii,156593892,VNKA01003662.1,1,1955,1.24845e-05,153215193,0.978424
D.birchii,156593892,VNKA01003582.1,1,1955,1.24845e-05,153217148,0.978436
D.birchii,156593892,VNKA01001056.1,1,1954,1.24781e-05,153219102,0.978449
D.birchii,156593892,VNKA01000692.1,1,1954,1.24781e-05,153221056,0.978461
D.birchii,156593892,VNKA01006858.1,1,1953,1.24718e-05,153223009,0.978474
D.birchii,156593892,VNKA01006793.1,1,1953,1.24718e-05,153224962,0.978486
D.birchii,156593892,VNKA01001980.1,1,1953,1.24718e-05,153226915,0.978499
D.birchii,156593892,VNKA01000034.1,1,1953,1.24718e-05,153228868,0.978511
D.birchii,156593892,VNKA01005424.1,1,1952,1.24654e-05,153230820,0.978524
D.birchii,156593892,VNKA01000686.1,1,1952,1.24654e-05,153232772,0.978536
D.birchii,156593892,VNKA01004532.1,1,1951,1.2459e-05,153234723,0.978549
D.birchii,156593892,VNKA01001316.1,1,1951,1.2459e-05,153236674,0.978561
D.birchii,156593892,VNKA01000269.1,1,1951,1.2459e-05,153238625,0.978573
D.birchii,156593892,VNKA01004402.1,1,1950,1.24526e-05,153240575,0.978586
D.birchii,156593892,VNKA01000614.1,1,1950,1.24526e-05,153242525,0.978598
D.birchii,156593892,VNKA01005913.1,1,1949,1.24462e-05,153244474,0.978611
D.birchii,156593892,VNKA01001154.1,1,1949,1.24462e-05,153246423,0.978623
D.birchii,156593892,VNKA01003229.1,1,1948,1.24398e-05,153248371,0.978636
D.birchii,156593892,VNKA01003658.1,1,1947,1.24334e-05,153250318,0.978648
D.birchii,156593892,VNKA01004758.1,1,1946,1.2427e-05,153252264,0.978661
D.birchii,156593892,VNKA01003561.1,1,1946,1.2427e-05,153254210,0.978673
D.birchii,156593892,VNKA01005806.1,1,1945,1.24207e-05,153256155,0.978685
D.birchii,156593892,VNKA01002619.1,1,1945,1.24207e-05,153258100,0.978698
D.birchii,156593892,VNKA01002487.1,1,1945,1.24207e-05,153260045,0.97871
D.birchii,156593892,VNKA01001646.1,1,1945,1.24207e-05,153261990,0.978723
D.birchii,156593892,VNKA01001893.1,1,1944,1.24143e-05,153263934,0.978735
D.birchii,156593892,VNKA01004681.1,1,1943,1.24079e-05,153265877,0.978747
D.birchii,156593892,VNKA01004457.1,1,1943,1.24079e-05,153267820,0.97876
D.birchii,156593892,VNKA01002727.1,1,1943,1.24079e-05,153269763,0.978772
D.birchii,156593892,VNKA01001573.1,1,1943,1.24079e-05,153271706,0.978785
D.birchii,156593892,VNKA01006439.1,1,1942,1.24015e-05,153273648,0.978797
D.birchii,156593892,VNKA01001774.1,1,1941,1.23951e-05,153275589,0.978809
D.birchii,156593892,VNKA01000546.1,1,1941,1.23951e-05,153277530,0.978822
D.birchii,156593892,VNKA01000271.1,1,1940,1.23887e-05,153279470,0.978834
D.birchii,156593892,VNKA01006262.1,1,1939,1.23823e-05,153281409,0.978847
D.birchii,156593892,VNKA01003322.1,1,1938,1.2376e-05,153283347,0.978859
D.birchii,156593892,VNKA01001658.1,1,1938,1.2376e-05,153285285,0.978871
D.birchii,156593892,VNKA01000799.1,1,1938,1.2376e-05,153287223,0.978884
D.birchii,156593892,VNKA01002042.1,1,1937,1.23696e-05,153289160,0.978896
D.birchii,156593892,VNKA01001114.1,1,1937,1.23696e-05,153291097,0.978909
D.birchii,156593892,VNKA01007026.1,1,1936,1.23632e-05,153293033,0.978921
D.birchii,156593892,VNKA01006621.1,1,1936,1.23632e-05,153294969,0.978933
D.birchii,156593892,VNKA01002096.1,1,1936,1.23632e-05,153296905,0.978946
D.birchii,156593892,VNKA01000360.1,1,1936,1.23632e-05,153298841,0.978958
D.birchii,156593892,VNKA01004531.1,1,1935,1.23568e-05,153300776,0.97897
D.birchii,156593892,VNKA01003575.1,1,1934,1.23504e-05,153302710,0.978983
D.birchii,156593892,VNKA01007341.1,1,1933,1.2344e-05,153304643,0.978995
D.birchii,156593892,VNKA01003780.1,1,1933,1.2344e-05,153306576,0.979007
D.birchii,156593892,VNKA01007012.1,1,1932,1.23376e-05,153308508,0.97902
D.birchii,156593892,VNKA01006976.1,1,1931,1.23313e-05,153310439,0.979032
D.birchii,156593892,VNKA01003150.1,1,1931,1.23313e-05,153312370,0.979044
D.birchii,156593892,VNKA01002343.1,1,1931,1.23313e-05,153314301,0.979057
D.birchii,156593892,VNKA01001184.1,1,1931,1.23313e-05,153316232,0.979069
D.birchii,156593892,VNKA01005411.1,1,1930,1.23249e-05,153318162,0.979081
D.birchii,156593892,VNKA01003760.1,1,1930,1.23249e-05,153320092,0.979094
D.birchii,156593892,VNKA01001834.1,1,1929,1.23185e-05,153322021,0.979106
D.birchii,156593892,VNKA01000343.1,1,1928,1.23121e-05,153323949,0.979118
D.birchii,156593892,VNKA01001014.1,1,1927,1.23057e-05,153325876,0.979131
D.birchii,156593892,VNKA01007492.1,1,1926,1.22993e-05,153327802,0.979143
D.birchii,156593892,VNKA01003177.1,1,1926,1.22993e-05,153329728,0.979155
D.birchii,156593892,VNKA01002594.1,1,1926,1.22993e-05,153331654,0.979168
D.birchii,156593892,VNKA01000368.1,1,1926,1.22993e-05,153333580,0.97918
D.birchii,156593892,VNKA01007548.1,1,1925,1.22929e-05,153335505,0.979192
D.birchii,156593892,VNKA01007497.1,1,1925,1.22929e-05,153337430,0.979204
D.birchii,156593892,VNKA01007133.1,1,1925,1.22929e-05,153339355,0.979217
D.birchii,156593892,VNKA01006202.1,1,1924,1.22866e-05,153341279,0.979229
D.birchii,156593892,VNKA01004791.1,1,1924,1.22866e-05,153343203,0.979241
D.birchii,156593892,VNKA01003074.1,1,1923,1.22802e-05,153345126,0.979254
D.birchii,156593892,VNKA01001500.1,1,1923,1.22802e-05,153347049,0.979266
D.birchii,156593892,VNKA01001635.1,1,1921,1.22674e-05,153348970,0.979278
D.birchii,156593892,VNKA01007386.1,1,1920,1.2261e-05,153350890,0.97929
D.birchii,156593892,VNKA01005799.1,1,1920,1.2261e-05,153352810,0.979303
D.birchii,156593892,VNKA01005395.1,1,1919,1.22546e-05,153354729,0.979315
D.birchii,156593892,VNKA01003511.1,1,1919,1.22546e-05,153356648,0.979327
D.birchii,156593892,VNKA01000526.1,1,1919,1.22546e-05,153358567,0.979339
D.birchii,156593892,VNKA01000649.1,1,1917,1.22419e-05,153360484,0.979352
D.birchii,156593892,VNKA01001708.1,1,1916,1.22355e-05,153362400,0.979364
D.birchii,156593892,VNKA01001873.1,1,1915,1.22291e-05,153364315,0.979376
D.birchii,156593892,VNKA01006582.1,1,1914,1.22227e-05,153366229,0.979388
D.birchii,156593892,VNKA01005437.1,1,1914,1.22227e-05,153368143,0.979401
D.birchii,156593892,VNKA01002755.1,1,1914,1.22227e-05,153370057,0.979413
D.birchii,156593892,VNKA01000918.1,1,1914,1.22227e-05,153371971,0.979425
D.birchii,156593892,VNKA01003361.1,1,1912,1.22099e-05,153373883,0.979437
D.birchii,156593892,VNKA01006484.1,1,1911,1.22035e-05,153375794,0.979449
D.birchii,156593892,VNKA01006340.1,1,1911,1.22035e-05,153377705,0.979462
D.birchii,156593892,VNKA01005332.1,1,1911,1.22035e-05,153379616,0.979474
D.birchii,156593892,VNKA01006418.1,1,1909,1.21908e-05,153381525,0.979486
D.birchii,156593892,VNKA01002484.1,1,1909,1.21908e-05,153383434,0.979498
D.birchii,156593892,VNKA01001793.1,1,1909,1.21908e-05,153385343,0.97951
D.birchii,156593892,VNKA01001180.1,1,1907,1.2178e-05,153387250,0.979523
D.birchii,156593892,VNKA01000534.1,1,1906,1.21716e-05,153389156,0.979535
D.birchii,156593892,VNKA01005623.1,1,1905,1.21652e-05,153391061,0.979547
D.birchii,156593892,VNKA01001382.1,1,1905,1.21652e-05,153392966,0.979559
D.birchii,156593892,VNKA01001342.1,1,1904,1.21588e-05,153394870,0.979571
D.birchii,156593892,VNKA01003589.1,1,1903,1.21525e-05,153396773,0.979583
D.birchii,156593892,VNKA01002415.1,1,1903,1.21525e-05,153398676,0.979596
D.birchii,156593892,VNKA01007073.1,1,1902,1.21461e-05,153400578,0.979608
D.birchii,156593892,VNKA01003036.1,1,1902,1.21461e-05,153402480,0.97962
D.birchii,156593892,VNKA01005765.1,1,1901,1.21397e-05,153404381,0.979632
D.birchii,156593892,VNKA01005745.1,1,1901,1.21397e-05,153406282,0.979644
D.birchii,156593892,VNKA01005189.1,1,1901,1.21397e-05,153408183,0.979656
D.birchii,156593892,VNKA01001900.1,1,1901,1.21397e-05,153410084,0.979668
D.birchii,156593892,VNKA01003597.1,1,1900,1.21333e-05,153411984,0.979681
D.birchii,156593892,VNKA01002810.1,1,1900,1.21333e-05,153413884,0.979693
D.birchii,156593892,VNKA01002079.1,1,1900,1.21333e-05,153415784,0.979705
D.birchii,156593892,VNKA01006280.1,1,1899,1.21269e-05,153417683,0.979717
D.birchii,156593892,VNKA01004839.1,1,1899,1.21269e-05,153419582,0.979729
D.birchii,156593892,VNKA01002436.1,1,1898,1.21205e-05,153421480,0.979741
D.birchii,156593892,VNKA01001916.1,1,1898,1.21205e-05,153423378,0.979753
D.birchii,156593892,VNKA01004474.1,1,1897,1.21141e-05,153425275,0.979765
D.birchii,156593892,VNKA01002870.1,1,1897,1.21141e-05,153427172,0.979777
D.birchii,156593892,VNKA01001445.1,1,1897,1.21141e-05,153429069,0.97979
D.birchii,156593892,VNKA01006152.1,1,1896,1.21078e-05,153430965,0.979802
D.birchii,156593892,VNKA01000434.1,1,1896,1.21078e-05,153432861,0.979814
D.birchii,156593892,VNKA01004115.1,1,1895,1.21014e-05,153434756,0.979826
D.birchii,156593892,VNKA01004114.1,1,1894,1.2095e-05,153436650,0.979838
D.birchii,156593892,VNKA01006069.1,1,1893,1.20886e-05,153438543,0.97985
D.birchii,156593892,VNKA01004740.1,1,1893,1.20886e-05,153440436,0.979862
D.birchii,156593892,VNKA01001224.1,1,1893,1.20886e-05,153442329,0.979874
D.birchii,156593892,VNKA01004714.1,1,1892,1.20822e-05,153444221,0.979886
D.birchii,156593892,VNKA01004302.1,1,1892,1.20822e-05,153446113,0.979898
D.birchii,156593892,VNKA01006039.1,1,1890,1.20694e-05,153448003,0.979911
D.birchii,156593892,VNKA01003343.1,1,1890,1.20694e-05,153449893,0.979923
D.birchii,156593892,VNKA01007551.1,1,1889,1.20631e-05,153451782,0.979935
D.birchii,156593892,VNKA01005975.1,1,1889,1.20631e-05,153453671,0.979947
D.birchii,156593892,VNKA01003050.1,1,1889,1.20631e-05,153455560,0.979959
D.birchii,156593892,VNKA01005066.1,1,1887,1.20503e-05,153457447,0.979971
D.birchii,156593892,VNKA01005559.1,1,1886,1.20439e-05,153459333,0.979983
D.birchii,156593892,VNKA01004856.1,1,1885,1.20375e-05,153461218,0.979995
D.birchii,156593892,VNKA01000426.1,1,1885,1.20375e-05,153463103,0.980007
D.birchii,156593892,VNKA01003942.1,1,1884,1.20311e-05,153464987,0.980019
D.birchii,156593892,VNKA01003862.1,1,1884,1.20311e-05,153466871,0.980031
D.birchii,156593892,VNKA01006335.1,1,1883,1.20247e-05,153468754,0.980043
D.birchii,156593892,VNKA01006374.1,1,1882,1.20183e-05,153470636,0.980055
D.birchii,156593892,VNKA01006025.1,1,1882,1.20183e-05,153472518,0.980067
D.birchii,156593892,VNKA01005965.1,1,1881,1.2012e-05,153474399,0.980079
D.birchii,156593892,VNKA01003359.1,1,1881,1.2012e-05,153476280,0.980091
D.birchii,156593892,VNKA01002431.1,1,1881,1.2012e-05,153478161,0.980103
D.birchii,156593892,VNKA01000836.1,1,1879,1.19992e-05,153480040,0.980115
D.birchii,156593892,VNKA01000696.1,1,1879,1.19992e-05,153481919,0.980127
D.birchii,156593892,VNKA01004123.1,1,1878,1.19928e-05,153483797,0.980139
D.birchii,156593892,VNKA01000723.1,1,1878,1.19928e-05,153485675,0.980151
D.birchii,156593892,VNKA01000909.1,1,1877,1.19864e-05,153487552,0.980163
D.birchii,156593892,VNKA01006636.1,1,1876,1.198e-05,153489428,0.980175
D.birchii,156593892,VNKA01000718.1,1,1876,1.198e-05,153491304,0.980187
D.birchii,156593892,VNKA01004263.1,1,1874,1.19673e-05,153493178,0.980199
D.birchii,156593892,VNKA01005991.1,1,1873,1.19609e-05,153495051,0.980211
D.birchii,156593892,VNKA01001387.1,1,1873,1.19609e-05,153496924,0.980223
D.birchii,156593892,VNKA01001908.1,1,1872,1.19545e-05,153498796,0.980235
D.birchii,156593892,VNKA01006448.1,1,1871,1.19481e-05,153500667,0.980247
D.birchii,156593892,VNKA01003032.1,1,1871,1.19481e-05,153502538,0.980259
D.birchii,156593892,VNKA01004463.1,1,1870,1.19417e-05,153504408,0.980271
D.birchii,156593892,VNKA01003214.1,1,1870,1.19417e-05,153506278,0.980283
D.birchii,156593892,VNKA01000561.1,1,1870,1.19417e-05,153508148,0.980295
D.birchii,156593892,VNKA01007246.1,1,1869,1.19353e-05,153510017,0.980307
D.birchii,156593892,VNKA01007155.1,1,1869,1.19353e-05,153511886,0.980318
D.birchii,156593892,VNKA01006426.1,1,1869,1.19353e-05,153513755,0.98033
D.birchii,156593892,VNKA01006610.1,1,1867,1.19226e-05,153515622,0.980342
D.birchii,156593892,VNKA01005445.1,1,1867,1.19226e-05,153517489,0.980354
D.birchii,156593892,VNKA01004486.1,1,1867,1.19226e-05,153519356,0.980366
D.birchii,156593892,VNKA01003249.1,1,1867,1.19226e-05,153521223,0.980378
D.birchii,156593892,VNKA01002713.1,1,1867,1.19226e-05,153523090,0.98039
D.birchii,156593892,VNKA01000117.1,1,1867,1.19226e-05,153524957,0.980402
D.birchii,156593892,VNKA01007168.1,1,1865,1.19098e-05,153526822,0.980414
D.birchii,156593892,VNKA01005165.1,1,1865,1.19098e-05,153528687,0.980426
D.birchii,156593892,VNKA01003237.1,1,1865,1.19098e-05,153530552,0.980438
D.birchii,156593892,VNKA01007054.1,1,1864,1.19034e-05,153532416,0.98045
D.birchii,156593892,VNKA01004120.1,1,1864,1.19034e-05,153534280,0.980461
D.birchii,156593892,VNKA01001167.1,1,1864,1.19034e-05,153536144,0.980473
D.birchii,156593892,VNKA01000625.1,1,1864,1.19034e-05,153538008,0.980485
D.birchii,156593892,VNKA01007380.1,1,1863,1.1897e-05,153539871,0.980497
D.birchii,156593892,VNKA01005008.1,1,1862,1.18906e-05,153541733,0.980509
D.birchii,156593892,VNKA01004920.1,1,1862,1.18906e-05,153543595,0.980521
D.birchii,156593892,VNKA01004318.1,1,1862,1.18906e-05,153545457,0.980533
D.birchii,156593892,VNKA01000866.1,1,1862,1.18906e-05,153547319,0.980545
D.birchii,156593892,VNKA01001879.1,1,1861,1.18842e-05,153549180,0.980557
D.birchii,156593892,VNKA01001380.1,1,1861,1.18842e-05,153551041,0.980569
D.birchii,156593892,VNKA01007079.1,1,1859,1.18715e-05,153552900,0.98058
D.birchii,156593892,VNKA01003182.1,1,1859,1.18715e-05,153554759,0.980592
D.birchii,156593892,VNKA01001258.1,1,1859,1.18715e-05,153556618,0.980604
D.birchii,156593892,VNKA01002232.1,1,1858,1.18651e-05,153558476,0.980616
D.birchii,156593892,VNKA01000558.1,1,1858,1.18651e-05,153560334,0.980628
D.birchii,156593892,VNKA01003981.1,1,1857,1.18587e-05,153562191,0.98064
D.birchii,156593892,VNKA01002772.1,1,1857,1.18587e-05,153564048,0.980652
D.birchii,156593892,VNKA01001541.1,1,1857,1.18587e-05,153565905,0.980663
D.birchii,156593892,VNKA01003241.1,1,1856,1.18523e-05,153567761,0.980675
D.birchii,156593892,VNKA01001878.1,1,1856,1.18523e-05,153569617,0.980687
D.birchii,156593892,VNKA01000369.1,1,1856,1.18523e-05,153571473,0.980699
D.birchii,156593892,VNKA01006258.1,1,1855,1.18459e-05,153573328,0.980711
D.birchii,156593892,VNKA01005756.1,1,1855,1.18459e-05,153575183,0.980723
D.birchii,156593892,VNKA01005677.1,1,1854,1.18395e-05,153577037,0.980735
D.birchii,156593892,VNKA01006264.1,1,1853,1.18332e-05,153578890,0.980746
D.birchii,156593892,VNKA01003396.1,1,1851,1.18204e-05,153580741,0.980758
D.birchii,156593892,VNKA01002025.1,1,1851,1.18204e-05,153582592,0.98077
D.birchii,156593892,VNKA01003054.1,1,1850,1.1814e-05,153584442,0.980782
D.birchii,156593892,VNKA01006564.1,1,1848,1.18012e-05,153586290,0.980794
D.birchii,156593892,VNKA01006441.1,1,1848,1.18012e-05,153588138,0.980805
D.birchii,156593892,VNKA01006274.1,1,1848,1.18012e-05,153589986,0.980817
D.birchii,156593892,VNKA01007464.1,1,1847,1.17948e-05,153591833,0.980829
D.birchii,156593892,VNKA01004685.1,1,1847,1.17948e-05,153593680,0.980841
D.birchii,156593892,VNKA01001819.1,1,1847,1.17948e-05,153595527,0.980853
D.birchii,156593892,VNKA01000365.1,1,1846,1.17885e-05,153597373,0.980864
D.birchii,156593892,VNKA01006786.1,1,1845,1.17821e-05,153599218,0.980876
D.birchii,156593892,VNKA01003357.1,1,1845,1.17821e-05,153601063,0.980888
D.birchii,156593892,VNKA01001923.1,1,1845,1.17821e-05,153602908,0.9809
D.birchii,156593892,VNKA01005862.1,1,1844,1.17757e-05,153604752,0.980912
D.birchii,156593892,VNKA01003495.1,1,1844,1.17757e-05,153606596,0.980923
D.birchii,156593892,VNKA01006452.1,1,1843,1.17693e-05,153608439,0.980935
D.birchii,156593892,VNKA01002271.1,1,1843,1.17693e-05,153610282,0.980947
D.birchii,156593892,VNKA01000323.1,1,1843,1.17693e-05,153612125,0.980959
D.birchii,156593892,VNKA01005312.1,1,1842,1.17629e-05,153613967,0.98097
D.birchii,156593892,VNKA01000334.1,1,1842,1.17629e-05,153615809,0.980982
D.birchii,156593892,VNKA01000154.1,1,1842,1.17629e-05,153617651,0.980994
D.birchii,156593892,VNKA01006024.1,1,1841,1.17565e-05,153619492,0.981006
D.birchii,156593892,VNKA01003491.1,1,1841,1.17565e-05,153621333,0.981017
D.birchii,156593892,VNKA01003106.1,1,1841,1.17565e-05,153623174,0.981029
D.birchii,156593892,VNKA01001861.1,1,1840,1.17501e-05,153625014,0.981041
D.birchii,156593892,VNKA01001012.1,1,1840,1.17501e-05,153626854,0.981053
D.birchii,156593892,VNKA01000640.1,1,1840,1.17501e-05,153628694,0.981064
D.birchii,156593892,VNKA01004010.1,1,1839,1.17438e-05,153630533,0.981076
D.birchii,156593892,VNKA01003801.1,1,1839,1.17438e-05,153632372,0.981088
D.birchii,156593892,VNKA01003073.1,1,1839,1.17438e-05,153634211,0.9811
D.birchii,156593892,VNKA01000990.1,1,1839,1.17438e-05,153636050,0.981111
D.birchii,156593892,VNKA01006852.1,1,1838,1.17374e-05,153637888,0.981123
D.birchii,156593892,VNKA01006821.1,1,1838,1.17374e-05,153639726,0.981135
D.birchii,156593892,VNKA01003866.1,1,1838,1.17374e-05,153641564,0.981147
D.birchii,156593892,VNKA01000553.1,1,1838,1.17374e-05,153643402,0.981158
D.birchii,156593892,VNKA01000108.1,1,1838,1.17374e-05,153645240,0.98117
D.birchii,156593892,VNKA01004338.1,1,1837,1.1731e-05,153647077,0.981182
D.birchii,156593892,VNKA01002801.1,1,1837,1.1731e-05,153648914,0.981194
D.birchii,156593892,VNKA01006983.1,1,1836,1.17246e-05,153650750,0.981205
D.birchii,156593892,VNKA01005379.1,1,1836,1.17246e-05,153652586,0.981217
D.birchii,156593892,VNKA01005017.1,1,1836,1.17246e-05,153654422,0.981229
D.birchii,156593892,VNKA01003915.1,1,1836,1.17246e-05,153656258,0.98124
D.birchii,156593892,VNKA01004838.1,1,1835,1.17182e-05,153658093,0.981252
D.birchii,156593892,VNKA01001197.1,1,1835,1.17182e-05,153659928,0.981264
D.birchii,156593892,VNKA01007284.1,1,1834,1.17118e-05,153661762,0.981276
D.birchii,156593892,VNKA01005451.1,1,1834,1.17118e-05,153663596,0.981287
D.birchii,156593892,VNKA01004209.1,1,1834,1.17118e-05,153665430,0.981299
D.birchii,156593892,VNKA01002711.1,1,1834,1.17118e-05,153667264,0.981311
D.birchii,156593892,VNKA01002453.1,1,1833,1.17054e-05,153669097,0.981322
D.birchii,156593892,VNKA01001616.1,1,1833,1.17054e-05,153670930,0.981334
D.birchii,156593892,VNKA01005815.1,1,1832,1.16991e-05,153672762,0.981346
D.birchii,156593892,VNKA01002648.1,1,1831,1.16927e-05,153674593,0.981358
D.birchii,156593892,VNKA01001782.1,1,1831,1.16927e-05,153676424,0.981369
D.birchii,156593892,VNKA01000683.1,1,1830,1.16863e-05,153678254,0.981381
D.birchii,156593892,VNKA01003360.1,1,1827,1.16671e-05,153680081,0.981393
D.birchii,156593892,VNKA01007476.1,1,1826,1.16607e-05,153681907,0.981404
D.birchii,156593892,VNKA01004753.1,1,1826,1.16607e-05,153683733,0.981416
D.birchii,156593892,VNKA01007287.1,1,1825,1.16543e-05,153685558,0.981428
D.birchii,156593892,VNKA01006775.1,1,1825,1.16543e-05,153687383,0.981439
D.birchii,156593892,VNKA01006619.1,1,1825,1.16543e-05,153689208,0.981451
D.birchii,156593892,VNKA01000959.1,1,1825,1.16543e-05,153691033,0.981463
D.birchii,156593892,VNKA01006822.1,1,1824,1.1648e-05,153692857,0.981474
D.birchii,156593892,VNKA01004527.1,1,1824,1.1648e-05,153694681,0.981486
D.birchii,156593892,VNKA01000894.1,1,1824,1.1648e-05,153696505,0.981497
D.birchii,156593892,VNKA01000845.1,1,1824,1.1648e-05,153698329,0.981509
D.birchii,156593892,VNKA01006672.1,1,1823,1.16416e-05,153700152,0.981521
D.birchii,156593892,VNKA01006595.1,1,1823,1.16416e-05,153701975,0.981532
D.birchii,156593892,VNKA01005303.1,1,1823,1.16416e-05,153703798,0.981544
D.birchii,156593892,VNKA01003605.1,1,1823,1.16416e-05,153705621,0.981556
D.birchii,156593892,VNKA01002123.1,1,1823,1.16416e-05,153707444,0.981567
D.birchii,156593892,VNKA01001449.1,1,1823,1.16416e-05,153709267,0.981579
D.birchii,156593892,VNKA01004611.1,1,1822,1.16352e-05,153711089,0.981591
D.birchii,156593892,VNKA01002004.1,1,1821,1.16288e-05,153712910,0.981602
D.birchii,156593892,VNKA01001715.1,1,1821,1.16288e-05,153714731,0.981614
D.birchii,156593892,VNKA01000562.1,1,1819,1.1616e-05,153716550,0.981625
D.birchii,156593892,VNKA01005988.1,1,1818,1.16096e-05,153718368,0.981637
D.birchii,156593892,VNKA01005170.1,1,1818,1.16096e-05,153720186,0.981649
D.birchii,156593892,VNKA01003650.1,1,1818,1.16096e-05,153722004,0.98166
D.birchii,156593892,VNKA01003533.1,1,1818,1.16096e-05,153723822,0.981672
D.birchii,156593892,VNKA01000172.1,1,1815,1.15905e-05,153725637,0.981683
D.birchii,156593892,VNKA01004248.1,1,1814,1.15841e-05,153727451,0.981695
D.birchii,156593892,VNKA01003369.1,1,1814,1.15841e-05,153729265,0.981707
D.birchii,156593892,VNKA01002227.1,1,1814,1.15841e-05,153731079,0.981718
D.birchii,156593892,VNKA01003275.1,1,1813,1.15777e-05,153732892,0.98173
D.birchii,156593892,VNKA01001975.1,1,1813,1.15777e-05,153734705,0.981741
D.birchii,156593892,VNKA01005005.1,1,1812,1.15713e-05,153736517,0.981753
D.birchii,156593892,VNKA01003970.1,1,1812,1.15713e-05,153738329,0.981765
D.birchii,156593892,VNKA01001368.1,1,1812,1.15713e-05,153740141,0.981776
D.birchii,156593892,VNKA01007447.1,1,1811,1.15649e-05,153741952,0.981788
D.birchii,156593892,VNKA01002417.1,1,1811,1.15649e-05,153743763,0.981799
D.birchii,156593892,VNKA01003557.1,1,1810,1.15586e-05,153745573,0.981811
D.birchii,156593892,VNKA01005483.1,1,1809,1.15522e-05,153747382,0.981822
D.birchii,156593892,VNKA01002309.1,1,1809,1.15522e-05,153749191,0.981834
D.birchii,156593892,VNKA01000643.1,1,1809,1.15522e-05,153751000,0.981845
D.birchii,156593892,VNKA01000480.1,1,1808,1.15458e-05,153752808,0.981857
D.birchii,156593892,VNKA01000168.1,1,1807,1.15394e-05,153754615,0.981869
D.birchii,156593892,VNKA01000040.1,1,1807,1.15394e-05,153756422,0.98188
D.birchii,156593892,VNKA01005768.1,1,1806,1.1533e-05,153758228,0.981892
D.birchii,156593892,VNKA01005415.1,1,1806,1.1533e-05,153760034,0.981903
D.birchii,156593892,VNKA01005375.1,1,1806,1.1533e-05,153761840,0.981915
D.birchii,156593892,VNKA01006135.1,1,1805,1.15266e-05,153763645,0.981926
D.birchii,156593892,VNKA01006735.1,1,1804,1.15202e-05,153765449,0.981938
D.birchii,156593892,VNKA01006231.1,1,1804,1.15202e-05,153767253,0.981949
D.birchii,156593892,VNKA01001954.1,1,1804,1.15202e-05,153769057,0.981961
D.birchii,156593892,VNKA01007213.1,1,1803,1.15139e-05,153770860,0.981972
D.birchii,156593892,VNKA01006237.1,1,1800,1.14947e-05,153772660,0.981984
D.birchii,156593892,VNKA01005706.1,1,1799,1.14883e-05,153774459,0.981995
D.birchii,156593892,VNKA01004614.1,1,1799,1.14883e-05,153776258,0.982007
D.birchii,156593892,VNKA01002975.1,1,1799,1.14883e-05,153778057,0.982018
D.birchii,156593892,VNKA01001384.1,1,1799,1.14883e-05,153779856,0.98203
D.birchii,156593892,VNKA01006669.1,1,1798,1.14819e-05,153781654,0.982041
D.birchii,156593892,VNKA01004573.1,1,1798,1.14819e-05,153783452,0.982053
D.birchii,156593892,VNKA01006878.1,1,1797,1.14755e-05,153785249,0.982064
D.birchii,156593892,VNKA01005300.1,1,1797,1.14755e-05,153787046,0.982076
D.birchii,156593892,VNKA01002205.1,1,1797,1.14755e-05,153788843,0.982087
D.birchii,156593892,VNKA01005380.1,1,1796,1.14692e-05,153790639,0.982099
D.birchii,156593892,VNKA01003702.1,1,1796,1.14692e-05,153792435,0.98211
D.birchii,156593892,VNKA01004976.1,1,1795,1.14628e-05,153794230,0.982122
D.birchii,156593892,VNKA01006915.1,1,1793,1.145e-05,153796023,0.982133
D.birchii,156593892,VNKA01000645.1,1,1793,1.145e-05,153797816,0.982144
D.birchii,156593892,VNKA01004771.1,1,1792,1.14436e-05,153799608,0.982156
D.birchii,156593892,VNKA01000203.1,1,1792,1.14436e-05,153801400,0.982167
D.birchii,156593892,VNKA01007520.1,1,1791,1.14372e-05,153803191,0.982179
D.birchii,156593892,VNKA01001431.1,1,1791,1.14372e-05,153804982,0.98219
D.birchii,156593892,VNKA01001151.1,1,1791,1.14372e-05,153806773,0.982202
D.birchii,156593892,VNKA01004148.1,1,1790,1.14308e-05,153808563,0.982213
D.birchii,156593892,VNKA01001978.1,1,1790,1.14308e-05,153810353,0.982224
D.birchii,156593892,VNKA01001365.1,1,1790,1.14308e-05,153812143,0.982236
D.birchii,156593892,VNKA01002970.1,1,1789,1.14245e-05,153813932,0.982247
D.birchii,156593892,VNKA01001811.1,1,1789,1.14245e-05,153815721,0.982259
D.birchii,156593892,VNKA01001069.1,1,1789,1.14245e-05,153817510,0.98227
D.birchii,156593892,VNKA01000981.1,1,1789,1.14245e-05,153819299,0.982282
D.birchii,156593892,VNKA01003261.1,1,1788,1.14181e-05,153821087,0.982293
D.birchii,156593892,VNKA01006145.1,1,1787,1.14117e-05,153822874,0.982304
D.birchii,156593892,VNKA01006819.1,1,1786,1.14053e-05,153824660,0.982316
D.birchii,156593892,VNKA01003422.1,1,1786,1.14053e-05,153826446,0.982327
D.birchii,156593892,VNKA01005418.1,1,1785,1.13989e-05,153828231,0.982339
D.birchii,156593892,VNKA01003100.1,1,1785,1.13989e-05,153830016,0.98235
D.birchii,156593892,VNKA01006963.1,1,1784,1.13925e-05,153831800,0.982361
D.birchii,156593892,VNKA01005261.1,1,1784,1.13925e-05,153833584,0.982373
D.birchii,156593892,VNKA01005253.1,1,1783,1.13861e-05,153835367,0.982384
D.birchii,156593892,VNKA01001165.1,1,1783,1.13861e-05,153837150,0.982396
D.birchii,156593892,VNKA01005102.1,1,1782,1.13798e-05,153838932,0.982407
D.birchii,156593892,VNKA01002265.1,1,1782,1.13798e-05,153840714,0.982418
D.birchii,156593892,VNKA01001670.1,1,1782,1.13798e-05,153842496,0.98243
D.birchii,156593892,VNKA01001113.1,1,1782,1.13798e-05,153844278,0.982441
D.birchii,156593892,VNKA01006841.1,1,1779,1.13606e-05,153846057,0.982452
D.birchii,156593892,VNKA01006263.1,1,1779,1.13606e-05,153847836,0.982464
D.birchii,156593892,VNKA01006854.1,1,1778,1.13542e-05,153849614,0.982475
D.birchii,156593892,VNKA01005883.1,1,1778,1.13542e-05,153851392,0.982487
D.birchii,156593892,VNKA01007221.1,1,1777,1.13478e-05,153853169,0.982498
D.birchii,156593892,VNKA01002688.1,1,1777,1.13478e-05,153854946,0.982509
D.birchii,156593892,VNKA01000362.1,1,1777,1.13478e-05,153856723,0.982521
D.birchii,156593892,VNKA01006936.1,1,1776,1.13414e-05,153858499,0.982532
D.birchii,156593892,VNKA01005955.1,1,1776,1.13414e-05,153860275,0.982543
D.birchii,156593892,VNKA01003366.1,1,1776,1.13414e-05,153862051,0.982555
D.birchii,156593892,VNKA01000453.1,1,1776,1.13414e-05,153863827,0.982566
D.birchii,156593892,VNKA01002686.1,1,1775,1.13351e-05,153865602,0.982577
D.birchii,156593892,VNKA01000782.1,1,1775,1.13351e-05,153867377,0.982589
D.birchii,156593892,VNKA01007046.1,1,1774,1.13287e-05,153869151,0.9826
D.birchii,156593892,VNKA01004946.1,1,1774,1.13287e-05,153870925,0.982611
D.birchii,156593892,VNKA01003576.1,1,1774,1.13287e-05,153872699,0.982623
D.birchii,156593892,VNKA01000701.1,1,1774,1.13287e-05,153874473,0.982634
D.birchii,156593892,VNKA01007029.1,1,1773,1.13223e-05,153876246,0.982645
D.birchii,156593892,VNKA01006581.1,1,1773,1.13223e-05,153878019,0.982657
D.birchii,156593892,VNKA01006270.1,1,1773,1.13223e-05,153879792,0.982668
D.birchii,156593892,VNKA01005244.1,1,1773,1.13223e-05,153881565,0.982679
D.birchii,156593892,VNKA01003825.1,1,1771,1.13095e-05,153883336,0.982691
D.birchii,156593892,VNKA01000860.1,1,1770,1.13031e-05,153885106,0.982702
D.birchii,156593892,VNKA01002524.1,1,1769,1.12967e-05,153886875,0.982713
D.birchii,156593892,VNKA01000660.1,1,1769,1.12967e-05,153888644,0.982724
D.birchii,156593892,VNKA01006370.1,1,1766,1.12776e-05,153890410,0.982736
D.birchii,156593892,VNKA01005432.1,1,1766,1.12776e-05,153892176,0.982747
D.birchii,156593892,VNKA01003021.1,1,1766,1.12776e-05,153893942,0.982758
D.birchii,156593892,VNKA01001961.1,1,1766,1.12776e-05,153895708,0.98277
D.birchii,156593892,VNKA01006201.1,1,1765,1.12712e-05,153897473,0.982781
D.birchii,156593892,VNKA01006052.1,1,1765,1.12712e-05,153899238,0.982792
D.birchii,156593892,VNKA01000705.1,1,1765,1.12712e-05,153901003,0.982803
D.birchii,156593892,VNKA01000222.1,1,1765,1.12712e-05,153902768,0.982815
D.birchii,156593892,VNKA01002691.1,1,1763,1.12584e-05,153904531,0.982826
D.birchii,156593892,VNKA01007400.1,1,1760,1.12393e-05,153906291,0.982837
D.birchii,156593892,VNKA01000039.1,1,1760,1.12393e-05,153908051,0.982848
D.birchii,156593892,VNKA01005397.1,1,1758,1.12265e-05,153909809,0.98286
D.birchii,156593892,VNKA01002704.1,1,1758,1.12265e-05,153911567,0.982871
D.birchii,156593892,VNKA01001364.1,1,1758,1.12265e-05,153913325,0.982882
D.birchii,156593892,VNKA01005041.1,1,1757,1.12201e-05,153915082,0.982893
D.birchii,156593892,VNKA01003138.1,1,1757,1.12201e-05,153916839,0.982904
D.birchii,156593892,VNKA01002984.1,1,1757,1.12201e-05,153918596,0.982916
D.birchii,156593892,VNKA01002777.1,1,1757,1.12201e-05,153920353,0.982927
D.birchii,156593892,VNKA01002242.1,1,1757,1.12201e-05,153922110,0.982938
D.birchii,156593892,VNKA01001091.1,1,1757,1.12201e-05,153923867,0.982949
D.birchii,156593892,VNKA01006046.1,1,1756,1.12137e-05,153925623,0.982961
D.birchii,156593892,VNKA01006105.1,1,1755,1.12073e-05,153927378,0.982972
D.birchii,156593892,VNKA01002339.1,1,1755,1.12073e-05,153929133,0.982983
D.birchii,156593892,VNKA01006855.1,1,1754,1.12009e-05,153930887,0.982994
D.birchii,156593892,VNKA01000288.1,1,1754,1.12009e-05,153932641,0.983005
D.birchii,156593892,VNKA01005381.1,1,1753,1.11946e-05,153934394,0.983017
D.birchii,156593892,VNKA01001615.1,1,1753,1.11946e-05,153936147,0.983028
D.birchii,156593892,VNKA01000702.1,1,1752,1.11882e-05,153937899,0.983039
D.birchii,156593892,VNKA01006415.1,1,1751,1.11818e-05,153939650,0.98305
D.birchii,156593892,VNKA01004779.1,1,1751,1.11818e-05,153941401,0.983061
D.birchii,156593892,VNKA01003552.1,1,1751,1.11818e-05,153943152,0.983073
D.birchii,156593892,VNKA01002302.1,1,1751,1.11818e-05,153944903,0.983084
D.birchii,156593892,VNKA01006784.1,1,1750,1.11754e-05,153946653,0.983095
D.birchii,156593892,VNKA01000977.1,1,1750,1.11754e-05,153948403,0.983106
D.birchii,156593892,VNKA01000396.1,1,1750,1.11754e-05,153950153,0.983117
D.birchii,156593892,VNKA01006798.1,1,1749,1.1169e-05,153951902,0.983128
D.birchii,156593892,VNKA01003230.1,1,1749,1.1169e-05,153953651,0.98314
D.birchii,156593892,VNKA01001866.1,1,1749,1.1169e-05,153955400,0.983151
D.birchii,156593892,VNKA01001803.1,1,1749,1.1169e-05,153957149,0.983162
D.birchii,156593892,VNKA01001268.1,1,1749,1.1169e-05,153958898,0.983173
D.birchii,156593892,VNKA01005584.1,1,1748,1.11626e-05,153960646,0.983184
D.birchii,156593892,VNKA01002088.1,1,1748,1.11626e-05,153962394,0.983195
D.birchii,156593892,VNKA01000560.1,1,1748,1.11626e-05,153964142,0.983207
D.birchii,156593892,VNKA01005594.1,1,1747,1.11562e-05,153965889,0.983218
D.birchii,156593892,VNKA01003438.1,1,1747,1.11562e-05,153967636,0.983229
D.birchii,156593892,VNKA01001097.1,1,1747,1.11562e-05,153969383,0.98324
D.birchii,156593892,VNKA01007332.1,1,1746,1.11499e-05,153971129,0.983251
D.birchii,156593892,VNKA01003305.1,1,1746,1.11499e-05,153972875,0.983262
D.birchii,156593892,VNKA01002377.1,1,1743,1.11307e-05,153974618,0.983273
D.birchii,156593892,VNKA01001687.1,1,1739,1.11052e-05,153976357,0.983285
D.birchii,156593892,VNKA01000807.1,1,1739,1.11052e-05,153978096,0.983296
D.birchii,156593892,VNKA01000759.1,1,1739,1.11052e-05,153979835,0.983307
D.birchii,156593892,VNKA01004998.1,1,1736,1.1086e-05,153981571,0.983318
D.birchii,156593892,VNKA01004669.1,1,1736,1.1086e-05,153983307,0.983329
D.birchii,156593892,VNKA01000728.1,1,1736,1.1086e-05,153985043,0.98334
D.birchii,156593892,VNKA01000543.1,1,1736,1.1086e-05,153986779,0.983351
D.birchii,156593892,VNKA01006324.1,1,1735,1.10796e-05,153988514,0.983362
D.birchii,156593892,VNKA01005781.1,1,1735,1.10796e-05,153990249,0.983373
D.birchii,156593892,VNKA01003504.1,1,1735,1.10796e-05,153991984,0.983384
D.birchii,156593892,VNKA01002554.1,1,1735,1.10796e-05,153993719,0.983395
D.birchii,156593892,VNKA01001499.1,1,1735,1.10796e-05,153995454,0.983407
D.birchii,156593892,VNKA01006109.1,1,1734,1.10732e-05,153997188,0.983418
D.birchii,156593892,VNKA01003520.1,1,1734,1.10732e-05,153998922,0.983429
D.birchii,156593892,VNKA01002020.1,1,1734,1.10732e-05,154000656,0.98344
D.birchii,156593892,VNKA01004350.1,1,1730,1.10477e-05,154002386,0.983451
D.birchii,156593892,VNKA01003671.1,1,1730,1.10477e-05,154004116,0.983462
D.birchii,156593892,VNKA01005759.1,1,1729,1.10413e-05,154005845,0.983473
D.birchii,156593892,VNKA01004353.1,1,1729,1.10413e-05,154007574,0.983484
D.birchii,156593892,VNKA01004346.1,1,1729,1.10413e-05,154009303,0.983495
D.birchii,156593892,VNKA01003567.1,1,1729,1.10413e-05,154011032,0.983506
D.birchii,156593892,VNKA01000335.1,1,1729,1.10413e-05,154012761,0.983517
D.birchii,156593892,VNKA01006471.1,1,1728,1.10349e-05,154014489,0.983528
D.birchii,156593892,VNKA01005318.1,1,1727,1.10285e-05,154016216,0.983539
D.birchii,156593892,VNKA01005078.1,1,1727,1.10285e-05,154017943,0.98355
D.birchii,156593892,VNKA01002203.1,1,1727,1.10285e-05,154019670,0.983561
D.birchii,156593892,VNKA01001406.1,1,1727,1.10285e-05,154021397,0.983572
D.birchii,156593892,VNKA01000634.1,1,1727,1.10285e-05,154023124,0.983583
D.birchii,156593892,VNKA01000582.1,1,1727,1.10285e-05,154024851,0.983594
D.birchii,156593892,VNKA01003898.1,1,1726,1.10221e-05,154026577,0.983605
D.birchii,156593892,VNKA01002803.1,1,1726,1.10221e-05,154028303,0.983616
D.birchii,156593892,VNKA01005588.1,1,1725,1.10158e-05,154030028,0.983627
D.birchii,156593892,VNKA01005453.1,1,1725,1.10158e-05,154031753,0.983638
D.birchii,156593892,VNKA01007216.1,1,1724,1.10094e-05,154033477,0.983649
D.birchii,156593892,VNKA01003848.1,1,1724,1.10094e-05,154035201,0.98366
D.birchii,156593892,VNKA01003093.1,1,1724,1.10094e-05,154036925,0.983671
D.birchii,156593892,VNKA01001989.1,1,1724,1.10094e-05,154038649,0.983682
D.birchii,156593892,VNKA01006478.1,1,1723,1.1003e-05,154040372,0.983693
D.birchii,156593892,VNKA01005243.1,1,1723,1.1003e-05,154042095,0.983704
D.birchii,156593892,VNKA01003262.1,1,1723,1.1003e-05,154043818,0.983715
D.birchii,156593892,VNKA01006787.1,1,1722,1.09966e-05,154045540,0.983726
D.birchii,156593892,VNKA01005609.1,1,1722,1.09966e-05,154047262,0.983737
D.birchii,156593892,VNKA01006713.1,1,1721,1.09902e-05,154048983,0.983748
D.birchii,156593892,VNKA01005449.1,1,1721,1.09902e-05,154050704,0.983759
D.birchii,156593892,VNKA01005267.1,1,1721,1.09902e-05,154052425,0.98377
D.birchii,156593892,VNKA01003609.1,1,1720,1.09838e-05,154054145,0.983781
D.birchii,156593892,VNKA01004301.1,1,1719,1.09774e-05,154055864,0.983792
D.birchii,156593892,VNKA01002266.1,1,1719,1.09774e-05,154057583,0.983803
D.birchii,156593892,VNKA01001743.1,1,1719,1.09774e-05,154059302,0.983814
D.birchii,156593892,VNKA01000983.1,1,1719,1.09774e-05,154061021,0.983825
D.birchii,156593892,VNKA01004523.1,1,1718,1.09711e-05,154062739,0.983836
D.birchii,156593892,VNKA01004415.1,1,1718,1.09711e-05,154064457,0.983847
D.birchii,156593892,VNKA01001667.1,1,1718,1.09711e-05,154066175,0.983858
D.birchii,156593892,VNKA01000556.1,1,1718,1.09711e-05,154067893,0.983869
D.birchii,156593892,VNKA01007030.1,1,1717,1.09647e-05,154069610,0.98388
D.birchii,156593892,VNKA01006365.1,1,1717,1.09647e-05,154071327,0.983891
D.birchii,156593892,VNKA01005830.1,1,1717,1.09647e-05,154073044,0.983902
D.birchii,156593892,VNKA01007437.1,1,1716,1.09583e-05,154074760,0.983913
D.birchii,156593892,VNKA01006293.1,1,1716,1.09583e-05,154076476,0.983924
D.birchii,156593892,VNKA01003131.1,1,1716,1.09583e-05,154078192,0.983935
D.birchii,156593892,VNKA01004895.1,1,1714,1.09455e-05,154079906,0.983946
D.birchii,156593892,VNKA01007379.1,1,1713,1.09391e-05,154081619,0.983957
D.birchii,156593892,VNKA01006547.1,1,1713,1.09391e-05,154083332,0.983968
D.birchii,156593892,VNKA01002622.1,1,1713,1.09391e-05,154085045,0.983979
D.birchii,156593892,VNKA01000464.1,1,1712,1.09327e-05,154086757,0.98399
D.birchii,156593892,VNKA01004620.1,1,1711,1.09264e-05,154088468,0.984
D.birchii,156593892,VNKA01002953.1,1,1711,1.09264e-05,154090179,0.984011
D.birchii,156593892,VNKA01005976.1,1,1710,1.092e-05,154091889,0.984022
D.birchii,156593892,VNKA01002089.1,1,1710,1.092e-05,154093599,0.984033
D.birchii,156593892,VNKA01001082.1,1,1710,1.092e-05,154095309,0.984044
D.birchii,156593892,VNKA01000630.1,1,1710,1.092e-05,154097019,0.984055
D.birchii,156593892,VNKA01006727.1,1,1709,1.09136e-05,154098728,0.984066
D.birchii,156593892,VNKA01004735.1,1,1709,1.09136e-05,154100437,0.984077
D.birchii,156593892,VNKA01001480.1,1,1709,1.09136e-05,154102146,0.984088
D.birchii,156593892,VNKA01001319.1,1,1709,1.09136e-05,154103855,0.984099
D.birchii,156593892,VNKA01003952.1,1,1708,1.09072e-05,154105563,0.98411
D.birchii,156593892,VNKA01003846.1,1,1708,1.09072e-05,154107271,0.984121
D.birchii,156593892,VNKA01003813.1,1,1706,1.08944e-05,154108977,0.984131
D.birchii,156593892,VNKA01004225.1,1,1705,1.0888e-05,154110682,0.984142
D.birchii,156593892,VNKA01003851.1,1,1705,1.0888e-05,154112387,0.984153
D.birchii,156593892,VNKA01001650.1,1,1705,1.0888e-05,154114092,0.984164
D.birchii,156593892,VNKA01007251.1,1,1704,1.08817e-05,154115796,0.984175
D.birchii,156593892,VNKA01003151.1,1,1704,1.08817e-05,154117500,0.984186
D.birchii,156593892,VNKA01001973.1,1,1704,1.08817e-05,154119204,0.984197
D.birchii,156593892,VNKA01002623.1,1,1703,1.08753e-05,154120907,0.984208
D.birchii,156593892,VNKA01001413.1,1,1703,1.08753e-05,154122610,0.984219
D.birchii,156593892,VNKA01000794.1,1,1703,1.08753e-05,154124313,0.984229
D.birchii,156593892,VNKA01003933.1,1,1702,1.08689e-05,154126015,0.98424
D.birchii,156593892,VNKA01003060.1,1,1702,1.08689e-05,154127717,0.984251
D.birchii,156593892,VNKA01006979.1,1,1700,1.08561e-05,154129417,0.984262
D.birchii,156593892,VNKA01003781.1,1,1700,1.08561e-05,154131117,0.984273
D.birchii,156593892,VNKA01002830.1,1,1700,1.08561e-05,154132817,0.984284
D.birchii,156593892,VNKA01000902.1,1,1700,1.08561e-05,154134517,0.984295
D.birchii,156593892,VNKA01006037.1,1,1699,1.08497e-05,154136216,0.984305
D.birchii,156593892,VNKA01005498.1,1,1699,1.08497e-05,154137915,0.984316
D.birchii,156593892,VNKA01004077.1,1,1698,1.08433e-05,154139613,0.984327
D.birchii,156593892,VNKA01001537.1,1,1698,1.08433e-05,154141311,0.984338
D.birchii,156593892,VNKA01007244.1,1,1697,1.08369e-05,154143008,0.984349
D.birchii,156593892,VNKA01002061.1,1,1695,1.08242e-05,154144703,0.98436
D.birchii,156593892,VNKA01004912.1,1,1694,1.08178e-05,154146397,0.98437
D.birchii,156593892,VNKA01000927.1,1,1694,1.08178e-05,154148091,0.984381
D.birchii,156593892,VNKA01000151.1,1,1694,1.08178e-05,154149785,0.984392
D.birchii,156593892,VNKA01006960.1,1,1693,1.08114e-05,154151478,0.984403
D.birchii,156593892,VNKA01004970.1,1,1693,1.08114e-05,154153171,0.984414
D.birchii,156593892,VNKA01000512.1,1,1693,1.08114e-05,154154864,0.984425
D.birchii,156593892,VNKA01005575.1,1,1692,1.0805e-05,154156556,0.984435
D.birchii,156593892,VNKA01003341.1,1,1692,1.0805e-05,154158248,0.984446
D.birchii,156593892,VNKA01003855.1,1,1691,1.07986e-05,154159939,0.984457
D.birchii,156593892,VNKA01003809.1,1,1691,1.07986e-05,154161630,0.984468
D.birchii,156593892,VNKA01003564.1,1,1691,1.07986e-05,154163321,0.984479
D.birchii,156593892,VNKA01005524.1,1,1690,1.07922e-05,154165011,0.984489
D.birchii,156593892,VNKA01002946.1,1,1689,1.07859e-05,154166700,0.9845
D.birchii,156593892,VNKA01000304.1,1,1689,1.07859e-05,154168389,0.984511
D.birchii,156593892,VNKA01005969.1,1,1688,1.07795e-05,154170077,0.984522
D.birchii,156593892,VNKA01002187.1,1,1688,1.07795e-05,154171765,0.984532
D.birchii,156593892,VNKA01001711.1,1,1688,1.07795e-05,154173453,0.984543
D.birchii,156593892,VNKA01005999.1,1,1687,1.07731e-05,154175140,0.984554
D.birchii,156593892,VNKA01004800.1,1,1687,1.07731e-05,154176827,0.984565
D.birchii,156593892,VNKA01006780.1,1,1686,1.07667e-05,154178513,0.984576
D.birchii,156593892,VNKA01004001.1,1,1686,1.07667e-05,154180199,0.984586
D.birchii,156593892,VNKA01003480.1,1,1686,1.07667e-05,154181885,0.984597
D.birchii,156593892,VNKA01003165.1,1,1686,1.07667e-05,154183571,0.984608
D.birchii,156593892,VNKA01002685.1,1,1686,1.07667e-05,154185257,0.984619
D.birchii,156593892,VNKA01000756.1,1,1685,1.07603e-05,154186942,0.984629
D.birchii,156593892,VNKA01000398.1,1,1685,1.07603e-05,154188627,0.98464
D.birchii,156593892,VNKA01005929.1,1,1683,1.07475e-05,154190310,0.984651
D.birchii,156593892,VNKA01005661.1,1,1683,1.07475e-05,154191993,0.984662
D.birchii,156593892,VNKA01003945.1,1,1683,1.07475e-05,154193676,0.984672
D.birchii,156593892,VNKA01002018.1,1,1683,1.07475e-05,154195359,0.984683
D.birchii,156593892,VNKA01000690.1,1,1683,1.07475e-05,154197042,0.984694
D.birchii,156593892,VNKA01003240.1,1,1682,1.07412e-05,154198724,0.984705
D.birchii,156593892,VNKA01000477.1,1,1682,1.07412e-05,154200406,0.984715
D.birchii,156593892,VNKA01000402.1,1,1682,1.07412e-05,154202088,0.984726
D.birchii,156593892,VNKA01006577.1,1,1681,1.07348e-05,154203769,0.984737
D.birchii,156593892,VNKA01006964.1,1,1680,1.07284e-05,154205449,0.984748
D.birchii,156593892,VNKA01006911.1,1,1680,1.07284e-05,154207129,0.984758
D.birchii,156593892,VNKA01004814.1,1,1680,1.07284e-05,154208809,0.984769
D.birchii,156593892,VNKA01007065.1,1,1679,1.0722e-05,154210488,0.98478
D.birchii,156593892,VNKA01007005.1,1,1679,1.0722e-05,154212167,0.98479
D.birchii,156593892,VNKA01005620.1,1,1679,1.0722e-05,154213846,0.984801
D.birchii,156593892,VNKA01004231.1,1,1679,1.0722e-05,154215525,0.984812
D.birchii,156593892,VNKA01001467.1,1,1679,1.0722e-05,154217204,0.984823
D.birchii,156593892,VNKA01004689.1,1,1677,1.07092e-05,154218881,0.984833
D.birchii,156593892,VNKA01002562.1,1,1677,1.07092e-05,154220558,0.984844
D.birchii,156593892,VNKA01004996.1,1,1675,1.06965e-05,154222233,0.984855
D.birchii,156593892,VNKA01000800.1,1,1675,1.06965e-05,154223908,0.984865
D.birchii,156593892,VNKA01005037.1,1,1674,1.06901e-05,154225582,0.984876
D.birchii,156593892,VNKA01004608.1,1,1674,1.06901e-05,154227256,0.984887
D.birchii,156593892,VNKA01006076.1,1,1673,1.06837e-05,154228929,0.984897
D.birchii,156593892,VNKA01004588.1,1,1673,1.06837e-05,154230602,0.984908
D.birchii,156593892,VNKA01003337.1,1,1673,1.06837e-05,154232275,0.984919
D.birchii,156593892,VNKA01000310.1,1,1673,1.06837e-05,154233948,0.98493
D.birchii,156593892,VNKA01002458.1,1,1672,1.06773e-05,154235620,0.98494
D.birchii,156593892,VNKA01001618.1,1,1672,1.06773e-05,154237292,0.984951
D.birchii,156593892,VNKA01001123.1,1,1671,1.06709e-05,154238963,0.984962
D.birchii,156593892,VNKA01007229.1,1,1670,1.06645e-05,154240633,0.984972
D.birchii,156593892,VNKA01005968.1,1,1670,1.06645e-05,154242303,0.984983
D.birchii,156593892,VNKA01005956.1,1,1670,1.06645e-05,154243973,0.984994
D.birchii,156593892,VNKA01005448.1,1,1670,1.06645e-05,154245643,0.985004
D.birchii,156593892,VNKA01001521.1,1,1670,1.06645e-05,154247313,0.985015
D.birchii,156593892,VNKA01003535.1,1,1669,1.06581e-05,154248982,0.985026
D.birchii,156593892,VNKA01003309.1,1,1669,1.06581e-05,154250651,0.985036
D.birchii,156593892,VNKA01000252.1,1,1669,1.06581e-05,154252320,0.985047
D.birchii,156593892,VNKA01006849.1,1,1668,1.06518e-05,154253988,0.985058
D.birchii,156593892,VNKA01002518.1,1,1668,1.06518e-05,154255656,0.985068
D.birchii,156593892,VNKA01005499.1,1,1667,1.06454e-05,154257323,0.985079
D.birchii,156593892,VNKA01003014.1,1,1667,1.06454e-05,154258990,0.985089
D.birchii,156593892,VNKA01001289.1,1,1667,1.06454e-05,154260657,0.9851
D.birchii,156593892,VNKA01006958.1,1,1666,1.0639e-05,154262323,0.985111
D.birchii,156593892,VNKA01004097.1,1,1666,1.0639e-05,154263989,0.985121
D.birchii,156593892,VNKA01003482.1,1,1666,1.0639e-05,154265655,0.985132
D.birchii,156593892,VNKA01001837.1,1,1666,1.0639e-05,154267321,0.985143
D.birchii,156593892,VNKA01007411.1,1,1664,1.06262e-05,154268985,0.985153
D.birchii,156593892,VNKA01006942.1,1,1664,1.06262e-05,154270649,0.985164
D.birchii,156593892,VNKA01006708.1,1,1664,1.06262e-05,154272313,0.985175
D.birchii,156593892,VNKA01006428.1,1,1664,1.06262e-05,154273977,0.985185
D.birchii,156593892,VNKA01002939.1,1,1664,1.06262e-05,154275641,0.985196
D.birchii,156593892,VNKA01003526.1,1,1663,1.06198e-05,154277304,0.985206
D.birchii,156593892,VNKA01001889.1,1,1663,1.06198e-05,154278967,0.985217
D.birchii,156593892,VNKA01001317.1,1,1662,1.06134e-05,154280629,0.985228
D.birchii,156593892,VNKA01007057.1,1,1661,1.06071e-05,154282290,0.985238
D.birchii,156593892,VNKA01003474.1,1,1661,1.06071e-05,154283951,0.985249
D.birchii,156593892,VNKA01003298.1,1,1661,1.06071e-05,154285612,0.985259
D.birchii,156593892,VNKA01002795.1,1,1661,1.06071e-05,154287273,0.98527
D.birchii,156593892,VNKA01002771.1,1,1661,1.06071e-05,154288934,0.985281
D.birchii,156593892,VNKA01001883.1,1,1661,1.06071e-05,154290595,0.985291
D.birchii,156593892,VNKA01000749.1,1,1661,1.06071e-05,154292256,0.985302
D.birchii,156593892,VNKA01005090.1,1,1660,1.06007e-05,154293916,0.985312
D.birchii,156593892,VNKA01004908.1,1,1659,1.05943e-05,154295575,0.985323
D.birchii,156593892,VNKA01003675.1,1,1659,1.05943e-05,154297234,0.985334
D.birchii,156593892,VNKA01000147.1,1,1659,1.05943e-05,154298893,0.985344
D.birchii,156593892,VNKA01005122.1,1,1658,1.05879e-05,154300551,0.985355
D.birchii,156593892,VNKA01004497.1,1,1658,1.05879e-05,154302209,0.985365
D.birchii,156593892,VNKA01006766.1,1,1657,1.05815e-05,154303866,0.985376
D.birchii,156593892,VNKA01006291.1,1,1657,1.05815e-05,154305523,0.985387
D.birchii,156593892,VNKA01006224.1,1,1657,1.05815e-05,154307180,0.985397
D.birchii,156593892,VNKA01000319.1,1,1657,1.05815e-05,154308837,0.985408
D.birchii,156593892,VNKA01001850.1,1,1656,1.05751e-05,154310493,0.985418
D.birchii,156593892,VNKA01007480.1,1,1655,1.05687e-05,154312148,0.985429
D.birchii,156593892,VNKA01000531.1,1,1655,1.05687e-05,154313803,0.985439
D.birchii,156593892,VNKA01007161.1,1,1654,1.05624e-05,154315457,0.98545
D.birchii,156593892,VNKA01006229.1,1,1653,1.0556e-05,154317110,0.985461
D.birchii,156593892,VNKA01004534.1,1,1653,1.0556e-05,154318763,0.985471
D.birchii,156593892,VNKA01004022.1,1,1653,1.0556e-05,154320416,0.985482
D.birchii,156593892,VNKA01000721.1,1,1652,1.05496e-05,154322068,0.985492
D.birchii,156593892,VNKA01005961.1,1,1650,1.05368e-05,154323718,0.985503
D.birchii,156593892,VNKA01005805.1,1,1650,1.05368e-05,154325368,0.985513
D.birchii,156593892,VNKA01005905.1,1,1649,1.05304e-05,154327017,0.985524
D.birchii,156593892,VNKA01002249.1,1,1649,1.05304e-05,154328666,0.985534
D.birchii,156593892,VNKA01007449.1,1,1648,1.0524e-05,154330314,0.985545
D.birchii,156593892,VNKA01003090.1,1,1648,1.0524e-05,154331962,0.985555
D.birchii,156593892,VNKA01000541.1,1,1648,1.0524e-05,154333610,0.985566
D.birchii,156593892,VNKA01006310.1,1,1647,1.05177e-05,154335257,0.985576
D.birchii,156593892,VNKA01005925.1,1,1647,1.05177e-05,154336904,0.985587
D.birchii,156593892,VNKA01004143.1,1,1647,1.05177e-05,154338551,0.985598
D.birchii,156593892,VNKA01006571.1,1,1645,1.05049e-05,154340196,0.985608
D.birchii,156593892,VNKA01005844.1,1,1645,1.05049e-05,154341841,0.985619
D.birchii,156593892,VNKA01007514.1,1,1644,1.04985e-05,154343485,0.985629
D.birchii,156593892,VNKA01001806.1,1,1644,1.04985e-05,154345129,0.98564
D.birchii,156593892,VNKA01000801.1,1,1644,1.04985e-05,154346773,0.98565
D.birchii,156593892,VNKA01002063.1,1,1643,1.04921e-05,154348416,0.985661
D.birchii,156593892,VNKA01004414.1,1,1642,1.04857e-05,154350058,0.985671
D.birchii,156593892,VNKA01007448.1,1,1641,1.04793e-05,154351699,0.985681
D.birchii,156593892,VNKA01005419.1,1,1641,1.04793e-05,154353340,0.985692
D.birchii,156593892,VNKA01004862.1,1,1641,1.04793e-05,154354981,0.985702
D.birchii,156593892,VNKA01000842.1,1,1641,1.04793e-05,154356622,0.985713
D.birchii,156593892,VNKA01001661.1,1,1640,1.04729e-05,154358262,0.985723
D.birchii,156593892,VNKA01005079.1,1,1638,1.04602e-05,154359900,0.985734
D.birchii,156593892,VNKA01003071.1,1,1638,1.04602e-05,154361538,0.985744
D.birchii,156593892,VNKA01006850.1,1,1637,1.04538e-05,154363175,0.985755
D.birchii,156593892,VNKA01007377.1,1,1636,1.04474e-05,154364811,0.985765
D.birchii,156593892,VNKA01006756.1,1,1636,1.04474e-05,154366447,0.985776
D.birchii,156593892,VNKA01001845.1,1,1636,1.04474e-05,154368083,0.985786
D.birchii,156593892,VNKA01007471.1,1,1635,1.0441e-05,154369718,0.985797
D.birchii,156593892,VNKA01006506.1,1,1635,1.0441e-05,154371353,0.985807
D.birchii,156593892,VNKA01005811.1,1,1635,1.0441e-05,154372988,0.985817
D.birchii,156593892,VNKA01004719.1,1,1635,1.0441e-05,154374623,0.985828
D.birchii,156593892,VNKA01004341.1,1,1635,1.0441e-05,154376258,0.985838
D.birchii,156593892,VNKA01007306.1,1,1634,1.04346e-05,154377892,0.985849
D.birchii,156593892,VNKA01002449.1,1,1634,1.04346e-05,154379526,0.985859
D.birchii,156593892,VNKA01001239.1,1,1634,1.04346e-05,154381160,0.98587
D.birchii,156593892,VNKA01000475.1,1,1634,1.04346e-05,154382794,0.98588
D.birchii,156593892,VNKA01002824.1,1,1633,1.04282e-05,154384427,0.98589
D.birchii,156593892,VNKA01001216.1,1,1633,1.04282e-05,154386060,0.985901
D.birchii,156593892,VNKA01000786.1,1,1633,1.04282e-05,154387693,0.985911
D.birchii,156593892,VNKA01006339.1,1,1632,1.04219e-05,154389325,0.985922
D.birchii,156593892,VNKA01005240.1,1,1632,1.04219e-05,154390957,0.985932
D.birchii,156593892,VNKA01003072.1,1,1632,1.04219e-05,154392589,0.985943
D.birchii,156593892,VNKA01005921.1,1,1631,1.04155e-05,154394220,0.985953
D.birchii,156593892,VNKA01005775.1,1,1631,1.04155e-05,154395851,0.985963
D.birchii,156593892,VNKA01004751.1,1,1631,1.04155e-05,154397482,0.985974
D.birchii,156593892,VNKA01003174.1,1,1631,1.04155e-05,154399113,0.985984
D.birchii,156593892,VNKA01005043.1,1,1629,1.04027e-05,154400742,0.985995
D.birchii,156593892,VNKA01004478.1,1,1629,1.04027e-05,154402371,0.986005
D.birchii,156593892,VNKA01003496.1,1,1629,1.04027e-05,154404000,0.986015
D.birchii,156593892,VNKA01001571.1,1,1629,1.04027e-05,154405629,0.986026
D.birchii,156593892,VNKA01004420.1,1,1628,1.03963e-05,154407257,0.986036
D.birchii,156593892,VNKA01003088.1,1,1628,1.03963e-05,154408885,0.986047
D.birchii,156593892,VNKA01005012.1,1,1626,1.03835e-05,154410511,0.986057
D.birchii,156593892,VNKA01003599.1,1,1626,1.03835e-05,154412137,0.986067
D.birchii,156593892,VNKA01002965.1,1,1626,1.03835e-05,154413763,0.986078
D.birchii,156593892,VNKA01005675.1,1,1624,1.03708e-05,154415387,0.986088
D.birchii,156593892,VNKA01003585.1,1,1624,1.03708e-05,154417011,0.986099
D.birchii,156593892,VNKA01002649.1,1,1624,1.03708e-05,154418635,0.986109
D.birchii,156593892,VNKA01002210.1,1,1623,1.03644e-05,154420258,0.986119
D.birchii,156593892,VNKA01004897.1,1,1622,1.0358e-05,154421880,0.98613
D.birchii,156593892,VNKA01003652.1,1,1622,1.0358e-05,154423502,0.98614
D.birchii,156593892,VNKA01000110.1,1,1622,1.0358e-05,154425124,0.98615
D.birchii,156593892,VNKA01004284.1,1,1621,1.03516e-05,154426745,0.986161
D.birchii,156593892,VNKA01003318.1,1,1621,1.03516e-05,154428366,0.986171
D.birchii,156593892,VNKA01003170.1,1,1621,1.03516e-05,154429987,0.986181
D.birchii,156593892,VNKA01002058.1,1,1621,1.03516e-05,154431608,0.986192
D.birchii,156593892,VNKA01005534.1,1,1620,1.03452e-05,154433228,0.986202
D.birchii,156593892,VNKA01004460.1,1,1620,1.03452e-05,154434848,0.986212
D.birchii,156593892,VNKA01000656.1,1,1620,1.03452e-05,154436468,0.986223
D.birchii,156593892,VNKA01000125.1,1,1620,1.03452e-05,154438088,0.986233
D.birchii,156593892,VNKA01000188.1,1,1619,1.03388e-05,154439707,0.986243
D.birchii,156593892,VNKA01000829.1,1,1618,1.03325e-05,154441325,0.986254
D.birchii,156593892,VNKA01002269.1,1,1616,1.03197e-05,154442941,0.986264
D.birchii,156593892,VNKA01006160.1,1,1615,1.03133e-05,154444556,0.986274
D.birchii,156593892,VNKA01004126.1,1,1615,1.03133e-05,154446171,0.986285
D.birchii,156593892,VNKA01001776.1,1,1615,1.03133e-05,154447786,0.986295
D.birchii,156593892,VNKA01001446.1,1,1615,1.03133e-05,154449401,0.986305
D.birchii,156593892,VNKA01001187.1,1,1614,1.03069e-05,154451015,0.986316
D.birchii,156593892,VNKA01000494.1,1,1614,1.03069e-05,154452629,0.986326
D.birchii,156593892,VNKA01006781.1,1,1613,1.03005e-05,154454242,0.986336
D.birchii,156593892,VNKA01004545.1,1,1613,1.03005e-05,154455855,0.986347
D.birchii,156593892,VNKA01003236.1,1,1613,1.03005e-05,154457468,0.986357
D.birchii,156593892,VNKA01000667.1,1,1613,1.03005e-05,154459081,0.986367
D.birchii,156593892,VNKA01001263.1,1,1612,1.02941e-05,154460693,0.986378
D.birchii,156593892,VNKA01001429.1,1,1610,1.02814e-05,154462303,0.986388
D.birchii,156593892,VNKA01005621.1,1,1609,1.0275e-05,154463912,0.986398
D.birchii,156593892,VNKA01000963.1,1,1609,1.0275e-05,154465521,0.986408
D.birchii,156593892,VNKA01006186.1,1,1608,1.02686e-05,154467129,0.986419
D.birchii,156593892,VNKA01005807.1,1,1608,1.02686e-05,154468737,0.986429
D.birchii,156593892,VNKA01002313.1,1,1608,1.02686e-05,154470345,0.986439
D.birchii,156593892,VNKA01000102.1,1,1608,1.02686e-05,154471953,0.986449
D.birchii,156593892,VNKA01004167.1,1,1607,1.02622e-05,154473560,0.98646
D.birchii,156593892,VNKA01002593.1,1,1607,1.02622e-05,154475167,0.98647
D.birchii,156593892,VNKA01002591.1,1,1607,1.02622e-05,154476774,0.98648
D.birchii,156593892,VNKA01000813.1,1,1607,1.02622e-05,154478381,0.98649
D.birchii,156593892,VNKA01005801.1,1,1606,1.02558e-05,154479987,0.986501
D.birchii,156593892,VNKA01004410.1,1,1606,1.02558e-05,154481593,0.986511
D.birchii,156593892,VNKA01001366.1,1,1606,1.02558e-05,154483199,0.986521
D.birchii,156593892,VNKA01003815.1,1,1605,1.02494e-05,154484804,0.986531
D.birchii,156593892,VNKA01002609.1,1,1605,1.02494e-05,154486409,0.986542
D.birchii,156593892,VNKA01000699.1,1,1605,1.02494e-05,154488014,0.986552
D.birchii,156593892,VNKA01001614.1,1,1604,1.02431e-05,154489618,0.986562
D.birchii,156593892,VNKA01001075.1,1,1604,1.02431e-05,154491222,0.986572
D.birchii,156593892,VNKA01003790.1,1,1603,1.02367e-05,154492825,0.986583
D.birchii,156593892,VNKA01000850.1,1,1603,1.02367e-05,154494428,0.986593
D.birchii,156593892,VNKA01000551.1,1,1603,1.02367e-05,154496031,0.986603
D.birchii,156593892,VNKA01004266.1,1,1602,1.02303e-05,154497633,0.986613
D.birchii,156593892,VNKA01002270.1,1,1602,1.02303e-05,154499235,0.986624
D.birchii,156593892,VNKA01001291.1,1,1602,1.02303e-05,154500837,0.986634
D.birchii,156593892,VNKA01000966.1,1,1602,1.02303e-05,154502439,0.986644
D.birchii,156593892,VNKA01006877.1,1,1601,1.02239e-05,154504040,0.986654
D.birchii,156593892,VNKA01006100.1,1,1601,1.02239e-05,154505641,0.986665
D.birchii,156593892,VNKA01004622.1,1,1601,1.02239e-05,154507242,0.986675
D.birchii,156593892,VNKA01004565.1,1,1601,1.02239e-05,154508843,0.986685
D.birchii,156593892,VNKA01004860.1,1,1600,1.02175e-05,154510443,0.986695
D.birchii,156593892,VNKA01002461.1,1,1600,1.02175e-05,154512043,0.986705
D.birchii,156593892,VNKA01005915.1,1,1599,1.02111e-05,154513642,0.986716
D.birchii,156593892,VNKA01004974.1,1,1599,1.02111e-05,154515241,0.986726
D.birchii,156593892,VNKA01003655.1,1,1599,1.02111e-05,154516840,0.986736
D.birchii,156593892,VNKA01002245.1,1,1599,1.02111e-05,154518439,0.986746
D.birchii,156593892,VNKA01000153.1,1,1599,1.02111e-05,154520038,0.986756
D.birchii,156593892,VNKA01005118.1,1,1598,1.02047e-05,154521636,0.986767
D.birchii,156593892,VNKA01004618.1,1,1598,1.02047e-05,154523234,0.986777
D.birchii,156593892,VNKA01004230.1,1,1598,1.02047e-05,154524832,0.986787
D.birchii,156593892,VNKA01004739.1,1,1597,1.01984e-05,154526429,0.986797
D.birchii,156593892,VNKA01002366.1,1,1597,1.01984e-05,154528026,0.986807
D.birchii,156593892,VNKA01002944.1,1,1596,1.0192e-05,154529622,0.986818
D.birchii,156593892,VNKA01000707.1,1,1596,1.0192e-05,154531218,0.986828
D.birchii,156593892,VNKA01006422.1,1,1595,1.01856e-05,154532813,0.986838
D.birchii,156593892,VNKA01005467.1,1,1595,1.01856e-05,154534408,0.986848
D.birchii,156593892,VNKA01005111.1,1,1593,1.01728e-05,154536001,0.986858
D.birchii,156593892,VNKA01002767.1,1,1593,1.01728e-05,154537594,0.986869
D.birchii,156593892,VNKA01000082.1,1,1593,1.01728e-05,154539187,0.986879
D.birchii,156593892,VNKA01006566.1,1,1592,1.01664e-05,154540779,0.986889
D.birchii,156593892,VNKA01004591.1,1,1591,1.016e-05,154542370,0.986899
D.birchii,156593892,VNKA01001468.1,1,1591,1.016e-05,154543961,0.986909
D.birchii,156593892,VNKA01001101.1,1,1591,1.016e-05,154545552,0.986919
D.birchii,156593892,VNKA01000648.1,1,1591,1.016e-05,154547143,0.98693
D.birchii,156593892,VNKA01006269.1,1,1590,1.01537e-05,154548733,0.98694
D.birchii,156593892,VNKA01000605.1,1,1590,1.01537e-05,154550323,0.98695
D.birchii,156593892,VNKA01004483.1,1,1589,1.01473e-05,154551912,0.98696
D.birchii,156593892,VNKA01006625.1,1,1588,1.01409e-05,154553500,0.98697
D.birchii,156593892,VNKA01001394.1,1,1587,1.01345e-05,154555087,0.98698
D.birchii,156593892,VNKA01000973.1,1,1587,1.01345e-05,154556674,0.98699
D.birchii,156593892,VNKA01006881.1,1,1586,1.01281e-05,154558260,0.987001
D.birchii,156593892,VNKA01003845.1,1,1586,1.01281e-05,154559846,0.987011
D.birchii,156593892,VNKA01002435.1,1,1586,1.01281e-05,154561432,0.987021
D.birchii,156593892,VNKA01002044.1,1,1586,1.01281e-05,154563018,0.987031
D.birchii,156593892,VNKA01005821.1,1,1585,1.01217e-05,154564603,0.987041
D.birchii,156593892,VNKA01004557.1,1,1585,1.01217e-05,154566188,0.987051
D.birchii,156593892,VNKA01001967.1,1,1585,1.01217e-05,154567773,0.987061
D.birchii,156593892,VNKA01001843.1,1,1585,1.01217e-05,154569358,0.987071
D.birchii,156593892,VNKA01001057.1,1,1585,1.01217e-05,154570943,0.987082
D.birchii,156593892,VNKA01007569.1,1,1584,1.01153e-05,154572527,0.987092
D.birchii,156593892,VNKA01002349.1,1,1584,1.01153e-05,154574111,0.987102
D.birchii,156593892,VNKA01000393.1,1,1584,1.01153e-05,154575695,0.987112
D.birchii,156593892,VNKA01005077.1,1,1583,1.0109e-05,154577278,0.987122
D.birchii,156593892,VNKA01003865.1,1,1583,1.0109e-05,154578861,0.987132
D.birchii,156593892,VNKA01001177.1,1,1583,1.0109e-05,154580444,0.987142
D.birchii,156593892,VNKA01003668.1,1,1582,1.01026e-05,154582026,0.987152
D.birchii,156593892,VNKA01001884.1,1,1581,1.00962e-05,154583607,0.987162
D.birchii,156593892,VNKA01005724.1,1,1580,1.00898e-05,154585187,0.987173
D.birchii,156593892,VNKA01004551.1,1,1580,1.00898e-05,154586767,0.987183
D.birchii,156593892,VNKA01006913.1,1,1579,1.00834e-05,154588346,0.987193
D.birchii,156593892,VNKA01000510.1,1,1579,1.00834e-05,154589925,0.987203
D.birchii,156593892,VNKA01003937.1,1,1578,1.0077e-05,154591503,0.987213
D.birchii,156593892,VNKA01004593.1,1,1577,1.00706e-05,154593080,0.987223
D.birchii,156593892,VNKA01003453.1,1,1576,1.00642e-05,154594656,0.987233
D.birchii,156593892,VNKA01002434.1,1,1576,1.00642e-05,154596232,0.987243
D.birchii,156593892,VNKA01002368.1,1,1576,1.00642e-05,154597808,0.987253
D.birchii,156593892,VNKA01007458.1,1,1575,1.00579e-05,154599383,0.987263
D.birchii,156593892,VNKA01005361.1,1,1575,1.00579e-05,154600958,0.987273
D.birchii,156593892,VNKA01004462.1,1,1575,1.00579e-05,154602533,0.987283
D.birchii,156593892,VNKA01000482.1,1,1575,1.00579e-05,154604108,0.987293
D.birchii,156593892,VNKA01005644.1,1,1574,1.00515e-05,154605682,0.987303
D.birchii,156593892,VNKA01001568.1,1,1573,1.00451e-05,154607255,0.987313
D.birchii,156593892,VNKA01006364.1,1,1572,1.00387e-05,154608827,0.987323
D.birchii,156593892,VNKA01004584.1,1,1572,1.00387e-05,154610399,0.987334
D.birchii,156593892,VNKA01002590.1,1,1572,1.00387e-05,154611971,0.987344
D.birchii,156593892,VNKA01005835.1,1,1571,1.00323e-05,154613542,0.987354
D.birchii,156593892,VNKA01006778.1,1,1570,1.00259e-05,154615112,0.987364
D.birchii,156593892,VNKA01003554.1,1,1570,1.00259e-05,154616682,0.987374
D.birchii,156593892,VNKA01007432.1,1,1569,1.00195e-05,154618251,0.987384
D.birchii,156593892,VNKA01006965.1,1,1569,1.00195e-05,154619820,0.987394
D.birchii,156593892,VNKA01005537.1,1,1569,1.00195e-05,154621389,0.987404
D.birchii,156593892,VNKA01007117.1,1,1568,1.00132e-05,154622957,0.987414
D.birchii,156593892,VNKA01005876.1,1,1567,1.00068e-05,154624524,0.987424
D.birchii,156593892,VNKA01002918.1,1,1567,1.00068e-05,154626091,0.987434
D.birchii,156593892,VNKA01005587.1,1,1566,1.00004e-05,154627657,0.987444
D.birchii,156593892,VNKA01004575.1,1,1566,1.00004e-05,154629223,0.987454
D.birchii,156593892,VNKA01003849.1,1,1566,1.00004e-05,154630789,0.987464
D.birchii,156593892,VNKA01002725.1,1,1566,1.00004e-05,154632355,0.987474
D.birchii,156593892,VNKA01007376.1,1,1565,9.994e-06,154633920,0.987484
D.birchii,156593892,VNKA01007017.1,1,1565,9.994e-06,154635485,0.987494
D.birchii,156593892,VNKA01004229.1,1,1565,9.994e-06,154637050,0.987504
D.birchii,156593892,VNKA01002094.1,1,1564,9.98762e-06,154638614,0.987514
D.birchii,156593892,VNKA01003745.1,1,1563,9.98123e-06,154640177,0.987524
D.birchii,156593892,VNKA01002638.1,1,1563,9.98123e-06,154641740,0.987534
D.birchii,156593892,VNKA01007446.1,1,1562,9.97485e-06,154643302,0.987544
D.birchii,156593892,VNKA01006851.1,1,1562,9.97485e-06,154644864,0.987554
D.birchii,156593892,VNKA01006782.1,1,1562,9.97485e-06,154646426,0.987564
D.birchii,156593892,VNKA01005144.1,1,1562,9.97485e-06,154647988,0.987574
D.birchii,156593892,VNKA01002818.1,1,1562,9.97485e-06,154649550,0.987584
D.birchii,156593892,VNKA01007453.1,1,1561,9.96846e-06,154651111,0.987594
D.birchii,156593892,VNKA01005347.1,1,1560,9.96207e-06,154652671,0.987603
D.birchii,156593892,VNKA01005002.1,1,1560,9.96207e-06,154654231,0.987613
D.birchii,156593892,VNKA01004869.1,1,1560,9.96207e-06,154655791,0.987623
D.birchii,156593892,VNKA01003075.1,1,1560,9.96207e-06,154657351,0.987633
D.birchii,156593892,VNKA01002413.1,1,1560,9.96207e-06,154658911,0.987643
D.birchii,156593892,VNKA01006306.1,1,1559,9.95569e-06,154660470,0.987653
D.birchii,156593892,VNKA01006117.1,1,1559,9.95569e-06,154662029,0.987663
D.birchii,156593892,VNKA01004303.1,1,1559,9.95569e-06,154663588,0.987673
D.birchii,156593892,VNKA01003657.1,1,1559,9.95569e-06,154665147,0.987683
D.birchii,156593892,VNKA01003593.1,1,1559,9.95569e-06,154666706,0.987693
D.birchii,156593892,VNKA01003008.1,1,1559,9.95569e-06,154668265,0.987703
D.birchii,156593892,VNKA01003940.1,1,1558,9.9493e-06,154669823,0.987713
D.birchii,156593892,VNKA01007413.1,1,1557,9.94292e-06,154671380,0.987723
D.birchii,156593892,VNKA01005705.1,1,1557,9.94292e-06,154672937,0.987733
D.birchii,156593892,VNKA01004450.1,1,1557,9.94292e-06,154674494,0.987743
D.birchii,156593892,VNKA01002450.1,1,1557,9.94292e-06,154676051,0.987753
D.birchii,156593892,VNKA01000570.1,1,1557,9.94292e-06,154677608,0.987763
D.birchii,156593892,VNKA01007479.1,1,1556,9.93653e-06,154679164,0.987773
D.birchii,156593892,VNKA01006091.1,1,1556,9.93653e-06,154680720,0.987783
D.birchii,156593892,VNKA01004874.1,1,1556,9.93653e-06,154682276,0.987793
D.birchii,156593892,VNKA01003110.1,1,1556,9.93653e-06,154683832,0.987802
D.birchii,156593892,VNKA01000716.1,1,1556,9.93653e-06,154685388,0.987812
D.birchii,156593892,VNKA01004881.1,1,1555,9.93014e-06,154686943,0.987822
D.birchii,156593892,VNKA01005186.1,1,1554,9.92376e-06,154688497,0.987832
D.birchii,156593892,VNKA01003999.1,1,1554,9.92376e-06,154690051,0.987842
D.birchii,156593892,VNKA01004530.1,1,1553,9.91737e-06,154691604,0.987852
D.birchii,156593892,VNKA01003258.1,1,1553,9.91737e-06,154693157,0.987862
D.birchii,156593892,VNKA01007396.1,1,1552,9.91099e-06,154694709,0.987872
D.birchii,156593892,VNKA01004083.1,1,1552,9.91099e-06,154696261,0.987882
D.birchii,156593892,VNKA01002907.1,1,1551,9.9046e-06,154697812,0.987892
D.birchii,156593892,VNKA01000593.1,1,1551,9.9046e-06,154699363,0.987902
D.birchii,156593892,VNKA01007217.1,1,1550,9.89821e-06,154700913,0.987912
D.birchii,156593892,VNKA01003509.1,1,1550,9.89821e-06,154702463,0.987921
D.birchii,156593892,VNKA01003450.1,1,1550,9.89821e-06,154704013,0.987931
D.birchii,156593892,VNKA01007308.1,1,1549,9.89183e-06,154705562,0.987941
D.birchii,156593892,VNKA01005558.1,1,1549,9.89183e-06,154707111,0.987951
D.birchii,156593892,VNKA01003783.1,1,1549,9.89183e-06,154708660,0.987961
D.birchii,156593892,VNKA01001869.1,1,1549,9.89183e-06,154710209,0.987971
D.birchii,156593892,VNKA01000815.1,1,1549,9.89183e-06,154711758,0.987981
D.birchii,156593892,VNKA01000152.1,1,1549,9.89183e-06,154713307,0.987991
D.birchii,156593892,VNKA01007170.1,1,1548,9.88544e-06,154714855,0.988001
D.birchii,156593892,VNKA01006513.1,1,1548,9.88544e-06,154716403,0.98801
D.birchii,156593892,VNKA01006312.1,1,1548,9.88544e-06,154717951,0.98802
D.birchii,156593892,VNKA01005566.1,1,1548,9.88544e-06,154719499,0.98803
D.birchii,156593892,VNKA01004981.1,1,1548,9.88544e-06,154721047,0.98804
D.birchii,156593892,VNKA01004629.1,1,1548,9.88544e-06,154722595,0.98805
D.birchii,156593892,VNKA01002717.1,1,1548,9.88544e-06,154724143,0.98806
D.birchii,156593892,VNKA01001529.1,1,1548,9.88544e-06,154725691,0.98807
D.birchii,156593892,VNKA01002475.1,1,1547,9.87906e-06,154727238,0.98808
D.birchii,156593892,VNKA01002048.1,1,1547,9.87906e-06,154728785,0.98809
D.birchii,156593892,VNKA01007148.1,1,1545,9.86629e-06,154730330,0.988099
D.birchii,156593892,VNKA01003765.1,1,1545,9.86629e-06,154731875,0.988109
D.birchii,156593892,VNKA01007249.1,1,1544,9.8599e-06,154733419,0.988119
D.birchii,156593892,VNKA01006010.1,1,1544,9.8599e-06,154734963,0.988129
D.birchii,156593892,VNKA01005083.1,1,1544,9.8599e-06,154736507,0.988139
D.birchii,156593892,VNKA01007317.1,1,1543,9.85351e-06,154738050,0.988149
D.birchii,156593892,VNKA01006759.1,1,1543,9.85351e-06,154739593,0.988159
D.birchii,156593892,VNKA01003738.1,1,1543,9.85351e-06,154741136,0.988168
D.birchii,156593892,VNKA01006469.1,1,1542,9.84713e-06,154742678,0.988178
D.birchii,156593892,VNKA01005660.1,1,1542,9.84713e-06,154744220,0.988188
D.birchii,156593892,VNKA01006828.1,1,1541,9.84074e-06,154745761,0.988198
D.birchii,156593892,VNKA01006026.1,1,1540,9.83436e-06,154747301,0.988208
D.birchii,156593892,VNKA01005104.1,1,1540,9.83436e-06,154748841,0.988218
D.birchii,156593892,VNKA01000776.1,1,1540,9.83436e-06,154750381,0.988227
D.birchii,156593892,VNKA01005192.1,1,1539,9.82797e-06,154751920,0.988237
D.birchii,156593892,VNKA01002980.1,1,1539,9.82797e-06,154753459,0.988247
D.birchii,156593892,VNKA01004918.1,1,1538,9.82158e-06,154754997,0.988257
D.birchii,156593892,VNKA01007483.1,1,1537,9.8152e-06,154756534,0.988267
D.birchii,156593892,VNKA01006245.1,1,1537,9.8152e-06,154758071,0.988277
D.birchii,156593892,VNKA01000058.1,1,1536,9.80881e-06,154759607,0.988286
D.birchii,156593892,VNKA01001530.1,1,1535,9.80243e-06,154761142,0.988296
D.birchii,156593892,VNKA01001245.1,1,1535,9.80243e-06,154762677,0.988306
D.birchii,156593892,VNKA01001318.1,1,1534,9.79604e-06,154764211,0.988316
D.birchii,156593892,VNKA01003959.1,1,1533,9.78965e-06,154765744,0.988326
D.birchii,156593892,VNKA01002645.1,1,1533,9.78965e-06,154767277,0.988335
D.birchii,156593892,VNKA01006552.1,1,1532,9.78327e-06,154768809,0.988345
D.birchii,156593892,VNKA01007302.1,1,1531,9.77688e-06,154770340,0.988355
D.birchii,156593892,VNKA01003835.1,1,1531,9.77688e-06,154771871,0.988365
D.birchii,156593892,VNKA01006587.1,1,1530,9.7705e-06,154773401,0.988374
D.birchii,156593892,VNKA01004916.1,1,1530,9.7705e-06,154774931,0.988384
D.birchii,156593892,VNKA01002462.1,1,1530,9.7705e-06,154776461,0.988394
D.birchii,156593892,VNKA01006941.1,1,1528,9.75772e-06,154777989,0.988404
D.birchii,156593892,VNKA01005297.1,1,1528,9.75772e-06,154779517,0.988414
D.birchii,156593892,VNKA01000550.1,1,1528,9.75772e-06,154781045,0.988423
D.birchii,156593892,VNKA01000223.1,1,1528,9.75772e-06,154782573,0.988433
D.birchii,156593892,VNKA01000192.1,1,1528,9.75772e-06,154784101,0.988443
D.birchii,156593892,VNKA01006526.1,1,1527,9.75134e-06,154785628,0.988453
D.birchii,156593892,VNKA01005463.1,1,1527,9.75134e-06,154787155,0.988462
D.birchii,156593892,VNKA01001003.1,1,1527,9.75134e-06,154788682,0.988472
D.birchii,156593892,VNKA01000139.1,1,1527,9.75134e-06,154790209,0.988482
D.birchii,156593892,VNKA01006363.1,1,1526,9.74495e-06,154791735,0.988492
D.birchii,156593892,VNKA01003092.1,1,1526,9.74495e-06,154793261,0.988501
D.birchii,156593892,VNKA01003077.1,1,1526,9.74495e-06,154794787,0.988511
D.birchii,156593892,VNKA01002635.1,1,1526,9.74495e-06,154796313,0.988521
D.birchii,156593892,VNKA01000663.1,1,1526,9.74495e-06,154797839,0.988531
D.birchii,156593892,VNKA01006146.1,1,1525,9.73857e-06,154799364,0.98854
D.birchii,156593892,VNKA01004518.1,1,1525,9.73857e-06,154800889,0.98855
D.birchii,156593892,VNKA01005409.1,1,1524,9.73218e-06,154802413,0.98856
D.birchii,156593892,VNKA01004449.1,1,1524,9.73218e-06,154803937,0.988569
D.birchii,156593892,VNKA01003348.1,1,1524,9.73218e-06,154805461,0.988579
D.birchii,156593892,VNKA01003078.1,1,1524,9.73218e-06,154806985,0.988589
D.birchii,156593892,VNKA01000533.1,1,1524,9.73218e-06,154808509,0.988599
D.birchii,156593892,VNKA01006824.1,1,1523,9.72579e-06,154810032,0.988608
D.birchii,156593892,VNKA01005865.1,1,1523,9.72579e-06,154811555,0.988618
D.birchii,156593892,VNKA01007130.1,1,1522,9.71941e-06,154813077,0.988628
D.birchii,156593892,VNKA01002790.1,1,1522,9.71941e-06,154814599,0.988638
D.birchii,156593892,VNKA01002724.1,1,1522,9.71941e-06,154816121,0.988647
D.birchii,156593892,VNKA01001598.1,1,1520,9.70664e-06,154817641,0.988657
D.birchii,156593892,VNKA01002607.1,1,1519,9.70025e-06,154819160,0.988667
D.birchii,156593892,VNKA01001511.1,1,1519,9.70025e-06,154820679,0.988676
D.birchii,156593892,VNKA01006830.1,1,1518,9.69386e-06,154822197,0.988686
D.birchii,156593892,VNKA01005860.1,1,1518,9.69386e-06,154823715,0.988696
D.birchii,156593892,VNKA01004020.1,1,1518,9.69386e-06,154825233,0.988705
D.birchii,156593892,VNKA01003455.1,1,1518,9.69386e-06,154826751,0.988715
D.birchii,156593892,VNKA01001877.1,1,1518,9.69386e-06,154828269,0.988725
D.birchii,156593892,VNKA01004278.1,1,1517,9.68748e-06,154829786,0.988735
D.birchii,156593892,VNKA01003810.1,1,1517,9.68748e-06,154831303,0.988744
D.birchii,156593892,VNKA01001913.1,1,1517,9.68748e-06,154832820,0.988754
D.birchii,156593892,VNKA01005927.1,1,1516,9.68109e-06,154834336,0.988764
D.birchii,156593892,VNKA01004339.1,1,1516,9.68109e-06,154835852,0.988773
D.birchii,156593892,VNKA01000450.1,1,1516,9.68109e-06,154837368,0.988783
D.birchii,156593892,VNKA01007288.1,1,1515,9.67471e-06,154838883,0.988793
D.birchii,156593892,VNKA01006119.1,1,1515,9.67471e-06,154840398,0.988802
D.birchii,156593892,VNKA01001017.1,1,1515,9.67471e-06,154841913,0.988812
D.birchii,156593892,VNKA01000732.1,1,1514,9.66832e-06,154843427,0.988822
D.birchii,156593892,VNKA01006691.1,1,1512,9.65555e-06,154844939,0.988831
D.birchii,156593892,VNKA01007489.1,1,1511,9.64916e-06,154846450,0.988841
D.birchii,156593892,VNKA01006601.1,1,1511,9.64916e-06,154847961,0.988851
D.birchii,156593892,VNKA01001261.1,1,1511,9.64916e-06,154849472,0.98886
D.birchii,156593892,VNKA01007193.1,1,1510,9.64278e-06,154850982,0.98887
D.birchii,156593892,VNKA01003778.1,1,1509,9.63639e-06,154852491,0.98888
D.birchii,156593892,VNKA01006580.1,1,1508,9.63001e-06,154853999,0.988889
D.birchii,156593892,VNKA01003362.1,1,1508,9.63001e-06,154855507,0.988899
D.birchii,156593892,VNKA01005094.1,1,1507,9.62362e-06,154857014,0.988908
D.birchii,156593892,VNKA01003707.1,1,1507,9.62362e-06,154858521,0.988918
D.birchii,156593892,VNKA01003515.1,1,1507,9.62362e-06,154860028,0.988928
D.birchii,156593892,VNKA01006943.1,1,1506,9.61723e-06,154861534,0.988937
D.birchii,156593892,VNKA01006275.1,1,1506,9.61723e-06,154863040,0.988947
D.birchii,156593892,VNKA01007456.1,1,1505,9.61085e-06,154864545,0.988956
D.birchii,156593892,VNKA01004408.1,1,1505,9.61085e-06,154866050,0.988966
D.birchii,156593892,VNKA01003051.1,1,1505,9.61085e-06,154867555,0.988976
D.birchii,156593892,VNKA01002541.1,1,1505,9.61085e-06,154869060,0.988985
D.birchii,156593892,VNKA01006002.1,1,1504,9.60446e-06,154870564,0.988995
D.birchii,156593892,VNKA01005946.1,1,1504,9.60446e-06,154872068,0.989005
D.birchii,156593892,VNKA01005054.1,1,1504,9.60446e-06,154873572,0.989014
D.birchii,156593892,VNKA01002624.1,1,1503,9.59808e-06,154875075,0.989024
D.birchii,156593892,VNKA01006155.1,1,1502,9.59169e-06,154876577,0.989033
D.birchii,156593892,VNKA01005809.1,1,1502,9.59169e-06,154878079,0.989043
D.birchii,156593892,VNKA01003196.1,1,1502,9.59169e-06,154879581,0.989053
D.birchii,156593892,VNKA01003130.1,1,1502,9.59169e-06,154881083,0.989062
D.birchii,156593892,VNKA01001190.1,1,1500,9.57892e-06,154882583,0.989072
D.birchii,156593892,VNKA01000487.1,1,1500,9.57892e-06,154884083,0.989081
D.birchii,156593892,VNKA01006944.1,1,1499,9.57253e-06,154885582,0.989091
D.birchii,156593892,VNKA01002098.1,1,1499,9.57253e-06,154887081,0.9891
D.birchii,156593892,VNKA01000891.1,1,1499,9.57253e-06,154888580,0.98911
D.birchii,156593892,VNKA01000840.1,1,1499,9.57253e-06,154890079,0.98912
D.birchii,156593892,VNKA01001603.1,1,1498,9.56615e-06,154891577,0.989129
D.birchii,156593892,VNKA01007331.1,1,1497,9.55976e-06,154893074,0.989139
D.birchii,156593892,VNKA01006276.1,1,1497,9.55976e-06,154894571,0.989148
D.birchii,156593892,VNKA01004330.1,1,1497,9.55976e-06,154896068,0.989158
D.birchii,156593892,VNKA01003870.1,1,1497,9.55976e-06,154897565,0.989167
D.birchii,156593892,VNKA01002253.1,1,1497,9.55976e-06,154899062,0.989177
D.birchii,156593892,VNKA01001528.1,1,1497,9.55976e-06,154900559,0.989186
D.birchii,156593892,VNKA01006994.1,1,1496,9.55337e-06,154902055,0.989196
D.birchii,156593892,VNKA01004027.1,1,1496,9.55337e-06,154903551,0.989206
D.birchii,156593892,VNKA01003022.1,1,1496,9.55337e-06,154905047,0.989215
D.birchii,156593892,VNKA01001143.1,1,1496,9.55337e-06,154906543,0.989225
D.birchii,156593892,VNKA01006118.1,1,1495,9.54699e-06,154908038,0.989234
D.birchii,156593892,VNKA01004995.1,1,1495,9.54699e-06,154909533,0.989244
D.birchii,156593892,VNKA01003600.1,1,1495,9.54699e-06,154911028,0.989253
D.birchii,156593892,VNKA01005939.1,1,1494,9.5406e-06,154912522,0.989263
D.birchii,156593892,VNKA01005234.1,1,1493,9.53422e-06,154914015,0.989272
D.birchii,156593892,VNKA01004713.1,1,1493,9.53422e-06,154915508,0.989282
D.birchii,156593892,VNKA01001024.1,1,1493,9.53422e-06,154917001,0.989291
D.birchii,156593892,VNKA01003412.1,1,1492,9.52783e-06,154918493,0.989301
D.birchii,156593892,VNKA01002764.1,1,1492,9.52783e-06,154919985,0.989311
D.birchii,156593892,VNKA01007172.1,1,1491,9.52144e-06,154921476,0.98932
D.birchii,156593892,VNKA01006081.1,1,1491,9.52144e-06,154922967,0.98933
D.birchii,156593892,VNKA01004971.1,1,1491,9.52144e-06,154924458,0.989339
D.birchii,156593892,VNKA01002993.1,1,1491,9.52144e-06,154925949,0.989349
D.birchii,156593892,VNKA01000196.1,1,1491,9.52144e-06,154927440,0.989358
D.birchii,156593892,VNKA01004675.1,1,1490,9.51506e-06,154928930,0.989368
D.birchii,156593892,VNKA01007516.1,1,1489,9.50867e-06,154930419,0.989377
D.birchii,156593892,VNKA01000993.1,1,1489,9.50867e-06,154931908,0.989387
D.birchii,156593892,VNKA01000703.1,1,1489,9.50867e-06,154933397,0.989396
D.birchii,156593892,VNKA01007481.1,1,1488,9.50229e-06,154934885,0.989406
D.birchii,156593892,VNKA01004282.1,1,1488,9.50229e-06,154936373,0.989415
D.birchii,156593892,VNKA01001241.1,1,1487,9.4959e-06,154937860,0.989425
D.birchii,156593892,VNKA01000874.1,1,1487,9.4959e-06,154939347,0.989434
D.birchii,156593892,VNKA01005732.1,1,1486,9.48951e-06,154940833,0.989444
D.birchii,156593892,VNKA01004587.1,1,1486,9.48951e-06,154942319,0.989453
D.birchii,156593892,VNKA01002721.1,1,1486,9.48951e-06,154943805,0.989463
D.birchii,156593892,VNKA01006825.1,1,1485,9.48313e-06,154945290,0.989472
D.birchii,156593892,VNKA01006549.1,1,1485,9.48313e-06,154946775,0.989482
D.birchii,156593892,VNKA01004762.1,1,1485,9.48313e-06,154948260,0.989491
D.birchii,156593892,VNKA01004037.1,1,1485,9.48313e-06,154949745,0.989501
D.birchii,156593892,VNKA01006221.1,1,1484,9.47674e-06,154951229,0.98951
D.birchii,156593892,VNKA01000126.1,1,1484,9.47674e-06,154952713,0.98952
D.birchii,156593892,VNKA01007360.1,1,1483,9.47036e-06,154954196,0.989529
D.birchii,156593892,VNKA01004544.1,1,1483,9.47036e-06,154955679,0.989538
D.birchii,156593892,VNKA01002701.1,1,1483,9.47036e-06,154957162,0.989548
D.birchii,156593892,VNKA01001960.1,1,1483,9.47036e-06,154958645,0.989557
D.birchii,156593892,VNKA01004609.1,1,1482,9.46397e-06,154960127,0.989567
D.birchii,156593892,VNKA01005392.1,1,1481,9.45758e-06,154961608,0.989576
D.birchii,156593892,VNKA01003737.1,1,1481,9.45758e-06,154963089,0.989586
D.birchii,156593892,VNKA01003314.1,1,1481,9.45758e-06,154964570,0.989595
D.birchii,156593892,VNKA01000174.1,1,1481,9.45758e-06,154966051,0.989605
D.birchii,156593892,VNKA01002675.1,1,1480,9.4512e-06,154967531,0.989614
D.birchii,156593892,VNKA01007198.1,1,1479,9.44481e-06,154969010,0.989624
D.birchii,156593892,VNKA01004590.1,1,1479,9.44481e-06,154970489,0.989633
D.birchii,156593892,VNKA01004169.1,1,1479,9.44481e-06,154971968,0.989642
D.birchii,156593892,VNKA01006548.1,1,1478,9.43843e-06,154973446,0.989652
D.birchii,156593892,VNKA01005466.1,1,1478,9.43843e-06,154974924,0.989661
D.birchii,156593892,VNKA01003836.1,1,1478,9.43843e-06,154976402,0.989671
D.birchii,156593892,VNKA01002700.1,1,1478,9.43843e-06,154977880,0.98968
D.birchii,156593892,VNKA01001862.1,1,1478,9.43843e-06,154979358,0.98969
D.birchii,156593892,VNKA01000544.1,1,1478,9.43843e-06,154980836,0.989699
D.birchii,156593892,VNKA01002357.1,1,1477,9.43204e-06,154982313,0.989709
D.birchii,156593892,VNKA01005585.1,1,1476,9.42565e-06,154983789,0.989718
D.birchii,156593892,VNKA01005714.1,1,1475,9.41927e-06,154985264,0.989727
D.birchii,156593892,VNKA01001022.1,1,1475,9.41927e-06,154986739,0.989737
D.birchii,156593892,VNKA01000824.1,1,1475,9.41927e-06,154988214,0.989746
D.birchii,156593892,VNKA01003326.1,1,1472,9.40011e-06,154989686,0.989756
D.birchii,156593892,VNKA01001815.1,1,1471,9.39373e-06,154991157,0.989765
D.birchii,156593892,VNKA01001427.1,1,1471,9.39373e-06,154992628,0.989774
D.birchii,156593892,VNKA01000719.1,1,1471,9.39373e-06,154994099,0.989784
D.birchii,156593892,VNKA01004359.1,1,1470,9.38734e-06,154995569,0.989793
D.birchii,156593892,VNKA01002811.1,1,1470,9.38734e-06,154997039,0.989803
D.birchii,156593892,VNKA01003411.1,1,1469,9.38095e-06,154998508,0.989812
D.birchii,156593892,VNKA01000785.1,1,1469,9.38095e-06,154999977,0.989821
D.birchii,156593892,VNKA01007410.1,1,1468,9.37457e-06,155001445,0.989831
D.birchii,156593892,VNKA01006654.1,1,1468,9.37457e-06,155002913,0.98984
D.birchii,156593892,VNKA01005870.1,1,1468,9.37457e-06,155004381,0.989849
D.birchii,156593892,VNKA01004586.1,1,1468,9.37457e-06,155005849,0.989859
D.birchii,156593892,VNKA01002095.1,1,1468,9.37457e-06,155007317,0.989868
D.birchii,156593892,VNKA01004491.1,1,1467,9.36818e-06,155008784,0.989878
D.birchii,156593892,VNKA01003997.1,1,1467,9.36818e-06,155010251,0.989887
D.birchii,156593892,VNKA01003957.1,1,1467,9.36818e-06,155011718,0.989896
D.birchii,156593892,VNKA01001240.1,1,1467,9.36818e-06,155013185,0.989906
D.birchii,156593892,VNKA01004749.1,1,1466,9.3618e-06,155014651,0.989915
D.birchii,156593892,VNKA01003521.1,1,1466,9.3618e-06,155016117,0.989924
D.birchii,156593892,VNKA01003324.1,1,1466,9.3618e-06,155017583,0.989934
D.birchii,156593892,VNKA01001255.1,1,1466,9.3618e-06,155019049,0.989943
D.birchii,156593892,VNKA01000969.1,1,1466,9.3618e-06,155020515,0.989953
D.birchii,156593892,VNKA01000347.1,1,1466,9.3618e-06,155021981,0.989962
D.birchii,156593892,VNKA01000081.1,1,1466,9.3618e-06,155023447,0.989971
D.birchii,156593892,VNKA01003475.1,1,1465,9.35541e-06,155024912,0.989981
D.birchii,156593892,VNKA01007019.1,1,1464,9.34902e-06,155026376,0.98999
D.birchii,156593892,VNKA01006670.1,1,1464,9.34902e-06,155027840,0.989999
D.birchii,156593892,VNKA01003549.1,1,1464,9.34902e-06,155029304,0.990009
D.birchii,156593892,VNKA01002759.1,1,1464,9.34902e-06,155030768,0.990018
D.birchii,156593892,VNKA01002999.1,1,1463,9.34264e-06,155032231,0.990027
D.birchii,156593892,VNKA01000875.1,1,1463,9.34264e-06,155033694,0.990037
D.birchii,156593892,VNKA01004682.1,1,1462,9.33625e-06,155035156,0.990046
D.birchii,156593892,VNKA01005550.1,1,1461,9.32987e-06,155036617,0.990055
D.birchii,156593892,VNKA01000234.1,1,1461,9.32987e-06,155038078,0.990065
D.birchii,156593892,VNKA01000901.1,1,1460,9.32348e-06,155039538,0.990074
D.birchii,156593892,VNKA01006677.1,1,1459,9.31709e-06,155040997,0.990083
D.birchii,156593892,VNKA01006296.1,1,1459,9.31709e-06,155042456,0.990093
D.birchii,156593892,VNKA01002858.1,1,1459,9.31709e-06,155043915,0.990102
D.birchii,156593892,VNKA01007202.1,1,1458,9.31071e-06,155045373,0.990111
D.birchii,156593892,VNKA01003976.1,1,1458,9.31071e-06,155046831,0.990121
D.birchii,156593892,VNKA01003792.1,1,1458,9.31071e-06,155048289,0.99013
D.birchii,156593892,VNKA01005845.1,1,1457,9.30432e-06,155049746,0.990139
D.birchii,156593892,VNKA01005964.1,1,1456,9.29794e-06,155051202,0.990148
D.birchii,156593892,VNKA01003494.1,1,1456,9.29794e-06,155052658,0.990158
D.birchii,156593892,VNKA01002217.1,1,1456,9.29794e-06,155054114,0.990167
D.birchii,156593892,VNKA01001795.1,1,1456,9.29794e-06,155055570,0.990176
D.birchii,156593892,VNKA01001620.1,1,1456,9.29794e-06,155057026,0.990186
D.birchii,156593892,VNKA01003598.1,1,1455,9.29155e-06,155058481,0.990195
D.birchii,156593892,VNKA01001944.1,1,1455,9.29155e-06,155059936,0.990204
D.birchii,156593892,VNKA01007366.1,1,1454,9.28516e-06,155061390,0.990214
D.birchii,156593892,VNKA01007292.1,1,1454,9.28516e-06,155062844,0.990223
D.birchii,156593892,VNKA01005740.1,1,1454,9.28516e-06,155064298,0.990232
D.birchii,156593892,VNKA01006948.1,1,1453,9.27878e-06,155065751,0.990241
D.birchii,156593892,VNKA01003023.1,1,1453,9.27878e-06,155067204,0.990251
D.birchii,156593892,VNKA01002519.1,1,1453,9.27878e-06,155068657,0.99026
D.birchii,156593892,VNKA01001105.1,1,1453,9.27878e-06,155070110,0.990269
D.birchii,156593892,VNKA01001838.1,1,1452,9.27239e-06,155071562,0.990278
D.birchii,156593892,VNKA01007349.1,1,1451,9.26601e-06,155073013,0.990288
D.birchii,156593892,VNKA01006615.1,1,1451,9.26601e-06,155074464,0.990297
D.birchii,156593892,VNKA01005795.1,1,1451,9.26601e-06,155075915,0.990306
D.birchii,156593892,VNKA01000636.1,1,1451,9.26601e-06,155077366,0.990316
D.birchii,156593892,VNKA01007180.1,1,1450,9.25962e-06,155078816,0.990325
D.birchii,156593892,VNKA01005824.1,1,1450,9.25962e-06,155080266,0.990334
D.birchii,156593892,VNKA01003676.1,1,1450,9.25962e-06,155081716,0.990343
D.birchii,156593892,VNKA01001640.1,1,1450,9.25962e-06,155083166,0.990353
D.birchii,156593892,VNKA01001062.1,1,1450,9.25962e-06,155084616,0.990362
D.birchii,156593892,VNKA01005027.1,1,1449,9.25323e-06,155086065,0.990371
D.birchii,156593892,VNKA01006624.1,1,1448,9.24685e-06,155087513,0.99038
D.birchii,156593892,VNKA01002046.1,1,1448,9.24685e-06,155088961,0.99039
D.birchii,156593892,VNKA01001090.1,1,1448,9.24685e-06,155090409,0.990399
D.birchii,156593892,VNKA01000423.1,1,1447,9.24046e-06,155091856,0.990408
D.birchii,156593892,VNKA01007225.1,1,1445,9.22769e-06,155093301,0.990417
D.birchii,156593892,VNKA01003508.1,1,1445,9.22769e-06,155094746,0.990427
D.birchii,156593892,VNKA01001469.1,1,1445,9.22769e-06,155096191,0.990436
D.birchii,156593892,VNKA01007478.1,1,1444,9.2213e-06,155097635,0.990445
D.birchii,156593892,VNKA01004712.1,1,1444,9.2213e-06,155099079,0.990454
D.birchii,156593892,VNKA01003202.1,1,1444,9.2213e-06,155100523,0.990463
D.birchii,156593892,VNKA01002942.1,1,1444,9.2213e-06,155101967,0.990473
D.birchii,156593892,VNKA01003934.1,1,1443,9.21492e-06,155103410,0.990482
D.birchii,156593892,VNKA01007294.1,1,1442,9.20853e-06,155104852,0.990491
D.birchii,156593892,VNKA01007291.1,1,1442,9.20853e-06,155106294,0.9905
D.birchii,156593892,VNKA01005763.1,1,1442,9.20853e-06,155107736,0.990509
D.birchii,156593892,VNKA01002614.1,1,1442,9.20853e-06,155109178,0.990519
D.birchii,156593892,VNKA01007521.1,1,1441,9.20215e-06,155110619,0.990528
D.birchii,156593892,VNKA01007307.1,1,1441,9.20215e-06,155112060,0.990537
D.birchii,156593892,VNKA01006475.1,1,1441,9.20215e-06,155113501,0.990546
D.birchii,156593892,VNKA01004073.1,1,1441,9.20215e-06,155114942,0.990556
D.birchii,156593892,VNKA01003769.1,1,1441,9.20215e-06,155116383,0.990565
D.birchii,156593892,VNKA01003398.1,1,1441,9.20215e-06,155117824,0.990574
D.birchii,156593892,VNKA01002983.1,1,1441,9.20215e-06,155119265,0.990583
D.birchii,156593892,VNKA01002684.1,1,1441,9.20215e-06,155120706,0.990592
D.birchii,156593892,VNKA01006908.1,1,1440,9.19576e-06,155122146,0.990602
D.birchii,156593892,VNKA01006797.1,1,1440,9.19576e-06,155123586,0.990611
D.birchii,156593892,VNKA01006219.1,1,1440,9.19576e-06,155125026,0.99062
D.birchii,156593892,VNKA01003203.1,1,1440,9.19576e-06,155126466,0.990629
D.birchii,156593892,VNKA01003156.1,1,1440,9.19576e-06,155127906,0.990638
D.birchii,156593892,VNKA01002137.1,1,1440,9.19576e-06,155129346,0.990647
D.birchii,156593892,VNKA01003938.1,1,1439,9.18938e-06,155130785,0.990657
D.birchii,156593892,VNKA01003345.1,1,1439,9.18938e-06,155132224,0.990666
D.birchii,156593892,VNKA01001362.1,1,1439,9.18938e-06,155133663,0.990675
D.birchii,156593892,VNKA01003334.1,1,1438,9.18299e-06,155135101,0.990684
D.birchii,156593892,VNKA01002330.1,1,1438,9.18299e-06,155136539,0.990693
D.birchii,156593892,VNKA01000826.1,1,1438,9.18299e-06,155137977,0.990703
D.birchii,156593892,VNKA01000456.1,1,1438,9.18299e-06,155139415,0.990712
D.birchii,156593892,VNKA01005477.1,1,1437,9.1766e-06,155140852,0.990721
D.birchii,156593892,VNKA01000638.1,1,1437,9.1766e-06,155142289,0.99073
D.birchii,156593892,VNKA01007451.1,1,1436,9.17022e-06,155143725,0.990739
D.birchii,156593892,VNKA01001564.1,1,1436,9.17022e-06,155145161,0.990748
D.birchii,156593892,VNKA01003414.1,1,1435,9.16383e-06,155146596,0.990758
D.birchii,156593892,VNKA01007297.1,1,1434,9.15745e-06,155148030,0.990767
D.birchii,156593892,VNKA01004163.1,1,1434,9.15745e-06,155149464,0.990776
D.birchii,156593892,VNKA01007211.1,1,1433,9.15106e-06,155150897,0.990785
D.birchii,156593892,VNKA01002650.1,1,1433,9.15106e-06,155152330,0.990794
D.birchii,156593892,VNKA01006553.1,1,1432,9.14467e-06,155153762,0.990803
D.birchii,156593892,VNKA01006213.1,1,1432,9.14467e-06,155155194,0.990813
D.birchii,156593892,VNKA01003967.1,1,1432,9.14467e-06,155156626,0.990822
D.birchii,156593892,VNKA01003471.1,1,1432,9.14467e-06,155158058,0.990831
D.birchii,156593892,VNKA01002588.1,1,1432,9.14467e-06,155159490,0.99084
D.birchii,156593892,VNKA01002246.1,1,1431,9.13829e-06,155160921,0.990849
D.birchii,156593892,VNKA01001346.1,1,1431,9.13829e-06,155162352,0.990858
D.birchii,156593892,VNKA01004337.1,1,1430,9.1319e-06,155163782,0.990867
D.birchii,156593892,VNKA01004121.1,1,1430,9.1319e-06,155165212,0.990877
D.birchii,156593892,VNKA01003479.1,1,1430,9.1319e-06,155166642,0.990886
D.birchii,156593892,VNKA01000318.1,1,1430,9.1319e-06,155168072,0.990895
D.birchii,156593892,VNKA01000131.1,1,1430,9.1319e-06,155169502,0.990904
D.birchii,156593892,VNKA01004558.1,1,1429,9.12552e-06,155170931,0.990913
D.birchii,156593892,VNKA01001532.1,1,1429,9.12552e-06,155172360,0.990922
D.birchii,156593892,VNKA01000837.1,1,1429,9.12552e-06,155173789,0.990931
D.birchii,156593892,VNKA01000430.1,1,1429,9.12552e-06,155175218,0.99094
D.birchii,156593892,VNKA01006180.1,1,1428,9.11913e-06,155176646,0.99095
D.birchii,156593892,VNKA01003729.1,1,1427,9.11274e-06,155178073,0.990959
D.birchii,156593892,VNKA01002963.1,1,1427,9.11274e-06,155179500,0.990968
D.birchii,156593892,VNKA01001970.1,1,1427,9.11274e-06,155180927,0.990977
D.birchii,156593892,VNKA01001788.1,1,1427,9.11274e-06,155182354,0.990986
D.birchii,156593892,VNKA01001117.1,1,1426,9.10636e-06,155183780,0.990995
D.birchii,156593892,VNKA01005758.1,1,1425,9.09997e-06,155185205,0.991004
D.birchii,156593892,VNKA01005630.1,1,1425,9.09997e-06,155186630,0.991013
D.birchii,156593892,VNKA01004122.1,1,1425,9.09997e-06,155188055,0.991022
D.birchii,156593892,VNKA01002960.1,1,1425,9.09997e-06,155189480,0.991032
D.birchii,156593892,VNKA01002763.1,1,1425,9.09997e-06,155190905,0.991041
D.birchii,156593892,VNKA01007293.1,1,1424,9.09359e-06,155192329,0.99105
D.birchii,156593892,VNKA01001016.1,1,1424,9.09359e-06,155193753,0.991059
D.birchii,156593892,VNKA01000586.1,1,1424,9.09359e-06,155195177,0.991068
D.birchii,156593892,VNKA01007261.1,1,1423,9.0872e-06,155196600,0.991077
D.birchii,156593892,VNKA01005471.1,1,1423,9.0872e-06,155198023,0.991086
D.birchii,156593892,VNKA01005181.1,1,1422,9.08081e-06,155199445,0.991095
D.birchii,156593892,VNKA01004465.1,1,1422,9.08081e-06,155200867,0.991104
D.birchii,156593892,VNKA01002838.1,1,1422,9.08081e-06,155202289,0.991113
D.birchii,156593892,VNKA01006536.1,1,1421,9.07443e-06,155203710,0.991122
D.birchii,156593892,VNKA01005306.1,1,1421,9.07443e-06,155205131,0.991131
D.birchii,156593892,VNKA01004672.1,1,1421,9.07443e-06,155206552,0.991141
D.birchii,156593892,VNKA01001106.1,1,1421,9.07443e-06,155207973,0.99115
D.birchii,156593892,VNKA01000170.1,1,1421,9.07443e-06,155209394,0.991159
D.birchii,156593892,VNKA01007475.1,1,1420,9.06804e-06,155210814,0.991168
D.birchii,156593892,VNKA01003264.1,1,1420,9.06804e-06,155212234,0.991177
D.birchii,156593892,VNKA01002158.1,1,1420,9.06804e-06,155213654,0.991186
D.birchii,156593892,VNKA01006646.1,1,1419,9.06166e-06,155215073,0.991195
D.birchii,156593892,VNKA01005009.1,1,1419,9.06166e-06,155216492,0.991204
D.birchii,156593892,VNKA01007124.1,1,1417,9.04888e-06,155217909,0.991213
D.birchii,156593892,VNKA01007160.1,1,1416,9.0425e-06,155219325,0.991222
D.birchii,156593892,VNKA01005417.1,1,1416,9.0425e-06,155220741,0.991231
D.birchii,156593892,VNKA01004556.1,1,1416,9.0425e-06,155222157,0.99124
D.birchii,156593892,VNKA01004999.1,1,1415,9.03611e-06,155223572,0.991249
D.birchii,156593892,VNKA01006529.1,1,1414,9.02973e-06,155224986,0.991258
D.birchii,156593892,VNKA01007454.1,1,1413,9.02334e-06,155226399,0.991267
D.birchii,156593892,VNKA01005796.1,1,1413,9.02334e-06,155227812,0.991276
D.birchii,156593892,VNKA01001956.1,1,1412,9.01695e-06,155229224,0.991285
D.birchii,156593892,VNKA01006664.1,1,1411,9.01057e-06,155230635,0.991294
D.birchii,156593892,VNKA01003697.1,1,1411,9.01057e-06,155232046,0.991303
D.birchii,156593892,VNKA01003674.1,1,1411,9.01057e-06,155233457,0.991312
D.birchii,156593892,VNKA01006995.1,1,1410,9.00418e-06,155234867,0.991321
D.birchii,156593892,VNKA01005539.1,1,1409,8.9978e-06,155236276,0.99133
D.birchii,156593892,VNKA01003932.1,1,1409,8.9978e-06,155237685,0.991339
D.birchii,156593892,VNKA01001118.1,1,1409,8.9978e-06,155239094,0.991348
D.birchii,156593892,VNKA01000113.1,1,1409,8.9978e-06,155240503,0.991357
D.birchii,156593892,VNKA01004222.1,1,1408,8.99141e-06,155241911,0.991366
D.birchii,156593892,VNKA01002951.1,1,1408,8.99141e-06,155243319,0.991375
D.birchii,156593892,VNKA01001512.1,1,1408,8.99141e-06,155244727,0.991384
D.birchii,156593892,VNKA01005177.1,1,1407,8.98502e-06,155246134,0.991393
D.birchii,156593892,VNKA01003534.1,1,1407,8.98502e-06,155247541,0.991402
D.birchii,156593892,VNKA01007023.1,1,1406,8.97864e-06,155248947,0.991411
D.birchii,156593892,VNKA01006886.1,1,1406,8.97864e-06,155250353,0.99142
D.birchii,156593892,VNKA01005304.1,1,1406,8.97864e-06,155251759,0.991429
D.birchii,156593892,VNKA01002883.1,1,1405,8.97225e-06,155253164,0.991438
D.birchii,156593892,VNKA01001221.1,1,1405,8.97225e-06,155254569,0.991447
D.birchii,156593892,VNKA01007214.1,1,1404,8.96587e-06,155255973,0.991456
D.birchii,156593892,VNKA01004332.1,1,1403,8.95948e-06,155257376,0.991465
D.birchii,156593892,VNKA01004304.1,1,1403,8.95948e-06,155258779,0.991474
D.birchii,156593892,VNKA01005977.1,1,1402,8.9531e-06,155260181,0.991483
D.birchii,156593892,VNKA01001288.1,1,1402,8.9531e-06,155261583,0.991492
D.birchii,156593892,VNKA01005011.1,1,1401,8.94671e-06,155262984,0.991501
D.birchii,156593892,VNKA01001632.1,1,1401,8.94671e-06,155264385,0.99151
D.birchii,156593892,VNKA01004804.1,1,1400,8.94032e-06,155265785,0.991519
D.birchii,156593892,VNKA01002899.1,1,1400,8.94032e-06,155267185,0.991528
D.birchii,156593892,VNKA01006694.1,1,1399,8.93394e-06,155268584,0.991537
D.birchii,156593892,VNKA01006268.1,1,1399,8.93394e-06,155269983,0.991546
D.birchii,156593892,VNKA01004448.1,1,1399,8.93394e-06,155271382,0.991555
D.birchii,156593892,VNKA01000499.1,1,1399,8.93394e-06,155272781,0.991563
D.birchii,156593892,VNKA01004943.1,1,1398,8.92755e-06,155274179,0.991572
D.birchii,156593892,VNKA01004193.1,1,1398,8.92755e-06,155275577,0.991581
D.birchii,156593892,VNKA01001428.1,1,1398,8.92755e-06,155276975,0.99159
D.birchii,156593892,VNKA01007199.1,1,1397,8.92117e-06,155278372,0.991599
D.birchii,156593892,VNKA01004597.1,1,1397,8.92117e-06,155279769,0.991608
D.birchii,156593892,VNKA01004436.1,1,1397,8.92117e-06,155281166,0.991617
D.birchii,156593892,VNKA01003458.1,1,1396,8.91478e-06,155282562,0.991626
D.birchii,156593892,VNKA01006962.1,1,1395,8.90839e-06,155283957,0.991635
D.birchii,156593892,VNKA01006134.1,1,1395,8.90839e-06,155285352,0.991644
D.birchii,156593892,VNKA01002583.1,1,1395,8.90839e-06,155286747,0.991653
D.birchii,156593892,VNKA01001215.1,1,1395,8.90839e-06,155288142,0.991662
D.birchii,156593892,VNKA01007372.1,1,1394,8.90201e-06,155289536,0.99167
D.birchii,156593892,VNKA01006737.1,1,1394,8.90201e-06,155290930,0.991679
D.birchii,156593892,VNKA01004100.1,1,1394,8.90201e-06,155292324,0.991688
D.birchii,156593892,VNKA01001983.1,1,1394,8.90201e-06,155293718,0.991697
D.birchii,156593892,VNKA01001581.1,1,1394,8.90201e-06,155295112,0.991706
D.birchii,156593892,VNKA01004439.1,1,1393,8.89562e-06,155296505,0.991715
D.birchii,156593892,VNKA01001875.1,1,1393,8.89562e-06,155297898,0.991724
D.birchii,156593892,VNKA01001731.1,1,1393,8.89562e-06,155299291,0.991733
D.birchii,156593892,VNKA01006034.1,1,1392,8.88924e-06,155300683,0.991742
D.birchii,156593892,VNKA01004967.1,1,1392,8.88924e-06,155302075,0.991751
D.birchii,156593892,VNKA01000665.1,1,1392,8.88924e-06,155303467,0.991759
D.birchii,156593892,VNKA01006101.1,1,1391,8.88285e-06,155304858,0.991768
D.birchii,156593892,VNKA01003812.1,1,1391,8.88285e-06,155306249,0.991777
D.birchii,156593892,VNKA01006659.1,1,1390,8.87646e-06,155307639,0.991786
D.birchii,156593892,VNKA01002000.1,1,1390,8.87646e-06,155309029,0.991795
D.birchii,156593892,VNKA01000899.1,1,1390,8.87646e-06,155310419,0.991804
D.birchii,156593892,VNKA01000594.1,1,1390,8.87646e-06,155311809,0.991813
D.birchii,156593892,VNKA01006698.1,1,1389,8.87008e-06,155313198,0.991822
D.birchii,156593892,VNKA01005778.1,1,1389,8.87008e-06,155314587,0.99183
D.birchii,156593892,VNKA01002081.1,1,1389,8.87008e-06,155315976,0.991839
D.birchii,156593892,VNKA01004192.1,1,1388,8.86369e-06,155317364,0.991848
D.birchii,156593892,VNKA01005989.1,1,1387,8.85731e-06,155318751,0.991857
D.birchii,156593892,VNKA01002093.1,1,1387,8.85731e-06,155320138,0.991866
D.birchii,156593892,VNKA01003659.1,1,1386,8.85092e-06,155321524,0.991875
D.birchii,156593892,VNKA01001982.1,1,1384,8.83815e-06,155322908,0.991884
D.birchii,156593892,VNKA01001267.1,1,1384,8.83815e-06,155324292,0.991892
D.birchii,156593892,VNKA01000804.1,1,1384,8.83815e-06,155325676,0.991901
D.birchii,156593892,VNKA01006945.1,1,1383,8.83176e-06,155327059,0.99191
D.birchii,156593892,VNKA01003831.1,1,1383,8.83176e-06,155328442,0.991919
D.birchii,156593892,VNKA01006233.1,1,1382,8.82538e-06,155329824,0.991928
D.birchii,156593892,VNKA01005936.1,1,1382,8.82538e-06,155331206,0.991937
D.birchii,156593892,VNKA01002068.1,1,1382,8.82538e-06,155332588,0.991945
D.birchii,156593892,VNKA01005827.1,1,1381,8.81899e-06,155333969,0.991954
D.birchii,156593892,VNKA01005480.1,1,1381,8.81899e-06,155335350,0.991963
D.birchii,156593892,VNKA01004397.1,1,1381,8.81899e-06,155336731,0.991972
D.birchii,156593892,VNKA01002409.1,1,1381,8.81899e-06,155338112,0.991981
D.birchii,156593892,VNKA01006372.1,1,1380,8.8126e-06,155339492,0.991989
D.birchii,156593892,VNKA01002996.1,1,1380,8.8126e-06,155340872,0.991998
D.birchii,156593892,VNKA01002783.1,1,1380,8.8126e-06,155342252,0.992007
D.birchii,156593892,VNKA01001915.1,1,1380,8.8126e-06,155343632,0.992016
D.birchii,156593892,VNKA01001381.1,1,1380,8.8126e-06,155345012,0.992025
D.birchii,156593892,VNKA01001270.1,1,1380,8.8126e-06,155346392,0.992034
D.birchii,156593892,VNKA01007301.1,1,1379,8.80622e-06,155347771,0.992042
D.birchii,156593892,VNKA01002778.1,1,1379,8.80622e-06,155349150,0.992051
D.birchii,156593892,VNKA01001079.1,1,1379,8.80622e-06,155350529,0.99206
D.birchii,156593892,VNKA01001435.1,1,1378,8.79983e-06,155351907,0.992069
D.birchii,156593892,VNKA01003418.1,1,1377,8.79345e-06,155353284,0.992078
D.birchii,156593892,VNKA01006667.1,1,1376,8.78706e-06,155354660,0.992086
D.birchii,156593892,VNKA01003472.1,1,1376,8.78706e-06,155356036,0.992095
D.birchii,156593892,VNKA01000775.1,1,1376,8.78706e-06,155357412,0.992104
D.birchii,156593892,VNKA01000379.1,1,1376,8.78706e-06,155358788,0.992113
D.birchii,156593892,VNKA01007215.1,1,1375,8.78067e-06,155360163,0.992121
D.birchii,156593892,VNKA01002627.1,1,1375,8.78067e-06,155361538,0.99213
D.birchii,156593892,VNKA01004494.1,1,1374,8.77429e-06,155362912,0.992139
D.birchii,156593892,VNKA01003925.1,1,1374,8.77429e-06,155364286,0.992148
D.birchii,156593892,VNKA01002356.1,1,1374,8.77429e-06,155365660,0.992157
D.birchii,156593892,VNKA01004406.1,1,1373,8.7679e-06,155367033,0.992165
D.birchii,156593892,VNKA01004005.1,1,1373,8.7679e-06,155368406,0.992174
D.birchii,156593892,VNKA01005863.1,1,1372,8.76152e-06,155369778,0.992183
D.birchii,156593892,VNKA01005592.1,1,1372,8.76152e-06,155371150,0.992192
D.birchii,156593892,VNKA01002399.1,1,1372,8.76152e-06,155372522,0.9922
D.birchii,156593892,VNKA01000124.1,1,1372,8.76152e-06,155373894,0.992209
D.birchii,156593892,VNKA01000091.1,1,1372,8.76152e-06,155375266,0.992218
D.birchii,156593892,VNKA01007007.1,1,1371,8.75513e-06,155376637,0.992227
D.birchii,156593892,VNKA01004138.1,1,1371,8.75513e-06,155378008,0.992235
D.birchii,156593892,VNKA01003719.1,1,1371,8.75513e-06,155379379,0.992244
D.birchii,156593892,VNKA01007067.1,1,1369,8.74236e-06,155380748,0.992253
D.birchii,156593892,VNKA01006417.1,1,1369,8.74236e-06,155382117,0.992262
D.birchii,156593892,VNKA01005940.1,1,1369,8.74236e-06,155383486,0.99227
D.birchii,156593892,VNKA01005454.1,1,1369,8.74236e-06,155384855,0.992279
D.birchii,156593892,VNKA01004662.1,1,1369,8.74236e-06,155386224,0.992288
D.birchii,156593892,VNKA01007028.1,1,1368,8.73597e-06,155387592,0.992297
D.birchii,156593892,VNKA01006153.1,1,1368,8.73597e-06,155388960,0.992305
D.birchii,156593892,VNKA01004481.1,1,1368,8.73597e-06,155390328,0.992314
D.birchii,156593892,VNKA01004164.1,1,1368,8.73597e-06,155391696,0.992323
D.birchii,156593892,VNKA01002102.1,1,1368,8.73597e-06,155393064,0.992332
D.birchii,156593892,VNKA01001419.1,1,1368,8.73597e-06,155394432,0.99234
D.birchii,156593892,VNKA01000905.1,1,1368,8.73597e-06,155395800,0.992349
D.birchii,156593892,VNKA01002060.1,1,1367,8.72959e-06,155397167,0.992358
D.birchii,156593892,VNKA01003750.1,1,1366,8.7232e-06,155398533,0.992367
D.birchii,156593892,VNKA01007010.1,1,1365,8.71682e-06,155399898,0.992375
D.birchii,156593892,VNKA01003391.1,1,1365,8.71682e-06,155401263,0.992384
D.birchii,156593892,VNKA01002052.1,1,1365,8.71682e-06,155402628,0.992393
D.birchii,156593892,VNKA01001542.1,1,1365,8.71682e-06,155403993,0.992401
D.birchii,156593892,VNKA01001418.1,1,1365,8.71682e-06,155405358,0.99241
D.birchii,156593892,VNKA01001020.1,1,1365,8.71682e-06,155406723,0.992419
D.birchii,156593892,VNKA01007498.1,1,1364,8.71043e-06,155408087,0.992428
D.birchii,156593892,VNKA01004759.1,1,1364,8.71043e-06,155409451,0.992436
D.birchii,156593892,VNKA01004747.1,1,1364,8.71043e-06,155410815,0.992445
D.birchii,156593892,VNKA01004227.1,1,1364,8.71043e-06,155412179,0.992454
D.birchii,156593892,VNKA01003294.1,1,1364,8.71043e-06,155413543,0.992462
D.birchii,156593892,VNKA01002416.1,1,1364,8.71043e-06,155414907,0.992471
D.birchii,156593892,VNKA01006017.1,1,1362,8.69766e-06,155416269,0.99248
D.birchii,156593892,VNKA01004585.1,1,1362,8.69766e-06,155417631,0.992488
D.birchii,156593892,VNKA01003227.1,1,1362,8.69766e-06,155418993,0.992497
D.birchii,156593892,VNKA01006354.1,1,1361,8.69127e-06,155420354,0.992506
D.birchii,156593892,VNKA01006022.1,1,1361,8.69127e-06,155421715,0.992515
D.birchii,156593892,VNKA01005698.1,1,1361,8.69127e-06,155423076,0.992523
D.birchii,156593892,VNKA01002392.1,1,1361,8.69127e-06,155424437,0.992532
D.birchii,156593892,VNKA01002148.1,1,1361,8.69127e-06,155425798,0.992541
D.birchii,156593892,VNKA01005307.1,1,1359,8.6785e-06,155427157,0.992549
D.birchii,156593892,VNKA01003663.1,1,1359,8.6785e-06,155428516,0.992558
D.birchii,156593892,VNKA01000179.1,1,1359,8.6785e-06,155429875,0.992567
D.birchii,156593892,VNKA01007567.1,1,1358,8.67211e-06,155431233,0.992575
D.birchii,156593892,VNKA01003325.1,1,1357,8.66573e-06,155432590,0.992584
D.birchii,156593892,VNKA01003135.1,1,1357,8.66573e-06,155433947,0.992593
D.birchii,156593892,VNKA01002208.1,1,1357,8.66573e-06,155435304,0.992601
D.birchii,156593892,VNKA01001652.1,1,1357,8.66573e-06,155436661,0.99261
D.birchii,156593892,VNKA01006622.1,1,1356,8.65934e-06,155438017,0.992619
D.birchii,156593892,VNKA01003666.1,1,1356,8.65934e-06,155439373,0.992627
D.birchii,156593892,VNKA01002565.1,1,1356,8.65934e-06,155440729,0.992636
D.birchii,156593892,VNKA01001495.1,1,1356,8.65934e-06,155442085,0.992645
D.birchii,156593892,VNKA01005560.1,1,1355,8.65296e-06,155443440,0.992653
D.birchii,156593892,VNKA01002816.1,1,1355,8.65296e-06,155444795,0.992662
D.birchii,156593892,VNKA01001882.1,1,1355,8.65296e-06,155446150,0.992671
D.birchii,156593892,VNKA01000953.1,1,1355,8.65296e-06,155447505,0.992679
D.birchii,156593892,VNKA01001570.1,1,1354,8.64657e-06,155448859,0.992688
D.birchii,156593892,VNKA01006329.1,1,1353,8.64018e-06,155450212,0.992697
D.birchii,156593892,VNKA01006179.1,1,1353,8.64018e-06,155451565,0.992705
D.birchii,156593892,VNKA01003265.1,1,1353,8.64018e-06,155452918,0.992714
D.birchii,156593892,VNKA01002625.1,1,1353,8.64018e-06,155454271,0.992722
D.birchii,156593892,VNKA01001414.1,1,1353,8.64018e-06,155455624,0.992731
D.birchii,156593892,VNKA01000608.1,1,1352,8.6338e-06,155456976,0.99274
D.birchii,156593892,VNKA01004987.1,1,1351,8.62741e-06,155458327,0.992748
D.birchii,156593892,VNKA01003295.1,1,1351,8.62741e-06,155459678,0.992757
D.birchii,156593892,VNKA01002952.1,1,1351,8.62741e-06,155461029,0.992766
D.birchii,156593892,VNKA01005872.1,1,1350,8.62103e-06,155462379,0.992774
D.birchii,156593892,VNKA01001059.1,1,1350,8.62103e-06,155463729,0.992783
D.birchii,156593892,VNKA01000954.1,1,1350,8.62103e-06,155465079,0.992791
D.birchii,156593892,VNKA01006442.1,1,1349,8.61464e-06,155466428,0.9928
D.birchii,156593892,VNKA01005357.1,1,1349,8.61464e-06,155467777,0.992809
D.birchii,156593892,VNKA01004572.1,1,1349,8.61464e-06,155469126,0.992817
D.birchii,156593892,VNKA01004070.1,1,1349,8.61464e-06,155470475,0.992826
D.birchii,156593892,VNKA01005156.1,1,1348,8.60825e-06,155471823,0.992835
D.birchii,156593892,VNKA01006507.1,1,1347,8.60187e-06,155473170,0.992843
D.birchii,156593892,VNKA01005928.1,1,1347,8.60187e-06,155474517,0.992852
D.birchii,156593892,VNKA01005327.1,1,1347,8.60187e-06,155475864,0.99286
D.birchii,156593892,VNKA01003852.1,1,1347,8.60187e-06,155477211,0.992869
D.birchii,156593892,VNKA01006514.1,1,1346,8.59548e-06,155478557,0.992878
D.birchii,156593892,VNKA01005901.1,1,1346,8.59548e-06,155479903,0.992886
D.birchii,156593892,VNKA01005603.1,1,1346,8.59548e-06,155481249,0.992895
D.birchii,156593892,VNKA01000885.1,1,1346,8.59548e-06,155482595,0.992903
D.birchii,156593892,VNKA01006791.1,1,1345,8.5891e-06,155483940,0.992912
D.birchii,156593892,VNKA01005504.1,1,1345,8.5891e-06,155485285,0.99292
D.birchii,156593892,VNKA01001543.1,1,1345,8.5891e-06,155486630,0.992929
D.birchii,156593892,VNKA01007185.1,1,1344,8.58271e-06,155487974,0.992938
D.birchii,156593892,VNKA01006887.1,1,1343,8.57632e-06,155489317,0.992946
D.birchii,156593892,VNKA01002757.1,1,1343,8.57632e-06,155490660,0.992955
D.birchii,156593892,VNKA01003161.1,1,1342,8.56994e-06,155492002,0.992963
D.birchii,156593892,VNKA01000186.1,1,1342,8.56994e-06,155493344,0.992972
D.birchii,156593892,VNKA01002912.1,1,1341,8.56355e-06,155494685,0.992981
D.birchii,156593892,VNKA01001933.1,1,1341,8.56355e-06,155496026,0.992989
D.birchii,156593892,VNKA01006651.1,1,1340,8.55717e-06,155497366,0.992998
D.birchii,156593892,VNKA01003389.1,1,1340,8.55717e-06,155498706,0.993006
D.birchii,156593892,VNKA01002910.1,1,1340,8.55717e-06,155500046,0.993015
D.birchii,156593892,VNKA01002427.1,1,1340,8.55717e-06,155501386,0.993023
D.birchii,156593892,VNKA01005047.1,1,1339,8.55078e-06,155502725,0.993032
D.birchii,156593892,VNKA01004717.1,1,1339,8.55078e-06,155504064,0.99304
D.birchii,156593892,VNKA01003786.1,1,1339,8.55078e-06,155505403,0.993049
D.birchii,156593892,VNKA01003770.1,1,1339,8.55078e-06,155506742,0.993058
D.birchii,156593892,VNKA01001226.1,1,1339,8.55078e-06,155508081,0.993066
D.birchii,156593892,VNKA01006419.1,1,1338,8.54439e-06,155509419,0.993075
D.birchii,156593892,VNKA01006953.1,1,1336,8.53162e-06,155510755,0.993083
D.birchii,156593892,VNKA01006453.1,1,1336,8.53162e-06,155512091,0.993092
D.birchii,156593892,VNKA01003344.1,1,1336,8.53162e-06,155513427,0.9931
D.birchii,156593892,VNKA01001736.1,1,1336,8.53162e-06,155514763,0.993109
D.birchii,156593892,VNKA01006632.1,1,1335,8.52524e-06,155516098,0.993117
D.birchii,156593892,VNKA01004395.1,1,1335,8.52524e-06,155517433,0.993126
D.birchii,156593892,VNKA01002312.1,1,1335,8.52524e-06,155518768,0.993134
D.birchii,156593892,VNKA01004612.1,1,1334,8.51885e-06,155520102,0.993143
D.birchii,156593892,VNKA01003731.1,1,1334,8.51885e-06,155521436,0.993151
D.birchii,156593892,VNKA01002753.1,1,1334,8.51885e-06,155522770,0.99316
D.birchii,156593892,VNKA01001626.1,1,1334,8.51885e-06,155524104,0.993168
D.birchii,156593892,VNKA01004602.1,1,1333,8.51246e-06,155525437,0.993177
D.birchii,156593892,VNKA01005247.1,1,1332,8.50608e-06,155526769,0.993185
D.birchii,156593892,VNKA01002698.1,1,1332,8.50608e-06,155528101,0.993194
D.birchii,156593892,VNKA01002509.1,1,1332,8.50608e-06,155529433,0.993202
D.birchii,156593892,VNKA01001917.1,1,1332,8.50608e-06,155530765,0.993211
D.birchii,156593892,VNKA01003514.1,1,1331,8.49969e-06,155532096,0.993219
D.birchii,156593892,VNKA01007365.1,1,1330,8.49331e-06,155533426,0.993228
D.birchii,156593892,VNKA01002493.1,1,1330,8.49331e-06,155534756,0.993236
D.birchii,156593892,VNKA01002407.1,1,1330,8.49331e-06,155536086,0.993245
D.birchii,156593892,VNKA01001860.1,1,1330,8.49331e-06,155537416,0.993253
D.birchii,156593892,VNKA01000552.1,1,1330,8.49331e-06,155538746,0.993262
D.birchii,156593892,VNKA01000228.1,1,1330,8.49331e-06,155540076,0.99327
D.birchii,156593892,VNKA01005818.1,1,1329,8.48692e-06,155541405,0.993279
D.birchii,156593892,VNKA01000372.1,1,1329,8.48692e-06,155542734,0.993287
D.birchii,156593892,VNKA01003172.1,1,1328,8.48054e-06,155544062,0.993296
D.birchii,156593892,VNKA01003346.1,1,1327,8.47415e-06,155545389,0.993304
D.birchii,156593892,VNKA01003313.1,1,1327,8.47415e-06,155546716,0.993313
D.birchii,156593892,VNKA01003033.1,1,1327,8.47415e-06,155548043,0.993321
D.birchii,156593892,VNKA01006093.1,1,1326,8.46776e-06,155549369,0.99333
D.birchii,156593892,VNKA01005708.1,1,1326,8.46776e-06,155550695,0.993338
D.birchii,156593892,VNKA01001722.1,1,1326,8.46776e-06,155552021,0.993347
D.birchii,156593892,VNKA01002055.1,1,1325,8.46138e-06,155553346,0.993355
D.birchii,156593892,VNKA01000720.1,1,1325,8.46138e-06,155554671,0.993364
D.birchii,156593892,VNKA01004268.1,1,1324,8.45499e-06,155555995,0.993372
D.birchii,156593892,VNKA01001656.1,1,1323,8.44861e-06,155557318,0.99338
D.birchii,156593892,VNKA01006586.1,1,1322,8.44222e-06,155558640,0.993389
D.birchii,156593892,VNKA01006488.1,1,1322,8.44222e-06,155559962,0.993397
D.birchii,156593892,VNKA01003711.1,1,1322,8.44222e-06,155561284,0.993406
D.birchii,156593892,VNKA01002745.1,1,1322,8.44222e-06,155562606,0.993414
D.birchii,156593892,VNKA01004267.1,1,1321,8.43583e-06,155563927,0.993423
D.birchii,156593892,VNKA01006414.1,1,1319,8.42306e-06,155565246,0.993431
D.birchii,156593892,VNKA01004940.1,1,1319,8.42306e-06,155566565,0.99344
D.birchii,156593892,VNKA01003498.1,1,1319,8.42306e-06,155567884,0.993448
D.birchii,156593892,VNKA01005416.1,1,1318,8.41668e-06,155569202,0.993456
D.birchii,156593892,VNKA01003393.1,1,1318,8.41668e-06,155570520,0.993465
D.birchii,156593892,VNKA01002749.1,1,1318,8.41668e-06,155571838,0.993473
D.birchii,156593892,VNKA01002391.1,1,1317,8.41029e-06,155573155,0.993482
D.birchii,156593892,VNKA01006051.1,1,1316,8.4039e-06,155574471,0.99349
D.birchii,156593892,VNKA01005825.1,1,1316,8.4039e-06,155575787,0.993498
D.birchii,156593892,VNKA01000569.1,1,1315,8.39752e-06,155577102,0.993507
D.birchii,156593892,VNKA01007416.1,1,1314,8.39113e-06,155578416,0.993515
D.birchii,156593892,VNKA01006572.1,1,1314,8.39113e-06,155579730,0.993524
D.birchii,156593892,VNKA01005049.1,1,1314,8.39113e-06,155581044,0.993532
D.birchii,156593892,VNKA01001752.1,1,1314,8.39113e-06,155582358,0.99354
D.birchii,156593892,VNKA01005403.1,1,1313,8.38475e-06,155583671,0.993549
D.birchii,156593892,VNKA01003179.1,1,1313,8.38475e-06,155584984,0.993557
D.birchii,156593892,VNKA01002862.1,1,1313,8.38475e-06,155586297,0.993566
D.birchii,156593892,VNKA01006174.1,1,1312,8.37836e-06,155587609,0.993574
D.birchii,156593892,VNKA01005438.1,1,1312,8.37836e-06,155588921,0.993582
D.birchii,156593892,VNKA01002437.1,1,1312,8.37836e-06,155590233,0.993591
D.birchii,156593892,VNKA01002129.1,1,1312,8.37836e-06,155591545,0.993599
D.birchii,156593892,VNKA01005748.1,1,1311,8.37197e-06,155592856,0.993607
D.birchii,156593892,VNKA01004715.1,1,1311,8.37197e-06,155594167,0.993616
D.birchii,156593892,VNKA01004002.1,1,1311,8.37197e-06,155595478,0.993624
D.birchii,156593892,VNKA01002151.1,1,1311,8.37197e-06,155596789,0.993633
D.birchii,156593892,VNKA01001257.1,1,1311,8.37197e-06,155598100,0.993641
D.birchii,156593892,VNKA01000722.1,1,1311,8.37197e-06,155599411,0.993649
D.birchii,156593892,VNKA01006196.1,1,1310,8.36559e-06,155600721,0.993658
D.birchii,156593892,VNKA01005230.1,1,1309,8.3592e-06,155602030,0.993666
D.birchii,156593892,VNKA01005152.1,1,1309,8.3592e-06,155603339,0.993674
D.birchii,156593892,VNKA01005143.1,1,1309,8.3592e-06,155604648,0.993683
D.birchii,156593892,VNKA01002930.1,1,1308,8.35282e-06,155605956,0.993691
D.birchii,156593892,VNKA01000294.1,1,1308,8.35282e-06,155607264,0.993699
D.birchii,156593892,VNKA01004078.1,1,1307,8.34643e-06,155608571,0.993708
D.birchii,156593892,VNKA01003975.1,1,1307,8.34643e-06,155609878,0.993716
D.birchii,156593892,VNKA01003047.1,1,1307,8.34643e-06,155611185,0.993724
D.birchii,156593892,VNKA01000255.1,1,1307,8.34643e-06,155612492,0.993733
D.birchii,156593892,VNKA01005760.1,1,1306,8.34004e-06,155613798,0.993741
D.birchii,156593892,VNKA01004174.1,1,1306,8.34004e-06,155615104,0.99375
D.birchii,156593892,VNKA01005099.1,1,1304,8.32727e-06,155616408,0.993758
D.birchii,156593892,VNKA01006249.1,1,1303,8.32089e-06,155617711,0.993766
D.birchii,156593892,VNKA01005491.1,1,1302,8.3145e-06,155619013,0.993774
D.birchii,156593892,VNKA01004915.1,1,1302,8.3145e-06,155620315,0.993783
D.birchii,156593892,VNKA01001367.1,1,1302,8.3145e-06,155621617,0.993791
D.birchii,156593892,VNKA01000599.1,1,1302,8.3145e-06,155622919,0.993799
D.birchii,156593892,VNKA01004770.1,1,1301,8.30811e-06,155624220,0.993808
D.birchii,156593892,VNKA01002003.1,1,1301,8.30811e-06,155625521,0.993816
D.birchii,156593892,VNKA01000655.1,1,1301,8.30811e-06,155626822,0.993824
D.birchii,156593892,VNKA01006366.1,1,1300,8.30173e-06,155628122,0.993833
D.birchii,156593892,VNKA01004233.1,1,1300,8.30173e-06,155629422,0.993841
D.birchii,156593892,VNKA01002464.1,1,1300,8.30173e-06,155630722,0.993849
D.birchii,156593892,VNKA01001847.1,1,1300,8.30173e-06,155632022,0.993858
D.birchii,156593892,VNKA01000455.1,1,1300,8.30173e-06,155633322,0.993866
D.birchii,156593892,VNKA01002358.1,1,1299,8.29534e-06,155634621,0.993874
D.birchii,156593892,VNKA01002325.1,1,1299,8.29534e-06,155635920,0.993882
D.birchii,156593892,VNKA01006882.1,1,1298,8.28896e-06,155637218,0.993891
D.birchii,156593892,VNKA01006016.1,1,1298,8.28896e-06,155638516,0.993899
D.birchii,156593892,VNKA01004710.1,1,1298,8.28896e-06,155639814,0.993907
D.birchii,156593892,VNKA01003935.1,1,1298,8.28896e-06,155641112,0.993916
D.birchii,156593892,VNKA01003006.1,1,1298,8.28896e-06,155642410,0.993924
D.birchii,156593892,VNKA01001997.1,1,1298,8.28896e-06,155643708,0.993932
D.birchii,156593892,VNKA01007565.1,1,1297,8.28257e-06,155645005,0.99394
D.birchii,156593892,VNKA01002572.1,1,1297,8.28257e-06,155646302,0.993949
D.birchii,156593892,VNKA01001971.1,1,1297,8.28257e-06,155647599,0.993957
D.birchii,156593892,VNKA01000225.1,1,1297,8.28257e-06,155648896,0.993965
D.birchii,156593892,VNKA01006115.1,1,1296,8.27618e-06,155650192,0.993974
D.birchii,156593892,VNKA01005538.1,1,1296,8.27618e-06,155651488,0.993982
D.birchii,156593892,VNKA01003559.1,1,1296,8.27618e-06,155652784,0.99399
D.birchii,156593892,VNKA01003510.1,1,1296,8.27618e-06,155654080,0.993998
D.birchii,156593892,VNKA01000796.1,1,1296,8.27618e-06,155655376,0.994007
D.birchii,156593892,VNKA01003144.1,1,1295,8.2698e-06,155656671,0.994015
D.birchii,156593892,VNKA01001269.1,1,1295,8.2698e-06,155657966,0.994023
D.birchii,156593892,VNKA01007338.1,1,1294,8.26341e-06,155659260,0.994031
D.birchii,156593892,VNKA01007174.1,1,1294,8.26341e-06,155660554,0.99404
D.birchii,156593892,VNKA01005142.1,1,1294,8.26341e-06,155661848,0.994048
D.birchii,156593892,VNKA01006972.1,1,1293,8.25703e-06,155663141,0.994056
D.birchii,156593892,VNKA01004789.1,1,1293,8.25703e-06,155664434,0.994065
D.birchii,156593892,VNKA01001856.1,1,1293,8.25703e-06,155665727,0.994073
D.birchii,156593892,VNKA01006369.1,1,1292,8.25064e-06,155667019,0.994081
D.birchii,156593892,VNKA01005659.1,1,1292,8.25064e-06,155668311,0.994089
D.birchii,156593892,VNKA01003516.1,1,1291,8.24426e-06,155669602,0.994098
D.birchii,156593892,VNKA01001049.1,1,1291,8.24426e-06,155670893,0.994106
D.birchii,156593892,VNKA01000950.1,1,1291,8.24426e-06,155672184,0.994114
D.birchii,156593892,VNKA01007166.1,1,1290,8.23787e-06,155673474,0.994122
D.birchii,156593892,VNKA01001464.1,1,1290,8.23787e-06,155674764,0.99413
D.birchii,156593892,VNKA01003320.1,1,1289,8.23148e-06,155676053,0.994139
D.birchii,156593892,VNKA01000654.1,1,1289,8.23148e-06,155677342,0.994147
D.birchii,156593892,VNKA01005746.1,1,1288,8.2251e-06,155678630,0.994155
D.birchii,156593892,VNKA01004454.1,1,1287,8.21871e-06,155679917,0.994163
D.birchii,156593892,VNKA01007083.1,1,1286,8.21233e-06,155681203,0.994172
D.birchii,156593892,VNKA01006628.1,1,1286,8.21233e-06,155682489,0.99418
D.birchii,156593892,VNKA01004180.1,1,1286,8.21233e-06,155683775,0.994188
D.birchii,156593892,VNKA01003651.1,1,1286,8.21233e-06,155685061,0.994196
D.birchii,156593892,VNKA01002321.1,1,1286,8.21233e-06,155686347,0.994204
D.birchii,156593892,VNKA01000757.1,1,1286,8.21233e-06,155687633,0.994213
D.birchii,156593892,VNKA01007111.1,1,1285,8.20594e-06,155688918,0.994221
D.birchii,156593892,VNKA01001567.1,1,1285,8.20594e-06,155690203,0.994229
D.birchii,156593892,VNKA01006711.1,1,1284,8.19955e-06,155691487,0.994237
D.birchii,156593892,VNKA01006173.1,1,1284,8.19955e-06,155692771,0.994245
D.birchii,156593892,VNKA01005476.1,1,1284,8.19955e-06,155694055,0.994254
D.birchii,156593892,VNKA01004038.1,1,1284,8.19955e-06,155695339,0.994262
D.birchii,156593892,VNKA01000787.1,1,1283,8.19317e-06,155696622,0.99427
D.birchii,156593892,VNKA01000653.1,1,1283,8.19317e-06,155697905,0.994278
D.birchii,156593892,VNKA01002967.1,1,1282,8.18678e-06,155699187,0.994286
D.birchii,156593892,VNKA01000682.1,1,1282,8.18678e-06,155700469,0.994295
D.birchii,156593892,VNKA01004552.1,1,1281,8.1804e-06,155701750,0.994303
D.birchii,156593892,VNKA01003321.1,1,1281,8.1804e-06,155703031,0.994311
D.birchii,156593892,VNKA01003217.1,1,1281,8.1804e-06,155704312,0.994319
D.birchii,156593892,VNKA01005846.1,1,1280,8.17401e-06,155705592,0.994327
D.birchii,156593892,VNKA01006444.1,1,1279,8.16762e-06,155706871,0.994336
D.birchii,156593892,VNKA01005779.1,1,1279,8.16762e-06,155708150,0.994344
D.birchii,156593892,VNKA01003270.1,1,1279,8.16762e-06,155709429,0.994352
D.birchii,156593892,VNKA01001508.1,1,1279,8.16762e-06,155710708,0.99436
D.birchii,156593892,VNKA01006934.1,1,1278,8.16124e-06,155711986,0.994368
D.birchii,156593892,VNKA01006073.1,1,1278,8.16124e-06,155713264,0.994376
D.birchii,156593892,VNKA01005388.1,1,1278,8.16124e-06,155714542,0.994385
D.birchii,156593892,VNKA01001065.1,1,1278,8.16124e-06,155715820,0.994393
D.birchii,156593892,VNKA01000127.1,1,1278,8.16124e-06,155717098,0.994401
D.birchii,156593892,VNKA01006011.1,1,1277,8.15485e-06,155718375,0.994409
D.birchii,156593892,VNKA01003428.1,1,1277,8.15485e-06,155719652,0.994417
D.birchii,156593892,VNKA01002776.1,1,1277,8.15485e-06,155720929,0.994425
D.birchii,156593892,VNKA01000184.1,1,1277,8.15485e-06,155722206,0.994433
D.birchii,156593892,VNKA01005859.1,1,1276,8.14847e-06,155723482,0.994442
D.birchii,156593892,VNKA01004098.1,1,1276,8.14847e-06,155724758,0.99445
D.birchii,156593892,VNKA01006918.1,1,1275,8.14208e-06,155726033,0.994458
D.birchii,156593892,VNKA01005109.1,1,1275,8.14208e-06,155727308,0.994466
D.birchii,156593892,VNKA01004068.1,1,1275,8.14208e-06,155728583,0.994474
D.birchii,156593892,VNKA01003293.1,1,1275,8.14208e-06,155729858,0.994482
D.birchii,156593892,VNKA01004677.1,1,1274,8.13569e-06,155731132,0.99449
D.birchii,156593892,VNKA01004665.1,1,1274,8.13569e-06,155732406,0.994499
D.birchii,156593892,VNKA01004496.1,1,1274,8.13569e-06,155733680,0.994507
D.birchii,156593892,VNKA01004204.1,1,1274,8.13569e-06,155734954,0.994515
D.birchii,156593892,VNKA01001642.1,1,1274,8.13569e-06,155736228,0.994523
D.birchii,156593892,VNKA01004969.1,1,1273,8.12931e-06,155737501,0.994531
D.birchii,156593892,VNKA01003718.1,1,1273,8.12931e-06,155738774,0.994539
D.birchii,156593892,VNKA01000148.1,1,1273,8.12931e-06,155740047,0.994547
D.birchii,156593892,VNKA01007352.1,1,1272,8.12292e-06,155741319,0.994556
D.birchii,156593892,VNKA01003936.1,1,1272,8.12292e-06,155742591,0.994564
D.birchii,156593892,VNKA01003767.1,1,1272,8.12292e-06,155743863,0.994572
D.birchii,156593892,VNKA01001742.1,1,1272,8.12292e-06,155745135,0.99458
D.birchii,156593892,VNKA01005469.1,1,1271,8.11654e-06,155746406,0.994588
D.birchii,156593892,VNKA01004703.1,1,1271,8.11654e-06,155747677,0.994596
D.birchii,156593892,VNKA01004288.1,1,1271,8.11654e-06,155748948,0.994604
D.birchii,156593892,VNKA01003365.1,1,1271,8.11654e-06,155750219,0.994612
D.birchii,156593892,VNKA01002012.1,1,1271,8.11654e-06,155751490,0.99462
D.birchii,156593892,VNKA01005325.1,1,1269,8.10376e-06,155752759,0.994629
D.birchii,156593892,VNKA01005233.1,1,1269,8.10376e-06,155754028,0.994637
D.birchii,156593892,VNKA01001437.1,1,1269,8.10376e-06,155755297,0.994645
D.birchii,156593892,VNKA01004729.1,1,1268,8.09738e-06,155756565,0.994653
D.birchii,156593892,VNKA01000532.1,1,1268,8.09738e-06,155757833,0.994661
D.birchii,156593892,VNKA01000479.1,1,1268,8.09738e-06,155759101,0.994669
D.birchii,156593892,VNKA01007300.1,1,1267,8.09099e-06,155760368,0.994677
D.birchii,156593892,VNKA01006657.1,1,1267,8.09099e-06,155761635,0.994685
D.birchii,156593892,VNKA01003104.1,1,1267,8.09099e-06,155762902,0.994693
D.birchii,156593892,VNKA01006914.1,1,1266,8.08461e-06,155764168,0.994701
D.birchii,156593892,VNKA01004162.1,1,1266,8.08461e-06,155765434,0.99471
D.birchii,156593892,VNKA01001395.1,1,1266,8.08461e-06,155766700,0.994718
D.birchii,156593892,VNKA01000955.1,1,1266,8.08461e-06,155767966,0.994726
D.birchii,156593892,VNKA01004320.1,1,1265,8.07822e-06,155769231,0.994734
D.birchii,156593892,VNKA01003424.1,1,1265,8.07822e-06,155770496,0.994742
D.birchii,156593892,VNKA01003307.1,1,1265,8.07822e-06,155771761,0.99475
D.birchii,156593892,VNKA01001360.1,1,1265,8.07822e-06,155773026,0.994758
D.birchii,156593892,VNKA01000183.1,1,1265,8.07822e-06,155774291,0.994766
D.birchii,156593892,VNKA01005141.1,1,1264,8.07183e-06,155775555,0.994774
D.birchii,156593892,VNKA01002543.1,1,1264,8.07183e-06,155776819,0.994782
D.birchii,156593892,VNKA01007263.1,1,1263,8.06545e-06,155778082,0.99479
D.birchii,156593892,VNKA01004392.1,1,1263,8.06545e-06,155779345,0.994798
D.birchii,156593892,VNKA01000111.1,1,1262,8.05906e-06,155780607,0.994806
D.birchii,156593892,VNKA01006371.1,1,1261,8.05268e-06,155781868,0.994814
D.birchii,156593892,VNKA01005370.1,1,1261,8.05268e-06,155783129,0.994823
D.birchii,156593892,VNKA01006955.1,1,1260,8.04629e-06,155784389,0.994831
D.birchii,156593892,VNKA01004793.1,1,1260,8.04629e-06,155785649,0.994839
D.birchii,156593892,VNKA01004130.1,1,1260,8.04629e-06,155786909,0.994847
D.birchii,156593892,VNKA01006551.1,1,1258,8.03352e-06,155788167,0.994855
D.birchii,156593892,VNKA01005427.1,1,1258,8.03352e-06,155789425,0.994863
D.birchii,156593892,VNKA01001246.1,1,1258,8.03352e-06,155790683,0.994871
D.birchii,156593892,VNKA01006888.1,1,1257,8.02713e-06,155791940,0.994879
D.birchii,156593892,VNKA01006158.1,1,1257,8.02713e-06,155793197,0.994887
D.birchii,156593892,VNKA01003169.1,1,1257,8.02713e-06,155794454,0.994895
D.birchii,156593892,VNKA01006848.1,1,1256,8.02075e-06,155795710,0.994903
D.birchii,156593892,VNKA01006362.1,1,1256,8.02075e-06,155796966,0.994911
D.birchii,156593892,VNKA01002617.1,1,1256,8.02075e-06,155798222,0.994919
D.birchii,156593892,VNKA01000598.1,1,1256,8.02075e-06,155799478,0.994927
D.birchii,156593892,VNKA01005967.1,1,1255,8.01436e-06,155800733,0.994935
D.birchii,156593892,VNKA01005082.1,1,1255,8.01436e-06,155801988,0.994943
D.birchii,156593892,VNKA01004334.1,1,1255,8.01436e-06,155803243,0.994951
D.birchii,156593892,VNKA01004247.1,1,1255,8.01436e-06,155804498,0.994959
D.birchii,156593892,VNKA01004134.1,1,1255,8.01436e-06,155805753,0.994967
D.birchii,156593892,VNKA01003102.1,1,1255,8.01436e-06,155807008,0.994975
D.birchii,156593892,VNKA01005711.1,1,1254,8.00798e-06,155808262,0.994983
D.birchii,156593892,VNKA01004331.1,1,1254,8.00798e-06,155809516,0.994991
D.birchii,156593892,VNKA01002845.1,1,1254,8.00798e-06,155810770,0.994999
D.birchii,156593892,VNKA01003387.1,1,1253,8.00159e-06,155812023,0.995007
D.birchii,156593892,VNKA01003310.1,1,1253,8.00159e-06,155813276,0.995015
D.birchii,156593892,VNKA01002361.1,1,1253,8.00159e-06,155814529,0.995023
D.birchii,156593892,VNKA01006620.1,1,1252,7.9952e-06,155815781,0.995031
D.birchii,156593892,VNKA01004853.1,1,1252,7.9952e-06,155817033,0.995039
D.birchii,156593892,VNKA01007544.1,1,1251,7.98882e-06,155818284,0.995047
D.birchii,156593892,VNKA01001886.1,1,1251,7.98882e-06,155819535,0.995055
D.birchii,156593892,VNKA01001385.1,1,1250,7.98243e-06,155820785,0.995063
D.birchii,156593892,VNKA01007542.1,1,1249,7.97605e-06,155822034,0.995071
D.birchii,156593892,VNKA01007303.1,1,1249,7.97605e-06,155823283,0.995079
D.birchii,156593892,VNKA01006978.1,1,1249,7.97605e-06,155824532,0.995087
D.birchii,156593892,VNKA01005580.1,1,1249,7.97605e-06,155825781,0.995095
D.birchii,156593892,VNKA01004704.1,1,1249,7.97605e-06,155827030,0.995103
D.birchii,156593892,VNKA01006990.1,1,1248,7.96966e-06,155828278,0.995111
D.birchii,156593892,VNKA01006917.1,1,1248,7.96966e-06,155829526,0.995119
D.birchii,156593892,VNKA01006376.1,1,1248,7.96966e-06,155830774,0.995127
D.birchii,156593892,VNKA01002510.1,1,1248,7.96966e-06,155832022,0.995135
D.birchii,156593892,VNKA01001765.1,1,1248,7.96966e-06,155833270,0.995143
D.birchii,156593892,VNKA01002320.1,1,1247,7.96327e-06,155834517,0.995151
D.birchii,156593892,VNKA01005199.1,1,1246,7.95689e-06,155835763,0.995159
D.birchii,156593892,VNKA01002587.1,1,1246,7.95689e-06,155837009,0.995167
D.birchii,156593892,VNKA01001693.1,1,1246,7.95689e-06,155838255,0.995175
D.birchii,156593892,VNKA01004168.1,1,1245,7.9505e-06,155839500,0.995182
D.birchii,156593892,VNKA01004087.1,1,1245,7.9505e-06,155840745,0.99519
D.birchii,156593892,VNKA01003331.1,1,1245,7.9505e-06,155841990,0.995198
D.birchii,156593892,VNKA01003255.1,1,1245,7.9505e-06,155843235,0.995206
D.birchii,156593892,VNKA01005581.1,1,1244,7.94412e-06,155844479,0.995214
D.birchii,156593892,VNKA01000149.1,1,1244,7.94412e-06,155845723,0.995222
D.birchii,156593892,VNKA01003536.1,1,1243,7.93773e-06,155846966,0.99523
D.birchii,156593892,VNKA01002926.1,1,1243,7.93773e-06,155848209,0.995238
D.birchii,156593892,VNKA01000528.1,1,1243,7.93773e-06,155849452,0.995246
D.birchii,156593892,VNKA01000956.1,1,1241,7.92496e-06,155850693,0.995254
D.birchii,156593892,VNKA01006141.1,1,1239,7.91219e-06,155851932,0.995262
D.birchii,156593892,VNKA01005052.1,1,1239,7.91219e-06,155853171,0.99527
D.birchii,156593892,VNKA01004135.1,1,1239,7.91219e-06,155854410,0.995278
D.birchii,156593892,VNKA01005671.1,1,1238,7.9058e-06,155855648,0.995286
D.birchii,156593892,VNKA01004683.1,1,1238,7.9058e-06,155856886,0.995294
D.birchii,156593892,VNKA01003732.1,1,1238,7.9058e-06,155858124,0.995301
D.birchii,156593892,VNKA01005777.1,1,1237,7.89941e-06,155859361,0.995309
D.birchii,156593892,VNKA01000755.1,1,1237,7.89941e-06,155860598,0.995317
D.birchii,156593892,VNKA01000140.1,1,1237,7.89941e-06,155861835,0.995325
D.birchii,156593892,VNKA01000753.1,1,1236,7.89303e-06,155863071,0.995333
D.birchii,156593892,VNKA01007034.1,1,1235,7.88664e-06,155864306,0.995341
D.birchii,156593892,VNKA01003452.1,1,1235,7.88664e-06,155865541,0.995349
D.birchii,156593892,VNKA01003232.1,1,1235,7.88664e-06,155866776,0.995357
D.birchii,156593892,VNKA01003221.1,1,1235,7.88664e-06,155868011,0.995365
D.birchii,156593892,VNKA01002408.1,1,1235,7.88664e-06,155869246,0.995372
D.birchii,156593892,VNKA01000361.1,1,1235,7.88664e-06,155870481,0.99538
D.birchii,156593892,VNKA01007441.1,1,1234,7.88026e-06,155871715,0.995388
D.birchii,156593892,VNKA01006531.1,1,1234,7.88026e-06,155872949,0.995396
D.birchii,156593892,VNKA01005764.1,1,1234,7.88026e-06,155874183,0.995404
D.birchii,156593892,VNKA01004592.1,1,1234,7.88026e-06,155875417,0.995412
D.birchii,156593892,VNKA01002191.1,1,1234,7.88026e-06,155876651,0.99542
D.birchii,156593892,VNKA01007252.1,1,1233,7.87387e-06,155877884,0.995428
D.birchii,156593892,VNKA01005540.1,1,1233,7.87387e-06,155879117,0.995435
D.birchii,156593892,VNKA01005455.1,1,1233,7.87387e-06,155880350,0.995443
D.birchii,156593892,VNKA01004607.1,1,1233,7.87387e-06,155881583,0.995451
D.birchii,156593892,VNKA01004281.1,1,1233,7.87387e-06,155882816,0.995459
D.birchii,156593892,VNKA01000444.1,1,1233,7.87387e-06,155884049,0.995467
D.birchii,156593892,VNKA01003371.1,1,1232,7.86748e-06,155885281,0.995475
D.birchii,156593892,VNKA01003332.1,1,1231,7.8611e-06,155886512,0.995483
D.birchii,156593892,VNKA01002738.1,1,1230,7.85471e-06,155887742,0.995491
D.birchii,156593892,VNKA01006288.1,1,1229,7.84833e-06,155888971,0.995498
D.birchii,156593892,VNKA01005586.1,1,1229,7.84833e-06,155890200,0.995506
D.birchii,156593892,VNKA01005508.1,1,1229,7.84833e-06,155891429,0.995514
D.birchii,156593892,VNKA01002911.1,1,1229,7.84833e-06,155892658,0.995522
D.birchii,156593892,VNKA01005529.1,1,1228,7.84194e-06,155893886,0.99553
D.birchii,156593892,VNKA01004984.1,1,1228,7.84194e-06,155895114,0.995538
D.birchii,156593892,VNKA01006458.1,1,1227,7.83555e-06,155896341,0.995545
D.birchii,156593892,VNKA01002927.1,1,1227,7.83555e-06,155897568,0.995553
D.birchii,156593892,VNKA01006326.1,1,1226,7.82917e-06,155898794,0.995561
D.birchii,156593892,VNKA01006660.1,1,1225,7.82278e-06,155900019,0.995569
D.birchii,156593892,VNKA01004289.1,1,1225,7.82278e-06,155901244,0.995577
D.birchii,156593892,VNKA01003954.1,1,1225,7.82278e-06,155902469,0.995585
D.birchii,156593892,VNKA01000493.1,1,1225,7.82278e-06,155903694,0.995592
D.birchii,156593892,VNKA01006946.1,1,1224,7.8164e-06,155904918,0.9956
D.birchii,156593892,VNKA01006643.1,1,1224,7.8164e-06,155906142,0.995608
D.birchii,156593892,VNKA01005442.1,1,1224,7.8164e-06,155907366,0.995616
D.birchii,156593892,VNKA01003476.1,1,1224,7.8164e-06,155908590,0.995624
D.birchii,156593892,VNKA01003468.1,1,1224,7.8164e-06,155909814,0.995632
D.birchii,156593892,VNKA01002262.1,1,1224,7.8164e-06,155911038,0.995639
D.birchii,156593892,VNKA01005990.1,1,1223,7.81001e-06,155912261,0.995647
D.birchii,156593892,VNKA01003968.1,1,1223,7.81001e-06,155913484,0.995655
D.birchii,156593892,VNKA01002481.1,1,1223,7.81001e-06,155914707,0.995663
D.birchii,156593892,VNKA01000700.1,1,1223,7.81001e-06,155915930,0.995671
D.birchii,156593892,VNKA01000589.1,1,1223,7.81001e-06,155917153,0.995678
D.birchii,156593892,VNKA01005321.1,1,1222,7.80362e-06,155918375,0.995686
D.birchii,156593892,VNKA01003579.1,1,1222,7.80362e-06,155919597,0.995694
D.birchii,156593892,VNKA01001897.1,1,1222,7.80362e-06,155920819,0.995702
D.birchii,156593892,VNKA01007011.1,1,1221,7.79724e-06,155922040,0.99571
D.birchii,156593892,VNKA01006652.1,1,1221,7.79724e-06,155923261,0.995717
D.birchii,156593892,VNKA01005875.1,1,1221,7.79724e-06,155924482,0.995725
D.birchii,156593892,VNKA01001809.1,1,1221,7.79724e-06,155925703,0.995733
D.birchii,156593892,VNKA01001799.1,1,1221,7.79724e-06,155926924,0.995741
D.birchii,156593892,VNKA01001465.1,1,1221,7.79724e-06,155928145,0.995749
D.birchii,156593892,VNKA01000346.1,1,1221,7.79724e-06,155929366,0.995756
D.birchii,156593892,VNKA01006746.1,1,1220,7.79085e-06,155930586,0.995764
D.birchii,156593892,VNKA01005110.1,1,1220,7.79085e-06,155931806,0.995772
D.birchii,156593892,VNKA01005834.1,1,1219,7.78447e-06,155933025,0.99578
D.birchii,156593892,VNKA01005211.1,1,1219,7.78447e-06,155934244,0.995788
D.birchii,156593892,VNKA01006554.1,1,1218,7.77808e-06,155935462,0.995795
D.birchii,156593892,VNKA01005146.1,1,1218,7.77808e-06,155936680,0.995803
D.birchii,156593892,VNKA01002099.1,1,1217,7.7717e-06,155937897,0.995811
D.birchii,156593892,VNKA01001669.1,1,1217,7.7717e-06,155939114,0.995819
D.birchii,156593892,VNKA01001265.1,1,1217,7.7717e-06,155940331,0.995826
D.birchii,156593892,VNKA01000917.1,1,1217,7.7717e-06,155941548,0.995834
D.birchii,156593892,VNKA01000227.1,1,1217,7.7717e-06,155942765,0.995842
D.birchii,156593892,VNKA01004598.1,1,1216,7.76531e-06,155943981,0.99585
D.birchii,156593892,VNKA01006743.1,1,1215,7.75892e-06,155945196,0.995857
D.birchii,156593892,VNKA01003728.1,1,1215,7.75892e-06,155946411,0.995865
D.birchii,156593892,VNKA01001911.1,1,1215,7.75892e-06,155947626,0.995873
D.birchii,156593892,VNKA01000670.1,1,1215,7.75892e-06,155948841,0.995881
D.birchii,156593892,VNKA01000394.1,1,1215,7.75892e-06,155950056,0.995888
D.birchii,156593892,VNKA01006035.1,1,1214,7.75254e-06,155951270,0.995896
D.birchii,156593892,VNKA01003563.1,1,1214,7.75254e-06,155952484,0.995904
D.birchii,156593892,VNKA01002775.1,1,1214,7.75254e-06,155953698,0.995912
D.birchii,156593892,VNKA01004942.1,1,1212,7.73977e-06,155954910,0.995919
D.birchii,156593892,VNKA01004679.1,1,1212,7.73977e-06,155956122,0.995927
D.birchii,156593892,VNKA01003315.1,1,1212,7.73977e-06,155957334,0.995935
D.birchii,156593892,VNKA01002511.1,1,1212,7.73977e-06,155958546,0.995943
D.birchii,156593892,VNKA01006730.1,1,1211,7.73338e-06,155959757,0.99595
D.birchii,156593892,VNKA01005531.1,1,1211,7.73338e-06,155960968,0.995958
D.birchii,156593892,VNKA01003457.1,1,1211,7.73338e-06,155962179,0.995966
D.birchii,156593892,VNKA01005196.1,1,1210,7.72699e-06,155963389,0.995974
D.birchii,156593892,VNKA01000138.1,1,1210,7.72699e-06,155964599,0.995981
D.birchii,156593892,VNKA01006796.1,1,1209,7.72061e-06,155965808,0.995989
D.birchii,156593892,VNKA01003698.1,1,1209,7.72061e-06,155967017,0.995997
D.birchii,156593892,VNKA01002319.1,1,1209,7.72061e-06,155968226,0.996005
D.birchii,156593892,VNKA01002708.1,1,1208,7.71422e-06,155969434,0.996012
D.birchii,156593892,VNKA01007513.1,1,1207,7.70784e-06,155970641,0.99602
D.birchii,156593892,VNKA01006284.1,1,1207,7.70784e-06,155971848,0.996028
D.birchii,156593892,VNKA01004476.1,1,1207,7.70784e-06,155973055,0.996035
D.birchii,156593892,VNKA01002940.1,1,1207,7.70784e-06,155974262,0.996043
D.birchii,156593892,VNKA01000961.1,1,1207,7.70784e-06,155975469,0.996051
D.birchii,156593892,VNKA01000900.1,1,1206,7.70145e-06,155976675,0.996058
D.birchii,156593892,VNKA01006930.1,1,1205,7.69506e-06,155977880,0.996066
D.birchii,156593892,VNKA01003501.1,1,1205,7.69506e-06,155979085,0.996074
D.birchii,156593892,VNKA01003292.1,1,1205,7.69506e-06,155980290,0.996082
D.birchii,156593892,VNKA01002683.1,1,1205,7.69506e-06,155981495,0.996089
D.birchii,156593892,VNKA01000666.1,1,1205,7.69506e-06,155982700,0.996097
D.birchii,156593892,VNKA01003336.1,1,1204,7.68868e-06,155983904,0.996105
D.birchii,156593892,VNKA01001745.1,1,1204,7.68868e-06,155985108,0.996112
D.birchii,156593892,VNKA01007442.1,1,1203,7.68229e-06,155986311,0.99612
D.birchii,156593892,VNKA01007077.1,1,1203,7.68229e-06,155987514,0.996128
D.birchii,156593892,VNKA01000440.1,1,1203,7.68229e-06,155988717,0.996135
D.birchii,156593892,VNKA01002908.1,1,1202,7.67591e-06,155989919,0.996143
D.birchii,156593892,VNKA01000652.1,1,1202,7.67591e-06,155991121,0.996151
D.birchii,156593892,VNKA01006662.1,1,1201,7.66952e-06,155992322,0.996158
D.birchii,156593892,VNKA01006413.1,1,1201,7.66952e-06,155993523,0.996166
D.birchii,156593892,VNKA01005458.1,1,1201,7.66952e-06,155994724,0.996174
D.birchii,156593892,VNKA01004357.1,1,1201,7.66952e-06,155995925,0.996181
D.birchii,156593892,VNKA01004283.1,1,1201,7.66952e-06,155997126,0.996189
D.birchii,156593892,VNKA01004265.1,1,1201,7.66952e-06,155998327,0.996197
D.birchii,156593892,VNKA01004902.1,1,1200,7.66313e-06,155999527,0.996204
D.birchii,156593892,VNKA01003748.1,1,1200,7.66313e-06,156000727,0.996212
D.birchii,156593892,VNKA01002101.1,1,1200,7.66313e-06,156001927,0.99622
D.birchii,156593892,VNKA01007351.1,1,1198,7.65036e-06,156003125,0.996227
D.birchii,156593892,VNKA01004790.1,1,1198,7.65036e-06,156004323,0.996235
D.birchii,156593892,VNKA01002290.1,1,1198,7.65036e-06,156005521,0.996243
D.birchii,156593892,VNKA01000600.1,1,1198,7.65036e-06,156006719,0.99625
D.birchii,156593892,VNKA01005058.1,1,1197,7.64398e-06,156007916,0.996258
D.birchii,156593892,VNKA01007190.1,1,1196,7.63759e-06,156009112,0.996266
D.birchii,156593892,VNKA01005819.1,1,1196,7.63759e-06,156010308,0.996273
D.birchii,156593892,VNKA01002138.1,1,1196,7.63759e-06,156011504,0.996281
D.birchii,156593892,VNKA01003291.1,1,1195,7.6312e-06,156012699,0.996289
D.birchii,156593892,VNKA01003026.1,1,1195,7.6312e-06,156013894,0.996296
D.birchii,156593892,VNKA01002746.1,1,1195,7.6312e-06,156015089,0.996304
D.birchii,156593892,VNKA01007562.1,1,1194,7.62482e-06,156016283,0.996311
D.birchii,156593892,VNKA01004555.1,1,1194,7.62482e-06,156017477,0.996319
D.birchii,156593892,VNKA01001595.1,1,1193,7.61843e-06,156018670,0.996327
D.birchii,156593892,VNKA01006618.1,1,1192,7.61205e-06,156019862,0.996334
D.birchii,156593892,VNKA01006120.1,1,1192,7.61205e-06,156021054,0.996342
D.birchii,156593892,VNKA01002512.1,1,1192,7.61205e-06,156022246,0.99635
D.birchii,156593892,VNKA01001102.1,1,1192,7.61205e-06,156023438,0.996357
D.birchii,156593892,VNKA01006102.1,1,1191,7.60566e-06,156024629,0.996365
D.birchii,156593892,VNKA01005185.1,1,1191,7.60566e-06,156025820,0.996372
D.birchii,156593892,VNKA01002316.1,1,1191,7.60566e-06,156027011,0.99638
D.birchii,156593892,VNKA01005924.1,1,1190,7.59927e-06,156028201,0.996388
D.birchii,156593892,VNKA01002906.1,1,1190,7.59927e-06,156029391,0.996395
D.birchii,156593892,VNKA01002817.1,1,1190,7.59927e-06,156030581,0.996403
D.birchii,156593892,VNKA01001081.1,1,1190,7.59927e-06,156031771,0.99641
D.birchii,156593892,VNKA01003580.1,1,1189,7.59289e-06,156032960,0.996418
D.birchii,156593892,VNKA01005926.1,1,1188,7.5865e-06,156034148,0.996426
D.birchii,156593892,VNKA01005658.1,1,1188,7.5865e-06,156035336,0.996433
D.birchii,156593892,VNKA01005329.1,1,1188,7.5865e-06,156036524,0.996441
D.birchii,156593892,VNKA01004941.1,1,1188,7.5865e-06,156037712,0.996448
D.birchii,156593892,VNKA01004447.1,1,1188,7.5865e-06,156038900,0.996456
D.birchii,156593892,VNKA01002715.1,1,1188,7.5865e-06,156040088,0.996463
D.birchii,156593892,VNKA01005044.1,1,1187,7.58012e-06,156041275,0.996471
D.birchii,156593892,VNKA01004616.1,1,1187,7.58012e-06,156042462,0.996479
D.birchii,156593892,VNKA01004274.1,1,1187,7.58012e-06,156043649,0.996486
D.birchii,156593892,VNKA01000177.1,1,1187,7.58012e-06,156044836,0.996494
D.birchii,156593892,VNKA01001033.1,1,1186,7.57373e-06,156046022,0.996501
D.birchii,156593892,VNKA01000984.1,1,1186,7.57373e-06,156047208,0.996509
D.birchii,156593892,VNKA01006208.1,1,1185,7.56734e-06,156048393,0.996516
D.birchii,156593892,VNKA01004127.1,1,1185,7.56734e-06,156049578,0.996524
D.birchii,156593892,VNKA01003485.1,1,1185,7.56734e-06,156050763,0.996532
D.birchii,156593892,VNKA01006360.1,1,1184,7.56096e-06,156051947,0.996539
D.birchii,156593892,VNKA01001506.1,1,1184,7.56096e-06,156053131,0.996547
D.birchii,156593892,VNKA01000348.1,1,1184,7.56096e-06,156054315,0.996554
D.birchii,156593892,VNKA01005962.1,1,1183,7.55457e-06,156055498,0.996562
D.birchii,156593892,VNKA01004529.1,1,1183,7.55457e-06,156056681,0.996569
D.birchii,156593892,VNKA01001666.1,1,1183,7.55457e-06,156057864,0.996577
D.birchii,156593892,VNKA01000708.1,1,1183,7.55457e-06,156059047,0.996585
D.birchii,156593892,VNKA01005210.1,1,1182,7.54819e-06,156060229,0.996592
D.birchii,156593892,VNKA01003502.1,1,1182,7.54819e-06,156061411,0.9966
D.birchii,156593892,VNKA01001792.1,1,1182,7.54819e-06,156062593,0.996607
D.birchii,156593892,VNKA01001539.1,1,1182,7.54819e-06,156063775,0.996615
D.birchii,156593892,VNKA01001264.1,1,1182,7.54819e-06,156064957,0.996622
D.birchii,156593892,VNKA01001004.1,1,1182,7.54819e-06,156066139,0.99663
D.birchii,156593892,VNKA01006223.1,1,1181,7.5418e-06,156067320,0.996637
D.birchii,156593892,VNKA01002251.1,1,1181,7.5418e-06,156068501,0.996645
D.birchii,156593892,VNKA01004792.1,1,1180,7.53542e-06,156069681,0.996652
D.birchii,156593892,VNKA01003779.1,1,1180,7.53542e-06,156070861,0.99666
D.birchii,156593892,VNKA01002258.1,1,1180,7.53542e-06,156072041,0.996667
D.birchii,156593892,VNKA01006688.1,1,1179,7.52903e-06,156073220,0.996675
D.birchii,156593892,VNKA01003596.1,1,1179,7.52903e-06,156074399,0.996683
D.birchii,156593892,VNKA01001482.1,1,1179,7.52903e-06,156075578,0.99669
D.birchii,156593892,VNKA01006211.1,1,1178,7.52264e-06,156076756,0.996698
D.birchii,156593892,VNKA01005882.1,1,1178,7.52264e-06,156077934,0.996705
D.birchii,156593892,VNKA01004325.1,1,1178,7.52264e-06,156079112,0.996713
D.birchii,156593892,VNKA01003167.1,1,1178,7.52264e-06,156080290,0.99672
D.birchii,156593892,VNKA01005126.1,1,1176,7.50987e-06,156081466,0.996728
D.birchii,156593892,VNKA01003228.1,1,1176,7.50987e-06,156082642,0.996735
D.birchii,156593892,VNKA01002479.1,1,1176,7.50987e-06,156083818,0.996743
D.birchii,156593892,VNKA01000555.1,1,1176,7.50987e-06,156084994,0.99675
D.birchii,156593892,VNKA01005690.1,1,1175,7.50349e-06,156086169,0.996758
D.birchii,156593892,VNKA01005050.1,1,1175,7.50349e-06,156087344,0.996765
D.birchii,156593892,VNKA01002252.1,1,1175,7.50349e-06,156088519,0.996773
D.birchii,156593892,VNKA01001802.1,1,1175,7.50349e-06,156089694,0.99678
D.birchii,156593892,VNKA01006933.1,1,1174,7.4971e-06,156090868,0.996788
D.birchii,156593892,VNKA01004347.1,1,1174,7.4971e-06,156092042,0.996795
D.birchii,156593892,VNKA01002874.1,1,1173,7.49071e-06,156093215,0.996803
D.birchii,156593892,VNKA01002692.1,1,1173,7.49071e-06,156094388,0.99681
D.birchii,156593892,VNKA01006679.1,1,1172,7.48433e-06,156095560,0.996818
D.birchii,156593892,VNKA01004096.1,1,1172,7.48433e-06,156096732,0.996825
D.birchii,156593892,VNKA01003417.1,1,1172,7.48433e-06,156097904,0.996833
D.birchii,156593892,VNKA01000235.1,1,1172,7.48433e-06,156099076,0.99684
D.birchii,156593892,VNKA01005615.1,1,1171,7.47794e-06,156100247,0.996848
D.birchii,156593892,VNKA01004613.1,1,1171,7.47794e-06,156101418,0.996855
D.birchii,156593892,VNKA01007238.1,1,1170,7.47156e-06,156102588,0.996863
D.birchii,156593892,VNKA01005232.1,1,1170,7.47156e-06,156103758,0.99687
D.birchii,156593892,VNKA01004783.1,1,1170,7.47156e-06,156104928,0.996878
D.birchii,156593892,VNKA01003224.1,1,1170,7.47156e-06,156106098,0.996885
D.birchii,156593892,VNKA01001625.1,1,1170,7.47156e-06,156107268,0.996892
D.birchii,156593892,VNKA01003180.1,1,1169,7.46517e-06,156108437,0.9969
D.birchii,156593892,VNKA01002156.1,1,1169,7.46517e-06,156109606,0.996907
D.birchii,156593892,VNKA01002127.1,1,1169,7.46517e-06,156110775,0.996915
D.birchii,156593892,VNKA01001417.1,1,1169,7.46517e-06,156111944,0.996922
D.birchii,156593892,VNKA01000928.1,1,1169,7.46517e-06,156113113,0.99693
D.birchii,156593892,VNKA01000602.1,1,1169,7.46517e-06,156114282,0.996937
D.birchii,156593892,VNKA01000893.1,1,1168,7.45878e-06,156115450,0.996945
D.birchii,156593892,VNKA01005930.1,1,1167,7.4524e-06,156116617,0.996952
D.birchii,156593892,VNKA01006971.1,1,1166,7.44601e-06,156117783,0.99696
D.birchii,156593892,VNKA01006861.1,1,1166,7.44601e-06,156118949,0.996967
D.birchii,156593892,VNKA01005861.1,1,1166,7.44601e-06,156120115,0.996974
D.birchii,156593892,VNKA01003971.1,1,1166,7.44601e-06,156121281,0.996982
D.birchii,156593892,VNKA01003278.1,1,1164,7.43324e-06,156122445,0.996989
D.birchii,156593892,VNKA01002750.1,1,1164,7.43324e-06,156123609,0.996997
D.birchii,156593892,VNKA01007033.1,1,1163,7.42685e-06,156124772,0.997004
D.birchii,156593892,VNKA01004499.1,1,1163,7.42685e-06,156125935,0.997012
D.birchii,156593892,VNKA01001423.1,1,1163,7.42685e-06,156127098,0.997019
D.birchii,156593892,VNKA01005593.1,1,1162,7.42047e-06,156128260,0.997026
D.birchii,156593892,VNKA01002634.1,1,1162,7.42047e-06,156129422,0.997034
D.birchii,156593892,VNKA01006752.1,1,1161,7.41408e-06,156130583,0.997041
D.birchii,156593892,VNKA01006631.1,1,1161,7.41408e-06,156131744,0.997049
D.birchii,156593892,VNKA01005995.1,1,1161,7.41408e-06,156132905,0.997056
D.birchii,156593892,VNKA01003828.1,1,1161,7.41408e-06,156134066,0.997064
D.birchii,156593892,VNKA01003335.1,1,1161,7.41408e-06,156135227,0.997071
D.birchii,156593892,VNKA01002740.1,1,1161,7.41408e-06,156136388,0.997078
D.birchii,156593892,VNKA01002352.1,1,1161,7.41408e-06,156137549,0.997086
D.birchii,156593892,VNKA01003827.1,1,1160,7.4077e-06,156138709,0.997093
D.birchii,156593892,VNKA01003133.1,1,1160,7.4077e-06,156139869,0.997101
D.birchii,156593892,VNKA01000611.1,1,1160,7.4077e-06,156141029,0.997108
D.birchii,156593892,VNKA01000285.1,1,1160,7.4077e-06,156142189,0.997115
D.birchii,156593892,VNKA01004433.1,1,1159,7.40131e-06,156143348,0.997123
D.birchii,156593892,VNKA01003483.1,1,1159,7.40131e-06,156144507,0.99713
D.birchii,156593892,VNKA01006993.1,1,1158,7.39492e-06,156145665,0.997138
D.birchii,156593892,VNKA01006641.1,1,1158,7.39492e-06,156146823,0.997145
D.birchii,156593892,VNKA01006104.1,1,1158,7.39492e-06,156147981,0.997152
D.birchii,156593892,VNKA01001487.1,1,1158,7.39492e-06,156149139,0.99716
D.birchii,156593892,VNKA01005231.1,1,1157,7.38854e-06,156150296,0.997167
D.birchii,156593892,VNKA01002244.1,1,1157,7.38854e-06,156151453,0.997175
D.birchii,156593892,VNKA01005694.1,1,1156,7.38215e-06,156152609,0.997182
D.birchii,156593892,VNKA01004464.1,1,1156,7.38215e-06,156153765,0.997189
D.birchii,156593892,VNKA01003132.1,1,1156,7.38215e-06,156154921,0.997197
D.birchii,156593892,VNKA01003043.1,1,1156,7.38215e-06,156156077,0.997204
D.birchii,156593892,VNKA01006617.1,1,1154,7.36938e-06,156157231,0.997212
D.birchii,156593892,VNKA01005092.1,1,1154,7.36938e-06,156158385,0.997219
D.birchii,156593892,VNKA01006950.1,1,1153,7.36299e-06,156159538,0.997226
D.birchii,156593892,VNKA01006021.1,1,1153,7.36299e-06,156160691,0.997234
D.birchii,156593892,VNKA01005970.1,1,1153,7.36299e-06,156161844,0.997241
D.birchii,156593892,VNKA01004553.1,1,1153,7.36299e-06,156162997,0.997248
D.birchii,156593892,VNKA01003028.1,1,1153,7.36299e-06,156164150,0.997256
D.birchii,156593892,VNKA01007265.1,1,1152,7.35661e-06,156165302,0.997263
D.birchii,156593892,VNKA01007189.1,1,1152,7.35661e-06,156166454,0.99727
D.birchii,156593892,VNKA01004868.1,1,1152,7.35661e-06,156167606,0.997278
D.birchii,156593892,VNKA01006853.1,1,1151,7.35022e-06,156168757,0.997285
D.birchii,156593892,VNKA01005285.1,1,1151,7.35022e-06,156169908,0.997292
D.birchii,156593892,VNKA01001473.1,1,1150,7.34384e-06,156171058,0.9973
D.birchii,156593892,VNKA01004000.1,1,1149,7.33745e-06,156172207,0.997307
D.birchii,156593892,VNKA01006375.1,1,1148,7.33106e-06,156173355,0.997314
D.birchii,156593892,VNKA01005820.1,1,1148,7.33106e-06,156174503,0.997322
D.birchii,156593892,VNKA01003830.1,1,1148,7.33106e-06,156175651,0.997329
D.birchii,156593892,VNKA01003220.1,1,1148,7.33106e-06,156176799,0.997336
D.birchii,156593892,VNKA01001851.1,1,1148,7.33106e-06,156177947,0.997344
D.birchii,156593892,VNKA01006959.1,1,1146,7.31829e-06,156179093,0.997351
D.birchii,156593892,VNKA01006074.1,1,1146,7.31829e-06,156180239,0.997358
D.birchii,156593892,VNKA01001408.1,1,1146,7.31829e-06,156181385,0.997366
D.birchii,156593892,VNKA01007266.1,1,1145,7.31191e-06,156182530,0.997373
D.birchii,156593892,VNKA01003364.1,1,1145,7.31191e-06,156183675,0.99738
D.birchii,156593892,VNKA01002131.1,1,1145,7.31191e-06,156184820,0.997388
D.birchii,156593892,VNKA01001388.1,1,1145,7.31191e-06,156185965,0.997395
D.birchii,156593892,VNKA01000573.1,1,1145,7.31191e-06,156187110,0.997402
D.birchii,156593892,VNKA01004965.1,1,1144,7.30552e-06,156188254,0.99741
D.birchii,156593892,VNKA01002122.1,1,1144,7.30552e-06,156189398,0.997417
D.birchii,156593892,VNKA01000607.1,1,1144,7.30552e-06,156190542,0.997424
D.birchii,156593892,VNKA01000105.1,1,1144,7.30552e-06,156191686,0.997432
D.birchii,156593892,VNKA01004561.1,1,1143,7.29914e-06,156192829,0.997439
D.birchii,156593892,VNKA01002917.1,1,1143,7.29914e-06,156193972,0.997446
D.birchii,156593892,VNKA01006996.1,1,1142,7.29275e-06,156195114,0.997453
D.birchii,156593892,VNKA01004461.1,1,1142,7.29275e-06,156196256,0.997461
D.birchii,156593892,VNKA01004321.1,1,1142,7.29275e-06,156197398,0.997468
D.birchii,156593892,VNKA01003537.1,1,1142,7.29275e-06,156198540,0.997475
D.birchii,156593892,VNKA01002263.1,1,1142,7.29275e-06,156199682,0.997483
D.birchii,156593892,VNKA01006204.1,1,1141,7.28636e-06,156200823,0.99749
D.birchii,156593892,VNKA01005996.1,1,1141,7.28636e-06,156201964,0.997497
D.birchii,156593892,VNKA01003390.1,1,1141,7.28636e-06,156203105,0.997504
D.birchii,156593892,VNKA01000761.1,1,1141,7.28636e-06,156204246,0.997512
D.birchii,156593892,VNKA01000661.1,1,1141,7.28636e-06,156205387,0.997519
D.birchii,156593892,VNKA01005006.1,1,1140,7.27998e-06,156206527,0.997526
D.birchii,156593892,VNKA01004589.1,1,1140,7.27998e-06,156207667,0.997534
D.birchii,156593892,VNKA01003795.1,1,1140,7.27998e-06,156208807,0.997541
D.birchii,156593892,VNKA01003020.1,1,1140,7.27998e-06,156209947,0.997548
D.birchii,156593892,VNKA01004980.1,1,1139,7.27359e-06,156211086,0.997555
D.birchii,156593892,VNKA01000417.1,1,1139,7.27359e-06,156212225,0.997563
D.birchii,156593892,VNKA01006637.1,1,1138,7.26721e-06,156213363,0.99757
D.birchii,156593892,VNKA01005420.1,1,1138,7.26721e-06,156214501,0.997577
D.birchii,156593892,VNKA01004344.1,1,1138,7.26721e-06,156215639,0.997584
D.birchii,156593892,VNKA01001657.1,1,1138,7.26721e-06,156216777,0.997592
D.birchii,156593892,VNKA01000991.1,1,1138,7.26721e-06,156217915,0.997599
D.birchii,156593892,VNKA01007364.1,1,1137,7.26082e-06,156219052,0.997606
D.birchii,156593892,VNKA01006826.1,1,1137,7.26082e-06,156220189,0.997614
D.birchii,156593892,VNKA01002780.1,1,1137,7.26082e-06,156221326,0.997621
D.birchii,156593892,VNKA01000399.1,1,1137,7.26082e-06,156222463,0.997628
D.birchii,156593892,VNKA01000185.1,1,1137,7.26082e-06,156223600,0.997635
D.birchii,156593892,VNKA01006846.1,1,1136,7.25443e-06,156224736,0.997643
D.birchii,156593892,VNKA01003921.1,1,1136,7.25443e-06,156225872,0.99765
D.birchii,156593892,VNKA01004279.1,1,1135,7.24805e-06,156227007,0.997657
D.birchii,156593892,VNKA01001104.1,1,1135,7.24805e-06,156228142,0.997664
D.birchii,156593892,VNKA01000952.1,1,1135,7.24805e-06,156229277,0.997672
D.birchii,156593892,VNKA01005678.1,1,1134,7.24166e-06,156230411,0.997679
D.birchii,156593892,VNKA01004286.1,1,1134,7.24166e-06,156231545,0.997686
D.birchii,156593892,VNKA01005443.1,1,1133,7.23528e-06,156232678,0.997693
D.birchii,156593892,VNKA01004092.1,1,1133,7.23528e-06,156233811,0.997701
D.birchii,156593892,VNKA01003137.1,1,1133,7.23528e-06,156234944,0.997708
D.birchii,156593892,VNKA01004503.1,1,1132,7.22889e-06,156236076,0.997715
D.birchii,156593892,VNKA01002787.1,1,1131,7.2225e-06,156237207,0.997722
D.birchii,156593892,VNKA01001823.1,1,1131,7.2225e-06,156238338,0.997729
D.birchii,156593892,VNKA01001233.1,1,1130,7.21612e-06,156239468,0.997737
D.birchii,156593892,VNKA01007504.1,1,1129,7.20973e-06,156240597,0.997744
D.birchii,156593892,VNKA01004554.1,1,1129,7.20973e-06,156241726,0.997751
D.birchii,156593892,VNKA01000415.1,1,1129,7.20973e-06,156242855,0.997758
D.birchii,156593892,VNKA01007187.1,1,1127,7.19696e-06,156243982,0.997765
D.birchii,156593892,VNKA01006509.1,1,1127,7.19696e-06,156245109,0.997773
D.birchii,156593892,VNKA01006267.1,1,1127,7.19696e-06,156246236,0.99778
D.birchii,156593892,VNKA01005823.1,1,1127,7.19696e-06,156247363,0.997787
D.birchii,156593892,VNKA01001885.1,1,1127,7.19696e-06,156248490,0.997794
D.birchii,156593892,VNKA01006482.1,1,1126,7.19057e-06,156249616,0.997801
D.birchii,156593892,VNKA01005084.1,1,1126,7.19057e-06,156250742,0.997809
D.birchii,156593892,VNKA01003538.1,1,1126,7.19057e-06,156251868,0.997816
D.birchii,156593892,VNKA01003283.1,1,1126,7.19057e-06,156252994,0.997823
D.birchii,156593892,VNKA01002478.1,1,1126,7.19057e-06,156254120,0.99783
D.birchii,156593892,VNKA01001853.1,1,1126,7.19057e-06,156255246,0.997837
D.birchii,156593892,VNKA01004637.1,1,1125,7.18419e-06,156256371,0.997845
D.birchii,156593892,VNKA01001228.1,1,1125,7.18419e-06,156257496,0.997852
D.birchii,156593892,VNKA01001058.1,1,1125,7.18419e-06,156258621,0.997859
D.birchii,156593892,VNKA01000674.1,1,1125,7.18419e-06,156259746,0.997866
D.birchii,156593892,VNKA01004641.1,1,1124,7.1778e-06,156260870,0.997873
D.birchii,156593892,VNKA01002459.1,1,1124,7.1778e-06,156261994,0.997881
D.birchii,156593892,VNKA01001483.1,1,1124,7.1778e-06,156263118,0.997888
D.birchii,156593892,VNKA01001142.1,1,1124,7.1778e-06,156264242,0.997895
D.birchii,156593892,VNKA01000345.1,1,1124,7.1778e-06,156265366,0.997902
D.birchii,156593892,VNKA01007419.1,1,1123,7.17142e-06,156266489,0.997909
D.birchii,156593892,VNKA01004907.1,1,1123,7.17142e-06,156267612,0.997916
D.birchii,156593892,VNKA01004889.1,1,1123,7.17142e-06,156268735,0.997924
D.birchii,156593892,VNKA01006748.1,1,1122,7.16503e-06,156269857,0.997931
D.birchii,156593892,VNKA01006447.1,1,1122,7.16503e-06,156270979,0.997938
D.birchii,156593892,VNKA01002418.1,1,1121,7.15864e-06,156272100,0.997945
D.birchii,156593892,VNKA01001232.1,1,1121,7.15864e-06,156273221,0.997952
D.birchii,156593892,VNKA01006297.1,1,1120,7.15226e-06,156274341,0.997959
D.birchii,156593892,VNKA01004835.1,1,1120,7.15226e-06,156275461,0.997967
D.birchii,156593892,VNKA01004235.1,1,1120,7.15226e-06,156276581,0.997974
D.birchii,156593892,VNKA01003654.1,1,1120,7.15226e-06,156277701,0.997981
D.birchii,156593892,VNKA01007552.1,1,1119,7.14587e-06,156278820,0.997988
D.birchii,156593892,VNKA01003958.1,1,1118,7.13949e-06,156279938,0.997995
D.birchii,156593892,VNKA01003246.1,1,1118,7.13949e-06,156281056,0.998002
D.birchii,156593892,VNKA01001794.1,1,1118,7.13949e-06,156282174,0.998009
D.birchii,156593892,VNKA01005358.1,1,1117,7.1331e-06,156283291,0.998017
D.birchii,156593892,VNKA01005149.1,1,1117,7.1331e-06,156284408,0.998024
D.birchii,156593892,VNKA01001485.1,1,1117,7.1331e-06,156285525,0.998031
D.birchii,156593892,VNKA01000596.1,1,1117,7.1331e-06,156286642,0.998038
D.birchii,156593892,VNKA01003388.1,1,1116,7.12671e-06,156287758,0.998045
D.birchii,156593892,VNKA01006328.1,1,1115,7.12033e-06,156288873,0.998052
D.birchii,156593892,VNKA01003427.1,1,1115,7.12033e-06,156289988,0.998059
D.birchii,156593892,VNKA01000429.1,1,1115,7.12033e-06,156291103,0.998066
D.birchii,156593892,VNKA01005618.1,1,1114,7.11394e-06,156292217,0.998074
D.birchii,156593892,VNKA01005183.1,1,1114,7.11394e-06,156293331,0.998081
D.birchii,156593892,VNKA01001613.1,1,1114,7.11394e-06,156294445,0.998088
D.birchii,156593892,VNKA01000595.1,1,1114,7.11394e-06,156295559,0.998095
D.birchii,156593892,VNKA01004507.1,1,1113,7.10756e-06,156296672,0.998102
D.birchii,156593892,VNKA01001185.1,1,1113,7.10756e-06,156297785,0.998109
D.birchii,156593892,VNKA01006490.1,1,1112,7.10117e-06,156298897,0.998116
D.birchii,156593892,VNKA01001849.1,1,1112,7.10117e-06,156300009,0.998123
D.birchii,156593892,VNKA01005947.1,1,1111,7.09479e-06,156301120,0.99813
D.birchii,156593892,VNKA01004004.1,1,1111,7.09479e-06,156302231,0.998137
D.birchii,156593892,VNKA01006295.1,1,1110,7.0884e-06,156303341,0.998145
D.birchii,156593892,VNKA01003342.1,1,1110,7.0884e-06,156304451,0.998152
D.birchii,156593892,VNKA01006476.1,1,1109,7.08201e-06,156305560,0.998159
D.birchii,156593892,VNKA01003948.1,1,1109,7.08201e-06,156306669,0.998166
D.birchii,156593892,VNKA01003583.1,1,1109,7.08201e-06,156307778,0.998173
D.birchii,156593892,VNKA01000930.1,1,1109,7.08201e-06,156308887,0.99818
D.birchii,156593892,VNKA01006092.1,1,1108,7.07563e-06,156309995,0.998187
D.birchii,156593892,VNKA01004756.1,1,1108,7.07563e-06,156311103,0.998194
D.birchii,156593892,VNKA01003456.1,1,1108,7.07563e-06,156312211,0.998201
D.birchii,156593892,VNKA01003234.1,1,1108,7.07563e-06,156313319,0.998208
D.birchii,156593892,VNKA01001746.1,1,1108,7.07563e-06,156314427,0.998215
D.birchii,156593892,VNKA01001340.1,1,1108,7.07563e-06,156315535,0.998222
D.birchii,156593892,VNKA01004152.1,1,1107,7.06924e-06,156316642,0.998229
D.birchii,156593892,VNKA01006346.1,1,1106,7.06286e-06,156317748,0.998237
D.birchii,156593892,VNKA01005310.1,1,1106,7.06286e-06,156318854,0.998244
D.birchii,156593892,VNKA01005071.1,1,1106,7.06286e-06,156319960,0.998251
D.birchii,156593892,VNKA01004255.1,1,1106,7.06286e-06,156321066,0.998258
D.birchii,156593892,VNKA01003744.1,1,1105,7.05647e-06,156322171,0.998265
D.birchii,156593892,VNKA01005399.1,1,1104,7.05008e-06,156323275,0.998272
D.birchii,156593892,VNKA01004032.1,1,1104,7.05008e-06,156324379,0.998279
D.birchii,156593892,VNKA01002664.1,1,1104,7.05008e-06,156325483,0.998286
D.birchii,156593892,VNKA01002374.1,1,1104,7.05008e-06,156326587,0.998293
D.birchii,156593892,VNKA01002355.1,1,1104,7.05008e-06,156327691,0.9983
D.birchii,156593892,VNKA01001488.1,1,1104,7.05008e-06,156328795,0.998307
D.birchii,156593892,VNKA01001220.1,1,1104,7.05008e-06,156329899,0.998314
D.birchii,156593892,VNKA01007176.1,1,1103,7.0437e-06,156331002,0.998321
D.birchii,156593892,VNKA01006795.1,1,1103,7.0437e-06,156332105,0.998328
D.birchii,156593892,VNKA01005718.1,1,1103,7.0437e-06,156333208,0.998335
D.birchii,156593892,VNKA01004401.1,1,1103,7.0437e-06,156334311,0.998342
D.birchii,156593892,VNKA01003764.1,1,1103,7.0437e-06,156335414,0.998349
D.birchii,156593892,VNKA01002869.1,1,1102,7.03731e-06,156336516,0.998356
D.birchii,156593892,VNKA01001574.1,1,1102,7.03731e-06,156337618,0.998363
D.birchii,156593892,VNKA01000932.1,1,1102,7.03731e-06,156338720,0.99837
D.birchii,156593892,VNKA01006988.1,1,1101,7.03093e-06,156339821,0.998378
D.birchii,156593892,VNKA01005902.1,1,1101,7.03093e-06,156340922,0.998385
D.birchii,156593892,VNKA01004509.1,1,1101,7.03093e-06,156342023,0.998392
D.birchii,156593892,VNKA01002403.1,1,1101,7.03093e-06,156343124,0.998399
D.birchii,156593892,VNKA01002197.1,1,1101,7.03093e-06,156344225,0.998406
D.birchii,156593892,VNKA01003175.1,1,1100,7.02454e-06,156345325,0.998413
D.birchii,156593892,VNKA01004643.1,1,1099,7.01815e-06,156346424,0.99842
D.birchii,156593892,VNKA01007486.1,1,1098,7.01177e-06,156347522,0.998427
D.birchii,156593892,VNKA01004644.1,1,1098,7.01177e-06,156348620,0.998434
D.birchii,156593892,VNKA01003497.1,1,1098,7.01177e-06,156349718,0.998441
D.birchii,156593892,VNKA01000230.1,1,1098,7.01177e-06,156350816,0.998448
D.birchii,156593892,VNKA01003762.1,1,1097,7.00538e-06,156351913,0.998455
D.birchii,156593892,VNKA01007571.1,1,1096,6.999e-06,156353009,0.998462
D.birchii,156593892,VNKA01006871.1,1,1096,6.999e-06,156354105,0.998469
D.birchii,156593892,VNKA01005627.1,1,1095,6.99261e-06,156355200,0.998476
D.birchii,156593892,VNKA01005516.1,1,1095,6.99261e-06,156356295,0.998483
D.birchii,156593892,VNKA01001836.1,1,1095,6.99261e-06,156357390,0.99849
D.birchii,156593892,VNKA01005330.1,1,1094,6.98622e-06,156358484,0.998497
D.birchii,156593892,VNKA01003704.1,1,1094,6.98622e-06,156359578,0.998504
D.birchii,156593892,VNKA01004007.1,1,1093,6.97984e-06,156360671,0.998511
D.birchii,156593892,VNKA01000103.1,1,1093,6.97984e-06,156361764,0.998518
D.birchii,156593892,VNKA01007035.1,1,1092,6.97345e-06,156362856,0.998525
D.birchii,156593892,VNKA01005869.1,1,1092,6.97345e-06,156363948,0.998532
D.birchii,156593892,VNKA01004110.1,1,1092,6.97345e-06,156365040,0.998539
D.birchii,156593892,VNKA01003766.1,1,1091,6.96707e-06,156366131,0.998546
D.birchii,156593892,VNKA01000995.1,1,1091,6.96707e-06,156367222,0.998552
D.birchii,156593892,VNKA01002640.1,1,1090,6.96068e-06,156368312,0.998559
D.birchii,156593892,VNKA01006228.1,1,1089,6.95429e-06,156369401,0.998566
D.birchii,156593892,VNKA01002390.1,1,1089,6.95429e-06,156370490,0.998573
D.birchii,156593892,VNKA01001230.1,1,1089,6.95429e-06,156371579,0.99858
D.birchii,156593892,VNKA01003716.1,1,1088,6.94791e-06,156372667,0.998587
D.birchii,156593892,VNKA01002966.1,1,1088,6.94791e-06,156373755,0.998594
D.birchii,156593892,VNKA01007440.1,1,1087,6.94152e-06,156374842,0.998601
D.birchii,156593892,VNKA01005030.1,1,1087,6.94152e-06,156375929,0.998608
D.birchii,156593892,VNKA01004374.1,1,1087,6.94152e-06,156377016,0.998615
D.birchii,156593892,VNKA01002806.1,1,1087,6.94152e-06,156378103,0.998622
D.birchii,156593892,VNKA01006511.1,1,1086,6.93514e-06,156379189,0.998629
D.birchii,156593892,VNKA01007418.1,1,1085,6.92875e-06,156380274,0.998636
D.birchii,156593892,VNKA01007195.1,1,1084,6.92236e-06,156381358,0.998643
D.birchii,156593892,VNKA01005707.1,1,1084,6.92236e-06,156382442,0.99865
D.birchii,156593892,VNKA01004880.1,1,1084,6.92236e-06,156383526,0.998657
D.birchii,156593892,VNKA01002998.1,1,1084,6.92236e-06,156384610,0.998664
D.birchii,156593892,VNKA01002420.1,1,1084,6.92236e-06,156385694,0.99867
D.birchii,156593892,VNKA01005637.1,1,1083,6.91598e-06,156386777,0.998677
D.birchii,156593892,VNKA01004769.1,1,1083,6.91598e-06,156387860,0.998684
D.birchii,156593892,VNKA01004356.1,1,1082,6.90959e-06,156388942,0.998691
D.birchii,156593892,VNKA01002539.1,1,1082,6.90959e-06,156390024,0.998698
D.birchii,156593892,VNKA01001654.1,1,1082,6.90959e-06,156391106,0.998705
D.birchii,156593892,VNKA01006685.1,1,1081,6.90321e-06,156392187,0.998712
D.birchii,156593892,VNKA01003481.1,1,1081,6.90321e-06,156393268,0.998719
D.birchii,156593892,VNKA01001855.1,1,1081,6.90321e-06,156394349,0.998726
D.birchii,156593892,VNKA01005470.1,1,1080,6.89682e-06,156395429,0.998733
D.birchii,156593892,VNKA01002514.1,1,1080,6.89682e-06,156396509,0.99874
D.birchii,156593892,VNKA01000664.1,1,1080,6.89682e-06,156397589,0.998746
D.birchii,156593892,VNKA01006272.1,1,1079,6.89043e-06,156398668,0.998753
D.birchii,156593892,VNKA01002693.1,1,1079,6.89043e-06,156399747,0.99876
D.birchii,156593892,VNKA01000414.1,1,1079,6.89043e-06,156400826,0.998767
D.birchii,156593892,VNKA01007474.1,1,1078,6.88405e-06,156401904,0.998774
D.birchii,156593892,VNKA01006627.1,1,1078,6.88405e-06,156402982,0.998781
D.birchii,156593892,VNKA01006032.1,1,1078,6.88405e-06,156404060,0.998788
D.birchii,156593892,VNKA01003297.1,1,1078,6.88405e-06,156405138,0.998795
D.birchii,156593892,VNKA01000397.1,1,1078,6.88405e-06,156406216,0.998802
D.birchii,156593892,VNKA01005770.1,1,1077,6.87766e-06,156407293,0.998808
D.birchii,156593892,VNKA01003244.1,1,1076,6.87128e-06,156408369,0.998815
D.birchii,156593892,VNKA01001527.1,1,1076,6.87128e-06,156409445,0.998822
D.birchii,156593892,VNKA01000317.1,1,1076,6.87128e-06,156410521,0.998829
D.birchii,156593892,VNKA01004854.1,1,1075,6.86489e-06,156411596,0.998836
D.birchii,156593892,VNKA01003646.1,1,1075,6.86489e-06,156412671,0.998843
D.birchii,156593892,VNKA01006480.1,1,1074,6.85851e-06,156413745,0.99885
D.birchii,156593892,VNKA01006226.1,1,1074,6.85851e-06,156414819,0.998856
D.birchii,156593892,VNKA01003834.1,1,1074,6.85851e-06,156415893,0.998863
D.birchii,156593892,VNKA01005589.1,1,1073,6.85212e-06,156416966,0.99887
D.birchii,156593892,VNKA01000376.1,1,1073,6.85212e-06,156418039,0.998877
D.birchii,156593892,VNKA01000136.1,1,1072,6.84573e-06,156419111,0.998884
D.birchii,156593892,VNKA01006736.1,1,1071,6.83935e-06,156420182,0.998891
D.birchii,156593892,VNKA01001572.1,1,1071,6.83935e-06,156421253,0.998898
D.birchii,156593892,VNKA01000762.1,1,1071,6.83935e-06,156422324,0.998904
D.birchii,156593892,VNKA01000431.1,1,1071,6.83935e-06,156423395,0.998911
D.birchii,156593892,VNKA01005461.1,1,1070,6.83296e-06,156424465,0.998918
D.birchii,156593892,VNKA01004716.1,1,1070,6.83296e-06,156425535,0.998925
D.birchii,156593892,VNKA01003803.1,1,1070,6.83296e-06,156426605,0.998932
D.birchii,156593892,VNKA01000516.1,1,1070,6.83296e-06,156427675,0.998939
D.birchii,156593892,VNKA01005994.1,1,1069,6.82658e-06,156428744,0.998945
D.birchii,156593892,VNKA01000010.1,1,1069,6.82658e-06,156429813,0.998952
D.birchii,156593892,VNKA01007200.1,1,1068,6.82019e-06,156430881,0.998959
D.birchii,156593892,VNKA01004562.1,1,1067,6.8138e-06,156431948,0.998966
D.birchii,156593892,VNKA01000086.1,1,1067,6.8138e-06,156433015,0.998973
D.birchii,156593892,VNKA01001147.1,1,1066,6.80742e-06,156434081,0.998979
D.birchii,156593892,VNKA01000947.1,1,1066,6.80742e-06,156435147,0.998986
D.birchii,156593892,VNKA01000697.1,1,1066,6.80742e-06,156436213,0.998993
D.birchii,156593892,VNKA01001829.1,1,1065,6.80103e-06,156437278,0.999
D.birchii,156593892,VNKA01007417.1,1,1063,6.78826e-06,156438341,0.999007
D.birchii,156593892,VNKA01001659.1,1,1063,6.78826e-06,156439404,0.999013
D.birchii,156593892,VNKA01007142.1,1,1062,6.78187e-06,156440466,0.99902
D.birchii,156593892,VNKA01006889.1,1,1062,6.78187e-06,156441528,0.999027
D.birchii,156593892,VNKA01006096.1,1,1061,6.77549e-06,156442589,0.999034
D.birchii,156593892,VNKA01001807.1,1,1061,6.77549e-06,156443650,0.999041
D.birchii,156593892,VNKA01001490.1,1,1060,6.7691e-06,156444710,0.999047
D.birchii,156593892,VNKA01006937.1,1,1058,6.75633e-06,156445768,0.999054
D.birchii,156593892,VNKA01005813.1,1,1058,6.75633e-06,156446826,0.999061
D.birchii,156593892,VNKA01007031.1,1,1057,6.74994e-06,156447883,0.999068
D.birchii,156593892,VNKA01006635.1,1,1057,6.74994e-06,156448940,0.999074
D.birchii,156593892,VNKA01002916.1,1,1057,6.74994e-06,156449997,0.999081
D.birchii,156593892,VNKA01005474.1,1,1056,6.74356e-06,156451053,0.999088
D.birchii,156593892,VNKA01004340.1,1,1056,6.74356e-06,156452109,0.999095
D.birchii,156593892,VNKA01007169.1,1,1055,6.73717e-06,156453164,0.999101
D.birchii,156593892,VNKA01006985.1,1,1055,6.73717e-06,156454219,0.999108
D.birchii,156593892,VNKA01005155.1,1,1055,6.73717e-06,156455274,0.999115
D.birchii,156593892,VNKA01004939.1,1,1055,6.73717e-06,156456329,0.999122
D.birchii,156593892,VNKA01002132.1,1,1055,6.73717e-06,156457384,0.999128
D.birchii,156593892,VNKA01002057.1,1,1055,6.73717e-06,156458439,0.999135
D.birchii,156593892,VNKA01003546.1,1,1054,6.73079e-06,156459493,0.999142
D.birchii,156593892,VNKA01002872.1,1,1054,6.73079e-06,156460547,0.999148
D.birchii,156593892,VNKA01003518.1,1,1053,6.7244e-06,156461600,0.999155
D.birchii,156593892,VNKA01005814.1,1,1052,6.71801e-06,156462652,0.999162
D.birchii,156593892,VNKA01003573.1,1,1052,6.71801e-06,156463704,0.999169
D.birchii,156593892,VNKA01003171.1,1,1052,6.71801e-06,156464756,0.999175
D.birchii,156593892,VNKA01005782.1,1,1051,6.71163e-06,156465807,0.999182
D.birchii,156593892,VNKA01001254.1,1,1050,6.70524e-06,156466857,0.999189
D.birchii,156593892,VNKA01002889.1,1,1049,6.69886e-06,156467906,0.999195
D.birchii,156593892,VNKA01004763.1,1,1048,6.69247e-06,156468954,0.999202
D.birchii,156593892,VNKA01002949.1,1,1048,6.69247e-06,156470002,0.999209
D.birchii,156593892,VNKA01004333.1,1,1047,6.68608e-06,156471049,0.999216
D.birchii,156593892,VNKA01003030.1,1,1047,6.68608e-06,156472096,0.999222
D.birchii,156593892,VNKA01004072.1,1,1046,6.6797e-06,156473142,0.999229
D.birchii,156593892,VNKA01005423.1,1,1045,6.67331e-06,156474187,0.999236
D.birchii,156593892,VNKA01001471.1,1,1045,6.67331e-06,156475232,0.999242
D.birchii,156593892,VNKA01000958.1,1,1045,6.67331e-06,156476277,0.999249
D.birchii,156593892,VNKA01000182.1,1,1045,6.67331e-06,156477322,0.999256
D.birchii,156593892,VNKA01006087.1,1,1044,6.66693e-06,156478366,0.999262
D.birchii,156593892,VNKA01005812.1,1,1044,6.66693e-06,156479410,0.999269
D.birchii,156593892,VNKA01003821.1,1,1044,6.66693e-06,156480454,0.999276
D.birchii,156593892,VNKA01004003.1,1,1043,6.66054e-06,156481497,0.999282
D.birchii,156593892,VNKA01003572.1,1,1043,6.66054e-06,156482540,0.999289
D.birchii,156593892,VNKA01006699.1,1,1042,6.65415e-06,156483582,0.999296
D.birchii,156593892,VNKA01006309.1,1,1042,6.65415e-06,156484624,0.999302
D.birchii,156593892,VNKA01003774.1,1,1042,6.65415e-06,156485666,0.999309
D.birchii,156593892,VNKA01003198.1,1,1042,6.65415e-06,156486708,0.999316
D.birchii,156593892,VNKA01001015.1,1,1042,6.65415e-06,156487750,0.999322
D.birchii,156593892,VNKA01005717.1,1,1041,6.64777e-06,156488791,0.999329
D.birchii,156593892,VNKA01005112.1,1,1041,6.64777e-06,156489832,0.999335
D.birchii,156593892,VNKA01006998.1,1,1040,6.64138e-06,156490872,0.999342
D.birchii,156593892,VNKA01005715.1,1,1040,6.64138e-06,156491912,0.999349
D.birchii,156593892,VNKA01002828.1,1,1040,6.64138e-06,156492952,0.999355
D.birchii,156593892,VNKA01002412.1,1,1040,6.64138e-06,156493992,0.999362
D.birchii,156593892,VNKA01001390.1,1,1040,6.64138e-06,156495032,0.999369
D.birchii,156593892,VNKA01004099.1,1,1039,6.635e-06,156496071,0.999375
D.birchii,156593892,VNKA01006005.1,1,1038,6.62861e-06,156497109,0.999382
D.birchii,156593892,VNKA01000530.1,1,1038,6.62861e-06,156498147,0.999389
D.birchii,156593892,VNKA01007196.1,1,1037,6.62223e-06,156499184,0.999395
D.birchii,156593892,VNKA01003154.1,1,1037,6.62223e-06,156500221,0.999402
D.birchii,156593892,VNKA01004131.1,1,1036,6.61584e-06,156501257,0.999408
D.birchii,156593892,VNKA01000435.1,1,1036,6.61584e-06,156502293,0.999415
D.birchii,156593892,VNKA01005313.1,1,1035,6.60945e-06,156503328,0.999422
D.birchii,156593892,VNKA01004514.1,1,1035,6.60945e-06,156504363,0.999428
D.birchii,156593892,VNKA01004431.1,1,1035,6.60945e-06,156505398,0.999435
D.birchii,156593892,VNKA01002955.1,1,1035,6.60945e-06,156506433,0.999441
D.birchii,156593892,VNKA01001352.1,1,1035,6.60945e-06,156507468,0.999448
D.birchii,156593892,VNKA01007037.1,1,1034,6.60307e-06,156508502,0.999455
D.birchii,156593892,VNKA01007036.1,1,1034,6.60307e-06,156509536,0.999461
D.birchii,156593892,VNKA01004882.1,1,1034,6.60307e-06,156510570,0.999468
D.birchii,156593892,VNKA01006423.1,1,1033,6.59668e-06,156511603,0.999475
D.birchii,156593892,VNKA01005178.1,1,1033,6.59668e-06,156512636,0.999481
D.birchii,156593892,VNKA01003817.1,1,1033,6.59668e-06,156513669,0.999488
D.birchii,156593892,VNKA01000906.1,1,1033,6.59668e-06,156514702,0.999494
D.birchii,156593892,VNKA01003273.1,1,1032,6.5903e-06,156515734,0.999501
D.birchii,156593892,VNKA01004982.1,1,1031,6.58391e-06,156516765,0.999507
D.birchii,156593892,VNKA01004071.1,1,1031,6.58391e-06,156517796,0.999514
D.birchii,156593892,VNKA01005150.1,1,1030,6.57752e-06,156518826,0.999521
D.birchii,156593892,VNKA01004411.1,1,1030,6.57752e-06,156519856,0.999527
D.birchii,156593892,VNKA01002405.1,1,1030,6.57752e-06,156520886,0.999534
D.birchii,156593892,VNKA01001872.1,1,1029,6.57114e-06,156521915,0.99954
D.birchii,156593892,VNKA01005045.1,1,1028,6.56475e-06,156522943,0.999547
D.birchii,156593892,VNKA01004109.1,1,1028,6.56475e-06,156523971,0.999553
D.birchii,156593892,VNKA01004866.1,1,1027,6.55837e-06,156524998,0.99956
D.birchii,156593892,VNKA01005591.1,1,1026,6.55198e-06,156526024,0.999567
D.birchii,156593892,VNKA01004568.1,1,1026,6.55198e-06,156527050,0.999573
D.birchii,156593892,VNKA01001633.1,1,1026,6.55198e-06,156528076,0.99958
D.birchii,156593892,VNKA01006799.1,1,1025,6.54559e-06,156529101,0.999586
D.birchii,156593892,VNKA01000657.1,1,1025,6.54559e-06,156530126,0.999593
D.birchii,156593892,VNKA01004864.1,1,1024,6.53921e-06,156531150,0.999599
D.birchii,156593892,VNKA01004913.1,1,1023,6.53282e-06,156532173,0.999606
D.birchii,156593892,VNKA01003473.1,1,1023,6.53282e-06,156533196,0.999612
D.birchii,156593892,VNKA01002023.1,1,1023,6.53282e-06,156534219,0.999619
D.birchii,156593892,VNKA01005998.1,1,1021,6.52005e-06,156535240,0.999625
D.birchii,156593892,VNKA01002307.1,1,1021,6.52005e-06,156536261,0.999632
D.birchii,156593892,VNKA01001076.1,1,1021,6.52005e-06,156537282,0.999638
D.birchii,156593892,VNKA01005440.1,1,1020,6.51366e-06,156538302,0.999645
D.birchii,156593892,VNKA01005226.1,1,1020,6.51366e-06,156539322,0.999652
D.birchii,156593892,VNKA01004887.1,1,1020,6.51366e-06,156540342,0.999658
D.birchii,156593892,VNKA01002781.1,1,1020,6.51366e-06,156541362,0.999665
D.birchii,156593892,VNKA01001808.1,1,1020,6.51366e-06,156542382,0.999671
D.birchii,156593892,VNKA01000575.1,1,1020,6.51366e-06,156543402,0.999678
D.birchii,156593892,VNKA01006307.1,1,1019,6.50728e-06,156544421,0.999684
D.birchii,156593892,VNKA01005509.1,1,1019,6.50728e-06,156545440,0.999691
D.birchii,156593892,VNKA01004865.1,1,1019,6.50728e-06,156546459,0.999697
D.birchii,156593892,VNKA01004238.1,1,1019,6.50728e-06,156547478,0.999704
D.birchii,156593892,VNKA01003776.1,1,1019,6.50728e-06,156548497,0.99971
D.birchii,156593892,VNKA01007335.1,1,1018,6.50089e-06,156549515,0.999717
D.birchii,156593892,VNKA01005712.1,1,1018,6.50089e-06,156550533,0.999723
D.birchii,156593892,VNKA01000419.1,1,1018,6.50089e-06,156551551,0.99973
D.birchii,156593892,VNKA01007000.1,1,1016,6.48812e-06,156552567,0.999736
D.birchii,156593892,VNKA01006330.1,1,1015,6.48173e-06,156553582,0.999743
D.birchii,156593892,VNKA01005000.1,1,1015,6.48173e-06,156554597,0.999749
D.birchii,156593892,VNKA01003499.1,1,1015,6.48173e-06,156555612,0.999756
D.birchii,156593892,VNKA01000392.1,1,1015,6.48173e-06,156556627,0.999762
D.birchii,156593892,VNKA01007139.1,1,1014,6.47535e-06,156557641,0.999769
D.birchii,156593892,VNKA01007082.1,1,1014,6.47535e-06,156558655,0.999775
D.birchii,156593892,VNKA01006906.1,1,1014,6.47535e-06,156559669,0.999781
D.birchii,156593892,VNKA01005229.1,1,1014,6.47535e-06,156560683,0.999788
D.birchii,156593892,VNKA01005117.1,1,1013,6.46896e-06,156561696,0.999794
D.birchii,156593892,VNKA01003055.1,1,1012,6.46258e-06,156562708,0.999801
D.birchii,156593892,VNKA01002668.1,1,1012,6.46258e-06,156563720,0.999807
D.birchii,156593892,VNKA01001910.1,1,1012,6.46258e-06,156564732,0.999814
D.birchii,156593892,VNKA01003512.1,1,1010,6.4498e-06,156565742,0.99982
D.birchii,156593892,VNKA01001759.1,1,1010,6.4498e-06,156566752,0.999827
D.birchii,156593892,VNKA01006043.1,1,1009,6.44342e-06,156567761,0.999833
D.birchii,156593892,VNKA01002653.1,1,1009,6.44342e-06,156568770,0.99984
D.birchii,156593892,VNKA01002633.1,1,1009,6.44342e-06,156569779,0.999846
D.birchii,156593892,VNKA01002157.1,1,1009,6.44342e-06,156570788,0.999852
D.birchii,156593892,VNKA01001252.1,1,1009,6.44342e-06,156571797,0.999859
D.birchii,156593892,VNKA01005472.1,1,1008,6.43703e-06,156572805,0.999865
D.birchii,156593892,VNKA01003969.1,1,1008,6.43703e-06,156573813,0.999872
D.birchii,156593892,VNKA01003488.1,1,1008,6.43703e-06,156574821,0.999878
D.birchii,156593892,VNKA01002250.1,1,1008,6.43703e-06,156575829,0.999885
D.birchii,156593892,VNKA01003914.1,1,1007,6.43065e-06,156576836,0.999891
D.birchii,156593892,VNKA01004674.1,1,1006,6.42426e-06,156577842,0.999898
D.birchii,156593892,VNKA01001747.1,1,1006,6.42426e-06,156578848,0.999904
D.birchii,156593892,VNKA01001619.1,1,1006,6.42426e-06,156579854,0.99991
D.birchii,156593892,VNKA01004680.1,1,1005,6.41787e-06,156580859,0.999917
D.birchii,156593892,VNKA01003437.1,1,1005,6.41787e-06,156581864,0.999923
D.birchii,156593892,VNKA01004319.1,1,1004,6.41149e-06,156582868,0.99993
D.birchii,156593892,VNKA01002322.1,1,1004,6.41149e-06,156583872,0.999936
D.birchii,156593892,VNKA01006757.1,1,1003,6.4051e-06,156584875,0.999942
D.birchii,156593892,VNKA01006510.1,1,1003,6.4051e-06,156585878,0.999949
D.birchii,156593892,VNKA01004711.1,1,1003,6.4051e-06,156586881,0.999955
D.birchii,156593892,VNKA01001748.1,1,1003,6.4051e-06,156587884,0.999962
D.birchii,156593892,VNKA01007459.1,1,1002,6.39872e-06,156588886,0.999968
D.birchii,156593892,VNKA01001720.1,1,1002,6.39872e-06,156589888,0.999974
D.birchii,156593892,VNKA01000806.1,1,1002,6.39872e-06,156590890,0.999981
D.birchii,156593892,VNKA01005713.1,1,1001,6.39233e-06,156591891,0.999987
D.birchii,156593892,VNKA01002354.1,1,1001,6.39233e-06,156592892,0.999994
D.birchii,156593892,VNKA01001871.1,1,1000,6.38595e-06,156593892,1
D.kanapiae,152203088,VNJM01003026.1,1,2274126,0.0149414,2274126,0.0149414
D.kanapiae,152203088,VNJM01003527.1,1,1917500,0.0125983,4191626,0.0275397
D.kanapiae,152203088,VNJM01000055.1,1,1782805,0.0117133,5974431,0.039253
D.kanapiae,152203088,VNJM01000924.1,1,1693728,0.0111281,7668159,0.0503811
D.kanapiae,152203088,VNJM01000522.1,1,1603681,0.0105365,9271840,0.0609176
D.kanapiae,152203088,VNJM01000232.1,1,1488139,0.00977732,10759979,0.0706949
D.kanapiae,152203088,VNJM01002139.1,1,1485919,0.00976274,12245898,0.0804576
D.kanapiae,152203088,VNJM01002978.1,1,1451629,0.00953745,13697527,0.0899951
D.kanapiae,152203088,VNJM01001375.1,1,1332551,0.00875509,15030078,0.0987502
D.kanapiae,152203088,VNJM01003467.1,1,1331974,0.00875129,16362052,0.107501
D.kanapiae,152203088,VNJM01001074.1,1,1324196,0.00870019,17686248,0.116202
D.kanapiae,152203088,VNJM01001629.1,1,1321007,0.00867924,19007255,0.124881
D.kanapiae,152203088,VNJM01002939.1,1,1287598,0.00845974,20294853,0.133341
D.kanapiae,152203088,VNJM01001898.1,1,1232501,0.00809774,21527354,0.141438
D.kanapiae,152203088,VNJM01001679.1,1,1230098,0.00808195,22757452,0.14952
D.kanapiae,152203088,VNJM01000305.1,1,1202928,0.00790344,23960380,0.157424
D.kanapiae,152203088,VNJM01001063.1,1,1148431,0.00754539,25108811,0.164969
D.kanapiae,152203088,VNJM01001647.1,1,1123094,0.00737892,26231905,0.172348
D.kanapiae,152203088,VNJM01002441.1,1,1089376,0.00715738,27321281,0.179505
D.kanapiae,152203088,VNJM01001909.1,1,1086669,0.0071396,28407950,0.186645
D.kanapiae,152203088,VNJM01002127.1,1,1069235,0.00702505,29477185,0.19367
D.kanapiae,152203088,VNJM01000302.1,1,1057680,0.00694914,30534865,0.200619
D.kanapiae,152203088,VNJM01003191.1,1,1022212,0.00671611,31557077,0.207335
D.kanapiae,152203088,VNJM01001108.1,1,1020320,0.00670367,32577397,0.214039
D.kanapiae,152203088,VNJM01002015.1,1,1011856,0.00664806,33589253,0.220687
D.kanapiae,152203088,VNJM01003371.1,1,976991,0.006419,34566244,0.227106
D.kanapiae,152203088,VNJM01003332.1,1,922736,0.00606253,35488980,0.233169
D.kanapiae,152203088,VNJM01000485.1,1,917494,0.00602809,36406474,0.239197
D.kanapiae,152203088,VNJM01000804.1,1,906630,0.00595671,37313104,0.245153
D.kanapiae,152203088,VNJM01002150.1,1,893112,0.0058679,38206216,0.251021
D.kanapiae,152203088,VNJM01002348.1,1,885195,0.00581588,39091411,0.256837
D.kanapiae,152203088,VNJM01000922.1,1,881082,0.00578886,39972493,0.262626
D.kanapiae,152203088,VNJM01001803.1,1,880386,0.00578428,40852879,0.26841
D.kanapiae,152203088,VNJM01000291.1,1,864706,0.00568126,41717585,0.274092
D.kanapiae,152203088,VNJM01000360.1,1,831324,0.00546194,42548909,0.279554
D.kanapiae,152203088,VNJM01001897.1,1,831192,0.00546107,43380101,0.285015
D.kanapiae,152203088,VNJM01003079.1,1,770317,0.00506111,44150418,0.290076
D.kanapiae,152203088,VNJM01000681.1,1,761271,0.00500168,44911689,0.295077
D.kanapiae,152203088,VNJM01002840.1,1,759591,0.00499064,45671280,0.300068
D.kanapiae,152203088,VNJM01000227.1,1,736122,0.00483645,46407402,0.304904
D.kanapiae,152203088,VNJM01000686.1,1,719000,0.00472395,47126402,0.309628
D.kanapiae,152203088,VNJM01000993.1,1,701209,0.00460706,47827611,0.314235
D.kanapiae,152203088,VNJM01001220.1,1,690409,0.0045361,48518020,0.318772
D.kanapiae,152203088,VNJM01001479.1,1,678088,0.00445515,49196108,0.323227
D.kanapiae,152203088,VNJM01002088.1,1,677431,0.00445084,49873539,0.327678
D.kanapiae,152203088,VNJM01000003.1,1,666341,0.00437797,50539880,0.332056
D.kanapiae,152203088,VNJM01000303.1,1,664836,0.00436808,51204716,0.336424
D.kanapiae,152203088,VNJM01002079.1,1,662877,0.00435521,51867593,0.340779
D.kanapiae,152203088,VNJM01000755.1,1,644673,0.00423561,52512266,0.345014
D.kanapiae,152203088,VNJM01002115.1,1,636564,0.00418233,53148830,0.349197
D.kanapiae,152203088,VNJM01000026.1,1,621041,0.00408034,53769871,0.353277
D.kanapiae,152203088,VNJM01003330.1,1,620109,0.00407422,54389980,0.357351
D.kanapiae,152203088,VNJM01002694.1,1,611738,0.00401922,55001718,0.361371
D.kanapiae,152203088,VNJM01000358.1,1,591979,0.0038894,55593697,0.36526
D.kanapiae,152203088,VNJM01001881.1,1,563462,0.00370204,56157159,0.368962
D.kanapiae,152203088,VNJM01001466.1,1,560778,0.00368441,56717937,0.372646
D.kanapiae,152203088,VNJM01003551.1,1,552231,0.00362825,57270168,0.376275
D.kanapiae,152203088,VNJM01003542.1,1,550905,0.00361954,57821073,0.379894
D.kanapiae,152203088,VNJM01002696.1,1,546284,0.00358918,58367357,0.383483
D.kanapiae,152203088,VNJM01000989.1,1,544011,0.00357424,58911368,0.387058
D.kanapiae,152203088,VNJM01001157.1,1,538508,0.00353809,59449876,0.390596
D.kanapiae,152203088,VNJM01002618.1,1,538259,0.00353645,59988135,0.394132
D.kanapiae,152203088,VNJM01001176.1,1,528992,0.00347557,60517127,0.397608
D.kanapiae,152203088,VNJM01002859.1,1,525830,0.00345479,61042957,0.401063
D.kanapiae,152203088,VNJM01000682.1,1,519826,0.00341534,61562783,0.404478
D.kanapiae,152203088,VNJM01001384.1,1,512561,0.00336761,62075344,0.407845
D.kanapiae,152203088,VNJM01000990.1,1,510015,0.00335088,62585359,0.411196
D.kanapiae,152203088,VNJM01001497.1,1,508432,0.00334048,63093791,0.414537
D.kanapiae,152203088,VNJM01001518.1,1,503160,0.00330585,63596951,0.417843
D.kanapiae,152203088,VNJM01000802.1,1,500587,0.00328894,64097538,0.421132
D.kanapiae,152203088,VNJM01000488.1,1,498850,0.00327753,64596388,0.424409
D.kanapiae,152203088,VNJM01003284.1,1,498480,0.0032751,65094868,0.427684
D.kanapiae,152203088,VNJM01001243.1,1,497112,0.00326611,65591980,0.43095
D.kanapiae,152203088,VNJM01003366.1,1,492707,0.00323717,66084687,0.434188
D.kanapiae,152203088,VNJM01001631.1,1,485900,0.00319245,66570587,0.43738
D.kanapiae,152203088,VNJM01002733.1,1,483799,0.00317864,67054386,0.440559
D.kanapiae,152203088,VNJM01002068.1,1,478274,0.00314234,67532660,0.443701
D.kanapiae,152203088,VNJM01003482.1,1,477048,0.00313429,68009708,0.446835
D.kanapiae,152203088,VNJM01002796.1,1,470864,0.00309366,68480572,0.449929
D.kanapiae,152203088,VNJM01000803.1,1,462189,0.00303666,68942761,0.452966
D.kanapiae,152203088,VNJM01002018.1,1,462128,0.00303626,69404889,0.456002
D.kanapiae,152203088,VNJM01001524.1,1,460204,0.00302362,69865093,0.459025
D.kanapiae,152203088,VNJM01002697.1,1,459855,0.00302133,70324948,0.462047
D.kanapiae,152203088,VNJM01001426.1,1,459275,0.00301751,70784223,0.465064
D.kanapiae,152203088,VNJM01002016.1,1,448328,0.00294559,71232551,0.46801
D.kanapiae,152203088,VNJM01000206.1,1,448129,0.00294428,71680680,0.470954
D.kanapiae,152203088,VNJM01000930.1,1,438885,0.00288355,72119565,0.473838
D.kanapiae,152203088,VNJM01001554.1,1,436681,0.00286907,72556246,0.476707
D.kanapiae,152203088,VNJM01003519.1,1,434573,0.00285522,72990819,0.479562
D.kanapiae,152203088,VNJM01001998.1,1,428688,0.00281655,73419507,0.482379
D.kanapiae,152203088,VNJM01000884.1,1,423379,0.00278167,73842886,0.48516
D.kanapiae,152203088,VNJM01002522.1,1,422205,0.00277396,74265091,0.487934
D.kanapiae,152203088,VNJM01000379.1,1,421784,0.00277119,74686875,0.490705
D.kanapiae,152203088,VNJM01000313.1,1,415675,0.00273105,75102550,0.493436
D.kanapiae,152203088,VNJM01003478.1,1,409298,0.00268916,75511848,0.496126
D.kanapiae,152203088,VNJM01001857.1,1,407546,0.00267765,75919394,0.498803
D.kanapiae,152203088,VNJM01003378.1,1,405601,0.00266487,76324995,0.501468
D.kanapiae,152203088,VNJM01003543.1,1,402179,0.00264238,76727174,0.50411
D.kanapiae,152203088,VNJM01000995.1,1,399688,0.00262602,77126862,0.506737
D.kanapiae,152203088,VNJM01001660.1,1,396154,0.0026028,77523016,0.509339
D.kanapiae,152203088,VNJM01001550.1,1,389587,0.00255965,77912603,0.511899
D.kanapiae,152203088,VNJM01001060.1,1,387344,0.00254492,78299947,0.514444
D.kanapiae,152203088,VNJM01000662.1,1,386763,0.0025411,78686710,0.516985
D.kanapiae,152203088,VNJM01000801.1,1,383317,0.00251846,79070027,0.519503
D.kanapiae,152203088,VNJM01001083.1,1,380585,0.00250051,79450612,0.522004
D.kanapiae,152203088,VNJM01003507.1,1,375620,0.00246789,79826232,0.524472
D.kanapiae,152203088,VNJM01000412.1,1,372501,0.00244739,80198733,0.526919
D.kanapiae,152203088,VNJM01002950.1,1,370225,0.00243244,80568958,0.529352
D.kanapiae,152203088,VNJM01000811.1,1,370120,0.00243175,80939078,0.531783
D.kanapiae,152203088,VNJM01002855.1,1,361867,0.00237753,81300945,0.534161
D.kanapiae,152203088,VNJM01002757.1,1,360504,0.00236857,81661449,0.53653
D.kanapiae,152203088,VNJM01003610.1,1,359012,0.00235877,82020461,0.538888
D.kanapiae,152203088,VNJM01001488.1,1,355758,0.00233739,82376219,0.541226
D.kanapiae,152203088,VNJM01002527.1,1,354598,0.00232977,82730817,0.543555
D.kanapiae,152203088,VNJM01002343.1,1,347886,0.00228567,83078703,0.545841
D.kanapiae,152203088,VNJM01001954.1,1,347785,0.00228501,83426488,0.548126
D.kanapiae,152203088,VNJM01000746.1,1,341229,0.00224193,83767717,0.550368
D.kanapiae,152203088,VNJM01002349.1,1,340836,0.00223935,84108553,0.552607
D.kanapiae,152203088,VNJM01002750.1,1,339657,0.0022316,84448210,0.554839
D.kanapiae,152203088,VNJM01003291.1,1,335752,0.00220595,84783962,0.557045
D.kanapiae,152203088,VNJM01002868.1,1,335500,0.00220429,85119462,0.559249
D.kanapiae,152203088,VNJM01002952.1,1,327918,0.00215448,85447380,0.561404
D.kanapiae,152203088,VNJM01001113.1,1,326257,0.00214356,85773637,0.563547
D.kanapiae,152203088,VNJM01000285.1,1,324828,0.00213417,86098465,0.565681
D.kanapiae,152203088,VNJM01001606.1,1,320947,0.00210868,86419412,0.56779
D.kanapiae,152203088,VNJM01002024.1,1,319994,0.00210241,86739406,0.569893
D.kanapiae,152203088,VNJM01001924.1,1,318503,0.00209262,87057909,0.571985
D.kanapiae,152203088,VNJM01001532.1,1,316407,0.00207885,87374316,0.574064
D.kanapiae,152203088,VNJM01000420.1,1,316262,0.00207789,87690578,0.576142
D.kanapiae,152203088,VNJM01002042.1,1,315516,0.00207299,88006094,0.578215
D.kanapiae,152203088,VNJM01000441.1,1,315486,0.0020728,88321580,0.580288
D.kanapiae,152203088,VNJM01001379.1,1,315483,0.00207278,88637063,0.58236
D.kanapiae,152203088,VNJM01000019.1,1,313060,0.00205686,88950123,0.584417
D.kanapiae,152203088,VNJM01002430.1,1,310838,0.00204226,89260961,0.58646
D.kanapiae,152203088,VNJM01003121.1,1,309707,0.00203483,89570668,0.588494
D.kanapiae,152203088,VNJM01003100.1,1,308807,0.00202891,89879475,0.590523
D.kanapiae,152203088,VNJM01003522.1,1,306822,0.00201587,90186297,0.592539
D.kanapiae,152203088,VNJM01001330.1,1,304329,0.00199949,90490626,0.594539
D.kanapiae,152203088,VNJM01002354.1,1,304001,0.00199734,90794627,0.596536
D.kanapiae,152203088,VNJM01000025.1,1,302346,0.00198646,91096973,0.598523
D.kanapiae,152203088,VNJM01002877.1,1,301207,0.00197898,91398180,0.600501
D.kanapiae,152203088,VNJM01000680.1,1,297574,0.00195511,91695754,0.602457
D.kanapiae,152203088,VNJM01001160.1,1,295848,0.00194377,91991602,0.6044
D.kanapiae,152203088,VNJM01001905.1,1,293579,0.00192886,92285181,0.606329
D.kanapiae,152203088,VNJM01001268.1,1,293405,0.00192772,92578586,0.608257
D.kanapiae,152203088,VNJM01002173.1,1,290602,0.0019093,92869188,0.610166
D.kanapiae,152203088,VNJM01002575.1,1,290386,0.00190789,93159574,0.612074
D.kanapiae,152203088,VNJM01002641.1,1,288803,0.00189748,93448377,0.613972
D.kanapiae,152203088,VNJM01001510.1,1,287099,0.00188629,93735476,0.615858
D.kanapiae,152203088,VNJM01001856.1,1,286502,0.00188237,94021978,0.61774
D.kanapiae,152203088,VNJM01000257.1,1,286102,0.00187974,94308080,0.61962
D.kanapiae,152203088,VNJM01002802.1,1,286052,0.00187941,94594132,0.621499
D.kanapiae,152203088,VNJM01002148.1,1,285427,0.0018753,94879559,0.623375
D.kanapiae,152203088,VNJM01000637.1,1,281432,0.00184906,95160991,0.625224
D.kanapiae,152203088,VNJM01002059.1,1,279943,0.00183927,95440934,0.627063
D.kanapiae,152203088,VNJM01000364.1,1,279168,0.00183418,95720102,0.628897
D.kanapiae,152203088,VNJM01001275.1,1,269201,0.0017687,95989303,0.630666
D.kanapiae,152203088,VNJM01000230.1,1,268272,0.00176259,96257575,0.632429
D.kanapiae,152203088,VNJM01001906.1,1,267263,0.00175596,96524838,0.634184
D.kanapiae,152203088,VNJM01001231.1,1,265861,0.00174675,96790699,0.635931
D.kanapiae,152203088,VNJM01002673.1,1,265794,0.00174631,97056493,0.637678
D.kanapiae,152203088,VNJM01002246.1,1,263974,0.00173435,97320467,0.639412
D.kanapiae,152203088,VNJM01002500.1,1,262599,0.00172532,97583066,0.641137
D.kanapiae,152203088,VNJM01001424.1,1,259723,0.00170642,97842789,0.642844
D.kanapiae,152203088,VNJM01000073.1,1,258672,0.00169952,98101461,0.644543
D.kanapiae,152203088,VNJM01002403.1,1,257993,0.00169506,98359454,0.646238
D.kanapiae,152203088,VNJM01000666.1,1,257053,0.00168888,98616507,0.647927
D.kanapiae,152203088,VNJM01000825.1,1,254157,0.00166985,98870664,0.649597
D.kanapiae,152203088,VNJM01000149.1,1,254052,0.00166916,99124716,0.651266
D.kanapiae,152203088,VNJM01000295.1,1,250184,0.00164375,99374900,0.65291
D.kanapiae,152203088,VNJM01003063.1,1,249635,0.00164014,99624535,0.65455
D.kanapiae,152203088,VNJM01000035.1,1,247711,0.0016275,99872246,0.656178
D.kanapiae,152203088,VNJM01000800.1,1,246099,0.00161691,100118345,0.657794
D.kanapiae,152203088,VNJM01003515.1,1,243300,0.00159852,100361645,0.659393
D.kanapiae,152203088,VNJM01000925.1,1,242313,0.00159204,100603958,0.660985
D.kanapiae,152203088,VNJM01000099.1,1,241507,0.00158674,100845465,0.662572
D.kanapiae,152203088,VNJM01001283.1,1,238743,0.00156858,101084208,0.66414
D.kanapiae,152203088,VNJM01001159.1,1,236854,0.00155617,101321062,0.665696
D.kanapiae,152203088,VNJM01000667.1,1,236138,0.00155147,101557200,0.667248
D.kanapiae,152203088,VNJM01003259.1,1,231847,0.00152327,101789047,0.668771
D.kanapiae,152203088,VNJM01001154.1,1,231402,0.00152035,102020449,0.670292
D.kanapiae,152203088,VNJM01001487.1,1,230531,0.00151463,102250980,0.671806
D.kanapiae,152203088,VNJM01003292.1,1,230235,0.00151268,102481215,0.673319
D.kanapiae,152203088,VNJM01001011.1,1,229428,0.00150738,102710643,0.674826
D.kanapiae,152203088,VNJM01001158.1,1,225559,0.00148196,102936202,0.676308
D.kanapiae,152203088,VNJM01002387.1,1,224339,0.00147395,103160541,0.677782
D.kanapiae,152203088,VNJM01002165.1,1,222695,0.00146314,103383236,0.679245
D.kanapiae,152203088,VNJM01003101.1,1,221742,0.00145688,103604978,0.680702
D.kanapiae,152203088,VNJM01003242.1,1,220945,0.00145165,103825923,0.682154
D.kanapiae,152203088,VNJM01002027.1,1,219911,0.00144485,104045834,0.683599
D.kanapiae,152203088,VNJM01001651.1,1,219376,0.00144134,104265210,0.68504
D.kanapiae,152203088,VNJM01000982.1,1,219207,0.00144023,104484417,0.68648
D.kanapiae,152203088,VNJM01001136.1,1,217974,0.00143213,104702391,0.687912
D.kanapiae,152203088,VNJM01001315.1,1,217776,0.00143083,104920167,0.689343
D.kanapiae,152203088,VNJM01002951.1,1,217412,0.00142843,105137579,0.690772
D.kanapiae,152203088,VNJM01002799.1,1,214084,0.00140657,105351663,0.692178
D.kanapiae,152203088,VNJM01000665.1,1,212801,0.00139814,105564464,0.693576
D.kanapiae,152203088,VNJM01002476.1,1,212096,0.00139351,105776560,0.69497
D.kanapiae,152203088,VNJM01001992.1,1,211909,0.00139228,105988469,0.696362
D.kanapiae,152203088,VNJM01002274.1,1,211896,0.00139219,106200365,0.697754
D.kanapiae,152203088,VNJM01001194.1,1,211847,0.00139187,106412212,0.699146
D.kanapiae,152203088,VNJM01003526.1,1,211468,0.00138938,106623680,0.700536
D.kanapiae,152203088,VNJM01001079.1,1,211418,0.00138905,106835098,0.701925
D.kanapiae,152203088,VNJM01001047.1,1,210730,0.00138453,107045828,0.703309
D.kanapiae,152203088,VNJM01000104.1,1,210718,0.00138445,107256546,0.704694
D.kanapiae,152203088,VNJM01001922.1,1,210383,0.00138225,107466929,0.706076
D.kanapiae,152203088,VNJM01002048.1,1,210247,0.00138136,107677176,0.707457
D.kanapiae,152203088,VNJM01001316.1,1,208701,0.0013712,107885877,0.708828
D.kanapiae,152203088,VNJM01000674.1,1,208359,0.00136895,108094236,0.710197
D.kanapiae,152203088,VNJM01002266.1,1,206759,0.00135844,108300995,0.711556
D.kanapiae,152203088,VNJM01002562.1,1,205729,0.00135167,108506724,0.712908
D.kanapiae,152203088,VNJM01000424.1,1,204203,0.00134165,108710927,0.714249
D.kanapiae,152203088,VNJM01000949.1,1,202311,0.00132922,108913238,0.715578
D.kanapiae,152203088,VNJM01002046.1,1,202127,0.00132801,109115365,0.716906
D.kanapiae,152203088,VNJM01000886.1,1,201901,0.00132652,109317266,0.718233
D.kanapiae,152203088,VNJM01000108.1,1,200132,0.0013149,109517398,0.719548
D.kanapiae,152203088,VNJM01003534.1,1,198887,0.00130672,109716285,0.720855
D.kanapiae,152203088,VNJM01003634.1,1,197566,0.00129804,109913851,0.722153
D.kanapiae,152203088,VNJM01001815.1,1,196552,0.00129138,110110403,0.723444
D.kanapiae,152203088,VNJM01002248.1,1,195748,0.0012861,110306151,0.72473
D.kanapiae,152203088,VNJM01002787.1,1,195609,0.00128518,110501760,0.726015
D.kanapiae,152203088,VNJM01003350.1,1,194913,0.00128061,110696673,0.727296
D.kanapiae,152203088,VNJM01003459.1,1,194472,0.00127771,110891145,0.728574
D.kanapiae,152203088,VNJM01001399.1,1,193568,0.00127177,111084713,0.729845
D.kanapiae,152203088,VNJM01002268.1,1,192504,0.00126478,111277217,0.73111
D.kanapiae,152203088,VNJM01003620.1,1,191511,0.00125826,111468728,0.732368
D.kanapiae,152203088,VNJM01001276.1,1,190248,0.00124996,111658976,0.733618
D.kanapiae,152203088,VNJM01000417.1,1,189302,0.00124375,111848278,0.734862
D.kanapiae,152203088,VNJM01002151.1,1,189247,0.00124338,112037525,0.736105
D.kanapiae,152203088,VNJM01003241.1,1,188669,0.00123959,112226194,0.737345
D.kanapiae,152203088,VNJM01002593.1,1,186070,0.00122251,112412264,0.738568
D.kanapiae,152203088,VNJM01002071.1,1,182807,0.00120107,112595071,0.739769
D.kanapiae,152203088,VNJM01000918.1,1,179689,0.00118059,112774760,0.740949
D.kanapiae,152203088,VNJM01002774.1,1,178752,0.00117443,112953512,0.742124
D.kanapiae,152203088,VNJM01002494.1,1,178730,0.00117429,113132242,0.743298
D.kanapiae,152203088,VNJM01001435.1,1,177128,0.00116376,113309370,0.744462
D.kanapiae,152203088,VNJM01001678.1,1,177034,0.00116314,113486404,0.745625
D.kanapiae,152203088,VNJM01002955.1,1,176224,0.00115782,113662628,0.746783
D.kanapiae,152203088,VNJM01000415.1,1,175713,0.00115446,113838341,0.747937
D.kanapiae,152203088,VNJM01002807.1,1,175668,0.00115417,114014009,0.749091
D.kanapiae,152203088,VNJM01001329.1,1,175594,0.00115368,114189603,0.750245
D.kanapiae,152203088,VNJM01000355.1,1,175375,0.00115224,114364978,0.751397
D.kanapiae,152203088,VNJM01000233.1,1,175366,0.00115218,114540344,0.752549
D.kanapiae,152203088,VNJM01002013.1,1,174752,0.00114815,114715096,0.753698
D.kanapiae,152203088,VNJM01003479.1,1,174508,0.00114655,114889604,0.754844
D.kanapiae,152203088,VNJM01000465.1,1,174391,0.00114578,115063995,0.75599
D.kanapiae,152203088,VNJM01001673.1,1,171885,0.00112931,115235880,0.757119
D.kanapiae,152203088,VNJM01001156.1,1,171834,0.00112898,115407714,0.758248
D.kanapiae,152203088,VNJM01000668.1,1,170817,0.0011223,115578531,0.75937
D.kanapiae,152203088,VNJM01001153.1,1,170803,0.0011222,115749334,0.760493
D.kanapiae,152203088,VNJM01000581.1,1,168946,0.00111,115918280,0.761603
D.kanapiae,152203088,VNJM01001490.1,1,168664,0.00110815,116086944,0.762711
D.kanapiae,152203088,VNJM01002816.1,1,165637,0.00108826,116252581,0.763799
D.kanapiae,152203088,VNJM01001064.1,1,164335,0.00107971,116416916,0.764879
D.kanapiae,152203088,VNJM01002305.1,1,162761,0.00106937,116579677,0.765948
D.kanapiae,152203088,VNJM01000558.1,1,162018,0.00106449,116741695,0.767013
D.kanapiae,152203088,VNJM01000153.1,1,158876,0.00104384,116900571,0.768056
D.kanapiae,152203088,VNJM01001326.1,1,157873,0.00103725,117058444,0.769094
D.kanapiae,152203088,VNJM01002700.1,1,155408,0.00102106,117213852,0.770115
D.kanapiae,152203088,VNJM01001195.1,1,154805,0.0010171,117368657,0.771132
D.kanapiae,152203088,VNJM01001035.1,1,153651,0.00100951,117522308,0.772141
D.kanapiae,152203088,VNJM01000760.1,1,149320,0.000981058,117671628,0.773122
D.kanapiae,152203088,VNJM01001141.1,1,149126,0.000979783,117820754,0.774102
D.kanapiae,152203088,VNJM01001184.1,1,148026,0.000972556,117968780,0.775075
D.kanapiae,152203088,VNJM01001021.1,1,146916,0.000965263,118115696,0.77604
D.kanapiae,152203088,VNJM01000919.1,1,146648,0.000963502,118262344,0.777004
D.kanapiae,152203088,VNJM01001819.1,1,145856,0.000958299,118408200,0.777962
D.kanapiae,152203088,VNJM01002790.1,1,145490,0.000955894,118553690,0.778918
D.kanapiae,152203088,VNJM01001288.1,1,144027,0.000946282,118697717,0.779864
D.kanapiae,152203088,VNJM01003280.1,1,143444,0.000942451,118841161,0.780807
D.kanapiae,152203088,VNJM01000623.1,1,143391,0.000942103,118984552,0.781749
D.kanapiae,152203088,VNJM01002704.1,1,143001,0.000939541,119127553,0.782688
D.kanapiae,152203088,VNJM01002021.1,1,142400,0.000935592,119269953,0.783624
D.kanapiae,152203088,VNJM01000624.1,1,141979,0.000932826,119411932,0.784557
D.kanapiae,152203088,VNJM01001429.1,1,140872,0.000925553,119552804,0.785482
D.kanapiae,152203088,VNJM01003517.1,1,140850,0.000925408,119693654,0.786408
D.kanapiae,152203088,VNJM01000271.1,1,138773,0.000911762,119832427,0.787319
D.kanapiae,152203088,VNJM01003257.1,1,137955,0.000906388,119970382,0.788226
D.kanapiae,152203088,VNJM01002147.1,1,137933,0.000906243,120108315,0.789132
D.kanapiae,152203088,VNJM01000017.1,1,137179,0.000901289,120245494,0.790033
D.kanapiae,152203088,VNJM01003320.1,1,134784,0.000885554,120380278,0.790919
D.kanapiae,152203088,VNJM01000885.1,1,133801,0.000879095,120514079,0.791798
D.kanapiae,152203088,VNJM01003202.1,1,133743,0.000878714,120647822,0.792677
D.kanapiae,152203088,VNJM01001042.1,1,133138,0.000874739,120780960,0.793551
D.kanapiae,152203088,VNJM01000806.1,1,132887,0.00087309,120913847,0.794424
D.kanapiae,152203088,VNJM01001799.1,1,132824,0.000872676,121046671,0.795297
D.kanapiae,152203088,VNJM01003262.1,1,132080,0.000867788,121178751,0.796165
D.kanapiae,152203088,VNJM01000107.1,1,130652,0.000858406,121309403,0.797023
D.kanapiae,152203088,VNJM01001109.1,1,128805,0.000846271,121438208,0.79787
D.kanapiae,152203088,VNJM01000428.1,1,128509,0.000844326,121566717,0.798714
D.kanapiae,152203088,VNJM01000021.1,1,127696,0.000838984,121694413,0.799553
D.kanapiae,152203088,VNJM01002386.1,1,126475,0.000830962,121820888,0.800384
D.kanapiae,152203088,VNJM01001198.1,1,125113,0.000822014,121946001,0.801206
D.kanapiae,152203088,VNJM01002908.1,1,124080,0.000815227,122070081,0.802021
D.kanapiae,152203088,VNJM01001190.1,1,121815,0.000800345,122191896,0.802821
D.kanapiae,152203088,VNJM01001668.1,1,121199,0.000796298,122313095,0.803618
D.kanapiae,152203088,VNJM01000154.1,1,119731,0.000786653,122432826,0.804404
D.kanapiae,152203088,VNJM01000920.1,1,118559,0.000778953,122551385,0.805183
D.kanapiae,152203088,VNJM01003521.1,1,116444,0.000765057,122667829,0.805948
D.kanapiae,152203088,VNJM01000152.1,1,116120,0.000762928,122783949,0.806711
D.kanapiae,152203088,VNJM01000508.1,1,115088,0.000756148,122899037,0.807467
D.kanapiae,152203088,VNJM01001356.1,1,114332,0.000751181,123013369,0.808219
D.kanapiae,152203088,VNJM01000799.1,1,114166,0.00075009,123127535,0.808969
D.kanapiae,152203088,VNJM01001423.1,1,113989,0.000748927,123241524,0.809718
D.kanapiae,152203088,VNJM01002661.1,1,113323,0.000744551,123354847,0.810462
D.kanapiae,152203088,VNJM01000293.1,1,113139,0.000743342,123467986,0.811206
D.kanapiae,152203088,VNJM01000917.1,1,112786,0.000741023,123580772,0.811947
D.kanapiae,152203088,VNJM01000572.1,1,112613,0.000739886,123693385,0.812686
D.kanapiae,152203088,VNJM01000851.1,1,112488,0.000739065,123805873,0.813426
D.kanapiae,152203088,VNJM01000749.1,1,112455,0.000738848,123918328,0.814164
D.kanapiae,152203088,VNJM01002273.1,1,112425,0.000738651,124030753,0.814903
D.kanapiae,152203088,VNJM01000020.1,1,112170,0.000736976,124142923,0.81564
D.kanapiae,152203088,VNJM01001085.1,1,112156,0.000736884,124255079,0.816377
D.kanapiae,152203088,VNJM01001013.1,1,112063,0.000736273,124367142,0.817113
D.kanapiae,152203088,VNJM01000156.1,1,110544,0.000726293,124477686,0.817839
D.kanapiae,152203088,VNJM01000357.1,1,109798,0.000721391,124587484,0.818561
D.kanapiae,152203088,VNJM01002682.1,1,109333,0.000718336,124696817,0.819279
D.kanapiae,152203088,VNJM01003099.1,1,107336,0.000705216,124804153,0.819984
D.kanapiae,152203088,VNJM01001301.1,1,105008,0.00068992,124909161,0.820674
D.kanapiae,152203088,VNJM01000419.1,1,104699,0.00068789,125013860,0.821362
D.kanapiae,152203088,VNJM01001199.1,1,104480,0.000686451,125118340,0.822049
D.kanapiae,152203088,VNJM01003518.1,1,104470,0.000686386,125222810,0.822735
D.kanapiae,152203088,VNJM01003192.1,1,104402,0.000685939,125327212,0.823421
D.kanapiae,152203088,VNJM01000309.1,1,104179,0.000684474,125431391,0.824105
D.kanapiae,152203088,VNJM01003175.1,1,104029,0.000683488,125535420,0.824789
D.kanapiae,152203088,VNJM01000155.1,1,103803,0.000682003,125639223,0.825471
D.kanapiae,152203088,VNJM01001164.1,1,103378,0.000679211,125742601,0.82615
D.kanapiae,152203088,VNJM01000566.1,1,101307,0.000665604,125843908,0.826816
D.kanapiae,152203088,VNJM01001853.1,1,100152,0.000658016,125944060,0.827474
D.kanapiae,152203088,VNJM01001341.1,1,100093,0.000657628,126044153,0.828131
D.kanapiae,152203088,VNJM01000780.1,1,98555,0.000647523,126142708,0.828779
D.kanapiae,152203088,VNJM01002509.1,1,98008,0.000643929,126240716,0.829423
D.kanapiae,152203088,VNJM01002300.1,1,97087,0.000637878,126337803,0.830061
D.kanapiae,152203088,VNJM01002267.1,1,96693,0.000635289,126434496,0.830696
D.kanapiae,152203088,VNJM01001129.1,1,96660,0.000635073,126531156,0.831331
D.kanapiae,152203088,VNJM01001163.1,1,95283,0.000626025,126626439,0.831957
D.kanapiae,152203088,VNJM01002271.1,1,94849,0.000623174,126721288,0.83258
D.kanapiae,152203088,VNJM01003158.1,1,93925,0.000617103,126815213,0.833197
D.kanapiae,152203088,VNJM01001939.1,1,92809,0.000609771,126908022,0.833807
D.kanapiae,152203088,VNJM01001604.1,1,92747,0.000609363,127000769,0.834417
D.kanapiae,152203088,VNJM01003637.1,1,92680,0.000608923,127093449,0.835025
D.kanapiae,152203088,VNJM01000022.1,1,92496,0.000607714,127185945,0.835633
D.kanapiae,152203088,VNJM01001049.1,1,91880,0.000603667,127277825,0.836237
D.kanapiae,152203088,VNJM01002302.1,1,91766,0.000602918,127369591,0.83684
D.kanapiae,152203088,VNJM01001891.1,1,90973,0.000597708,127460564,0.837437
D.kanapiae,152203088,VNJM01002301.1,1,89102,0.000585415,127549666,0.838023
D.kanapiae,152203088,VNJM01000160.1,1,89059,0.000585133,127638725,0.838608
D.kanapiae,152203088,VNJM01003638.1,1,88784,0.000583326,127727509,0.839191
D.kanapiae,152203088,VNJM01000683.1,1,88476,0.000581302,127815985,0.839773
D.kanapiae,152203088,VNJM01001428.1,1,85080,0.00055899,127901065,0.840332
D.kanapiae,152203088,VNJM01000981.1,1,84967,0.000558248,127986032,0.84089
D.kanapiae,152203088,VNJM01003177.1,1,83745,0.000550219,128069777,0.84144
D.kanapiae,152203088,VNJM01001008.1,1,81633,0.000536343,128151410,0.841976
D.kanapiae,152203088,VNJM01001051.1,1,81273,0.000533977,128232683,0.84251
D.kanapiae,152203088,VNJM01000207.1,1,80905,0.00053156,128313588,0.843042
D.kanapiae,152203088,VNJM01001436.1,1,80900,0.000531527,128394488,0.843573
D.kanapiae,152203088,VNJM01003516.1,1,80126,0.000526441,128474614,0.8441
D.kanapiae,152203088,VNJM01003597.1,1,79934,0.00052518,128554548,0.844625
D.kanapiae,152203088,VNJM01000945.1,1,79738,0.000523892,128634286,0.845149
D.kanapiae,152203088,VNJM01001716.1,1,78860,0.000518124,128713146,0.845667
D.kanapiae,152203088,VNJM01001591.1,1,78547,0.000516067,128791693,0.846183
D.kanapiae,152203088,VNJM01002402.1,1,77039,0.000506159,128868732,0.846689
D.kanapiae,152203088,VNJM01002568.1,1,75893,0.00049863,128944625,0.847188
D.kanapiae,152203088,VNJM01002303.1,1,75490,0.000495982,129020115,0.847684
D.kanapiae,152203088,VNJM01002087.1,1,74114,0.000486942,129094229,0.848171
D.kanapiae,152203088,VNJM01002019.1,1,74062,0.0004866,129168291,0.848657
D.kanapiae,152203088,VNJM01003095.1,1,74043,0.000486475,129242334,0.849144
D.kanapiae,152203088,VNJM01002695.1,1,73654,0.000483919,129315988,0.849628
D.kanapiae,152203088,VNJM01001009.1,1,73560,0.000483302,129389548,0.850111
D.kanapiae,152203088,VNJM01001723.1,1,71135,0.000467369,129460683,0.850579
D.kanapiae,152203088,VNJM01002124.1,1,69363,0.000455727,129530046,0.851034
D.kanapiae,152203088,VNJM01000921.1,1,68856,0.000452396,129598902,0.851487
D.kanapiae,152203088,VNJM01000362.1,1,68177,0.000447934,129667079,0.851935
D.kanapiae,152203088,VNJM01003611.1,1,66823,0.000439038,129733902,0.852374
D.kanapiae,152203088,VNJM01000220.1,1,66711,0.000438303,129800613,0.852812
D.kanapiae,152203088,VNJM01002272.1,1,66538,0.000437166,129867151,0.853249
D.kanapiae,152203088,VNJM01002012.1,1,65346,0.000429334,129932497,0.853678
D.kanapiae,152203088,VNJM01003341.1,1,65127,0.000427895,129997624,0.854106
D.kanapiae,152203088,VNJM01000418.1,1,64898,0.000426391,130062522,0.854533
D.kanapiae,152203088,VNJM01000151.1,1,64347,0.000422771,130126869,0.854956
D.kanapiae,152203088,VNJM01001623.1,1,64235,0.000422035,130191104,0.855378
D.kanapiae,152203088,VNJM01001531.1,1,64052,0.000420832,130255156,0.855798
D.kanapiae,152203088,VNJM01002444.1,1,63937,0.000420077,130319093,0.856218
D.kanapiae,152203088,VNJM01000512.1,1,63850,0.000419505,130382943,0.856638
D.kanapiae,152203088,VNJM01002230.1,1,63277,0.000415741,130446220,0.857054
D.kanapiae,152203088,VNJM01002898.1,1,62938,0.000413513,130509158,0.857467
D.kanapiae,152203088,VNJM01001014.1,1,62463,0.000410392,130571621,0.857878
D.kanapiae,152203088,VNJM01002792.1,1,62447,0.000410287,130634068,0.858288
D.kanapiae,152203088,VNJM01002805.1,1,61761,0.00040578,130695829,0.858694
D.kanapiae,152203088,VNJM01001144.1,1,61663,0.000405136,130757492,0.859099
D.kanapiae,152203088,VNJM01001599.1,1,61165,0.000401864,130818657,0.859501
D.kanapiae,152203088,VNJM01002214.1,1,61057,0.000401155,130879714,0.859902
D.kanapiae,152203088,VNJM01003525.1,1,61053,0.000401129,130940767,0.860303
D.kanapiae,152203088,VNJM01001287.1,1,60819,0.000399591,131001586,0.860703
D.kanapiae,152203088,VNJM01003492.1,1,60772,0.000399282,131062358,0.861102
D.kanapiae,152203088,VNJM01002304.1,1,60110,0.000394933,131122468,0.861497
D.kanapiae,152203088,VNJM01001719.1,1,59918,0.000393671,131182386,0.86189
D.kanapiae,152203088,VNJM01000636.1,1,59671,0.000392049,131242057,0.862282
D.kanapiae,152203088,VNJM01001828.1,1,59649,0.000391904,131301706,0.862674
D.kanapiae,152203088,VNJM01000549.1,1,59568,0.000391372,131361274,0.863066
D.kanapiae,152203088,VNJM01000754.1,1,59318,0.000389729,131420592,0.863455
D.kanapiae,152203088,VNJM01003255.1,1,58440,0.000383961,131479032,0.863839
D.kanapiae,152203088,VNJM01001607.1,1,58230,0.000382581,131537262,0.864222
D.kanapiae,152203088,VNJM01001486.1,1,57887,0.000380327,131595149,0.864602
D.kanapiae,152203088,VNJM01002657.1,1,57407,0.000377174,131652556,0.86498
D.kanapiae,152203088,VNJM01002914.1,1,57146,0.000375459,131709702,0.865355
D.kanapiae,152203088,VNJM01002732.1,1,56964,0.000374263,131766666,0.865729
D.kanapiae,152203088,VNJM01002329.1,1,56918,0.000373961,131823584,0.866103
D.kanapiae,152203088,VNJM01000815.1,1,56550,0.000371543,131880134,0.866475
D.kanapiae,152203088,VNJM01003033.1,1,56484,0.000371109,131936618,0.866846
D.kanapiae,152203088,VNJM01000100.1,1,55168,0.000362463,131991786,0.867208
D.kanapiae,152203088,VNJM01001352.1,1,54964,0.000361123,132046750,0.867569
D.kanapiae,152203088,VNJM01003256.1,1,54615,0.00035883,132101365,0.867928
D.kanapiae,152203088,VNJM01001684.1,1,54343,0.000357043,132155708,0.868285
D.kanapiae,152203088,VNJM01002223.1,1,54244,0.000356392,132209952,0.868642
D.kanapiae,152203088,VNJM01000188.1,1,53812,0.000353554,132263764,0.868995
D.kanapiae,152203088,VNJM01000080.1,1,53621,0.000352299,132317385,0.869348
D.kanapiae,152203088,VNJM01002058.1,1,53544,0.000351793,132370929,0.869699
D.kanapiae,152203088,VNJM01003520.1,1,53482,0.000351386,132424411,0.870051
D.kanapiae,152203088,VNJM01002317.1,1,53433,0.000351064,132477844,0.870402
D.kanapiae,152203088,VNJM01001485.1,1,53259,0.000349921,132531103,0.870752
D.kanapiae,152203088,VNJM01002558.1,1,53091,0.000348817,132584194,0.871101
D.kanapiae,152203088,VNJM01001598.1,1,52770,0.000346708,132636964,0.871447
D.kanapiae,152203088,VNJM01002909.1,1,52595,0.000345558,132689559,0.871793
D.kanapiae,152203088,VNJM01002556.1,1,52457,0.000344651,132742016,0.872137
D.kanapiae,152203088,VNJM01002125.1,1,51702,0.000339691,132793718,0.872477
D.kanapiae,152203088,VNJM01000570.1,1,51227,0.00033657,132844945,0.872814
D.kanapiae,152203088,VNJM01003500.1,1,50756,0.000333475,132895701,0.873147
D.kanapiae,152203088,VNJM01001701.1,1,50721,0.000333246,132946422,0.87348
D.kanapiae,152203088,VNJM01000657.1,1,50551,0.000332129,132996973,0.873813
D.kanapiae,152203088,VNJM01001877.1,1,50432,0.000331347,133047405,0.874144
D.kanapiae,152203088,VNJM01003608.1,1,50198,0.000329809,133097603,0.874474
D.kanapiae,152203088,VNJM01001582.1,1,50063,0.000328922,133147666,0.874803
D.kanapiae,152203088,VNJM01002299.1,1,50018,0.000328627,133197684,0.875131
D.kanapiae,152203088,VNJM01002761.1,1,50006,0.000328548,133247690,0.87546
D.kanapiae,152203088,VNJM01000007.1,1,49677,0.000326386,133297367,0.875786
D.kanapiae,152203088,VNJM01001751.1,1,49136,0.000322832,133346503,0.876109
D.kanapiae,152203088,VNJM01001798.1,1,48739,0.000320223,133395242,0.876429
D.kanapiae,152203088,VNJM01002136.1,1,48626,0.000319481,133443868,0.876749
D.kanapiae,152203088,VNJM01000255.1,1,48228,0.000316866,133492096,0.877066
D.kanapiae,152203088,VNJM01000709.1,1,47966,0.000315145,133540062,0.877381
D.kanapiae,152203088,VNJM01002149.1,1,47877,0.00031456,133587939,0.877695
D.kanapiae,152203088,VNJM01002270.1,1,47408,0.000311479,133635347,0.878007
D.kanapiae,152203088,VNJM01001325.1,1,47269,0.000310565,133682616,0.878317
D.kanapiae,152203088,VNJM01002356.1,1,46974,0.000308627,133729590,0.878626
D.kanapiae,152203088,VNJM01001756.1,1,46524,0.000305671,133776114,0.878932
D.kanapiae,152203088,VNJM01003024.1,1,46452,0.000305197,133822566,0.879237
D.kanapiae,152203088,VNJM01002057.1,1,46386,0.000304764,133868952,0.879542
D.kanapiae,152203088,VNJM01003355.1,1,46164,0.000303305,133915116,0.879845
D.kanapiae,152203088,VNJM01000172.1,1,46121,0.000303023,133961237,0.880148
D.kanapiae,152203088,VNJM01002083.1,1,45754,0.000300612,134006991,0.880449
D.kanapiae,152203088,VNJM01000723.1,1,45677,0.000300106,134052668,0.880749
D.kanapiae,152203088,VNJM01001724.1,1,45465,0.000298713,134098133,0.881047
D.kanapiae,152203088,VNJM01001267.1,1,45208,0.000297024,134143341,0.881344
D.kanapiae,152203088,VNJM01003181.1,1,44990,0.000295592,134188331,0.88164
D.kanapiae,152203088,VNJM01003102.1,1,44138,0.000289994,134232469,0.88193
D.kanapiae,152203088,VNJM01002053.1,1,44065,0.000289514,134276534,0.88222
D.kanapiae,152203088,VNJM01002777.1,1,43877,0.000288279,134320411,0.882508
D.kanapiae,152203088,VNJM01002345.1,1,43598,0.000286446,134364009,0.882794
D.kanapiae,152203088,VNJM01001061.1,1,43397,0.000285126,134407406,0.883079
D.kanapiae,152203088,VNJM01001027.1,1,43348,0.000284804,134450754,0.883364
D.kanapiae,152203088,VNJM01001241.1,1,43086,0.000283082,134493840,0.883647
D.kanapiae,152203088,VNJM01000150.1,1,42912,0.000281939,134536752,0.883929
D.kanapiae,152203088,VNJM01003367.1,1,42750,0.000280875,134579502,0.88421
D.kanapiae,152203088,VNJM01003260.1,1,42707,0.000280592,134622209,0.884491
D.kanapiae,152203088,VNJM01003295.1,1,42346,0.00027822,134664555,0.884769
D.kanapiae,152203088,VNJM01000279.1,1,42128,0.000276788,134706683,0.885046
D.kanapiae,152203088,VNJM01002617.1,1,41783,0.000274521,134748466,0.88532
D.kanapiae,152203088,VNJM01001515.1,1,41608,0.000273372,134790074,0.885594
D.kanapiae,152203088,VNJM01000157.1,1,41410,0.000272071,134831484,0.885866
D.kanapiae,152203088,VNJM01002384.1,1,41284,0.000271243,134872768,0.886137
D.kanapiae,152203088,VNJM01002122.1,1,41220,0.000270822,134913988,0.886408
D.kanapiae,152203088,VNJM01002443.1,1,40824,0.000268221,134954812,0.886676
D.kanapiae,152203088,VNJM01002131.1,1,40455,0.000265796,134995267,0.886942
D.kanapiae,152203088,VNJM01003185.1,1,40408,0.000265487,135035675,0.887207
D.kanapiae,152203088,VNJM01000489.1,1,40327,0.000264955,135076002,0.887472
D.kanapiae,152203088,VNJM01003523.1,1,40325,0.000264942,135116327,0.887737
D.kanapiae,152203088,VNJM01002307.1,1,40164,0.000263884,135156491,0.888001
D.kanapiae,152203088,VNJM01000797.1,1,39953,0.000262498,135196444,0.888263
D.kanapiae,152203088,VNJM01000202.1,1,39513,0.000259607,135235957,0.888523
D.kanapiae,152203088,VNJM01001848.1,1,39198,0.000257537,135275155,0.888781
D.kanapiae,152203088,VNJM01002708.1,1,39157,0.000257268,135314312,0.889038
D.kanapiae,152203088,VNJM01001048.1,1,38983,0.000256125,135353295,0.889294
D.kanapiae,152203088,VNJM01001638.1,1,38969,0.000256033,135392264,0.88955
D.kanapiae,152203088,VNJM01002507.1,1,38816,0.000255028,135431080,0.889805
D.kanapiae,152203088,VNJM01000445.1,1,38747,0.000254574,135469827,0.89006
D.kanapiae,152203088,VNJM01003258.1,1,38618,0.000253727,135508445,0.890313
D.kanapiae,152203088,VNJM01001603.1,1,38096,0.000250297,135546541,0.890564
D.kanapiae,152203088,VNJM01001753.1,1,37630,0.000247235,135584171,0.890811
D.kanapiae,152203088,VNJM01000532.1,1,37274,0.000244896,135621445,0.891056
D.kanapiae,152203088,VNJM01003435.1,1,37205,0.000244443,135658650,0.8913
D.kanapiae,152203088,VNJM01000883.1,1,36871,0.000242249,135695521,0.891542
D.kanapiae,152203088,VNJM01003205.1,1,36217,0.000237952,135731738,0.89178
D.kanapiae,152203088,VNJM01001552.1,1,36202,0.000237853,135767940,0.892018
D.kanapiae,152203088,VNJM01000247.1,1,36049,0.000236848,135803989,0.892255
D.kanapiae,152203088,VNJM01000411.1,1,35729,0.000234746,135839718,0.89249
D.kanapiae,152203088,VNJM01003340.1,1,35676,0.000234397,135875394,0.892724
D.kanapiae,152203088,VNJM01002022.1,1,35573,0.000233721,135910967,0.892958
D.kanapiae,152203088,VNJM01002376.1,1,35533,0.000233458,135946500,0.893191
D.kanapiae,152203088,VNJM01002047.1,1,35529,0.000233432,135982029,0.893425
D.kanapiae,152203088,VNJM01001367.1,1,35498,0.000233228,136017527,0.893658
D.kanapiae,152203088,VNJM01001080.1,1,35408,0.000232637,136052935,0.893891
D.kanapiae,152203088,VNJM01003344.1,1,35163,0.000231027,136088098,0.894122
D.kanapiae,152203088,VNJM01000470.1,1,35160,0.000231007,136123258,0.894353
D.kanapiae,152203088,VNJM01001978.1,1,34934,0.000229522,136158192,0.894582
D.kanapiae,152203088,VNJM01001493.1,1,34927,0.000229476,136193119,0.894812
D.kanapiae,152203088,VNJM01003343.1,1,34923,0.00022945,136228042,0.895041
D.kanapiae,152203088,VNJM01002887.1,1,34887,0.000229213,136262929,0.89527
D.kanapiae,152203088,VNJM01000640.1,1,34740,0.000228248,136297669,0.895499
D.kanapiae,152203088,VNJM01003618.1,1,34728,0.000228169,136332397,0.895727
D.kanapiae,152203088,VNJM01000446.1,1,34555,0.000227032,136366952,0.895954
D.kanapiae,152203088,VNJM01003596.1,1,34314,0.000225449,136401266,0.896179
D.kanapiae,152203088,VNJM01000531.1,1,34208,0.000224752,136435474,0.896404
D.kanapiae,152203088,VNJM01002756.1,1,34141,0.000224312,136469615,0.896628
D.kanapiae,152203088,VNJM01003385.1,1,34060,0.00022378,136503675,0.896852
D.kanapiae,152203088,VNJM01002129.1,1,34001,0.000223392,136537676,0.897076
D.kanapiae,152203088,VNJM01003377.1,1,33759,0.000221802,136571435,0.897297
D.kanapiae,152203088,VNJM01002322.1,1,33580,0.000220626,136605015,0.897518
D.kanapiae,152203088,VNJM01001491.1,1,33416,0.000219549,136638431,0.897738
D.kanapiae,152203088,VNJM01001528.1,1,33360,0.000219181,136671791,0.897957
D.kanapiae,152203088,VNJM01001802.1,1,33329,0.000218977,136705120,0.898176
D.kanapiae,152203088,VNJM01000689.1,1,33262,0.000218537,136738382,0.898394
D.kanapiae,152203088,VNJM01000482.1,1,33211,0.000218202,136771593,0.898612
D.kanapiae,152203088,VNJM01000750.1,1,33142,0.000217749,136804735,0.89883
D.kanapiae,152203088,VNJM01001235.1,1,32643,0.00021447,136837378,0.899045
D.kanapiae,152203088,VNJM01001003.1,1,32320,0.000212348,136869698,0.899257
D.kanapiae,152203088,VNJM01001862.1,1,32279,0.000212078,136901977,0.899469
D.kanapiae,152203088,VNJM01001313.1,1,32084,0.000210797,136934061,0.89968
D.kanapiae,152203088,VNJM01000861.1,1,32002,0.000210259,136966063,0.89989
D.kanapiae,152203088,VNJM01002725.1,1,31933,0.000209805,136997996,0.9001
D.kanapiae,152203088,VNJM01001882.1,1,31748,0.00020859,137029744,0.900309
D.kanapiae,152203088,VNJM01001809.1,1,31674,0.000208104,137061418,0.900517
D.kanapiae,152203088,VNJM01003572.1,1,31558,0.000207341,137092976,0.900724
D.kanapiae,152203088,VNJM01001065.1,1,31086,0.00020424,137124062,0.900928
D.kanapiae,152203088,VNJM01002488.1,1,31000,0.000203675,137155062,0.901132
D.kanapiae,152203088,VNJM01002226.1,1,30999,0.000203669,137186061,0.901336
D.kanapiae,152203088,VNJM01001744.1,1,30405,0.000199766,137216466,0.901535
D.kanapiae,152203088,VNJM01000158.1,1,30388,0.000199654,137246854,0.901735
D.kanapiae,152203088,VNJM01002769.1,1,30231,0.000198623,137277085,0.901934
D.kanapiae,152203088,VNJM01003631.1,1,30009,0.000197164,137307094,0.902131
D.kanapiae,152203088,VNJM01000442.1,1,29922,0.000196593,137337016,0.902327
D.kanapiae,152203088,VNJM01000902.1,1,29801,0.000195798,137366817,0.902523
D.kanapiae,152203088,VNJM01001496.1,1,29713,0.000195219,137396530,0.902718
D.kanapiae,152203088,VNJM01003180.1,1,29682,0.000195016,137426212,0.902913
D.kanapiae,152203088,VNJM01002961.1,1,29637,0.00019472,137455849,0.903108
D.kanapiae,152203088,VNJM01003071.1,1,29580,0.000194346,137485429,0.903302
D.kanapiae,152203088,VNJM01001871.1,1,29546,0.000194122,137514975,0.903497
D.kanapiae,152203088,VNJM01000561.1,1,29450,0.000193491,137544425,0.90369
D.kanapiae,152203088,VNJM01000416.1,1,29346,0.000192808,137573771,0.903883
D.kanapiae,152203088,VNJM01003278.1,1,29342,0.000192782,137603113,0.904076
D.kanapiae,152203088,VNJM01001941.1,1,29251,0.000192184,137632364,0.904268
D.kanapiae,152203088,VNJM01001094.1,1,29212,0.000191928,137661576,0.90446
D.kanapiae,152203088,VNJM01000535.1,1,29133,0.000191409,137690709,0.904651
D.kanapiae,152203088,VNJM01002314.1,1,29063,0.000190949,137719772,0.904842
D.kanapiae,152203088,VNJM01003508.1,1,28608,0.000187959,137748380,0.90503
D.kanapiae,152203088,VNJM01003056.1,1,28502,0.000187263,137776882,0.905217
D.kanapiae,152203088,VNJM01001150.1,1,28458,0.000186974,137805340,0.905404
D.kanapiae,152203088,VNJM01000425.1,1,28279,0.000185798,137833619,0.90559
D.kanapiae,152203088,VNJM01000538.1,1,28068,0.000184412,137861687,0.905775
D.kanapiae,152203088,VNJM01001914.1,1,27999,0.000183958,137889686,0.905959
D.kanapiae,152203088,VNJM01002243.1,1,27975,0.0001838,137917661,0.906142
D.kanapiae,152203088,VNJM01003524.1,1,27776,0.000182493,137945437,0.906325
D.kanapiae,152203088,VNJM01001373.1,1,27773,0.000182473,137973210,0.906507
D.kanapiae,152203088,VNJM01001481.1,1,27766,0.000182427,138000976,0.90669
D.kanapiae,152203088,VNJM01002555.1,1,27649,0.000181659,138028625,0.906871
D.kanapiae,152203088,VNJM01000537.1,1,27616,0.000181442,138056241,0.907053
D.kanapiae,152203088,VNJM01002752.1,1,27289,0.000179293,138083530,0.907232
D.kanapiae,152203088,VNJM01002264.1,1,27040,0.000177657,138110570,0.90741
D.kanapiae,152203088,VNJM01000109.1,1,26872,0.000176554,138137442,0.907586
D.kanapiae,152203088,VNJM01000574.1,1,26812,0.000176159,138164254,0.907762
D.kanapiae,152203088,VNJM01000274.1,1,26663,0.00017518,138190917,0.907938
D.kanapiae,152203088,VNJM01000719.1,1,26655,0.000175128,138217572,0.908113
D.kanapiae,152203088,VNJM01003176.1,1,26545,0.000174405,138244117,0.908287
D.kanapiae,152203088,VNJM01000970.1,1,26495,0.000174077,138270612,0.908461
D.kanapiae,152203088,VNJM01002192.1,1,26408,0.000173505,138297020,0.908635
D.kanapiae,152203088,VNJM01002250.1,1,26246,0.000172441,138323266,0.908807
D.kanapiae,152203088,VNJM01002634.1,1,26031,0.000171028,138349297,0.908978
D.kanapiae,152203088,VNJM01000839.1,1,25931,0.000170371,138375228,0.909149
D.kanapiae,152203088,VNJM01000556.1,1,25828,0.000169694,138401056,0.909318
D.kanapiae,152203088,VNJM01001885.1,1,25777,0.000169359,138426833,0.909488
D.kanapiae,152203088,VNJM01000539.1,1,25662,0.000168604,138452495,0.909656
D.kanapiae,152203088,VNJM01000748.1,1,25600,0.000168196,138478095,0.909824
D.kanapiae,152203088,VNJM01000790.1,1,25543,0.000167822,138503638,0.909992
D.kanapiae,152203088,VNJM01000929.1,1,25422,0.000167027,138529060,0.910159
D.kanapiae,152203088,VNJM01001266.1,1,25382,0.000166764,138554442,0.910326
D.kanapiae,152203088,VNJM01000853.1,1,25286,0.000166133,138579728,0.910492
D.kanapiae,152203088,VNJM01000515.1,1,25150,0.00016524,138604878,0.910657
D.kanapiae,152203088,VNJM01001077.1,1,25128,0.000165095,138630006,0.910823
D.kanapiae,152203088,VNJM01003060.1,1,25100,0.000164911,138655106,0.910987
D.kanapiae,152203088,VNJM01002339.1,1,24963,0.000164011,138680069,0.911151
D.kanapiae,152203088,VNJM01000997.1,1,24783,0.000162828,138704852,0.911314
D.kanapiae,152203088,VNJM01003449.1,1,24760,0.000162677,138729612,0.911477
D.kanapiae,152203088,VNJM01000768.1,1,24752,0.000162625,138754364,0.91164
D.kanapiae,152203088,VNJM01000039.1,1,24704,0.000162309,138779068,0.911802
D.kanapiae,152203088,VNJM01001368.1,1,24619,0.000161751,138803687,0.911964
D.kanapiae,152203088,VNJM01002035.1,1,24465,0.000160739,138828152,0.912124
D.kanapiae,152203088,VNJM01003131.1,1,24384,0.000160207,138852536,0.912285
D.kanapiae,152203088,VNJM01000163.1,1,24384,0.000160207,138876920,0.912445
D.kanapiae,152203088,VNJM01000413.1,1,24329,0.000159846,138901249,0.912605
D.kanapiae,152203088,VNJM01001039.1,1,24007,0.00015773,138925256,0.912762
D.kanapiae,152203088,VNJM01000304.1,1,23869,0.000156823,138949125,0.912919
D.kanapiae,152203088,VNJM01002755.1,1,23646,0.000155358,138972771,0.913075
D.kanapiae,152203088,VNJM01003485.1,1,23489,0.000154327,138996260,0.913229
D.kanapiae,152203088,VNJM01000289.1,1,23454,0.000154097,139019714,0.913383
D.kanapiae,152203088,VNJM01000430.1,1,23310,0.000153151,139043024,0.913536
D.kanapiae,152203088,VNJM01000808.1,1,23296,0.000153059,139066320,0.913689
D.kanapiae,152203088,VNJM01001343.1,1,23131,0.000151975,139089451,0.913841
D.kanapiae,152203088,VNJM01000798.1,1,23094,0.000151731,139112545,0.913993
D.kanapiae,152203088,VNJM01000231.1,1,22872,0.000150273,139135417,0.914143
D.kanapiae,152203088,VNJM01002491.1,1,22735,0.000149373,139158152,0.914293
D.kanapiae,152203088,VNJM01002911.1,1,22615,0.000148584,139180767,0.914441
D.kanapiae,152203088,VNJM01001437.1,1,22563,0.000148243,139203330,0.914589
D.kanapiae,152203088,VNJM01001770.1,1,22437,0.000147415,139225767,0.914737
D.kanapiae,152203088,VNJM01001340.1,1,22379,0.000147034,139248146,0.914884
D.kanapiae,152203088,VNJM01002389.1,1,22257,0.000146232,139270403,0.91503
D.kanapiae,152203088,VNJM01001037.1,1,22189,0.000145785,139292592,0.915176
D.kanapiae,152203088,VNJM01003420.1,1,22004,0.00014457,139314596,0.91532
D.kanapiae,152203088,VNJM01000366.1,1,21975,0.000144379,139336571,0.915465
D.kanapiae,152203088,VNJM01001285.1,1,21965,0.000144314,139358536,0.915609
D.kanapiae,152203088,VNJM01000812.1,1,21729,0.000142763,139380265,0.915752
D.kanapiae,152203088,VNJM01001007.1,1,21640,0.000142178,139401905,0.915894
D.kanapiae,152203088,VNJM01002172.1,1,21562,0.000141666,139423467,0.916036
D.kanapiae,152203088,VNJM01001796.1,1,21497,0.000141239,139444964,0.916177
D.kanapiae,152203088,VNJM01000243.1,1,21495,0.000141226,139466459,0.916318
D.kanapiae,152203088,VNJM01000767.1,1,21389,0.000140529,139487848,0.916459
D.kanapiae,152203088,VNJM01002265.1,1,21382,0.000140483,139509230,0.916599
D.kanapiae,152203088,VNJM01000312.1,1,21361,0.000140345,139530591,0.91674
D.kanapiae,152203088,VNJM01002498.1,1,21209,0.000139347,139551800,0.916879
D.kanapiae,152203088,VNJM01000484.1,1,21171,0.000139097,139572971,0.917018
D.kanapiae,152203088,VNJM01003222.1,1,21122,0.000138775,139594093,0.917157
D.kanapiae,152203088,VNJM01000855.1,1,21084,0.000138525,139615177,0.917295
D.kanapiae,152203088,VNJM01001186.1,1,20914,0.000137409,139636091,0.917433
D.kanapiae,152203088,VNJM01000292.1,1,20897,0.000137297,139656988,0.91757
D.kanapiae,152203088,VNJM01003384.1,1,20875,0.000137152,139677863,0.917707
D.kanapiae,152203088,VNJM01003375.1,1,20803,0.000136679,139698666,0.917844
D.kanapiae,152203088,VNJM01001855.1,1,20797,0.00013664,139719463,0.91798
D.kanapiae,152203088,VNJM01002954.1,1,20666,0.000135779,139740129,0.918116
D.kanapiae,152203088,VNJM01002678.1,1,20664,0.000135766,139760793,0.918252
D.kanapiae,152203088,VNJM01003388.1,1,20603,0.000135365,139781396,0.918387
D.kanapiae,152203088,VNJM01002922.1,1,20530,0.000134886,139801926,0.918522
D.kanapiae,152203088,VNJM01000414.1,1,20474,0.000134518,139822400,0.918657
D.kanapiae,152203088,VNJM01002036.1,1,20444,0.000134321,139842844,0.918791
D.kanapiae,152203088,VNJM01000835.1,1,20325,0.000133539,139863169,0.918925
D.kanapiae,152203088,VNJM01003544.1,1,20244,0.000133006,139883413,0.919058
D.kanapiae,152203088,VNJM01003132.1,1,20189,0.000132645,139903602,0.91919
D.kanapiae,152203088,VNJM01003150.1,1,20059,0.000131791,139923661,0.919322
D.kanapiae,152203088,VNJM01001482.1,1,20020,0.000131535,139943681,0.919454
D.kanapiae,152203088,VNJM01002775.1,1,20006,0.000131443,139963687,0.919585
D.kanapiae,152203088,VNJM01000553.1,1,19989,0.000131331,139983676,0.919716
D.kanapiae,152203088,VNJM01002338.1,1,19867,0.00013053,140003543,0.919847
D.kanapiae,152203088,VNJM01003195.1,1,19815,0.000130188,140023358,0.919977
D.kanapiae,152203088,VNJM01003117.1,1,19788,0.000130011,140043146,0.920107
D.kanapiae,152203088,VNJM01002475.1,1,19723,0.000129583,140062869,0.920237
D.kanapiae,152203088,VNJM01000434.1,1,19715,0.000129531,140082584,0.920366
D.kanapiae,152203088,VNJM01002671.1,1,19627,0.000128953,140102211,0.920495
D.kanapiae,152203088,VNJM01002851.1,1,19597,0.000128756,140121808,0.920624
D.kanapiae,152203088,VNJM01002968.1,1,19539,0.000128375,140141347,0.920752
D.kanapiae,152203088,VNJM01002876.1,1,19419,0.000127586,140160766,0.92088
D.kanapiae,152203088,VNJM01002699.1,1,19374,0.00012729,140180140,0.921007
D.kanapiae,152203088,VNJM01000528.1,1,19345,0.0001271,140199485,0.921134
D.kanapiae,152203088,VNJM01000762.1,1,19330,0.000127001,140218815,0.921261
D.kanapiae,152203088,VNJM01002894.1,1,19302,0.000126817,140238117,0.921388
D.kanapiae,152203088,VNJM01002056.1,1,19293,0.000126758,140257410,0.921515
D.kanapiae,152203088,VNJM01000860.1,1,19247,0.000126456,140276657,0.921641
D.kanapiae,152203088,VNJM01003609.1,1,19109,0.000125549,140295766,0.921767
D.kanapiae,152203088,VNJM01001667.1,1,19046,0.000125135,140314812,0.921892
D.kanapiae,152203088,VNJM01000028.1,1,19045,0.000125129,140333857,0.922017
D.kanapiae,152203088,VNJM01000994.1,1,19027,0.000125011,140352884,0.922142
D.kanapiae,152203088,VNJM01000002.1,1,18955,0.000124538,140371839,0.922267
D.kanapiae,152203088,VNJM01001281.1,1,18897,0.000124156,140390736,0.922391
D.kanapiae,152203088,VNJM01001573.1,1,18868,0.000123966,140409604,0.922515
D.kanapiae,152203088,VNJM01000491.1,1,18849,0.000123841,140428453,0.922639
D.kanapiae,152203088,VNJM01002175.1,1,18817,0.000123631,140447270,0.922762
D.kanapiae,152203088,VNJM01001038.1,1,18787,0.000123434,140466057,0.922886
D.kanapiae,152203088,VNJM01003607.1,1,18768,0.000123309,140484825,0.923009
D.kanapiae,152203088,VNJM01000733.1,1,18748,0.000123178,140503573,0.923132
D.kanapiae,152203088,VNJM01001483.1,1,18655,0.000122567,140522228,0.923255
D.kanapiae,152203088,VNJM01002649.1,1,18607,0.000122251,140540835,0.923377
D.kanapiae,152203088,VNJM01000752.1,1,18595,0.000122172,140559430,0.923499
D.kanapiae,152203088,VNJM01002130.1,1,18516,0.000121653,140577946,0.923621
D.kanapiae,152203088,VNJM01000587.1,1,18461,0.000121292,140596407,0.923742
D.kanapiae,152203088,VNJM01001755.1,1,18329,0.000120425,140614736,0.923863
D.kanapiae,152203088,VNJM01000984.1,1,18306,0.000120274,140633042,0.923983
D.kanapiae,152203088,VNJM01002135.1,1,18294,0.000120195,140651336,0.924103
D.kanapiae,152203088,VNJM01002490.1,1,18260,0.000119971,140669596,0.924223
D.kanapiae,152203088,VNJM01001023.1,1,18217,0.000119689,140687813,0.924343
D.kanapiae,152203088,VNJM01001292.1,1,18079,0.000118782,140705892,0.924461
D.kanapiae,152203088,VNJM01000053.1,1,18005,0.000118296,140723897,0.92458
D.kanapiae,152203088,VNJM01003412.1,1,17959,0.000117994,140741856,0.924698
D.kanapiae,152203088,VNJM01000792.1,1,17927,0.000117783,140759783,0.924816
D.kanapiae,152203088,VNJM01000843.1,1,17864,0.000117369,140777647,0.924933
D.kanapiae,152203088,VNJM01000084.1,1,17828,0.000117133,140795475,0.92505
D.kanapiae,152203088,VNJM01001484.1,1,17825,0.000117113,140813300,0.925167
D.kanapiae,152203088,VNJM01000475.1,1,17730,0.000116489,140831030,0.925284
D.kanapiae,152203088,VNJM01002310.1,1,17708,0.000116345,140848738,0.9254
D.kanapiae,152203088,VNJM01003051.1,1,17652,0.000115977,140866390,0.925516
D.kanapiae,152203088,VNJM01002110.1,1,17635,0.000115865,140884025,0.925632
D.kanapiae,152203088,VNJM01000793.1,1,17562,0.000115385,140901587,0.925747
D.kanapiae,152203088,VNJM01001852.1,1,17561,0.000115379,140919148,0.925863
D.kanapiae,152203088,VNJM01003475.1,1,17386,0.000114229,140936534,0.925977
D.kanapiae,152203088,VNJM01001794.1,1,17360,0.000114058,140953894,0.926091
D.kanapiae,152203088,VNJM01000339.1,1,17335,0.000113894,140971229,0.926205
D.kanapiae,152203088,VNJM01002357.1,1,17220,0.000113138,140988449,0.926318
D.kanapiae,152203088,VNJM01002341.1,1,17193,0.000112961,141005642,0.926431
D.kanapiae,152203088,VNJM01002599.1,1,17147,0.000112659,141022789,0.926544
D.kanapiae,152203088,VNJM01000306.1,1,17137,0.000112593,141039926,0.926656
D.kanapiae,152203088,VNJM01001860.1,1,17136,0.000112586,141057062,0.926769
D.kanapiae,152203088,VNJM01002786.1,1,17057,0.000112067,141074119,0.926881
D.kanapiae,152203088,VNJM01003025.1,1,17032,0.000111903,141091151,0.926993
D.kanapiae,152203088,VNJM01001394.1,1,16884,0.000110931,141108035,0.927104
D.kanapiae,152203088,VNJM01001323.1,1,16549,0.00010873,141124584,0.927212
D.kanapiae,152203088,VNJM01000211.1,1,16513,0.000108493,141141097,0.927321
D.kanapiae,152203088,VNJM01002225.1,1,16507,0.000108454,141157604,0.927429
D.kanapiae,152203088,VNJM01003053.1,1,16500,0.000108408,141174104,0.927538
D.kanapiae,152203088,VNJM01002701.1,1,16496,0.000108382,141190600,0.927646
D.kanapiae,152203088,VNJM01001526.1,1,16472,0.000108224,141207072,0.927754
D.kanapiae,152203088,VNJM01001002.1,1,16443,0.000108033,141223515,0.927862
D.kanapiae,152203088,VNJM01003204.1,1,16428,0.000107935,141239943,0.92797
D.kanapiae,152203088,VNJM01003614.1,1,16393,0.000107705,141256336,0.928078
D.kanapiae,152203088,VNJM01001211.1,1,16382,0.000107633,141272718,0.928186
D.kanapiae,152203088,VNJM01003061.1,1,16374,0.00010758,141289092,0.928293
D.kanapiae,152203088,VNJM01003154.1,1,16338,0.000107343,141305430,0.928401
D.kanapiae,152203088,VNJM01001214.1,1,16299,0.000107087,141321729,0.928508
D.kanapiae,152203088,VNJM01002319.1,1,16264,0.000106857,141337993,0.928614
D.kanapiae,152203088,VNJM01000541.1,1,16219,0.000106562,141354212,0.928721
D.kanapiae,152203088,VNJM01001016.1,1,16143,0.000106062,141370355,0.928827
D.kanapiae,152203088,VNJM01003546.1,1,16135,0.00010601,141386490,0.928933
D.kanapiae,152203088,VNJM01002957.1,1,16134,0.000106003,141402624,0.929039
D.kanapiae,152203088,VNJM01000040.1,1,16077,0.000105629,141418701,0.929145
D.kanapiae,152203088,VNJM01001754.1,1,16076,0.000105622,141434777,0.92925
D.kanapiae,152203088,VNJM01000940.1,1,16073,0.000105602,141450850,0.929356
D.kanapiae,152203088,VNJM01000182.1,1,16015,0.000105221,141466865,0.929461
D.kanapiae,152203088,VNJM01000822.1,1,15994,0.000105083,141482859,0.929566
D.kanapiae,152203088,VNJM01003143.1,1,15978,0.000104978,141498837,0.929671
D.kanapiae,152203088,VNJM01003370.1,1,15969,0.000104919,141514806,0.929776
D.kanapiae,152203088,VNJM01001521.1,1,15856,0.000104177,141530662,0.92988
D.kanapiae,152203088,VNJM01000310.1,1,15827,0.000103986,141546489,0.929984
D.kanapiae,152203088,VNJM01001760.1,1,15789,0.000103736,141562278,0.930088
D.kanapiae,152203088,VNJM01001332.1,1,15689,0.000103079,141577967,0.930191
D.kanapiae,152203088,VNJM01002828.1,1,15674,0.000102981,141593641,0.930294
D.kanapiae,152203088,VNJM01001563.1,1,15641,0.000102764,141609282,0.930397
D.kanapiae,152203088,VNJM01003122.1,1,15604,0.000102521,141624886,0.930499
D.kanapiae,152203088,VNJM01002086.1,1,15574,0.000102324,141640460,0.930602
D.kanapiae,152203088,VNJM01000770.1,1,15550,0.000102166,141656010,0.930704
D.kanapiae,152203088,VNJM01001232.1,1,15516,0.000101943,141671526,0.930806
D.kanapiae,152203088,VNJM01001032.1,1,15502,0.000101851,141687028,0.930908
D.kanapiae,152203088,VNJM01003391.1,1,15466,0.000101614,141702494,0.931009
D.kanapiae,152203088,VNJM01002672.1,1,15359,0.000100911,141717853,0.93111
D.kanapiae,152203088,VNJM01000858.1,1,15351,0.000100859,141733204,0.931211
D.kanapiae,152203088,VNJM01000317.1,1,15343,0.000100806,141748547,0.931312
D.kanapiae,152203088,VNJM01000869.1,1,15337,0.000100767,141763884,0.931413
D.kanapiae,152203088,VNJM01002508.1,1,15248,0.000100182,141779132,0.931513
D.kanapiae,152203088,VNJM01001737.1,1,15163,9.96235e-05,141794295,0.931612
D.kanapiae,152203088,VNJM01000983.1,1,15051,9.88876e-05,141809346,0.931711
D.kanapiae,152203088,VNJM01003190.1,1,15036,9.87891e-05,141824382,0.93181
D.kanapiae,152203088,VNJM01002497.1,1,14981,9.84277e-05,141839363,0.931909
D.kanapiae,152203088,VNJM01000778.1,1,14978,9.8408e-05,141854341,0.932007
D.kanapiae,152203088,VNJM01001336.1,1,14973,9.83751e-05,141869314,0.932105
D.kanapiae,152203088,VNJM01002949.1,1,14954,9.82503e-05,141884268,0.932204
D.kanapiae,152203088,VNJM01000200.1,1,14797,9.72188e-05,141899065,0.932301
D.kanapiae,152203088,VNJM01000810.1,1,14789,9.71662e-05,141913854,0.932398
D.kanapiae,152203088,VNJM01000696.1,1,14788,9.71597e-05,141928642,0.932495
D.kanapiae,152203088,VNJM01002839.1,1,14677,9.64304e-05,141943319,0.932592
D.kanapiae,152203088,VNJM01002371.1,1,14668,9.63712e-05,141957987,0.932688
D.kanapiae,152203088,VNJM01001460.1,1,14607,9.59705e-05,141972594,0.932784
D.kanapiae,152203088,VNJM01002091.1,1,14579,9.57865e-05,141987173,0.93288
D.kanapiae,152203088,VNJM01003104.1,1,14548,9.55828e-05,142001721,0.932975
D.kanapiae,152203088,VNJM01001212.1,1,14534,9.54908e-05,142016255,0.933071
D.kanapiae,152203088,VNJM01001010.1,1,14530,9.54646e-05,142030785,0.933166
D.kanapiae,152203088,VNJM01002891.1,1,14526,9.54383e-05,142045311,0.933262
D.kanapiae,152203088,VNJM01001758.1,1,14511,9.53397e-05,142059822,0.933357
D.kanapiae,152203088,VNJM01003028.1,1,14406,9.46499e-05,142074228,0.933452
D.kanapiae,152203088,VNJM01001031.1,1,14393,9.45644e-05,142088621,0.933546
D.kanapiae,152203088,VNJM01002636.1,1,14391,9.45513e-05,142103012,0.933641
D.kanapiae,152203088,VNJM01001759.1,1,14370,9.44133e-05,142117382,0.933735
D.kanapiae,152203088,VNJM01000980.1,1,14367,9.43936e-05,142131749,0.93383
D.kanapiae,152203088,VNJM01000978.1,1,14253,9.36446e-05,142146002,0.933923
D.kanapiae,152203088,VNJM01003098.1,1,14180,9.3165e-05,142160182,0.934016
D.kanapiae,152203088,VNJM01000941.1,1,14080,9.2508e-05,142174262,0.934109
D.kanapiae,152203088,VNJM01002366.1,1,14028,9.21663e-05,142188290,0.934201
D.kanapiae,152203088,VNJM01001513.1,1,13879,9.11874e-05,142202169,0.934292
D.kanapiae,152203088,VNJM01001664.1,1,13794,9.06289e-05,142215963,0.934383
D.kanapiae,152203088,VNJM01001562.1,1,13790,9.06026e-05,142229753,0.934474
D.kanapiae,152203088,VNJM01000985.1,1,13769,9.04647e-05,142243522,0.934564
D.kanapiae,152203088,VNJM01003473.1,1,13749,9.03333e-05,142257271,0.934654
D.kanapiae,152203088,VNJM01002381.1,1,13647,8.96631e-05,142270918,0.934744
D.kanapiae,152203088,VNJM01000663.1,1,13644,8.96434e-05,142284562,0.934834
D.kanapiae,152203088,VNJM01001766.1,1,13618,8.94726e-05,142298180,0.934923
D.kanapiae,152203088,VNJM01003442.1,1,13599,8.93477e-05,142311779,0.935012
D.kanapiae,152203088,VNJM01000977.1,1,13592,8.93017e-05,142325371,0.935102
D.kanapiae,152203088,VNJM01000008.1,1,13502,8.87104e-05,142338873,0.93519
D.kanapiae,152203088,VNJM01001699.1,1,13409,8.80994e-05,142352282,0.935279
D.kanapiae,152203088,VNJM01000431.1,1,13407,8.80863e-05,142365689,0.935367
D.kanapiae,152203088,VNJM01002055.1,1,13379,8.79023e-05,142379068,0.935455
D.kanapiae,152203088,VNJM01002526.1,1,13359,8.77709e-05,142392427,0.935542
D.kanapiae,152203088,VNJM01003633.1,1,13293,8.73373e-05,142405720,0.93563
D.kanapiae,152203088,VNJM01001712.1,1,13237,8.69693e-05,142418957,0.935717
D.kanapiae,152203088,VNJM01002600.1,1,13172,8.65423e-05,142432129,0.935803
D.kanapiae,152203088,VNJM01001477.1,1,13137,8.63123e-05,142445266,0.935889
D.kanapiae,152203088,VNJM01000772.1,1,13095,8.60364e-05,142458361,0.935975
D.kanapiae,152203088,VNJM01002333.1,1,13069,8.58655e-05,142471430,0.936061
D.kanapiae,152203088,VNJM01000236.1,1,12991,8.53531e-05,142484421,0.936147
D.kanapiae,152203088,VNJM01000628.1,1,12896,8.47289e-05,142497317,0.936231
D.kanapiae,152203088,VNJM01002003.1,1,12884,8.46501e-05,142510201,0.936316
D.kanapiae,152203088,VNJM01001970.1,1,12860,8.44924e-05,142523061,0.936401
D.kanapiae,152203088,VNJM01002154.1,1,12786,8.40062e-05,142535847,0.936485
D.kanapiae,152203088,VNJM01002748.1,1,12772,8.39142e-05,142548619,0.936569
D.kanapiae,152203088,VNJM01000237.1,1,12772,8.39142e-05,142561391,0.936652
D.kanapiae,152203088,VNJM01001348.1,1,12699,8.34346e-05,142574090,0.936736
D.kanapiae,152203088,VNJM01003603.1,1,12583,8.26724e-05,142586673,0.936819
D.kanapiae,152203088,VNJM01001117.1,1,12565,8.25542e-05,142599238,0.936901
D.kanapiae,152203088,VNJM01002364.1,1,12536,8.23636e-05,142611774,0.936983
D.kanapiae,152203088,VNJM01001942.1,1,12454,8.18249e-05,142624228,0.937065
D.kanapiae,152203088,VNJM01002650.1,1,12394,8.14307e-05,142636622,0.937147
D.kanapiae,152203088,VNJM01001537.1,1,12364,8.12336e-05,142648986,0.937228
D.kanapiae,152203088,VNJM01001219.1,1,12325,8.09773e-05,142661311,0.937309
D.kanapiae,152203088,VNJM01003219.1,1,12310,8.08788e-05,142673621,0.93739
D.kanapiae,152203088,VNJM01001835.1,1,12298,8.07999e-05,142685919,0.937471
D.kanapiae,152203088,VNJM01000027.1,1,12272,8.06291e-05,142698191,0.937551
D.kanapiae,152203088,VNJM01001761.1,1,12261,8.05568e-05,142710452,0.937632
D.kanapiae,152203088,VNJM01000564.1,1,12259,8.05437e-05,142722711,0.937712
D.kanapiae,152203088,VNJM01000833.1,1,12156,7.9867e-05,142734867,0.937792
D.kanapiae,152203088,VNJM01000789.1,1,12066,7.92757e-05,142746933,0.937871
D.kanapiae,152203088,VNJM01002923.1,1,12063,7.92559e-05,142758996,0.937951
D.kanapiae,152203088,VNJM01000249.1,1,12061,7.92428e-05,142771057,0.93803
D.kanapiae,152203088,VNJM01000492.1,1,12033,7.90588e-05,142783090,0.938109
D.kanapiae,152203088,VNJM01002437.1,1,12003,7.88617e-05,142795093,0.938188
D.kanapiae,152203088,VNJM01003379.1,1,11965,7.86121e-05,142807058,0.938266
D.kanapiae,152203088,VNJM01002837.1,1,11950,7.85135e-05,142819008,0.938345
D.kanapiae,152203088,VNJM01001006.1,1,11898,7.81719e-05,142830906,0.938423
D.kanapiae,152203088,VNJM01000942.1,1,11898,7.81719e-05,142842804,0.938501
D.kanapiae,152203088,VNJM01001339.1,1,11862,7.79353e-05,142854666,0.938579
D.kanapiae,152203088,VNJM01001691.1,1,11853,7.78762e-05,142866519,0.938657
D.kanapiae,152203088,VNJM01000568.1,1,11828,7.7712e-05,142878347,0.938735
D.kanapiae,152203088,VNJM01003007.1,1,11811,7.76003e-05,142890158,0.938812
D.kanapiae,152203088,VNJM01002705.1,1,11794,7.74886e-05,142901952,0.93889
D.kanapiae,152203088,VNJM01003394.1,1,11778,7.73834e-05,142913730,0.938967
D.kanapiae,152203088,VNJM01000319.1,1,11774,7.73572e-05,142925504,0.939045
D.kanapiae,152203088,VNJM01003327.1,1,11735,7.71009e-05,142937239,0.939122
D.kanapiae,152203088,VNJM01002158.1,1,11709,7.69301e-05,142948948,0.939199
D.kanapiae,152203088,VNJM01000081.1,1,11706,7.69104e-05,142960654,0.939276
D.kanapiae,152203088,VNJM01001302.1,1,11704,7.68973e-05,142972358,0.939353
D.kanapiae,152203088,VNJM01002111.1,1,11628,7.63979e-05,142983986,0.939429
D.kanapiae,152203088,VNJM01002918.1,1,11605,7.62468e-05,142995591,0.939505
D.kanapiae,152203088,VNJM01002378.1,1,11597,7.61942e-05,143007188,0.939581
D.kanapiae,152203088,VNJM01000946.1,1,11557,7.59314e-05,143018745,0.939657
D.kanapiae,152203088,VNJM01000463.1,1,11551,7.5892e-05,143030296,0.939733
D.kanapiae,152203088,VNJM01001894.1,1,11486,7.5465e-05,143041782,0.939809
D.kanapiae,152203088,VNJM01000571.1,1,11473,7.53795e-05,143053255,0.939884
D.kanapiae,152203088,VNJM01003037.1,1,11465,7.5327e-05,143064720,0.939959
D.kanapiae,152203088,VNJM01002726.1,1,11431,7.51036e-05,143076151,0.940034
D.kanapiae,152203088,VNJM01000164.1,1,11427,7.50773e-05,143087578,0.94011
D.kanapiae,152203088,VNJM01000284.1,1,11417,7.50116e-05,143098995,0.940185
D.kanapiae,152203088,VNJM01000029.1,1,11417,7.50116e-05,143110412,0.94026
D.kanapiae,152203088,VNJM01003310.1,1,11350,7.45714e-05,143121762,0.940334
D.kanapiae,152203088,VNJM01001571.1,1,11327,7.44203e-05,143133089,0.940409
D.kanapiae,152203088,VNJM01001057.1,1,11321,7.43809e-05,143144410,0.940483
D.kanapiae,152203088,VNJM01002745.1,1,11306,7.42823e-05,143155716,0.940557
D.kanapiae,152203088,VNJM01001086.1,1,11276,7.40852e-05,143166992,0.940631
D.kanapiae,152203088,VNJM01000495.1,1,11253,7.39341e-05,143178245,0.940705
D.kanapiae,152203088,VNJM01001677.1,1,11244,7.3875e-05,143189489,0.940779
D.kanapiae,152203088,VNJM01003112.1,1,11195,7.3553e-05,143200684,0.940853
D.kanapiae,152203088,VNJM01000234.1,1,11154,7.32837e-05,143211838,0.940926
D.kanapiae,152203088,VNJM01000586.1,1,11143,7.32114e-05,143222981,0.940999
D.kanapiae,152203088,VNJM01002064.1,1,11088,7.285e-05,143234069,0.941072
D.kanapiae,152203088,VNJM01002956.1,1,11044,7.25609e-05,143245113,0.941145
D.kanapiae,152203088,VNJM01002815.1,1,11025,7.24361e-05,143256138,0.941217
D.kanapiae,152203088,VNJM01000577.1,1,11010,7.23376e-05,143267148,0.941289
D.kanapiae,152203088,VNJM01003184.1,1,11009,7.2331e-05,143278157,0.941362
D.kanapiae,152203088,VNJM01001498.1,1,11007,7.23178e-05,143289164,0.941434
D.kanapiae,152203088,VNJM01002401.1,1,10979,7.21339e-05,143300143,0.941506
D.kanapiae,152203088,VNJM01001767.1,1,10951,7.19499e-05,143311094,0.941578
D.kanapiae,152203088,VNJM01001605.1,1,10945,7.19105e-05,143322039,0.94165
D.kanapiae,152203088,VNJM01001842.1,1,10921,7.17528e-05,143332960,0.941722
D.kanapiae,152203088,VNJM01001863.1,1,10912,7.16937e-05,143343872,0.941793
D.kanapiae,152203088,VNJM01001473.1,1,10835,7.11878e-05,143354707,0.941865
D.kanapiae,152203088,VNJM01001453.1,1,10826,7.11286e-05,143365533,0.941936
D.kanapiae,152203088,VNJM01001858.1,1,10810,7.10235e-05,143376343,0.942007
D.kanapiae,152203088,VNJM01000443.1,1,10803,7.09775e-05,143387146,0.942078
D.kanapiae,152203088,VNJM01000030.1,1,10792,7.09053e-05,143397938,0.942149
D.kanapiae,152203088,VNJM01000365.1,1,10790,7.08921e-05,143408728,0.94222
D.kanapiae,152203088,VNJM01000009.1,1,10757,7.06753e-05,143419485,0.94229
D.kanapiae,152203088,VNJM01003140.1,1,10734,7.05242e-05,143430219,0.942361
D.kanapiae,152203088,VNJM01002940.1,1,10734,7.05242e-05,143440953,0.942431
D.kanapiae,152203088,VNJM01001204.1,1,10731,7.05045e-05,143451684,0.942502
D.kanapiae,152203088,VNJM01000725.1,1,10653,6.9992e-05,143462337,0.942572
D.kanapiae,152203088,VNJM01002670.1,1,10641,6.99132e-05,143472978,0.942642
D.kanapiae,152203088,VNJM01001022.1,1,10641,6.99132e-05,143483619,0.942712
D.kanapiae,152203088,VNJM01002201.1,1,10620,6.97752e-05,143494239,0.942781
D.kanapiae,152203088,VNJM01002544.1,1,10614,6.97358e-05,143504853,0.942851
D.kanapiae,152203088,VNJM01002492.1,1,10535,6.92167e-05,143515388,0.94292
D.kanapiae,152203088,VNJM01001102.1,1,10487,6.89014e-05,143525875,0.942989
D.kanapiae,152203088,VNJM01001748.1,1,10483,6.88751e-05,143536358,0.943058
D.kanapiae,152203088,VNJM01002570.1,1,10475,6.88225e-05,143546833,0.943127
D.kanapiae,152203088,VNJM01000336.1,1,10470,6.87897e-05,143557303,0.943196
D.kanapiae,152203088,VNJM01000297.1,1,10397,6.831e-05,143567700,0.943264
D.kanapiae,152203088,VNJM01001933.1,1,10385,6.82312e-05,143578085,0.943332
D.kanapiae,152203088,VNJM01001889.1,1,10366,6.81064e-05,143588451,0.9434
D.kanapiae,152203088,VNJM01001054.1,1,10353,6.8021e-05,143598804,0.943468
D.kanapiae,152203088,VNJM01001570.1,1,10349,6.79947e-05,143609153,0.943536
D.kanapiae,152203088,VNJM01002642.1,1,10337,6.79158e-05,143619490,0.943604
D.kanapiae,152203088,VNJM01001611.1,1,10312,6.77516e-05,143629802,0.943672
D.kanapiae,152203088,VNJM01000703.1,1,10293,6.76267e-05,143640095,0.94374
D.kanapiae,152203088,VNJM01001596.1,1,10270,6.74756e-05,143650365,0.943807
D.kanapiae,152203088,VNJM01002582.1,1,10256,6.73837e-05,143660621,0.943875
D.kanapiae,152203088,VNJM01001218.1,1,10255,6.73771e-05,143670876,0.943942
D.kanapiae,152203088,VNJM01000490.1,1,10242,6.72917e-05,143681118,0.944009
D.kanapiae,152203088,VNJM01003196.1,1,10233,6.72325e-05,143691351,0.944076
D.kanapiae,152203088,VNJM01002469.1,1,10225,6.718e-05,143701576,0.944144
D.kanapiae,152203088,VNJM01003059.1,1,10212,6.70946e-05,143711788,0.944211
D.kanapiae,152203088,VNJM01001865.1,1,10180,6.68843e-05,143721968,0.944278
D.kanapiae,152203088,VNJM01002290.1,1,10170,6.68186e-05,143732138,0.944344
D.kanapiae,152203088,VNJM01000057.1,1,10153,6.67069e-05,143742291,0.944411
D.kanapiae,152203088,VNJM01001337.1,1,10145,6.66544e-05,143752436,0.944478
D.kanapiae,152203088,VNJM01002496.1,1,10141,6.66281e-05,143762577,0.944544
D.kanapiae,152203088,VNJM01000246.1,1,10113,6.64441e-05,143772690,0.944611
D.kanapiae,152203088,VNJM01001404.1,1,10111,6.6431e-05,143782801,0.944677
D.kanapiae,152203088,VNJM01003430.1,1,10074,6.61879e-05,143792875,0.944743
D.kanapiae,152203088,VNJM01002146.1,1,10064,6.61222e-05,143802939,0.94481
D.kanapiae,152203088,VNJM01000836.1,1,9985,6.56031e-05,143812924,0.944875
D.kanapiae,152203088,VNJM01000283.1,1,9906,6.50841e-05,143822830,0.94494
D.kanapiae,152203088,VNJM01002117.1,1,9891,6.49855e-05,143832721,0.945005
D.kanapiae,152203088,VNJM01002550.1,1,9875,6.48804e-05,143842596,0.94507
D.kanapiae,152203088,VNJM01000701.1,1,9864,6.48081e-05,143852460,0.945135
D.kanapiae,152203088,VNJM01002654.1,1,9844,6.46767e-05,143862304,0.9452
D.kanapiae,152203088,VNJM01002626.1,1,9762,6.4138e-05,143872066,0.945264
D.kanapiae,152203088,VNJM01003208.1,1,9733,6.39475e-05,143881799,0.945328
D.kanapiae,152203088,VNJM01001475.1,1,9729,6.39212e-05,143891528,0.945392
D.kanapiae,152203088,VNJM01001242.1,1,9713,6.38161e-05,143901241,0.945455
D.kanapiae,152203088,VNJM01002958.1,1,9712,6.38095e-05,143910953,0.945519
D.kanapiae,152203088,VNJM01000622.1,1,9695,6.36978e-05,143920648,0.945583
D.kanapiae,152203088,VNJM01000148.1,1,9633,6.32904e-05,143930281,0.945646
D.kanapiae,152203088,VNJM01003088.1,1,9606,6.3113e-05,143939887,0.945709
D.kanapiae,152203088,VNJM01002069.1,1,9594,6.30342e-05,143949481,0.945772
D.kanapiae,152203088,VNJM01001746.1,1,9594,6.30342e-05,143959075,0.945835
D.kanapiae,152203088,VNJM01001548.1,1,9556,6.27845e-05,143968631,0.945898
D.kanapiae,152203088,VNJM01000031.1,1,9527,6.2594e-05,143978158,0.945961
D.kanapiae,152203088,VNJM01002533.1,1,9503,6.24363e-05,143987661,0.946023
D.kanapiae,152203088,VNJM01003383.1,1,9468,6.22064e-05,143997129,0.946085
D.kanapiae,152203088,VNJM01003305.1,1,9443,6.20421e-05,144006572,0.946148
D.kanapiae,152203088,VNJM01000972.1,1,9391,6.17005e-05,144015963,0.946209
D.kanapiae,152203088,VNJM01000294.1,1,9383,6.16479e-05,144025346,0.946271
D.kanapiae,152203088,VNJM01002116.1,1,9357,6.14771e-05,144034703,0.946332
D.kanapiae,152203088,VNJM01001956.1,1,9351,6.14376e-05,144044054,0.946394
D.kanapiae,152203088,VNJM01001958.1,1,9337,6.13457e-05,144053391,0.946455
D.kanapiae,152203088,VNJM01000320.1,1,9329,6.12931e-05,144062720,0.946516
D.kanapiae,152203088,VNJM01001067.1,1,9324,6.12603e-05,144072044,0.946578
D.kanapiae,152203088,VNJM01000242.1,1,9322,6.12471e-05,144081366,0.946639
D.kanapiae,152203088,VNJM01000301.1,1,9259,6.08332e-05,144090625,0.9467
D.kanapiae,152203088,VNJM01003074.1,1,9257,6.08201e-05,144099882,0.946761
D.kanapiae,152203088,VNJM01001662.1,1,9207,6.04915e-05,144109089,0.946821
D.kanapiae,152203088,VNJM01002434.1,1,9182,6.03273e-05,144118271,0.946881
D.kanapiae,152203088,VNJM01001191.1,1,9167,6.02287e-05,144127438,0.946942
D.kanapiae,152203088,VNJM01001614.1,1,9136,6.00251e-05,144136574,0.947002
D.kanapiae,152203088,VNJM01000487.1,1,9123,5.99397e-05,144145697,0.947062
D.kanapiae,152203088,VNJM01003142.1,1,9094,5.97491e-05,144154791,0.947121
D.kanapiae,152203088,VNJM01003301.1,1,9085,5.969e-05,144163876,0.947181
D.kanapiae,152203088,VNJM01003030.1,1,9050,5.946e-05,144172926,0.94724
D.kanapiae,152203088,VNJM01001642.1,1,9048,5.94469e-05,144181974,0.9473
D.kanapiae,152203088,VNJM01001740.1,1,9023,5.92826e-05,144190997,0.947359
D.kanapiae,152203088,VNJM01001884.1,1,9014,5.92235e-05,144200011,0.947418
D.kanapiae,152203088,VNJM01000814.1,1,9002,5.91447e-05,144209013,0.947478
D.kanapiae,152203088,VNJM01000272.1,1,8964,5.8895e-05,144217977,0.947536
D.kanapiae,152203088,VNJM01000834.1,1,8928,5.86585e-05,144226905,0.947595
D.kanapiae,152203088,VNJM01000740.1,1,8890,5.84088e-05,144235795,0.947654
D.kanapiae,152203088,VNJM01003352.1,1,8883,5.83628e-05,144244678,0.947712
D.kanapiae,152203088,VNJM01003093.1,1,8860,5.82117e-05,144253538,0.94777
D.kanapiae,152203088,VNJM01001359.1,1,8849,5.81394e-05,144262387,0.947828
D.kanapiae,152203088,VNJM01002347.1,1,8833,5.80343e-05,144271220,0.947886
D.kanapiae,152203088,VNJM01002722.1,1,8830,5.80146e-05,144280050,0.947944
D.kanapiae,152203088,VNJM01003601.1,1,8824,5.79752e-05,144288874,0.948002
D.kanapiae,152203088,VNJM01000113.1,1,8752,5.75021e-05,144297626,0.94806
D.kanapiae,152203088,VNJM01002934.1,1,8741,5.74298e-05,144306367,0.948117
D.kanapiae,152203088,VNJM01001366.1,1,8735,5.73904e-05,144315102,0.948175
D.kanapiae,152203088,VNJM01002133.1,1,8684,5.70553e-05,144323786,0.948232
D.kanapiae,152203088,VNJM01000181.1,1,8676,5.70028e-05,144332462,0.948289
D.kanapiae,152203088,VNJM01002832.1,1,8632,5.67137e-05,144341094,0.948345
D.kanapiae,152203088,VNJM01001462.1,1,8621,5.66414e-05,144349715,0.948402
D.kanapiae,152203088,VNJM01002751.1,1,8616,5.66086e-05,144358331,0.948459
D.kanapiae,152203088,VNJM01000228.1,1,8574,5.63326e-05,144366905,0.948515
D.kanapiae,152203088,VNJM01003116.1,1,8498,5.58333e-05,144375403,0.948571
D.kanapiae,152203088,VNJM01002817.1,1,8489,5.57742e-05,144383892,0.948627
D.kanapiae,152203088,VNJM01003225.1,1,8481,5.57216e-05,144392373,0.948682
D.kanapiae,152203088,VNJM01000033.1,1,8466,5.56231e-05,144400839,0.948738
D.kanapiae,152203088,VNJM01002238.1,1,8457,5.55639e-05,144409296,0.948793
D.kanapiae,152203088,VNJM01000697.1,1,8391,5.51303e-05,144417687,0.948849
D.kanapiae,152203088,VNJM01000481.1,1,8382,5.50712e-05,144426069,0.948904
D.kanapiae,152203088,VNJM01000588.1,1,8368,5.49792e-05,144434437,0.948959
D.kanapiae,152203088,VNJM01000032.1,1,8360,5.49266e-05,144442797,0.949014
D.kanapiae,152203088,VNJM01003218.1,1,8343,5.48149e-05,144451140,0.949068
D.kanapiae,152203088,VNJM01001058.1,1,8323,5.46835e-05,144459463,0.949123
D.kanapiae,152203088,VNJM01002193.1,1,8300,5.45324e-05,144467763,0.949178
D.kanapiae,152203088,VNJM01000175.1,1,8293,5.44864e-05,144476056,0.949232
D.kanapiae,152203088,VNJM01003369.1,1,8277,5.43813e-05,144484333,0.949286
D.kanapiae,152203088,VNJM01000177.1,1,8246,5.41776e-05,144492579,0.949341
D.kanapiae,152203088,VNJM01000480.1,1,8223,5.40265e-05,144500802,0.949395
D.kanapiae,152203088,VNJM01003433.1,1,8222,5.40199e-05,144509024,0.949449
D.kanapiae,152203088,VNJM01003436.1,1,8178,5.37308e-05,144517202,0.949502
D.kanapiae,152203088,VNJM01002404.1,1,8175,5.37111e-05,144525377,0.949556
D.kanapiae,152203088,VNJM01001757.1,1,8175,5.37111e-05,144533552,0.94961
D.kanapiae,152203088,VNJM01002084.1,1,8132,5.34286e-05,144541684,0.949663
D.kanapiae,152203088,VNJM01000300.1,1,8118,5.33366e-05,144549802,0.949717
D.kanapiae,152203088,VNJM01002050.1,1,8098,5.32052e-05,144557900,0.94977
D.kanapiae,152203088,VNJM01002105.1,1,8089,5.31461e-05,144565989,0.949823
D.kanapiae,152203088,VNJM01001189.1,1,8087,5.3133e-05,144574076,0.949876
D.kanapiae,152203088,VNJM01001986.1,1,8084,5.31132e-05,144582160,0.949929
D.kanapiae,152203088,VNJM01000545.1,1,8054,5.29161e-05,144590214,0.949982
D.kanapiae,152203088,VNJM01001385.1,1,8052,5.2903e-05,144598266,0.950035
D.kanapiae,152203088,VNJM01002901.1,1,7978,5.24168e-05,144606244,0.950087
D.kanapiae,152203088,VNJM01001107.1,1,7978,5.24168e-05,144614222,0.95014
D.kanapiae,152203088,VNJM01003573.1,1,7976,5.24037e-05,144622198,0.950192
D.kanapiae,152203088,VNJM01003067.1,1,7966,5.2338e-05,144630164,0.950245
D.kanapiae,152203088,VNJM01000299.1,1,7953,5.22526e-05,144638117,0.950297
D.kanapiae,152203088,VNJM01001062.1,1,7936,5.21409e-05,144646053,0.950349
D.kanapiae,152203088,VNJM01001687.1,1,7922,5.20489e-05,144653975,0.950401
D.kanapiae,152203088,VNJM01003092.1,1,7920,5.20357e-05,144661895,0.950453
D.kanapiae,152203088,VNJM01000069.1,1,7900,5.19043e-05,144669795,0.950505
D.kanapiae,152203088,VNJM01000664.1,1,7889,5.18321e-05,144677684,0.950557
D.kanapiae,152203088,VNJM01001717.1,1,7884,5.17992e-05,144685568,0.950609
D.kanapiae,152203088,VNJM01001823.1,1,7877,5.17532e-05,144693445,0.95066
D.kanapiae,152203088,VNJM01001955.1,1,7867,5.16875e-05,144701312,0.950712
D.kanapiae,152203088,VNJM01000700.1,1,7852,5.1589e-05,144709164,0.950764
D.kanapiae,152203088,VNJM01002606.1,1,7838,5.1497e-05,144717002,0.950815
D.kanapiae,152203088,VNJM01000476.1,1,7836,5.14838e-05,144724838,0.950867
D.kanapiae,152203088,VNJM01002998.1,1,7815,5.13459e-05,144732653,0.950918
D.kanapiae,152203088,VNJM01000114.1,1,7804,5.12736e-05,144740457,0.950969
D.kanapiae,152203088,VNJM01002835.1,1,7789,5.1175e-05,144748246,0.95102
D.kanapiae,152203088,VNJM01002511.1,1,7784,5.11422e-05,144756030,0.951072
D.kanapiae,152203088,VNJM01001649.1,1,7771,5.10568e-05,144763801,0.951123
D.kanapiae,152203088,VNJM01001827.1,1,7759,5.09779e-05,144771560,0.951174
D.kanapiae,152203088,VNJM01003172.1,1,7711,5.06626e-05,144779271,0.951224
D.kanapiae,152203088,VNJM01001728.1,1,7711,5.06626e-05,144786982,0.951275
D.kanapiae,152203088,VNJM01003281.1,1,7707,5.06363e-05,144794689,0.951326
D.kanapiae,152203088,VNJM01000015.1,1,7700,5.05903e-05,144802389,0.951376
D.kanapiae,152203088,VNJM01000573.1,1,7698,5.05772e-05,144810087,0.951427
D.kanapiae,152203088,VNJM01001523.1,1,7695,5.05574e-05,144817782,0.951477
D.kanapiae,152203088,VNJM01001290.1,1,7693,5.05443e-05,144825475,0.951528
D.kanapiae,152203088,VNJM01003616.1,1,7681,5.04655e-05,144833156,0.951578
D.kanapiae,152203088,VNJM01001525.1,1,7663,5.03472e-05,144840819,0.951629
D.kanapiae,152203088,VNJM01002292.1,1,7635,5.01632e-05,144848454,0.951679
D.kanapiae,152203088,VNJM01001026.1,1,7632,5.01435e-05,144856086,0.951729
D.kanapiae,152203088,VNJM01002881.1,1,7621,5.00713e-05,144863707,0.951779
D.kanapiae,152203088,VNJM01003365.1,1,7620,5.00647e-05,144871327,0.951829
D.kanapiae,152203088,VNJM01001795.1,1,7605,4.99661e-05,144878932,0.951879
D.kanapiae,152203088,VNJM01003613.1,1,7577,4.97822e-05,144886509,0.951929
D.kanapiae,152203088,VNJM01002293.1,1,7574,4.97625e-05,144894083,0.951979
D.kanapiae,152203088,VNJM01000286.1,1,7574,4.97625e-05,144901657,0.952028
D.kanapiae,152203088,VNJM01003446.1,1,7573,4.97559e-05,144909230,0.952078
D.kanapiae,152203088,VNJM01000505.1,1,7572,4.97493e-05,144916802,0.952128
D.kanapiae,152203088,VNJM01001904.1,1,7570,4.97362e-05,144924372,0.952178
D.kanapiae,152203088,VNJM01000540.1,1,7564,4.96968e-05,144931936,0.952227
D.kanapiae,152203088,VNJM01002578.1,1,7553,4.96245e-05,144939489,0.952277
D.kanapiae,152203088,VNJM01000647.1,1,7521,4.94142e-05,144947010,0.952326
D.kanapiae,152203088,VNJM01002062.1,1,7484,4.91711e-05,144954494,0.952376
D.kanapiae,152203088,VNJM01002180.1,1,7483,4.91646e-05,144961977,0.952425
D.kanapiae,152203088,VNJM01002633.1,1,7477,4.91252e-05,144969454,0.952474
D.kanapiae,152203088,VNJM01000384.1,1,7476,4.91186e-05,144976930,0.952523
D.kanapiae,152203088,VNJM01002516.1,1,7461,4.902e-05,144984391,0.952572
D.kanapiae,152203088,VNJM01002595.1,1,7459,4.90069e-05,144991850,0.952621
D.kanapiae,152203088,VNJM01002405.1,1,7426,4.87901e-05,144999276,0.95267
D.kanapiae,152203088,VNJM01001355.1,1,7412,4.86981e-05,145006688,0.952718
D.kanapiae,152203088,VNJM01002559.1,1,7375,4.8455e-05,145014063,0.952767
D.kanapiae,152203088,VNJM01002609.1,1,7369,4.84156e-05,145021432,0.952815
D.kanapiae,152203088,VNJM01002258.1,1,7353,4.83105e-05,145028785,0.952864
D.kanapiae,152203088,VNJM01001069.1,1,7346,4.82645e-05,145036131,0.952912
D.kanapiae,152203088,VNJM01000296.1,1,7344,4.82513e-05,145043475,0.95296
D.kanapiae,152203088,VNJM01001414.1,1,7341,4.82316e-05,145050816,0.953008
D.kanapiae,152203088,VNJM01001386.1,1,7332,4.81725e-05,145058148,0.953057
D.kanapiae,152203088,VNJM01001111.1,1,7323,4.81133e-05,145065471,0.953105
D.kanapiae,152203088,VNJM01001084.1,1,7318,4.80805e-05,145072789,0.953153
D.kanapiae,152203088,VNJM01001609.1,1,7312,4.80411e-05,145080101,0.953201
D.kanapiae,152203088,VNJM01001148.1,1,7256,4.76731e-05,145087357,0.953248
D.kanapiae,152203088,VNJM01003041.1,1,7252,4.76469e-05,145094609,0.953296
D.kanapiae,152203088,VNJM01002103.1,1,7238,4.75549e-05,145101847,0.953344
D.kanapiae,152203088,VNJM01001470.1,1,7201,4.73118e-05,145109048,0.953391
D.kanapiae,152203088,VNJM01002262.1,1,7192,4.72527e-05,145116240,0.953438
D.kanapiae,152203088,VNJM01003009.1,1,7185,4.72067e-05,145123425,0.953485
D.kanapiae,152203088,VNJM01003376.1,1,7182,4.7187e-05,145130607,0.953533
D.kanapiae,152203088,VNJM01001317.1,1,7173,4.71278e-05,145137780,0.95358
D.kanapiae,152203088,VNJM01002580.1,1,7158,4.70293e-05,145144938,0.953627
D.kanapiae,152203088,VNJM01001979.1,1,7151,4.69833e-05,145152089,0.953674
D.kanapiae,152203088,VNJM01000729.1,1,7148,4.69636e-05,145159237,0.953721
D.kanapiae,152203088,VNJM01001585.1,1,7133,4.6865e-05,145166370,0.953768
D.kanapiae,152203088,VNJM01000699.1,1,7115,4.67468e-05,145173485,0.953814
D.kanapiae,152203088,VNJM01000817.1,1,7101,4.66548e-05,145180586,0.953861
D.kanapiae,152203088,VNJM01003302.1,1,7096,4.66219e-05,145187682,0.953908
D.kanapiae,152203088,VNJM01000471.1,1,7077,4.64971e-05,145194759,0.953954
D.kanapiae,152203088,VNJM01000730.1,1,7063,4.64051e-05,145201822,0.954
D.kanapiae,152203088,VNJM01001864.1,1,7052,4.63328e-05,145208874,0.954047
D.kanapiae,152203088,VNJM01002090.1,1,7044,4.62803e-05,145215918,0.954093
D.kanapiae,152203088,VNJM01000473.1,1,7024,4.61489e-05,145222942,0.954139
D.kanapiae,152203088,VNJM01001626.1,1,7004,4.60175e-05,145229946,0.954185
D.kanapiae,152203088,VNJM01002369.1,1,6989,4.59189e-05,145236935,0.954231
D.kanapiae,152203088,VNJM01001551.1,1,6989,4.59189e-05,145243924,0.954277
D.kanapiae,152203088,VNJM01002002.1,1,6972,4.58072e-05,145250896,0.954323
D.kanapiae,152203088,VNJM01000307.1,1,6956,4.57021e-05,145257852,0.954369
D.kanapiae,152203088,VNJM01002468.1,1,6949,4.56561e-05,145264801,0.954414
D.kanapiae,152203088,VNJM01001309.1,1,6947,4.5643e-05,145271748,0.95446
D.kanapiae,152203088,VNJM01001400.1,1,6938,4.55838e-05,145278686,0.954506
D.kanapiae,152203088,VNJM01002472.1,1,6918,4.54524e-05,145285604,0.954551
D.kanapiae,152203088,VNJM01001661.1,1,6891,4.5275e-05,145292495,0.954596
D.kanapiae,152203088,VNJM01001899.1,1,6851,4.50122e-05,145299346,0.954641
D.kanapiae,152203088,VNJM01001349.1,1,6842,4.49531e-05,145306188,0.954686
D.kanapiae,152203088,VNJM01002066.1,1,6828,4.48611e-05,145313016,0.954731
D.kanapiae,152203088,VNJM01002579.1,1,6809,4.47363e-05,145319825,0.954776
D.kanapiae,152203088,VNJM01001357.1,1,6803,4.46969e-05,145326628,0.95482
D.kanapiae,152203088,VNJM01002806.1,1,6795,4.46443e-05,145333423,0.954865
D.kanapiae,152203088,VNJM01001619.1,1,6783,4.45655e-05,145340206,0.95491
D.kanapiae,152203088,VNJM01000393.1,1,6783,4.45655e-05,145346989,0.954954
D.kanapiae,152203088,VNJM01002798.1,1,6778,4.45326e-05,145353767,0.954999
D.kanapiae,152203088,VNJM01001680.1,1,6763,4.44341e-05,145360530,0.955043
D.kanapiae,152203088,VNJM01001925.1,1,6759,4.44078e-05,145367289,0.955088
D.kanapiae,152203088,VNJM01000956.1,1,6756,4.43881e-05,145374045,0.955132
D.kanapiae,152203088,VNJM01000562.1,1,6752,4.43618e-05,145380797,0.955176
D.kanapiae,152203088,VNJM01000509.1,1,6728,4.42041e-05,145387525,0.955221
D.kanapiae,152203088,VNJM01003062.1,1,6709,4.40793e-05,145394234,0.955265
D.kanapiae,152203088,VNJM01001273.1,1,6696,4.39939e-05,145400930,0.955309
D.kanapiae,152203088,VNJM01003444.1,1,6694,4.39807e-05,145407624,0.955353
D.kanapiae,152203088,VNJM01003362.1,1,6689,4.39479e-05,145414313,0.955397
D.kanapiae,152203088,VNJM01001837.1,1,6680,4.38887e-05,145420993,0.95544
D.kanapiae,152203088,VNJM01001216.1,1,6673,4.38427e-05,145427666,0.955484
D.kanapiae,152203088,VNJM01002028.1,1,6668,4.38099e-05,145434334,0.955528
D.kanapiae,152203088,VNJM01002257.1,1,6662,4.37705e-05,145440996,0.955572
D.kanapiae,152203088,VNJM01003335.1,1,6654,4.37179e-05,145447650,0.955616
D.kanapiae,152203088,VNJM01002073.1,1,6646,4.36653e-05,145454296,0.955659
D.kanapiae,152203088,VNJM01000905.1,1,6646,4.36653e-05,145460942,0.955703
D.kanapiae,152203088,VNJM01002315.1,1,6640,4.36259e-05,145467582,0.955747
D.kanapiae,152203088,VNJM01000143.1,1,6626,4.35339e-05,145474208,0.95579
D.kanapiae,152203088,VNJM01003211.1,1,6613,4.34485e-05,145480821,0.955834
D.kanapiae,152203088,VNJM01002157.1,1,6611,4.34354e-05,145487432,0.955877
D.kanapiae,152203088,VNJM01003438.1,1,6608,4.34157e-05,145494040,0.95592
D.kanapiae,152203088,VNJM01001745.1,1,6598,4.335e-05,145500638,0.955964
D.kanapiae,152203088,VNJM01003040.1,1,6578,4.32186e-05,145507216,0.956007
D.kanapiae,152203088,VNJM01002900.1,1,6573,4.31857e-05,145513789,0.95605
D.kanapiae,152203088,VNJM01000621.1,1,6553,4.30543e-05,145520342,0.956093
D.kanapiae,152203088,VNJM01001319.1,1,6515,4.28047e-05,145526857,0.956136
D.kanapiae,152203088,VNJM01001040.1,1,6495,4.26732e-05,145533352,0.956179
D.kanapiae,152203088,VNJM01002944.1,1,6456,4.2417e-05,145539808,0.956221
D.kanapiae,152203088,VNJM01002244.1,1,6443,4.23316e-05,145546251,0.956263
D.kanapiae,152203088,VNJM01001516.1,1,6432,4.22593e-05,145552683,0.956306
D.kanapiae,152203088,VNJM01003395.1,1,6430,4.22462e-05,145559113,0.956348
D.kanapiae,152203088,VNJM01002237.1,1,6411,4.21214e-05,145565524,0.95639
D.kanapiae,152203088,VNJM01000117.1,1,6398,4.20359e-05,145571922,0.956432
D.kanapiae,152203088,VNJM01002513.1,1,6391,4.19899e-05,145578313,0.956474
D.kanapiae,152203088,VNJM01003089.1,1,6385,4.19505e-05,145584698,0.956516
D.kanapiae,152203088,VNJM01002999.1,1,6340,4.16549e-05,145591038,0.956558
D.kanapiae,152203088,VNJM01002560.1,1,6335,4.1622e-05,145597373,0.956599
D.kanapiae,152203088,VNJM01002541.1,1,6334,4.16155e-05,145603707,0.956641
D.kanapiae,152203088,VNJM01001569.1,1,6334,4.16155e-05,145610041,0.956683
D.kanapiae,152203088,VNJM01001627.1,1,6326,4.15629e-05,145616367,0.956724
D.kanapiae,152203088,VNJM01001641.1,1,6318,4.15103e-05,145622685,0.956766
D.kanapiae,152203088,VNJM01002749.1,1,6307,4.14381e-05,145628992,0.956807
D.kanapiae,152203088,VNJM01001440.1,1,6300,4.13921e-05,145635292,0.956848
D.kanapiae,152203088,VNJM01003565.1,1,6298,4.13789e-05,145641590,0.95689
D.kanapiae,152203088,VNJM01001553.1,1,6293,4.13461e-05,145647883,0.956931
D.kanapiae,152203088,VNJM01002327.1,1,6289,4.13198e-05,145654172,0.956973
D.kanapiae,152203088,VNJM01000167.1,1,6282,4.12738e-05,145660454,0.957014
D.kanapiae,152203088,VNJM01003145.1,1,6271,4.12015e-05,145666725,0.957055
D.kanapiae,152203088,VNJM01003298.1,1,6267,4.11752e-05,145672992,0.957096
D.kanapiae,152203088,VNJM01003333.1,1,6261,4.11358e-05,145679253,0.957137
D.kanapiae,152203088,VNJM01000498.1,1,6260,4.11293e-05,145685513,0.957178
D.kanapiae,152203088,VNJM01000321.1,1,6254,4.10898e-05,145691767,0.95722
D.kanapiae,152203088,VNJM01001213.1,1,6221,4.0873e-05,145697988,0.95726
D.kanapiae,152203088,VNJM01001044.1,1,6212,4.08139e-05,145704200,0.957301
D.kanapiae,152203088,VNJM01002132.1,1,6206,4.07745e-05,145710406,0.957342
D.kanapiae,152203088,VNJM01002780.1,1,6205,4.07679e-05,145716611,0.957383
D.kanapiae,152203088,VNJM01000005.1,1,6199,4.07285e-05,145722810,0.957423
D.kanapiae,152203088,VNJM01002393.1,1,6189,4.06628e-05,145728999,0.957464
D.kanapiae,152203088,VNJM01000901.1,1,6183,4.06234e-05,145735182,0.957505
D.kanapiae,152203088,VNJM01003505.1,1,6144,4.03671e-05,145741326,0.957545
D.kanapiae,152203088,VNJM01002254.1,1,6130,4.02751e-05,145747456,0.957585
D.kanapiae,152203088,VNJM01002162.1,1,6125,4.02423e-05,145753581,0.957626
D.kanapiae,152203088,VNJM01000477.1,1,6110,4.01437e-05,145759691,0.957666
D.kanapiae,152203088,VNJM01002199.1,1,6103,4.00977e-05,145765794,0.957706
D.kanapiae,152203088,VNJM01003364.1,1,6089,4.00058e-05,145771883,0.957746
D.kanapiae,152203088,VNJM01003562.1,1,6081,3.99532e-05,145777964,0.957786
D.kanapiae,152203088,VNJM01002603.1,1,6052,3.97627e-05,145784016,0.957826
D.kanapiae,152203088,VNJM01000514.1,1,6044,3.97101e-05,145790060,0.957865
D.kanapiae,152203088,VNJM01001149.1,1,6040,3.96838e-05,145796100,0.957905
D.kanapiae,152203088,VNJM01001463.1,1,6031,3.96247e-05,145802131,0.957945
D.kanapiae,152203088,VNJM01001387.1,1,6023,3.95721e-05,145808154,0.957984
D.kanapiae,152203088,VNJM01002919.1,1,6016,3.95261e-05,145814170,0.958024
D.kanapiae,152203088,VNJM01002152.1,1,6007,3.9467e-05,145820177,0.958063
D.kanapiae,152203088,VNJM01001807.1,1,5999,3.94144e-05,145826176,0.958103
D.kanapiae,152203088,VNJM01001743.1,1,5974,3.92502e-05,145832150,0.958142
D.kanapiae,152203088,VNJM01000943.1,1,5974,3.92502e-05,145838124,0.958181
D.kanapiae,152203088,VNJM01000486.1,1,5967,3.92042e-05,145844091,0.95822
D.kanapiae,152203088,VNJM01001880.1,1,5960,3.91582e-05,145850051,0.958259
D.kanapiae,152203088,VNJM01000278.1,1,5957,3.91385e-05,145856008,0.958299
D.kanapiae,152203088,VNJM01001821.1,1,5953,3.91122e-05,145861961,0.958338
D.kanapiae,152203088,VNJM01000598.1,1,5949,3.90859e-05,145867910,0.958377
D.kanapiae,152203088,VNJM01000594.1,1,5932,3.89742e-05,145873842,0.958416
D.kanapiae,152203088,VNJM01002101.1,1,5926,3.89348e-05,145879768,0.958455
D.kanapiae,152203088,VNJM01002991.1,1,5920,3.88954e-05,145885688,0.958494
D.kanapiae,152203088,VNJM01002363.1,1,5916,3.88691e-05,145891604,0.958532
D.kanapiae,152203088,VNJM01001444.1,1,5915,3.88625e-05,145897519,0.958571
D.kanapiae,152203088,VNJM01002675.1,1,5909,3.88231e-05,145903428,0.95861
D.kanapiae,152203088,VNJM01002094.1,1,5883,3.86523e-05,145909311,0.958649
D.kanapiae,152203088,VNJM01001556.1,1,5866,3.85406e-05,145915177,0.958687
D.kanapiae,152203088,VNJM01002399.1,1,5850,3.84355e-05,145921027,0.958726
D.kanapiae,152203088,VNJM01003250.1,1,5841,3.83764e-05,145926868,0.958764
D.kanapiae,152203088,VNJM01000606.1,1,5824,3.82647e-05,145932692,0.958802
D.kanapiae,152203088,VNJM01002698.1,1,5820,3.82384e-05,145938512,0.958841
D.kanapiae,152203088,VNJM01003329.1,1,5807,3.8153e-05,145944319,0.958879
D.kanapiae,152203088,VNJM01002134.1,1,5805,3.81398e-05,145950124,0.958917
D.kanapiae,152203088,VNJM01003619.1,1,5790,3.80413e-05,145955914,0.958955
D.kanapiae,152203088,VNJM01000298.1,1,5790,3.80413e-05,145961704,0.958993
D.kanapiae,152203088,VNJM01002311.1,1,5753,3.77982e-05,145967457,0.959031
D.kanapiae,152203088,VNJM01000938.1,1,5748,3.77653e-05,145973205,0.959069
D.kanapiae,152203088,VNJM01000738.1,1,5733,3.76668e-05,145978938,0.959106
D.kanapiae,152203088,VNJM01000269.1,1,5728,3.76339e-05,145984666,0.959144
D.kanapiae,152203088,VNJM01002309.1,1,5707,3.7496e-05,145990373,0.959181
D.kanapiae,152203088,VNJM01001383.1,1,5705,3.74828e-05,145996078,0.959219
D.kanapiae,152203088,VNJM01001338.1,1,5705,3.74828e-05,146001783,0.959256
D.kanapiae,152203088,VNJM01002658.1,1,5704,3.74762e-05,146007487,0.959294
D.kanapiae,152203088,VNJM01002449.1,1,5689,3.73777e-05,146013176,0.959331
D.kanapiae,152203088,VNJM01000761.1,1,5687,3.73646e-05,146018863,0.959369
D.kanapiae,152203088,VNJM01002141.1,1,5686,3.7358e-05,146024549,0.959406
D.kanapiae,152203088,VNJM01003244.1,1,5682,3.73317e-05,146030231,0.959443
D.kanapiae,152203088,VNJM01003110.1,1,5681,3.73251e-05,146035912,0.959481
D.kanapiae,152203088,VNJM01000421.1,1,5665,3.722e-05,146041577,0.959518
D.kanapiae,152203088,VNJM01000110.1,1,5665,3.722e-05,146047242,0.959555
D.kanapiae,152203088,VNJM01000121.1,1,5661,3.71937e-05,146052903,0.959592
D.kanapiae,152203088,VNJM01000275.1,1,5658,3.7174e-05,146058561,0.959629
D.kanapiae,152203088,VNJM01001050.1,1,5655,3.71543e-05,146064216,0.959667
D.kanapiae,152203088,VNJM01002346.1,1,5634,3.70163e-05,146069850,0.959704
D.kanapiae,152203088,VNJM01000739.1,1,5632,3.70032e-05,146075482,0.959741
D.kanapiae,152203088,VNJM01002412.1,1,5630,3.69901e-05,146081112,0.959778
D.kanapiae,152203088,VNJM01001966.1,1,5626,3.69638e-05,146086738,0.959815
D.kanapiae,152203088,VNJM01000695.1,1,5624,3.69506e-05,146092362,0.959851
D.kanapiae,152203088,VNJM01000971.1,1,5620,3.69243e-05,146097982,0.959888
D.kanapiae,152203088,VNJM01001514.1,1,5606,3.68324e-05,146103588,0.959925
D.kanapiae,152203088,VNJM01001779.1,1,5590,3.67272e-05,146109178,0.959962
D.kanapiae,152203088,VNJM01002060.1,1,5589,3.67207e-05,146114767,0.959999
D.kanapiae,152203088,VNJM01003386.1,1,5578,3.66484e-05,146120345,0.960035
D.kanapiae,152203088,VNJM01002856.1,1,5577,3.66418e-05,146125922,0.960072
D.kanapiae,152203088,VNJM01001587.1,1,5567,3.65761e-05,146131489,0.960109
D.kanapiae,152203088,VNJM01000071.1,1,5559,3.65236e-05,146137048,0.960145
D.kanapiae,152203088,VNJM01000245.1,1,5557,3.65104e-05,146142605,0.960182
D.kanapiae,152203088,VNJM01002332.1,1,5549,3.64579e-05,146148154,0.960218
D.kanapiae,152203088,VNJM01002372.1,1,5548,3.64513e-05,146153702,0.960255
D.kanapiae,152203088,VNJM01000831.1,1,5547,3.64447e-05,146159249,0.960291
D.kanapiae,152203088,VNJM01000854.1,1,5544,3.6425e-05,146164793,0.960327
D.kanapiae,152203088,VNJM01002126.1,1,5532,3.63462e-05,146170325,0.960364
D.kanapiae,152203088,VNJM01001335.1,1,5529,3.63265e-05,146175854,0.9604
D.kanapiae,152203088,VNJM01001579.1,1,5523,3.6287e-05,146181377,0.960436
D.kanapiae,152203088,VNJM01002454.1,1,5506,3.61754e-05,146186883,0.960473
D.kanapiae,152203088,VNJM01003363.1,1,5493,3.60899e-05,146192376,0.960509
D.kanapiae,152203088,VNJM01001076.1,1,5491,3.60768e-05,146197867,0.960545
D.kanapiae,152203088,VNJM01001092.1,1,5486,3.60439e-05,146203353,0.960581
D.kanapiae,152203088,VNJM01002337.1,1,5485,3.60374e-05,146208838,0.960617
D.kanapiae,152203088,VNJM01000631.1,1,5480,3.60045e-05,146214318,0.960653
D.kanapiae,152203088,VNJM01003595.1,1,5476,3.59782e-05,146219794,0.960689
D.kanapiae,152203088,VNJM01002852.1,1,5473,3.59585e-05,146225267,0.960725
D.kanapiae,152203088,VNJM01001314.1,1,5473,3.59585e-05,146230740,0.960761
D.kanapiae,152203088,VNJM01000830.1,1,5473,3.59585e-05,146236213,0.960797
D.kanapiae,152203088,VNJM01001249.1,1,5457,3.58534e-05,146241670,0.960832
D.kanapiae,152203088,VNJM01001868.1,1,5455,3.58403e-05,146247125,0.960868
D.kanapiae,152203088,VNJM01002353.1,1,5452,3.58206e-05,146252577,0.960904
D.kanapiae,152203088,VNJM01002517.1,1,5447,3.57877e-05,146258024,0.96094
D.kanapiae,152203088,VNJM01001043.1,1,5441,3.57483e-05,146263465,0.960976
D.kanapiae,152203088,VNJM01001703.1,1,5423,3.563e-05,146268888,0.961011
D.kanapiae,152203088,VNJM01003135.1,1,5417,3.55906e-05,146274305,0.961047
D.kanapiae,152203088,VNJM01002536.1,1,5415,3.55775e-05,146279720,0.961082
D.kanapiae,152203088,VNJM01002793.1,1,5412,3.55578e-05,146285132,0.961118
D.kanapiae,152203088,VNJM01001911.1,1,5412,3.55578e-05,146290544,0.961154
D.kanapiae,152203088,VNJM01002913.1,1,5410,3.55446e-05,146295954,0.961189
D.kanapiae,152203088,VNJM01001167.1,1,5407,3.55249e-05,146301361,0.961225
D.kanapiae,152203088,VNJM01001405.1,1,5406,3.55183e-05,146306767,0.96126
D.kanapiae,152203088,VNJM01003065.1,1,5403,3.54986e-05,146312170,0.961296
D.kanapiae,152203088,VNJM01003126.1,1,5397,3.54592e-05,146317567,0.961331
D.kanapiae,152203088,VNJM01002217.1,1,5390,3.54132e-05,146322957,0.961367
D.kanapiae,152203088,VNJM01002063.1,1,5388,3.54001e-05,146328345,0.961402
D.kanapiae,152203088,VNJM01000432.1,1,5370,3.52818e-05,146333715,0.961437
D.kanapiae,152203088,VNJM01002574.1,1,5358,3.5203e-05,146339073,0.961472
D.kanapiae,152203088,VNJM01003576.1,1,5351,3.5157e-05,146344424,0.961508
D.kanapiae,152203088,VNJM01001792.1,1,5344,3.5111e-05,146349768,0.961543
D.kanapiae,152203088,VNJM01001209.1,1,5334,3.50453e-05,146355102,0.961578
D.kanapiae,152203088,VNJM01000787.1,1,5315,3.49204e-05,146360417,0.961613
D.kanapiae,152203088,VNJM01000474.1,1,5308,3.48745e-05,146365725,0.961648
D.kanapiae,152203088,VNJM01000090.1,1,5300,3.48219e-05,146371025,0.961682
D.kanapiae,152203088,VNJM01001495.1,1,5290,3.47562e-05,146376315,0.961717
D.kanapiae,152203088,VNJM01003567.1,1,5283,3.47102e-05,146381598,0.961752
D.kanapiae,152203088,VNJM01000976.1,1,5266,3.45985e-05,146386864,0.961786
D.kanapiae,152203088,VNJM01003600.1,1,5250,3.44934e-05,146392114,0.961821
D.kanapiae,152203088,VNJM01002452.1,1,5239,3.44211e-05,146397353,0.961855
D.kanapiae,152203088,VNJM01003299.1,1,5237,3.4408e-05,146402590,0.96189
D.kanapiae,152203088,VNJM01001901.1,1,5232,3.43751e-05,146407822,0.961924
D.kanapiae,152203088,VNJM01003361.1,1,5230,3.4362e-05,146413052,0.961958
D.kanapiae,152203088,VNJM01002210.1,1,5230,3.4362e-05,146418282,0.961993
D.kanapiae,152203088,VNJM01001640.1,1,5229,3.43554e-05,146423511,0.962027
D.kanapiae,152203088,VNJM01002037.1,1,5222,3.43094e-05,146428733,0.962062
D.kanapiae,152203088,VNJM01001353.1,1,5210,3.42306e-05,146433943,0.962096
D.kanapiae,152203088,VNJM01003466.1,1,5206,3.42043e-05,146439149,0.96213
D.kanapiae,152203088,VNJM01000168.1,1,5206,3.42043e-05,146444355,0.962164
D.kanapiae,152203088,VNJM01003469.1,1,5203,3.41846e-05,146449558,0.962198
D.kanapiae,152203088,VNJM01002395.1,1,5199,3.41583e-05,146454757,0.962232
D.kanapiae,152203088,VNJM01000979.1,1,5186,3.40729e-05,146459943,0.962267
D.kanapiae,152203088,VNJM01002848.1,1,5185,3.40663e-05,146465128,0.962301
D.kanapiae,152203088,VNJM01000650.1,1,5164,3.39284e-05,146470292,0.962335
D.kanapiae,152203088,VNJM01000955.1,1,5163,3.39218e-05,146475455,0.962368
D.kanapiae,152203088,VNJM01003055.1,1,5162,3.39152e-05,146480617,0.962402
D.kanapiae,152203088,VNJM01001969.1,1,5150,3.38364e-05,146485767,0.962436
D.kanapiae,152203088,VNJM01003197.1,1,5149,3.38298e-05,146490916,0.96247
D.kanapiae,152203088,VNJM01003594.1,1,5147,3.38167e-05,146496063,0.962504
D.kanapiae,152203088,VNJM01000805.1,1,5141,3.37772e-05,146501204,0.962538
D.kanapiae,152203088,VNJM01002833.1,1,5139,3.37641e-05,146506343,0.962571
D.kanapiae,152203088,VNJM01001504.1,1,5112,3.35867e-05,146511455,0.962605
D.kanapiae,152203088,VNJM01001025.1,1,5095,3.3475e-05,146516550,0.962638
D.kanapiae,152203088,VNJM01003108.1,1,5093,3.34619e-05,146521643,0.962672
D.kanapiae,152203088,VNJM01000340.1,1,5080,3.33765e-05,146526723,0.962705
D.kanapiae,152203088,VNJM01002686.1,1,5072,3.33239e-05,146531795,0.962739
D.kanapiae,152203088,VNJM01002890.1,1,5063,3.32648e-05,146536858,0.962772
D.kanapiae,152203088,VNJM01000629.1,1,5060,3.32451e-05,146541918,0.962805
D.kanapiae,152203088,VNJM01001943.1,1,5057,3.32253e-05,146546975,0.962838
D.kanapiae,152203088,VNJM01000555.1,1,5048,3.31662e-05,146552023,0.962872
D.kanapiae,152203088,VNJM01001344.1,1,5047,3.31596e-05,146557070,0.962905
D.kanapiae,152203088,VNJM01003075.1,1,5039,3.31071e-05,146562109,0.962938
D.kanapiae,152203088,VNJM01000394.1,1,5039,3.31071e-05,146567148,0.962971
D.kanapiae,152203088,VNJM01002563.1,1,5036,3.30874e-05,146572184,0.963004
D.kanapiae,152203088,VNJM01002821.1,1,5034,3.30742e-05,146577218,0.963037
D.kanapiae,152203088,VNJM01001813.1,1,5027,3.30282e-05,146582245,0.96307
D.kanapiae,152203088,VNJM01002099.1,1,5024,3.30085e-05,146587269,0.963103
D.kanapiae,152203088,VNJM01000796.1,1,5017,3.29625e-05,146592286,0.963136
D.kanapiae,152203088,VNJM01002493.1,1,5010,3.29165e-05,146597296,0.963169
D.kanapiae,152203088,VNJM01002284.1,1,5001,3.28574e-05,146602297,0.963202
D.kanapiae,152203088,VNJM01001033.1,1,5000,3.28508e-05,146607297,0.963235
D.kanapiae,152203088,VNJM01000759.1,1,4990,3.27851e-05,146612287,0.963267
D.kanapiae,152203088,VNJM01002625.1,1,4989,3.27786e-05,146617276,0.9633
D.kanapiae,152203088,VNJM01003347.1,1,4981,3.2726e-05,146622257,0.963333
D.kanapiae,152203088,VNJM01000510.1,1,4981,3.2726e-05,146627238,0.963366
D.kanapiae,152203088,VNJM01000244.1,1,4960,3.2588e-05,146632198,0.963398
D.kanapiae,152203088,VNJM01001788.1,1,4958,3.25749e-05,146637156,0.963431
D.kanapiae,152203088,VNJM01001046.1,1,4950,3.25223e-05,146642106,0.963463
D.kanapiae,152203088,VNJM01001846.1,1,4936,3.24304e-05,146647042,0.963496
D.kanapiae,152203088,VNJM01001752.1,1,4934,3.24172e-05,146651976,0.963528
D.kanapiae,152203088,VNJM01002539.1,1,4932,3.24041e-05,146656908,0.963561
D.kanapiae,152203088,VNJM01003549.1,1,4930,3.23909e-05,146661838,0.963593
D.kanapiae,152203088,VNJM01003337.1,1,4924,3.23515e-05,146666762,0.963625
D.kanapiae,152203088,VNJM01002710.1,1,4921,3.23318e-05,146671683,0.963658
D.kanapiae,152203088,VNJM01001182.1,1,4919,3.23187e-05,146676602,0.96369
D.kanapiae,152203088,VNJM01001985.1,1,4917,3.23055e-05,146681519,0.963722
D.kanapiae,152203088,VNJM01000614.1,1,4916,3.2299e-05,146686435,0.963755
D.kanapiae,152203088,VNJM01002905.1,1,4913,3.22792e-05,146691348,0.963787
D.kanapiae,152203088,VNJM01003168.1,1,4909,3.2253e-05,146696257,0.963819
D.kanapiae,152203088,VNJM01003477.1,1,4903,3.22135e-05,146701160,0.963851
D.kanapiae,152203088,VNJM01001896.1,1,4903,3.22135e-05,146706063,0.963884
D.kanapiae,152203088,VNJM01002100.1,1,4899,3.21873e-05,146710962,0.963916
D.kanapiae,152203088,VNJM01001318.1,1,4899,3.21873e-05,146715861,0.963948
D.kanapiae,152203088,VNJM01003115.1,1,4893,3.21478e-05,146720754,0.96398
D.kanapiae,152203088,VNJM01003539.1,1,4885,3.20953e-05,146725639,0.964012
D.kanapiae,152203088,VNJM01000713.1,1,4882,3.20756e-05,146730521,0.964044
D.kanapiae,152203088,VNJM01002297.1,1,4866,3.19704e-05,146735387,0.964076
D.kanapiae,152203088,VNJM01001217.1,1,4864,3.19573e-05,146740251,0.964108
D.kanapiae,152203088,VNJM01002598.1,1,4845,3.18325e-05,146745096,0.96414
D.kanapiae,152203088,VNJM01002072.1,1,4838,3.17865e-05,146749934,0.964172
D.kanapiae,152203088,VNJM01001950.1,1,4836,3.17733e-05,146754770,0.964204
D.kanapiae,152203088,VNJM01001381.1,1,4832,3.17471e-05,146759602,0.964235
D.kanapiae,152203088,VNJM01003547.1,1,4814,3.16288e-05,146764416,0.964267
D.kanapiae,152203088,VNJM01000423.1,1,4808,3.15894e-05,146769224,0.964299
D.kanapiae,152203088,VNJM01001987.1,1,4803,3.15565e-05,146774027,0.96433
D.kanapiae,152203088,VNJM01001305.1,1,4802,3.155e-05,146778829,0.964362
D.kanapiae,152203088,VNJM01002138.1,1,4801,3.15434e-05,146783630,0.964393
D.kanapiae,152203088,VNJM01002554.1,1,4798,3.15237e-05,146788428,0.964425
D.kanapiae,152203088,VNJM01002716.1,1,4793,3.14908e-05,146793221,0.964456
D.kanapiae,152203088,VNJM01003359.1,1,4792,3.14842e-05,146798013,0.964488
D.kanapiae,152203088,VNJM01000661.1,1,4792,3.14842e-05,146802805,0.964519
D.kanapiae,152203088,VNJM01000931.1,1,4784,3.14317e-05,146807589,0.964551
D.kanapiae,152203088,VNJM01000439.1,1,4771,3.13463e-05,146812360,0.964582
D.kanapiae,152203088,VNJM01002113.1,1,4770,3.13397e-05,146817130,0.964613
D.kanapiae,152203088,VNJM01003137.1,1,4769,3.13331e-05,146821899,0.964645
D.kanapiae,152203088,VNJM01001001.1,1,4762,3.12871e-05,146826661,0.964676
D.kanapiae,152203088,VNJM01003403.1,1,4759,3.12674e-05,146831420,0.964707
D.kanapiae,152203088,VNJM01003468.1,1,4755,3.12412e-05,146836175,0.964738
D.kanapiae,152203088,VNJM01002591.1,1,4755,3.12412e-05,146840930,0.96477
D.kanapiae,152203088,VNJM01002924.1,1,4748,3.11952e-05,146845678,0.964801
D.kanapiae,152203088,VNJM01001508.1,1,4748,3.11952e-05,146850426,0.964832
D.kanapiae,152203088,VNJM01003240.1,1,4747,3.11886e-05,146855173,0.964863
D.kanapiae,152203088,VNJM01003452.1,1,4745,3.11755e-05,146859918,0.964894
D.kanapiae,152203088,VNJM01001197.1,1,4744,3.11689e-05,146864662,0.964926
D.kanapiae,152203088,VNJM01002156.1,1,4743,3.11623e-05,146869405,0.964957
D.kanapiae,152203088,VNJM01000764.1,1,4735,3.11097e-05,146874140,0.964988
D.kanapiae,152203088,VNJM01000659.1,1,4733,3.10966e-05,146878873,0.965019
D.kanapiae,152203088,VNJM01000744.1,1,4732,3.109e-05,146883605,0.96505
D.kanapiae,152203088,VNJM01003407.1,1,4726,3.10506e-05,146888331,0.965081
D.kanapiae,152203088,VNJM01000403.1,1,4725,3.1044e-05,146893056,0.965112
D.kanapiae,152203088,VNJM01000771.1,1,4724,3.10375e-05,146897780,0.965143
D.kanapiae,152203088,VNJM01001615.1,1,4712,3.09586e-05,146902492,0.965174
D.kanapiae,152203088,VNJM01000766.1,1,4709,3.09389e-05,146907201,0.965205
D.kanapiae,152203088,VNJM01003532.1,1,4705,3.09126e-05,146911906,0.965236
D.kanapiae,152203088,VNJM01001555.1,1,4704,3.09061e-05,146916610,0.965267
D.kanapiae,152203088,VNJM01000496.1,1,4701,3.08864e-05,146921311,0.965298
D.kanapiae,152203088,VNJM01000669.1,1,4700,3.08798e-05,146926011,0.965329
D.kanapiae,152203088,VNJM01001782.1,1,4693,3.08338e-05,146930704,0.96536
D.kanapiae,152203088,VNJM01002809.1,1,4678,3.07353e-05,146935382,0.96539
D.kanapiae,152203088,VNJM01002451.1,1,4678,3.07353e-05,146940060,0.965421
D.kanapiae,152203088,VNJM01002330.1,1,4673,3.07024e-05,146944733,0.965452
D.kanapiae,152203088,VNJM01000846.1,1,4668,3.06695e-05,146949401,0.965482
D.kanapiae,152203088,VNJM01000075.1,1,4663,3.06367e-05,146954064,0.965513
D.kanapiae,152203088,VNJM01003031.1,1,4662,3.06301e-05,146958726,0.965544
D.kanapiae,152203088,VNJM01001834.1,1,4662,3.06301e-05,146963388,0.965574
D.kanapiae,152203088,VNJM01000544.1,1,4653,3.0571e-05,146968041,0.965605
D.kanapiae,152203088,VNJM01002208.1,1,4628,3.04067e-05,146972669,0.965635
D.kanapiae,152203088,VNJM01002097.1,1,4625,3.0387e-05,146977294,0.965666
D.kanapiae,152203088,VNJM01001081.1,1,4610,3.02885e-05,146981904,0.965696
D.kanapiae,152203088,VNJM01001983.1,1,4590,3.01571e-05,146986494,0.965726
D.kanapiae,152203088,VNJM01002651.1,1,4587,3.01374e-05,146991081,0.965756
D.kanapiae,152203088,VNJM01001967.1,1,4581,3.00979e-05,146995662,0.965786
D.kanapiae,152203088,VNJM01001134.1,1,4570,3.00257e-05,147000232,0.965816
D.kanapiae,152203088,VNJM01001887.1,1,4565,2.99928e-05,147004797,0.965846
D.kanapiae,152203088,VNJM01002102.1,1,4557,2.99403e-05,147009354,0.965876
D.kanapiae,152203088,VNJM01002484.1,1,4556,2.99337e-05,147013910,0.965906
D.kanapiae,152203088,VNJM01001476.1,1,4553,2.9914e-05,147018463,0.965936
D.kanapiae,152203088,VNJM01001750.1,1,4548,2.98811e-05,147023011,0.965966
D.kanapiae,152203088,VNJM01002331.1,1,4542,2.98417e-05,147027553,0.965996
D.kanapiae,152203088,VNJM01000653.1,1,4539,2.9822e-05,147032092,0.966026
D.kanapiae,152203088,VNJM01002734.1,1,4538,2.98154e-05,147036630,0.966055
D.kanapiae,152203088,VNJM01003267.1,1,4537,2.98089e-05,147041167,0.966085
D.kanapiae,152203088,VNJM01002692.1,1,4537,2.98089e-05,147045704,0.966115
D.kanapiae,152203088,VNJM01001964.1,1,4534,2.97891e-05,147050238,0.966145
D.kanapiae,152203088,VNJM01001972.1,1,4529,2.97563e-05,147054767,0.966175
D.kanapiae,152203088,VNJM01003326.1,1,4522,2.97103e-05,147059289,0.966204
D.kanapiae,152203088,VNJM01000082.1,1,4519,2.96906e-05,147063808,0.966234
D.kanapiae,152203088,VNJM01001854.1,1,4517,2.96775e-05,147068325,0.966264
D.kanapiae,152203088,VNJM01001297.1,1,4513,2.96512e-05,147072838,0.966293
D.kanapiae,152203088,VNJM01002818.1,1,4510,2.96315e-05,147077348,0.966323
D.kanapiae,152203088,VNJM01002144.1,1,4507,2.96118e-05,147081855,0.966353
D.kanapiae,152203088,VNJM01001432.1,1,4507,2.96118e-05,147086362,0.966382
D.kanapiae,152203088,VNJM01001861.1,1,4497,2.9546e-05,147090859,0.966412
D.kanapiae,152203088,VNJM01000676.1,1,4496,2.95395e-05,147095355,0.966441
D.kanapiae,152203088,VNJM01000337.1,1,4496,2.95395e-05,147099851,0.966471
D.kanapiae,152203088,VNJM01002400.1,1,4493,2.95198e-05,147104344,0.9665
D.kanapiae,152203088,VNJM01001200.1,1,4483,2.94541e-05,147108827,0.96653
D.kanapiae,152203088,VNJM01003005.1,1,4470,2.93687e-05,147113297,0.966559
D.kanapiae,152203088,VNJM01000359.1,1,4470,2.93687e-05,147117767,0.966589
D.kanapiae,152203088,VNJM01001739.1,1,4459,2.92964e-05,147122226,0.966618
D.kanapiae,152203088,VNJM01003153.1,1,4451,2.92438e-05,147126677,0.966647
D.kanapiae,152203088,VNJM01002886.1,1,4449,2.92307e-05,147131126,0.966676
D.kanapiae,152203088,VNJM01002902.1,1,4448,2.92241e-05,147135574,0.966706
D.kanapiae,152203088,VNJM01000095.1,1,4445,2.92044e-05,147140019,0.966735
D.kanapiae,152203088,VNJM01002336.1,1,4444,2.91978e-05,147144463,0.966764
D.kanapiae,152203088,VNJM01002808.1,1,4441,2.91781e-05,147148904,0.966793
D.kanapiae,152203088,VNJM01001430.1,1,4441,2.91781e-05,147153345,0.966822
D.kanapiae,152203088,VNJM01003147.1,1,4436,2.91453e-05,147157781,0.966851
D.kanapiae,152203088,VNJM01003555.1,1,4430,2.91058e-05,147162211,0.966881
D.kanapiae,152203088,VNJM01003206.1,1,4426,2.90796e-05,147166637,0.96691
D.kanapiae,152203088,VNJM01000483.1,1,4425,2.9073e-05,147171062,0.966939
D.kanapiae,152203088,VNJM01003125.1,1,4420,2.90401e-05,147175482,0.966968
D.kanapiae,152203088,VNJM01001104.1,1,4406,2.89482e-05,147179888,0.966997
D.kanapiae,152203088,VNJM01000625.1,1,4397,2.8889e-05,147184285,0.967026
D.kanapiae,152203088,VNJM01002205.1,1,4388,2.88299e-05,147188673,0.967054
D.kanapiae,152203088,VNJM01002044.1,1,4387,2.88233e-05,147193060,0.967083
D.kanapiae,152203088,VNJM01001254.1,1,4386,2.88168e-05,147197446,0.967112
D.kanapiae,152203088,VNJM01002822.1,1,4383,2.87971e-05,147201829,0.967141
D.kanapiae,152203088,VNJM01002065.1,1,4380,2.87773e-05,147206209,0.96717
D.kanapiae,152203088,VNJM01003621.1,1,4371,2.87182e-05,147210580,0.967198
D.kanapiae,152203088,VNJM01003538.1,1,4371,2.87182e-05,147214951,0.967227
D.kanapiae,152203088,VNJM01000363.1,1,4370,2.87116e-05,147219321,0.967256
D.kanapiae,152203088,VNJM01001238.1,1,4368,2.86985e-05,147223689,0.967285
D.kanapiae,152203088,VNJM01003277.1,1,4367,2.86919e-05,147228056,0.967313
D.kanapiae,152203088,VNJM01001264.1,1,4364,2.86722e-05,147232420,0.967342
D.kanapiae,152203088,VNJM01002706.1,1,4362,2.86591e-05,147236782,0.967371
D.kanapiae,152203088,VNJM01001580.1,1,4357,2.86262e-05,147241139,0.967399
D.kanapiae,152203088,VNJM01000219.1,1,4355,2.86131e-05,147245494,0.967428
D.kanapiae,152203088,VNJM01003548.1,1,4349,2.85737e-05,147249843,0.967456
D.kanapiae,152203088,VNJM01000024.1,1,4349,2.85737e-05,147254192,0.967485
D.kanapiae,152203088,VNJM01003141.1,1,4331,2.84554e-05,147258523,0.967513
D.kanapiae,152203088,VNJM01000166.1,1,4329,2.84423e-05,147262852,0.967542
D.kanapiae,152203088,VNJM01001610.1,1,4328,2.84357e-05,147267180,0.96757
D.kanapiae,152203088,VNJM01002514.1,1,4321,2.83897e-05,147271501,0.967599
D.kanapiae,152203088,VNJM01001900.1,1,4316,2.83568e-05,147275817,0.967627
D.kanapiae,152203088,VNJM01001322.1,1,4313,2.83371e-05,147280130,0.967655
D.kanapiae,152203088,VNJM01001451.1,1,4310,2.83174e-05,147284440,0.967684
D.kanapiae,152203088,VNJM01000427.1,1,4309,2.83109e-05,147288749,0.967712
D.kanapiae,152203088,VNJM01003472.1,1,4307,2.82977e-05,147293056,0.96774
D.kanapiae,152203088,VNJM01002007.1,1,4307,2.82977e-05,147297363,0.967769
D.kanapiae,152203088,VNJM01000627.1,1,4304,2.8278e-05,147301667,0.967797
D.kanapiae,152203088,VNJM01000706.1,1,4297,2.8232e-05,147305964,0.967825
D.kanapiae,152203088,VNJM01000468.1,1,4291,2.81926e-05,147310255,0.967853
D.kanapiae,152203088,VNJM01001676.1,1,4287,2.81663e-05,147314542,0.967881
D.kanapiae,152203088,VNJM01000816.1,1,4287,2.81663e-05,147318829,0.96791
D.kanapiae,152203088,VNJM01000327.1,1,4284,2.81466e-05,147323113,0.967938
D.kanapiae,152203088,VNJM01003504.1,1,4283,2.814e-05,147327396,0.967966
D.kanapiae,152203088,VNJM01000837.1,1,4271,2.80612e-05,147331667,0.967994
D.kanapiae,152203088,VNJM01003042.1,1,4267,2.80349e-05,147335934,0.968022
D.kanapiae,152203088,VNJM01002743.1,1,4261,2.79955e-05,147340195,0.96805
D.kanapiae,152203088,VNJM01002510.1,1,4259,2.79823e-05,147344454,0.968078
D.kanapiae,152203088,VNJM01000347.1,1,4258,2.79758e-05,147348712,0.968106
D.kanapiae,152203088,VNJM01000112.1,1,4250,2.79232e-05,147352962,0.968134
D.kanapiae,152203088,VNJM01000116.1,1,4249,2.79166e-05,147357211,0.968162
D.kanapiae,152203088,VNJM01002834.1,1,4248,2.79101e-05,147361459,0.96819
D.kanapiae,152203088,VNJM01000638.1,1,4247,2.79035e-05,147365706,0.968218
D.kanapiae,152203088,VNJM01001793.1,1,4246,2.78969e-05,147369952,0.968245
D.kanapiae,152203088,VNJM01001105.1,1,4242,2.78707e-05,147374194,0.968273
D.kanapiae,152203088,VNJM01003529.1,1,4233,2.78115e-05,147378427,0.968301
D.kanapiae,152203088,VNJM01002137.1,1,4228,2.77787e-05,147382655,0.968329
D.kanapiae,152203088,VNJM01002831.1,1,4213,2.76801e-05,147386868,0.968357
D.kanapiae,152203088,VNJM01002512.1,1,4213,2.76801e-05,147391081,0.968384
D.kanapiae,152203088,VNJM01000887.1,1,4213,2.76801e-05,147395294,0.968412
D.kanapiae,152203088,VNJM01003064.1,1,4206,2.76341e-05,147399500,0.96844
D.kanapiae,152203088,VNJM01001825.1,1,4203,2.76144e-05,147403703,0.968467
D.kanapiae,152203088,VNJM01001583.1,1,4198,2.75816e-05,147407901,0.968495
D.kanapiae,152203088,VNJM01002043.1,1,4197,2.7575e-05,147412098,0.968522
D.kanapiae,152203088,VNJM01003008.1,1,4191,2.75356e-05,147416289,0.96855
D.kanapiae,152203088,VNJM01002153.1,1,4189,2.75224e-05,147420478,0.968577
D.kanapiae,152203088,VNJM01002026.1,1,4188,2.75159e-05,147424666,0.968605
D.kanapiae,152203088,VNJM01002453.1,1,4179,2.74567e-05,147428845,0.968632
D.kanapiae,152203088,VNJM01002567.1,1,4170,2.73976e-05,147433015,0.96866
D.kanapiae,152203088,VNJM01000526.1,1,4166,2.73713e-05,147437181,0.968687
D.kanapiae,152203088,VNJM01000013.1,1,4166,2.73713e-05,147441347,0.968715
D.kanapiae,152203088,VNJM01002440.1,1,4164,2.73582e-05,147445511,0.968742
D.kanapiae,152203088,VNJM01002826.1,1,4162,2.7345e-05,147449673,0.968769
D.kanapiae,152203088,VNJM01003171.1,1,4160,2.73319e-05,147453833,0.968797
D.kanapiae,152203088,VNJM01001849.1,1,4156,2.73056e-05,147457989,0.968824
D.kanapiae,152203088,VNJM01003602.1,1,4152,2.72793e-05,147462141,0.968851
D.kanapiae,152203088,VNJM01003353.1,1,4147,2.72465e-05,147466288,0.968878
D.kanapiae,152203088,VNJM01002875.1,1,4145,2.72334e-05,147470433,0.968906
D.kanapiae,152203088,VNJM01003106.1,1,4143,2.72202e-05,147474576,0.968933
D.kanapiae,152203088,VNJM01001689.1,1,4140,2.72005e-05,147478716,0.96896
D.kanapiae,152203088,VNJM01000820.1,1,4139,2.71939e-05,147482855,0.968987
D.kanapiae,152203088,VNJM01002892.1,1,4137,2.71808e-05,147486992,0.969014
D.kanapiae,152203088,VNJM01001371.1,1,4124,2.70954e-05,147491116,0.969042
D.kanapiae,152203088,VNJM01001830.1,1,4113,2.70231e-05,147495229,0.969069
D.kanapiae,152203088,VNJM01002106.1,1,4111,2.701e-05,147499340,0.969096
D.kanapiae,152203088,VNJM01002765.1,1,4109,2.69968e-05,147503449,0.969123
D.kanapiae,152203088,VNJM01000523.1,1,4109,2.69968e-05,147507558,0.96915
D.kanapiae,152203088,VNJM01003471.1,1,4107,2.69837e-05,147511665,0.969177
D.kanapiae,152203088,VNJM01003043.1,1,4106,2.69771e-05,147515771,0.969204
D.kanapiae,152203088,VNJM01003004.1,1,4100,2.69377e-05,147519871,0.96923
D.kanapiae,152203088,VNJM01002334.1,1,4099,2.69311e-05,147523970,0.969257
D.kanapiae,152203088,VNJM01001265.1,1,4092,2.68851e-05,147528062,0.969284
D.kanapiae,152203088,VNJM01001500.1,1,4083,2.6826e-05,147532145,0.969311
D.kanapiae,152203088,VNJM01000783.1,1,4082,2.68194e-05,147536227,0.969338
D.kanapiae,152203088,VNJM01002051.1,1,4078,2.67931e-05,147540305,0.969365
D.kanapiae,152203088,VNJM01000838.1,1,4076,2.678e-05,147544381,0.969392
D.kanapiae,152203088,VNJM01003605.1,1,4074,2.67669e-05,147548455,0.969418
D.kanapiae,152203088,VNJM01000174.1,1,4070,2.67406e-05,147552525,0.969445
D.kanapiae,152203088,VNJM01003569.1,1,4068,2.67274e-05,147556593,0.969472
D.kanapiae,152203088,VNJM01000499.1,1,4067,2.67209e-05,147560660,0.969498
D.kanapiae,152203088,VNJM01003416.1,1,4066,2.67143e-05,147564726,0.969525
D.kanapiae,152203088,VNJM01002602.1,1,4065,2.67077e-05,147568791,0.969552
D.kanapiae,152203088,VNJM01001953.1,1,4062,2.6688e-05,147572853,0.969579
D.kanapiae,152203088,VNJM01001567.1,1,4059,2.66683e-05,147576912,0.969605
D.kanapiae,152203088,VNJM01002229.1,1,4057,2.66552e-05,147580969,0.969632
D.kanapiae,152203088,VNJM01002001.1,1,4055,2.6642e-05,147585024,0.969659
D.kanapiae,152203088,VNJM01001274.1,1,4052,2.66223e-05,147589076,0.969685
D.kanapiae,152203088,VNJM01001282.1,1,4049,2.66026e-05,147593125,0.969712
D.kanapiae,152203088,VNJM01001017.1,1,4046,2.65829e-05,147597171,0.969738
D.kanapiae,152203088,VNJM01002109.1,1,4045,2.65763e-05,147601216,0.969765
D.kanapiae,152203088,VNJM01000958.1,1,4042,2.65566e-05,147605258,0.969791
D.kanapiae,152203088,VNJM01002450.1,1,4036,2.65172e-05,147609294,0.969818
D.kanapiae,152203088,VNJM01002621.1,1,4034,2.65041e-05,147613328,0.969845
D.kanapiae,152203088,VNJM01002974.1,1,4030,2.64778e-05,147617358,0.969871
D.kanapiae,152203088,VNJM01001263.1,1,4017,2.63924e-05,147621375,0.969897
D.kanapiae,152203088,VNJM01000006.1,1,4017,2.63924e-05,147625392,0.969924
D.kanapiae,152203088,VNJM01001902.1,1,4016,2.63858e-05,147629408,0.96995
D.kanapiae,152203088,VNJM01000354.1,1,4011,2.63529e-05,147633419,0.969977
D.kanapiae,152203088,VNJM01003081.1,1,4008,2.63332e-05,147637427,0.970003
D.kanapiae,152203088,VNJM01001469.1,1,4006,2.63201e-05,147641433,0.970029
D.kanapiae,152203088,VNJM01002458.1,1,4002,2.62938e-05,147645435,0.970055
D.kanapiae,152203088,VNJM01002352.1,1,4002,2.62938e-05,147649437,0.970082
D.kanapiae,152203088,VNJM01002014.1,1,4000,2.62807e-05,147653437,0.970108
D.kanapiae,152203088,VNJM01003334.1,1,3997,2.6261e-05,147657434,0.970134
D.kanapiae,152203088,VNJM01000952.1,1,3994,2.62413e-05,147661428,0.970161
D.kanapiae,152203088,VNJM01003382.1,1,3992,2.62281e-05,147665420,0.970187
D.kanapiae,152203088,VNJM01002656.1,1,3985,2.61821e-05,147669405,0.970213
D.kanapiae,152203088,VNJM01001633.1,1,3980,2.61493e-05,147673385,0.970239
D.kanapiae,152203088,VNJM01000342.1,1,3978,2.61361e-05,147677363,0.970265
D.kanapiae,152203088,VNJM01003082.1,1,3973,2.61033e-05,147681336,0.970291
D.kanapiae,152203088,VNJM01001299.1,1,3972,2.60967e-05,147685308,0.970317
D.kanapiae,152203088,VNJM01001875.1,1,3971,2.60901e-05,147689279,0.970344
D.kanapiae,152203088,VNJM01001151.1,1,3954,2.59784e-05,147693233,0.970369
D.kanapiae,152203088,VNJM01000807.1,1,3953,2.59719e-05,147697186,0.970395
D.kanapiae,152203088,VNJM01001564.1,1,3952,2.59653e-05,147701138,0.970421
D.kanapiae,152203088,VNJM01000345.1,1,3945,2.59193e-05,147705083,0.970447
D.kanapiae,152203088,VNJM01001407.1,1,3943,2.59062e-05,147709026,0.970473
D.kanapiae,152203088,VNJM01003039.1,1,3942,2.58996e-05,147712968,0.970499
D.kanapiae,152203088,VNJM01002276.1,1,3937,2.58668e-05,147716905,0.970525
D.kanapiae,152203088,VNJM01003282.1,1,3934,2.5847e-05,147720839,0.970551
D.kanapiae,152203088,VNJM01002573.1,1,3934,2.5847e-05,147724773,0.970577
D.kanapiae,152203088,VNJM01001168.1,1,3933,2.58405e-05,147728706,0.970603
D.kanapiae,152203088,VNJM01000011.1,1,3930,2.58208e-05,147732636,0.970628
D.kanapiae,152203088,VNJM01003237.1,1,3929,2.58142e-05,147736565,0.970654
D.kanapiae,152203088,VNJM01003632.1,1,3924,2.57813e-05,147740489,0.97068
D.kanapiae,152203088,VNJM01000034.1,1,3924,2.57813e-05,147744413,0.970706
D.kanapiae,152203088,VNJM01002714.1,1,3921,2.57616e-05,147748334,0.970732
D.kanapiae,152203088,VNJM01003035.1,1,3913,2.57091e-05,147752247,0.970757
D.kanapiae,152203088,VNJM01002216.1,1,3901,2.56302e-05,147756148,0.970783
D.kanapiae,152203088,VNJM01001445.1,1,3900,2.56237e-05,147760048,0.970808
D.kanapiae,152203088,VNJM01003032.1,1,3899,2.56171e-05,147763947,0.970834
D.kanapiae,152203088,VNJM01000933.1,1,3896,2.55974e-05,147767843,0.97086
D.kanapiae,152203088,VNJM01001468.1,1,3891,2.55645e-05,147771734,0.970885
D.kanapiae,152203088,VNJM01003068.1,1,3889,2.55514e-05,147775623,0.970911
D.kanapiae,152203088,VNJM01001574.1,1,3883,2.5512e-05,147779506,0.970936
D.kanapiae,152203088,VNJM01002049.1,1,3881,2.54988e-05,147783387,0.970962
D.kanapiae,152203088,VNJM01003120.1,1,3880,2.54923e-05,147787267,0.970987
D.kanapiae,152203088,VNJM01003021.1,1,3879,2.54857e-05,147791146,0.971013
D.kanapiae,152203088,VNJM01001346.1,1,3869,2.542e-05,147795015,0.971038
D.kanapiae,152203088,VNJM01003318.1,1,3852,2.53083e-05,147798867,0.971064
D.kanapiae,152203088,VNJM01000437.1,1,3848,2.5282e-05,147802715,0.971089
D.kanapiae,152203088,VNJM01000370.1,1,3845,2.52623e-05,147806560,0.971114
D.kanapiae,152203088,VNJM01000678.1,1,3843,2.52492e-05,147810403,0.971139
D.kanapiae,152203088,VNJM01001233.1,1,3841,2.5236e-05,147814244,0.971165
D.kanapiae,152203088,VNJM01001590.1,1,3839,2.52229e-05,147818083,0.97119
D.kanapiae,152203088,VNJM01000916.1,1,3836,2.52032e-05,147821919,0.971215
D.kanapiae,152203088,VNJM01002977.1,1,3834,2.519e-05,147825753,0.97124
D.kanapiae,152203088,VNJM01002865.1,1,3826,2.51375e-05,147829579,0.971265
D.kanapiae,152203088,VNJM01000908.1,1,3825,2.51309e-05,147833404,0.97129
D.kanapiae,152203088,VNJM01001541.1,1,3820,2.5098e-05,147837224,0.971316
D.kanapiae,152203088,VNJM01002367.1,1,3817,2.50783e-05,147841041,0.971341
D.kanapiae,152203088,VNJM01000751.1,1,3815,2.50652e-05,147844856,0.971366
D.kanapiae,152203088,VNJM01002413.1,1,3809,2.50258e-05,147848665,0.971391
D.kanapiae,152203088,VNJM01001354.1,1,3807,2.50126e-05,147852472,0.971416
D.kanapiae,152203088,VNJM01000240.1,1,3805,2.49995e-05,147856277,0.971441
D.kanapiae,152203088,VNJM01002183.1,1,3803,2.49864e-05,147860080,0.971466
D.kanapiae,152203088,VNJM01000314.1,1,3792,2.49141e-05,147863872,0.971491
D.kanapiae,152203088,VNJM01002252.1,1,3791,2.49075e-05,147867663,0.971516
D.kanapiae,152203088,VNJM01002860.1,1,3786,2.48747e-05,147871449,0.97154
D.kanapiae,152203088,VNJM01002145.1,1,3785,2.48681e-05,147875234,0.971565
D.kanapiae,152203088,VNJM01000133.1,1,3785,2.48681e-05,147879019,0.97159
D.kanapiae,152203088,VNJM01002196.1,1,3783,2.48549e-05,147882802,0.971615
D.kanapiae,152203088,VNJM01001959.1,1,3782,2.48484e-05,147886584,0.97164
D.kanapiae,152203088,VNJM01002178.1,1,3780,2.48352e-05,147890364,0.971665
D.kanapiae,152203088,VNJM01002408.1,1,3775,2.48024e-05,147894139,0.971689
D.kanapiae,152203088,VNJM01003080.1,1,3774,2.47958e-05,147897913,0.971714
D.kanapiae,152203088,VNJM01002597.1,1,3770,2.47695e-05,147901683,0.971739
D.kanapiae,152203088,VNJM01001644.1,1,3770,2.47695e-05,147905453,0.971764
D.kanapiae,152203088,VNJM01002614.1,1,3766,2.47433e-05,147909219,0.971789
D.kanapiae,152203088,VNJM01000407.1,1,3764,2.47301e-05,147912983,0.971813
D.kanapiae,152203088,VNJM01003212.1,1,3761,2.47104e-05,147916744,0.971838
D.kanapiae,152203088,VNJM01001520.1,1,3759,2.46973e-05,147920503,0.971863
D.kanapiae,152203088,VNJM01002179.1,1,3758,2.46907e-05,147924261,0.971887
D.kanapiae,152203088,VNJM01003627.1,1,3756,2.46776e-05,147928017,0.971912
D.kanapiae,152203088,VNJM01003564.1,1,3756,2.46776e-05,147931773,0.971937
D.kanapiae,152203088,VNJM01002549.1,1,3756,2.46776e-05,147935529,0.971961
D.kanapiae,152203088,VNJM01000656.1,1,3751,2.46447e-05,147939280,0.971986
D.kanapiae,152203088,VNJM01002462.1,1,3750,2.46381e-05,147943030,0.972011
D.kanapiae,152203088,VNJM01002521.1,1,3741,2.4579e-05,147946771,0.972035
D.kanapiae,152203088,VNJM01001589.1,1,3741,2.4579e-05,147950512,0.97206
D.kanapiae,152203088,VNJM01002388.1,1,3738,2.45593e-05,147954250,0.972084
D.kanapiae,152203088,VNJM01002279.1,1,3733,2.45264e-05,147957983,0.972109
D.kanapiae,152203088,VNJM01001333.1,1,3725,2.44739e-05,147961708,0.972133
D.kanapiae,152203088,VNJM01002120.1,1,3724,2.44673e-05,147965432,0.972158
D.kanapiae,152203088,VNJM01000374.1,1,3723,2.44607e-05,147969155,0.972182
D.kanapiae,152203088,VNJM01002424.1,1,3719,2.44345e-05,147972874,0.972207
D.kanapiae,152203088,VNJM01001030.1,1,3718,2.44279e-05,147976592,0.972231
D.kanapiae,152203088,VNJM01000597.1,1,3710,2.43753e-05,147980302,0.972256
D.kanapiae,152203088,VNJM01001558.1,1,3706,2.4349e-05,147984008,0.97228
D.kanapiae,152203088,VNJM01001530.1,1,3705,2.43425e-05,147987713,0.972304
D.kanapiae,152203088,VNJM01000877.1,1,3704,2.43359e-05,147991417,0.972329
D.kanapiae,152203088,VNJM01000643.1,1,3702,2.43228e-05,147995119,0.972353
D.kanapiae,152203088,VNJM01002534.1,1,3701,2.43162e-05,147998820,0.972377
D.kanapiae,152203088,VNJM01003119.1,1,3700,2.43096e-05,148002520,0.972402
D.kanapiae,152203088,VNJM01003357.1,1,3698,2.42965e-05,148006218,0.972426
D.kanapiae,152203088,VNJM01000405.1,1,3689,2.42374e-05,148009907,0.97245
D.kanapiae,152203088,VNJM01003134.1,1,3686,2.42176e-05,148013593,0.972474
D.kanapiae,152203088,VNJM01002801.1,1,3682,2.41914e-05,148017275,0.972499
D.kanapiae,152203088,VNJM01000715.1,1,3682,2.41914e-05,148020957,0.972523
D.kanapiae,152203088,VNJM01000259.1,1,3678,2.41651e-05,148024635,0.972547
D.kanapiae,152203088,VNJM01001747.1,1,3675,2.41454e-05,148028310,0.972571
D.kanapiae,152203088,VNJM01003374.1,1,3671,2.41191e-05,148031981,0.972595
D.kanapiae,152203088,VNJM01002619.1,1,3667,2.40928e-05,148035648,0.972619
D.kanapiae,152203088,VNJM01003297.1,1,3662,2.406e-05,148039310,0.972643
D.kanapiae,152203088,VNJM01000630.1,1,3662,2.406e-05,148042972,0.972667
D.kanapiae,152203088,VNJM01001522.1,1,3661,2.40534e-05,148046633,0.972691
D.kanapiae,152203088,VNJM01002160.1,1,3659,2.40402e-05,148050292,0.972715
D.kanapiae,152203088,VNJM01002234.1,1,3653,2.40008e-05,148053945,0.972739
D.kanapiae,152203088,VNJM01003396.1,1,3650,2.39811e-05,148057595,0.972763
D.kanapiae,152203088,VNJM01002020.1,1,3648,2.3968e-05,148061243,0.972787
D.kanapiae,152203088,VNJM01003425.1,1,3644,2.39417e-05,148064887,0.972811
D.kanapiae,152203088,VNJM01001024.1,1,3642,2.39286e-05,148068529,0.972835
D.kanapiae,152203088,VNJM01002312.1,1,3637,2.38957e-05,148072166,0.972859
D.kanapiae,152203088,VNJM01002812.1,1,3633,2.38694e-05,148075799,0.972883
D.kanapiae,152203088,VNJM01003408.1,1,3632,2.38629e-05,148079431,0.972907
D.kanapiae,152203088,VNJM01002253.1,1,3632,2.38629e-05,148083063,0.972931
D.kanapiae,152203088,VNJM01002882.1,1,3629,2.38431e-05,148086692,0.972955
D.kanapiae,152203088,VNJM01002945.1,1,3628,2.38366e-05,148090320,0.972978
D.kanapiae,152203088,VNJM01001622.1,1,3628,2.38366e-05,148093948,0.973002
D.kanapiae,152203088,VNJM01002321.1,1,3625,2.38169e-05,148097573,0.973026
D.kanapiae,152203088,VNJM01003630.1,1,3623,2.38037e-05,148101196,0.97305
D.kanapiae,152203088,VNJM01001921.1,1,3623,2.38037e-05,148104819,0.973074
D.kanapiae,152203088,VNJM01000222.1,1,3618,2.37709e-05,148108437,0.973097
D.kanapiae,152203088,VNJM01000036.1,1,3618,2.37709e-05,148112055,0.973121
D.kanapiae,152203088,VNJM01002893.1,1,3614,2.37446e-05,148115669,0.973145
D.kanapiae,152203088,VNJM01000776.1,1,3613,2.3738e-05,148119282,0.973169
D.kanapiae,152203088,VNJM01002850.1,1,3611,2.37249e-05,148122893,0.973192
D.kanapiae,152203088,VNJM01001800.1,1,3611,2.37249e-05,148126504,0.973216
D.kanapiae,152203088,VNJM01003400.1,1,3595,2.36198e-05,148130099,0.97324
D.kanapiae,152203088,VNJM01002703.1,1,3595,2.36198e-05,148133694,0.973263
D.kanapiae,152203088,VNJM01003127.1,1,3594,2.36132e-05,148137288,0.973287
D.kanapiae,152203088,VNJM01002903.1,1,3592,2.36e-05,148140880,0.973311
D.kanapiae,152203088,VNJM01003483.1,1,3591,2.35935e-05,148144471,0.973334
D.kanapiae,152203088,VNJM01003348.1,1,3590,2.35869e-05,148148061,0.973358
D.kanapiae,152203088,VNJM01000368.1,1,3585,2.35541e-05,148151646,0.973381
D.kanapiae,152203088,VNJM01000708.1,1,3579,2.35146e-05,148155225,0.973405
D.kanapiae,152203088,VNJM01002861.1,1,3578,2.35081e-05,148158803,0.973428
D.kanapiae,152203088,VNJM01000288.1,1,3576,2.34949e-05,148162379,0.973452
D.kanapiae,152203088,VNJM01002282.1,1,3567,2.34358e-05,148165946,0.973475
D.kanapiae,152203088,VNJM01000322.1,1,3563,2.34095e-05,148169509,0.973499
D.kanapiae,152203088,VNJM01000559.1,1,3558,2.33767e-05,148173067,0.973522
D.kanapiae,152203088,VNJM01000542.1,1,3557,2.33701e-05,148176624,0.973545
D.kanapiae,152203088,VNJM01003488.1,1,3556,2.33635e-05,148180180,0.973569
D.kanapiae,152203088,VNJM01001034.1,1,3551,2.33307e-05,148183731,0.973592
D.kanapiae,152203088,VNJM01003587.1,1,3547,2.33044e-05,148187278,0.973615
D.kanapiae,152203088,VNJM01000773.1,1,3546,2.32978e-05,148190824,0.973639
D.kanapiae,152203088,VNJM01003090.1,1,3545,2.32912e-05,148194369,0.973662
D.kanapiae,152203088,VNJM01001471.1,1,3540,2.32584e-05,148197909,0.973685
D.kanapiae,152203088,VNJM01002428.1,1,3537,2.32387e-05,148201446,0.973709
D.kanapiae,152203088,VNJM01002992.1,1,3536,2.32321e-05,148204982,0.973732
D.kanapiae,152203088,VNJM01001829.1,1,3536,2.32321e-05,148208518,0.973755
D.kanapiae,152203088,VNJM01002204.1,1,3534,2.3219e-05,148212052,0.973778
D.kanapiae,152203088,VNJM01002383.1,1,3526,2.31664e-05,148215578,0.973801
D.kanapiae,152203088,VNJM01000061.1,1,3526,2.31664e-05,148219104,0.973825
D.kanapiae,152203088,VNJM01002269.1,1,3524,2.31533e-05,148222628,0.973848
D.kanapiae,152203088,VNJM01001617.1,1,3524,2.31533e-05,148226152,0.973871
D.kanapiae,152203088,VNJM01002537.1,1,3517,2.31073e-05,148229669,0.973894
D.kanapiae,152203088,VNJM01002728.1,1,3506,2.3035e-05,148233175,0.973917
D.kanapiae,152203088,VNJM01000351.1,1,3506,2.3035e-05,148236681,0.97394
D.kanapiae,152203088,VNJM01000402.1,1,3505,2.30284e-05,148240186,0.973963
D.kanapiae,152203088,VNJM01000506.1,1,3504,2.30219e-05,148243690,0.973986
D.kanapiae,152203088,VNJM01002746.1,1,3503,2.30153e-05,148247193,0.974009
D.kanapiae,152203088,VNJM01003554.1,1,3501,2.30022e-05,148250694,0.974032
D.kanapiae,152203088,VNJM01003480.1,1,3501,2.30022e-05,148254195,0.974055
D.kanapiae,152203088,VNJM01002794.1,1,3499,2.2989e-05,148257694,0.974078
D.kanapiae,152203088,VNJM01003012.1,1,3494,2.29562e-05,148261188,0.974101
D.kanapiae,152203088,VNJM01002335.1,1,3493,2.29496e-05,148264681,0.974124
D.kanapiae,152203088,VNJM01002181.1,1,3489,2.29233e-05,148268170,0.974147
D.kanapiae,152203088,VNJM01002680.1,1,3486,2.29036e-05,148271656,0.97417
D.kanapiae,152203088,VNJM01002499.1,1,3485,2.2897e-05,148275141,0.974193
D.kanapiae,152203088,VNJM01001454.1,1,3484,2.28905e-05,148278625,0.974216
D.kanapiae,152203088,VNJM01002896.1,1,3482,2.28773e-05,148282107,0.974238
D.kanapiae,152203088,VNJM01001797.1,1,3482,2.28773e-05,148285589,0.974261
D.kanapiae,152203088,VNJM01000684.1,1,3482,2.28773e-05,148289071,0.974284
D.kanapiae,152203088,VNJM01001229.1,1,3475,2.28313e-05,148292546,0.974307
D.kanapiae,152203088,VNJM01001789.1,1,3474,2.28248e-05,148296020,0.97433
D.kanapiae,152203088,VNJM01003045.1,1,3473,2.28182e-05,148299493,0.974353
D.kanapiae,152203088,VNJM01000119.1,1,3472,2.28116e-05,148302965,0.974376
D.kanapiae,152203088,VNJM01000436.1,1,3470,2.27985e-05,148306435,0.974398
D.kanapiae,152203088,VNJM01003203.1,1,3469,2.27919e-05,148309904,0.974421
D.kanapiae,152203088,VNJM01002294.1,1,3469,2.27919e-05,148313373,0.974444
D.kanapiae,152203088,VNJM01003421.1,1,3465,2.27656e-05,148316838,0.974467
D.kanapiae,152203088,VNJM01002538.1,1,3465,2.27656e-05,148320303,0.974489
D.kanapiae,152203088,VNJM01002495.1,1,3463,2.27525e-05,148323766,0.974512
D.kanapiae,152203088,VNJM01000106.1,1,3461,2.27394e-05,148327227,0.974535
D.kanapiae,152203088,VNJM01003049.1,1,3456,2.27065e-05,148330683,0.974558
D.kanapiae,152203088,VNJM01002240.1,1,3451,2.26737e-05,148334134,0.97458
D.kanapiae,152203088,VNJM01002552.1,1,3450,2.26671e-05,148337584,0.974603
D.kanapiae,152203088,VNJM01003373.1,1,3448,2.26539e-05,148341032,0.974626
D.kanapiae,152203088,VNJM01000280.1,1,3446,2.26408e-05,148344478,0.974648
D.kanapiae,152203088,VNJM01000186.1,1,3444,2.26277e-05,148347922,0.974671
D.kanapiae,152203088,VNJM01000067.1,1,3444,2.26277e-05,148351366,0.974694
D.kanapiae,152203088,VNJM01000203.1,1,3443,2.26211e-05,148354809,0.974716
D.kanapiae,152203088,VNJM01001004.1,1,3441,2.2608e-05,148358250,0.974739
D.kanapiae,152203088,VNJM01002967.1,1,3438,2.25882e-05,148361688,0.974761
D.kanapiae,152203088,VNJM01003328.1,1,3432,2.25488e-05,148365120,0.974784
D.kanapiae,152203088,VNJM01002298.1,1,3432,2.25488e-05,148368552,0.974806
D.kanapiae,152203088,VNJM01001284.1,1,3432,2.25488e-05,148371984,0.974829
D.kanapiae,152203088,VNJM01001695.1,1,3429,2.25291e-05,148375413,0.974852
D.kanapiae,152203088,VNJM01002885.1,1,3428,2.25225e-05,148378841,0.974874
D.kanapiae,152203088,VNJM01002643.1,1,3427,2.2516e-05,148382268,0.974897
D.kanapiae,152203088,VNJM01002471.1,1,3425,2.25028e-05,148385693,0.974919
D.kanapiae,152203088,VNJM01000821.1,1,3425,2.25028e-05,148389118,0.974942
D.kanapiae,152203088,VNJM01000118.1,1,3422,2.24831e-05,148392540,0.974964
D.kanapiae,152203088,VNJM01002011.1,1,3421,2.24765e-05,148395961,0.974987
D.kanapiae,152203088,VNJM01003465.1,1,3420,2.247e-05,148399381,0.975009
D.kanapiae,152203088,VNJM01001257.1,1,3418,2.24568e-05,148402799,0.975031
D.kanapiae,152203088,VNJM01001255.1,1,3412,2.24174e-05,148406211,0.975054
D.kanapiae,152203088,VNJM01003325.1,1,3408,2.23911e-05,148409619,0.975076
D.kanapiae,152203088,VNJM01002740.1,1,3408,2.23911e-05,148413027,0.975099
D.kanapiae,152203088,VNJM01002996.1,1,3406,2.2378e-05,148416433,0.975121
D.kanapiae,152203088,VNJM01001192.1,1,3405,2.23714e-05,148419838,0.975143
D.kanapiae,152203088,VNJM01001540.1,1,3403,2.23583e-05,148423241,0.975166
D.kanapiae,152203088,VNJM01000111.1,1,3396,2.23123e-05,148426637,0.975188
D.kanapiae,152203088,VNJM01003023.1,1,3394,2.22992e-05,148430031,0.97521
D.kanapiae,152203088,VNJM01002242.1,1,3392,2.2286e-05,148433423,0.975233
D.kanapiae,152203088,VNJM01001643.1,1,3392,2.2286e-05,148436815,0.975255
D.kanapiae,152203088,VNJM01001162.1,1,3392,2.2286e-05,148440207,0.975277
D.kanapiae,152203088,VNJM01000784.1,1,3384,2.22335e-05,148443591,0.975299
D.kanapiae,152203088,VNJM01001542.1,1,3383,2.22269e-05,148446974,0.975322
D.kanapiae,152203088,VNJM01003556.1,1,3382,2.22203e-05,148450356,0.975344
D.kanapiae,152203088,VNJM01002631.1,1,3379,2.22006e-05,148453735,0.975366
D.kanapiae,152203088,VNJM01003200.1,1,3377,2.21875e-05,148457112,0.975388
D.kanapiae,152203088,VNJM01001780.1,1,3377,2.21875e-05,148460489,0.97541
D.kanapiae,152203088,VNJM01003199.1,1,3373,2.21612e-05,148463862,0.975433
D.kanapiae,152203088,VNJM01001438.1,1,3373,2.21612e-05,148467235,0.975455
D.kanapiae,152203088,VNJM01002553.1,1,3371,2.2148e-05,148470606,0.975477
D.kanapiae,152203088,VNJM01001019.1,1,3362,2.20889e-05,148473968,0.975499
D.kanapiae,152203088,VNJM01001738.1,1,3353,2.20298e-05,148477321,0.975521
D.kanapiae,152203088,VNJM01002773.1,1,3351,2.20166e-05,148480672,0.975543
D.kanapiae,152203088,VNJM01000229.1,1,3351,2.20166e-05,148484023,0.975565
D.kanapiae,152203088,VNJM01002971.1,1,3349,2.20035e-05,148487372,0.975587
D.kanapiae,152203088,VNJM01002232.1,1,3349,2.20035e-05,148490721,0.975609
D.kanapiae,152203088,VNJM01000142.1,1,3347,2.19904e-05,148494068,0.975631
D.kanapiae,152203088,VNJM01001975.1,1,3342,2.19575e-05,148497410,0.975653
D.kanapiae,152203088,VNJM01002953.1,1,3334,2.19049e-05,148500744,0.975675
D.kanapiae,152203088,VNJM01002177.1,1,3333,2.18984e-05,148504077,0.975697
D.kanapiae,152203088,VNJM01002005.1,1,3327,2.1859e-05,148507404,0.975719
D.kanapiae,152203088,VNJM01001926.1,1,3324,2.18392e-05,148510728,0.975741
D.kanapiae,152203088,VNJM01000551.1,1,3323,2.18327e-05,148514051,0.975762
D.kanapiae,152203088,VNJM01001989.1,1,3321,2.18195e-05,148517372,0.975784
D.kanapiae,152203088,VNJM01002236.1,1,3318,2.17998e-05,148520690,0.975806
D.kanapiae,152203088,VNJM01002830.1,1,3315,2.17801e-05,148524005,0.975828
D.kanapiae,152203088,VNJM01001529.1,1,3313,2.1767e-05,148527318,0.97585
D.kanapiae,152203088,VNJM01002350.1,1,3309,2.17407e-05,148530627,0.975871
D.kanapiae,152203088,VNJM01001221.1,1,3309,2.17407e-05,148533936,0.975893
D.kanapiae,152203088,VNJM01002542.1,1,3306,2.1721e-05,148537242,0.975915
D.kanapiae,152203088,VNJM01000757.1,1,3303,2.17013e-05,148540545,0.975936
D.kanapiae,152203088,VNJM01002532.1,1,3296,2.16553e-05,148543841,0.975958
D.kanapiae,152203088,VNJM01003006.1,1,3294,2.16421e-05,148547135,0.97598
D.kanapiae,152203088,VNJM01003581.1,1,3293,2.16356e-05,148550428,0.976001
D.kanapiae,152203088,VNJM01002571.1,1,3291,2.16224e-05,148553719,0.976023
D.kanapiae,152203088,VNJM01003029.1,1,3287,2.15961e-05,148557006,0.976045
D.kanapiae,152203088,VNJM01000722.1,1,3284,2.15764e-05,148560290,0.976066
D.kanapiae,152203088,VNJM01001269.1,1,3278,2.1537e-05,148563568,0.976088
D.kanapiae,152203088,VNJM01003113.1,1,3277,2.15304e-05,148566845,0.976109
D.kanapiae,152203088,VNJM01000935.1,1,3273,2.15042e-05,148570118,0.976131
D.kanapiae,152203088,VNJM01003606.1,1,3267,2.14647e-05,148573385,0.976152
D.kanapiae,152203088,VNJM01000747.1,1,3267,2.14647e-05,148576652,0.976174
D.kanapiae,152203088,VNJM01003489.1,1,3264,2.1445e-05,148579916,0.976195
D.kanapiae,152203088,VNJM01003201.1,1,3264,2.1445e-05,148583180,0.976217
D.kanapiae,152203088,VNJM01000404.1,1,3263,2.14385e-05,148586443,0.976238
D.kanapiae,152203088,VNJM01000239.1,1,3263,2.14385e-05,148589706,0.976259
D.kanapiae,152203088,VNJM01003077.1,1,3262,2.14319e-05,148592968,0.976281
D.kanapiae,152203088,VNJM01000248.1,1,3254,2.13793e-05,148596222,0.976302
D.kanapiae,152203088,VNJM01002867.1,1,3253,2.13728e-05,148599475,0.976324
D.kanapiae,152203088,VNJM01000400.1,1,3253,2.13728e-05,148602728,0.976345
D.kanapiae,152203088,VNJM01003091.1,1,3246,2.13268e-05,148605974,0.976366
D.kanapiae,152203088,VNJM01001248.1,1,3246,2.13268e-05,148609220,0.976388
D.kanapiae,152203088,VNJM01000185.1,1,3244,2.13136e-05,148612464,0.976409
D.kanapiae,152203088,VNJM01000001.1,1,3243,2.13071e-05,148615707,0.97643
D.kanapiae,152203088,VNJM01002712.1,1,3242,2.13005e-05,148618949,0.976452
D.kanapiae,152203088,VNJM01003457.1,1,3241,2.12939e-05,148622190,0.976473
D.kanapiae,152203088,VNJM01002691.1,1,3233,2.12414e-05,148625423,0.976494
D.kanapiae,152203088,VNJM01000585.1,1,3231,2.12282e-05,148628654,0.976515
D.kanapiae,152203088,VNJM01000966.1,1,3229,2.12151e-05,148631883,0.976537
D.kanapiae,152203088,VNJM01002829.1,1,3227,2.12019e-05,148635110,0.976558
D.kanapiae,152203088,VNJM01002288.1,1,3225,2.11888e-05,148638335,0.976579
D.kanapiae,152203088,VNJM01002077.1,1,3225,2.11888e-05,148641560,0.9766
D.kanapiae,152203088,VNJM01000795.1,1,3225,2.11888e-05,148644785,0.976621
D.kanapiae,152203088,VNJM01001581.1,1,3224,2.11822e-05,148648009,0.976643
D.kanapiae,152203088,VNJM01002622.1,1,3221,2.11625e-05,148651230,0.976664
D.kanapiae,152203088,VNJM01000882.1,1,3221,2.11625e-05,148654451,0.976685
D.kanapiae,152203088,VNJM01001838.1,1,3216,2.11297e-05,148657667,0.976706
D.kanapiae,152203088,VNJM01003440.1,1,3214,2.11165e-05,148660881,0.976727
D.kanapiae,152203088,VNJM01002176.1,1,3213,2.111e-05,148664094,0.976748
D.kanapiae,152203088,VNJM01002947.1,1,3212,2.11034e-05,148667306,0.976769
D.kanapiae,152203088,VNJM01002811.1,1,3211,2.10968e-05,148670517,0.97679
D.kanapiae,152203088,VNJM01002504.1,1,3211,2.10968e-05,148673728,0.976812
D.kanapiae,152203088,VNJM01001879.1,1,3211,2.10968e-05,148676939,0.976833
D.kanapiae,152203088,VNJM01002410.1,1,3206,2.1064e-05,148680145,0.976854
D.kanapiae,152203088,VNJM01000273.1,1,3205,2.10574e-05,148683350,0.976875
D.kanapiae,152203088,VNJM01002219.1,1,3199,2.1018e-05,148686549,0.976896
D.kanapiae,152203088,VNJM01000141.1,1,3199,2.1018e-05,148689748,0.976917
D.kanapiae,152203088,VNJM01003462.1,1,3196,2.09983e-05,148692944,0.976938
D.kanapiae,152203088,VNJM01000127.1,1,3195,2.09917e-05,148696139,0.976959
D.kanapiae,152203088,VNJM01001311.1,1,3189,2.09523e-05,148699328,0.97698
D.kanapiae,152203088,VNJM01000864.1,1,3188,2.09457e-05,148702516,0.977001
D.kanapiae,152203088,VNJM01000311.1,1,3188,2.09457e-05,148705704,0.977022
D.kanapiae,152203088,VNJM01003234.1,1,3187,2.09391e-05,148708891,0.977043
D.kanapiae,152203088,VNJM01002583.1,1,3186,2.09326e-05,148712077,0.977063
D.kanapiae,152203088,VNJM01001029.1,1,3186,2.09326e-05,148715263,0.977084
D.kanapiae,152203088,VNJM01001650.1,1,3178,2.088e-05,148718441,0.977105
D.kanapiae,152203088,VNJM01001859.1,1,3177,2.08734e-05,148721618,0.977126
D.kanapiae,152203088,VNJM01000742.1,1,3176,2.08669e-05,148724794,0.977147
D.kanapiae,152203088,VNJM01003279.1,1,3175,2.08603e-05,148727969,0.977168
D.kanapiae,152203088,VNJM01002937.1,1,3175,2.08603e-05,148731144,0.977189
D.kanapiae,152203088,VNJM01001112.1,1,3172,2.08406e-05,148734316,0.97721
D.kanapiae,152203088,VNJM01002884.1,1,3166,2.08012e-05,148737482,0.97723
D.kanapiae,152203088,VNJM01002010.1,1,3162,2.07749e-05,148740644,0.977251
D.kanapiae,152203088,VNJM01000361.1,1,3156,2.07355e-05,148743800,0.977272
D.kanapiae,152203088,VNJM01002070.1,1,3153,2.07157e-05,148746953,0.977293
D.kanapiae,152203088,VNJM01001534.1,1,3150,2.0696e-05,148750103,0.977313
D.kanapiae,152203088,VNJM01003010.1,1,3147,2.06763e-05,148753250,0.977334
D.kanapiae,152203088,VNJM01001098.1,1,3147,2.06763e-05,148756397,0.977355
D.kanapiae,152203088,VNJM01001036.1,1,3144,2.06566e-05,148759541,0.977375
D.kanapiae,152203088,VNJM01002820.1,1,3143,2.065e-05,148762684,0.977396
D.kanapiae,152203088,VNJM01002730.1,1,3140,2.06303e-05,148765824,0.977417
D.kanapiae,152203088,VNJM01001370.1,1,3139,2.06238e-05,148768963,0.977437
D.kanapiae,152203088,VNJM01003349.1,1,3137,2.06106e-05,148772100,0.977458
D.kanapiae,152203088,VNJM01002417.1,1,3137,2.06106e-05,148775237,0.977478
D.kanapiae,152203088,VNJM01002853.1,1,3131,2.05712e-05,148778368,0.977499
D.kanapiae,152203088,VNJM01002735.1,1,3129,2.05581e-05,148781497,0.97752
D.kanapiae,152203088,VNJM01002075.1,1,3128,2.05515e-05,148784625,0.97754
D.kanapiae,152203088,VNJM01001012.1,1,3128,2.05515e-05,148787753,0.977561
D.kanapiae,152203088,VNJM01003345.1,1,3126,2.05383e-05,148790879,0.977581
D.kanapiae,152203088,VNJM01000371.1,1,3119,2.04924e-05,148793998,0.977602
D.kanapiae,152203088,VNJM01003111.1,1,3118,2.04858e-05,148797116,0.977622
D.kanapiae,152203088,VNJM01003381.1,1,3117,2.04792e-05,148800233,0.977643
D.kanapiae,152203088,VNJM01002456.1,1,3115,2.04661e-05,148803348,0.977663
D.kanapiae,152203088,VNJM01000085.1,1,3110,2.04332e-05,148806458,0.977684
D.kanapiae,152203088,VNJM01000012.1,1,3109,2.04267e-05,148809567,0.977704
D.kanapiae,152203088,VNJM01001185.1,1,3105,2.04004e-05,148812672,0.977724
D.kanapiae,152203088,VNJM01002392.1,1,3104,2.03938e-05,148815776,0.977745
D.kanapiae,152203088,VNJM01002009.1,1,3104,2.03938e-05,148818880,0.977765
D.kanapiae,152203088,VNJM01002215.1,1,3102,2.03807e-05,148821982,0.977786
D.kanapiae,152203088,VNJM01002085.1,1,3102,2.03807e-05,148825084,0.977806
D.kanapiae,152203088,VNJM01000745.1,1,3102,2.03807e-05,148828186,0.977826
D.kanapiae,152203088,VNJM01001279.1,1,3101,2.03741e-05,148831287,0.977847
D.kanapiae,152203088,VNJM01002688.1,1,3100,2.03675e-05,148834387,0.977867
D.kanapiae,152203088,VNJM01001700.1,1,3097,2.03478e-05,148837484,0.977887
D.kanapiae,152203088,VNJM01003315.1,1,3096,2.03412e-05,148840580,0.977908
D.kanapiae,152203088,VNJM01000334.1,1,3093,2.03215e-05,148843673,0.977928
D.kanapiae,152203088,VNJM01001114.1,1,3092,2.0315e-05,148846765,0.977948
D.kanapiae,152203088,VNJM01002170.1,1,3091,2.03084e-05,148849856,0.977969
D.kanapiae,152203088,VNJM01001183.1,1,3091,2.03084e-05,148852947,0.977989
D.kanapiae,152203088,VNJM01000047.1,1,3091,2.03084e-05,148856038,0.978009
D.kanapiae,152203088,VNJM01003118.1,1,3087,2.02821e-05,148859125,0.97803
D.kanapiae,152203088,VNJM01002030.1,1,3086,2.02755e-05,148862211,0.97805
D.kanapiae,152203088,VNJM01001298.1,1,3085,2.0269e-05,148865296,0.97807
D.kanapiae,152203088,VNJM01002515.1,1,3084,2.02624e-05,148868380,0.97809
D.kanapiae,152203088,VNJM01003372.1,1,3079,2.02296e-05,148871459,0.978111
D.kanapiae,152203088,VNJM01003537.1,1,3078,2.0223e-05,148874537,0.978131
D.kanapiae,152203088,VNJM01001372.1,1,3072,2.01836e-05,148877609,0.978151
D.kanapiae,152203088,VNJM01000517.1,1,3071,2.0177e-05,148880680,0.978171
D.kanapiae,152203088,VNJM01000326.1,1,3071,2.0177e-05,148883751,0.978191
D.kanapiae,152203088,VNJM01002928.1,1,3063,2.01244e-05,148886814,0.978212
D.kanapiae,152203088,VNJM01002814.1,1,3060,2.01047e-05,148889874,0.978232
D.kanapiae,152203088,VNJM01001927.1,1,3058,2.00916e-05,148892932,0.978252
D.kanapiae,152203088,VNJM01002762.1,1,3057,2.0085e-05,148895989,0.978272
D.kanapiae,152203088,VNJM01002810.1,1,3054,2.00653e-05,148899043,0.978292
D.kanapiae,152203088,VNJM01003368.1,1,3047,2.00193e-05,148902090,0.978312
D.kanapiae,152203088,VNJM01000308.1,1,3043,1.9993e-05,148905133,0.978332
D.kanapiae,152203088,VNJM01001331.1,1,3041,1.99799e-05,148908174,0.978352
D.kanapiae,152203088,VNJM01000998.1,1,3040,1.99733e-05,148911214,0.978372
D.kanapiae,152203088,VNJM01002221.1,1,3038,1.99602e-05,148914252,0.978392
D.kanapiae,152203088,VNJM01001253.1,1,3035,1.99405e-05,148917287,0.978412
D.kanapiae,152203088,VNJM01001252.1,1,3031,1.99142e-05,148920318,0.978432
D.kanapiae,152203088,VNJM01001087.1,1,3031,1.99142e-05,148923349,0.978452
D.kanapiae,152203088,VNJM01002610.1,1,3029,1.9901e-05,148926378,0.978471
D.kanapiae,152203088,VNJM01003342.1,1,3028,1.98945e-05,148929406,0.978491
D.kanapiae,152203088,VNJM01000788.1,1,3025,1.98748e-05,148932431,0.978511
D.kanapiae,152203088,VNJM01001402.1,1,3023,1.98616e-05,148935454,0.978531
D.kanapiae,152203088,VNJM01003429.1,1,3022,1.98551e-05,148938476,0.978551
D.kanapiae,152203088,VNJM01002965.1,1,3021,1.98485e-05,148941497,0.978571
D.kanapiae,152203088,VNJM01001977.1,1,3020,1.98419e-05,148944517,0.978591
D.kanapiae,152203088,VNJM01001210.1,1,3019,1.98353e-05,148947536,0.97861
D.kanapiae,152203088,VNJM01000565.1,1,3018,1.98288e-05,148950554,0.97863
D.kanapiae,152203088,VNJM01000954.1,1,3014,1.98025e-05,148953568,0.97865
D.kanapiae,152203088,VNJM01000763.1,1,3014,1.98025e-05,148956582,0.97867
D.kanapiae,152203088,VNJM01001478.1,1,3012,1.97893e-05,148959594,0.97869
D.kanapiae,152203088,VNJM01001293.1,1,3012,1.97893e-05,148962606,0.978709
D.kanapiae,152203088,VNJM01001458.1,1,3006,1.97499e-05,148965612,0.978729
D.kanapiae,152203088,VNJM01001259.1,1,3002,1.97236e-05,148968614,0.978749
D.kanapiae,152203088,VNJM01001256.1,1,3002,1.97236e-05,148971616,0.978769
D.kanapiae,152203088,VNJM01003593.1,1,3001,1.97171e-05,148974617,0.978788
D.kanapiae,152203088,VNJM01000595.1,1,3000,1.97105e-05,148977617,0.978808
D.kanapiae,152203088,VNJM01002779.1,1,2998,1.96974e-05,148980615,0.978828
D.kanapiae,152203088,VNJM01000077.1,1,2998,1.96974e-05,148983613,0.978848
D.kanapiae,152203088,VNJM01000809.1,1,2993,1.96645e-05,148986606,0.978867
D.kanapiae,152203088,VNJM01002182.1,1,2992,1.96579e-05,148989598,0.978887
D.kanapiae,152203088,VNJM01000903.1,1,2992,1.96579e-05,148992590,0.978906
D.kanapiae,152203088,VNJM01003294.1,1,2988,1.96317e-05,148995578,0.978926
D.kanapiae,152203088,VNJM01001713.1,1,2988,1.96317e-05,148998566,0.978946
D.kanapiae,152203088,VNJM01000223.1,1,2987,1.96251e-05,149001553,0.978965
D.kanapiae,152203088,VNJM01003324.1,1,2986,1.96185e-05,149004539,0.978985
D.kanapiae,152203088,VNJM01003586.1,1,2983,1.95988e-05,149007522,0.979005
D.kanapiae,152203088,VNJM01000315.1,1,2975,1.95463e-05,149010497,0.979024
D.kanapiae,152203088,VNJM01003163.1,1,2974,1.95397e-05,149013471,0.979044
D.kanapiae,152203088,VNJM01001289.1,1,2973,1.95331e-05,149016444,0.979063
D.kanapiae,152203088,VNJM01002753.1,1,2970,1.95134e-05,149019414,0.979083
D.kanapiae,152203088,VNJM01000567.1,1,2968,1.95003e-05,149022382,0.979102
D.kanapiae,152203088,VNJM01001222.1,1,2962,1.94608e-05,149025344,0.979122
D.kanapiae,152203088,VNJM01001742.1,1,2959,1.94411e-05,149028303,0.979141
D.kanapiae,152203088,VNJM01001932.1,1,2958,1.94346e-05,149031261,0.979161
D.kanapiae,152203088,VNJM01001876.1,1,2958,1.94346e-05,149034219,0.97918
D.kanapiae,152203088,VNJM01000765.1,1,2958,1.94346e-05,149037177,0.979199
D.kanapiae,152203088,VNJM01002140.1,1,2956,1.94214e-05,149040133,0.979219
D.kanapiae,152203088,VNJM01002235.1,1,2954,1.94083e-05,149043087,0.979238
D.kanapiae,152203088,VNJM01000349.1,1,2954,1.94083e-05,149046041,0.979258
D.kanapiae,152203088,VNJM01000350.1,1,2952,1.93951e-05,149048993,0.979277
D.kanapiae,152203088,VNJM01003589.1,1,2951,1.93886e-05,149051944,0.979296
D.kanapiae,152203088,VNJM01001018.1,1,2948,1.93689e-05,149054892,0.979316
D.kanapiae,152203088,VNJM01002263.1,1,2947,1.93623e-05,149057839,0.979335
D.kanapiae,152203088,VNJM01001110.1,1,2945,1.93491e-05,149060784,0.979355
D.kanapiae,152203088,VNJM01000101.1,1,2943,1.9336e-05,149063727,0.979374
D.kanapiae,152203088,VNJM01002174.1,1,2942,1.93294e-05,149066669,0.979393
D.kanapiae,152203088,VNJM01002605.1,1,2935,1.92834e-05,149069604,0.979412
D.kanapiae,152203088,VNJM01000516.1,1,2933,1.92703e-05,149072537,0.979432
D.kanapiae,152203088,VNJM01001258.1,1,2931,1.92572e-05,149075468,0.979451
D.kanapiae,152203088,VNJM01001205.1,1,2930,1.92506e-05,149078398,0.97947
D.kanapiae,152203088,VNJM01000388.1,1,2927,1.92309e-05,149081325,0.979489
D.kanapiae,152203088,VNJM01000290.1,1,2923,1.92046e-05,149084248,0.979509
D.kanapiae,152203088,VNJM01002503.1,1,2921,1.91915e-05,149087169,0.979528
D.kanapiae,152203088,VNJM01000847.1,1,2921,1.91915e-05,149090090,0.979547
D.kanapiae,152203088,VNJM01002435.1,1,2920,1.91849e-05,149093010,0.979566
D.kanapiae,152203088,VNJM01000685.1,1,2919,1.91783e-05,149095929,0.979585
D.kanapiae,152203088,VNJM01003254.1,1,2913,1.91389e-05,149098842,0.979605
D.kanapiae,152203088,VNJM01003220.1,1,2911,1.91258e-05,149101753,0.979624
D.kanapiae,152203088,VNJM01000256.1,1,2911,1.91258e-05,149104664,0.979643
D.kanapiae,152203088,VNJM01002988.1,1,2907,1.90995e-05,149107571,0.979662
D.kanapiae,152203088,VNJM01001693.1,1,2907,1.90995e-05,149110478,0.979681
D.kanapiae,152203088,VNJM01000395.1,1,2907,1.90995e-05,149113385,0.9797
D.kanapiae,152203088,VNJM01003179.1,1,2903,1.90732e-05,149116288,0.979719
D.kanapiae,152203088,VNJM01003015.1,1,2903,1.90732e-05,149119191,0.979738
D.kanapiae,152203088,VNJM01001557.1,1,2901,1.90601e-05,149122092,0.979757
D.kanapiae,152203088,VNJM01000329.1,1,2899,1.90469e-05,149124991,0.979776
D.kanapiae,152203088,VNJM01000734.1,1,2898,1.90403e-05,149127889,0.979795
D.kanapiae,152203088,VNJM01001072.1,1,2895,1.90206e-05,149130784,0.979814
D.kanapiae,152203088,VNJM01003622.1,1,2893,1.90075e-05,149133677,0.979833
D.kanapiae,152203088,VNJM01001174.1,1,2892,1.90009e-05,149136569,0.979852
D.kanapiae,152203088,VNJM01003235.1,1,2891,1.89944e-05,149139460,0.979871
D.kanapiae,152203088,VNJM01001577.1,1,2891,1.89944e-05,149142351,0.97989
D.kanapiae,152203088,VNJM01002731.1,1,2888,1.89746e-05,149145239,0.979909
D.kanapiae,152203088,VNJM01001247.1,1,2883,1.89418e-05,149148122,0.979928
D.kanapiae,152203088,VNJM01002477.1,1,2882,1.89352e-05,149151004,0.979947
D.kanapiae,152203088,VNJM01001251.1,1,2881,1.89287e-05,149153885,0.979966
D.kanapiae,152203088,VNJM01001433.1,1,2877,1.89024e-05,149156762,0.979985
D.kanapiae,152203088,VNJM01002391.1,1,2870,1.88564e-05,149159632,0.980004
D.kanapiae,152203088,VNJM01002711.1,1,2868,1.88432e-05,149162500,0.980023
D.kanapiae,152203088,VNJM01000534.1,1,2868,1.88432e-05,149165368,0.980042
D.kanapiae,152203088,VNJM01000333.1,1,2868,1.88432e-05,149168236,0.980061
D.kanapiae,152203088,VNJM01002470.1,1,2862,1.88038e-05,149171098,0.980079
D.kanapiae,152203088,VNJM01000037.1,1,2855,1.87578e-05,149173953,0.980098
D.kanapiae,152203088,VNJM01000241.1,1,2854,1.87513e-05,149176807,0.980117
D.kanapiae,152203088,VNJM01001000.1,1,2851,1.87316e-05,149179658,0.980136
D.kanapiae,152203088,VNJM01000217.1,1,2850,1.8725e-05,149182508,0.980154
D.kanapiae,152203088,VNJM01001778.1,1,2849,1.87184e-05,149185357,0.980173
D.kanapiae,152203088,VNJM01001147.1,1,2846,1.86987e-05,149188203,0.980192
D.kanapiae,152203088,VNJM01002164.1,1,2844,1.86856e-05,149191047,0.98021
D.kanapiae,152203088,VNJM01002052.1,1,2843,1.8679e-05,149193890,0.980229
D.kanapiae,152203088,VNJM01001840.1,1,2841,1.86658e-05,149196731,0.980248
D.kanapiae,152203088,VNJM01003087.1,1,2838,1.86461e-05,149199569,0.980266
D.kanapiae,152203088,VNJM01001506.1,1,2838,1.86461e-05,149202407,0.980285
D.kanapiae,152203088,VNJM01002637.1,1,2837,1.86396e-05,149205244,0.980304
D.kanapiae,152203088,VNJM01001630.1,1,2836,1.8633e-05,149208080,0.980322
D.kanapiae,152203088,VNJM01001512.1,1,2830,1.85936e-05,149210910,0.980341
D.kanapiae,152203088,VNJM01000261.1,1,2829,1.8587e-05,149213739,0.980359
D.kanapiae,152203088,VNJM01001810.1,1,2828,1.85804e-05,149216567,0.980378
D.kanapiae,152203088,VNJM01001467.1,1,2828,1.85804e-05,149219395,0.980397
D.kanapiae,152203088,VNJM01003050.1,1,2826,1.85673e-05,149222221,0.980415
D.kanapiae,152203088,VNJM01002561.1,1,2823,1.85476e-05,149225044,0.980434
D.kanapiae,152203088,VNJM01000501.1,1,2821,1.85344e-05,149227865,0.980452
D.kanapiae,152203088,VNJM01002917.1,1,2816,1.85016e-05,149230681,0.980471
D.kanapiae,152203088,VNJM01000794.1,1,2816,1.85016e-05,149233497,0.980489
D.kanapiae,152203088,VNJM01001727.1,1,2815,1.8495e-05,149236312,0.980508
D.kanapiae,152203088,VNJM01003486.1,1,2814,1.84885e-05,149239126,0.980526
D.kanapiae,152203088,VNJM01000548.1,1,2813,1.84819e-05,149241939,0.980545
D.kanapiae,152203088,VNJM01002679.1,1,2811,1.84687e-05,149244750,0.980563
D.kanapiae,152203088,VNJM01001722.1,1,2809,1.84556e-05,149247559,0.980582
D.kanapiae,152203088,VNJM01002873.1,1,2808,1.8449e-05,149250367,0.9806
D.kanapiae,152203088,VNJM01002255.1,1,2808,1.8449e-05,149253175,0.980619
D.kanapiae,152203088,VNJM01000478.1,1,2808,1.8449e-05,149255983,0.980637
D.kanapiae,152203088,VNJM01002804.1,1,2801,1.8403e-05,149258784,0.980655
D.kanapiae,152203088,VNJM01002986.1,1,2798,1.83833e-05,149261582,0.980674
D.kanapiae,152203088,VNJM01000707.1,1,2797,1.83768e-05,149264379,0.980692
D.kanapiae,152203088,VNJM01000529.1,1,2796,1.83702e-05,149267175,0.980711
D.kanapiae,152203088,VNJM01000281.1,1,2793,1.83505e-05,149269968,0.980729
D.kanapiae,152203088,VNJM01002032.1,1,2791,1.83373e-05,149272759,0.980747
D.kanapiae,152203088,VNJM01003013.1,1,2790,1.83308e-05,149275549,0.980766
D.kanapiae,152203088,VNJM01000890.1,1,2788,1.83176e-05,149278337,0.980784
D.kanapiae,152203088,VNJM01002846.1,1,2787,1.83111e-05,149281124,0.980802
D.kanapiae,152203088,VNJM01002277.1,1,2785,1.82979e-05,149283909,0.980821
D.kanapiae,152203088,VNJM01002187.1,1,2785,1.82979e-05,149286694,0.980839
D.kanapiae,152203088,VNJM01002948.1,1,2783,1.82848e-05,149289477,0.980857
D.kanapiae,152203088,VNJM01000679.1,1,2780,1.82651e-05,149292257,0.980875
D.kanapiae,152203088,VNJM01003246.1,1,2777,1.82454e-05,149295034,0.980894
D.kanapiae,152203088,VNJM01000518.1,1,2775,1.82322e-05,149297809,0.980912
D.kanapiae,152203088,VNJM01002613.1,1,2772,1.82125e-05,149300581,0.98093
D.kanapiae,152203088,VNJM01001892.1,1,2772,1.82125e-05,149303353,0.980948
D.kanapiae,152203088,VNJM01001628.1,1,2771,1.82059e-05,149306124,0.980966
D.kanapiae,152203088,VNJM01001781.1,1,2770,1.81994e-05,149308894,0.980985
D.kanapiae,152203088,VNJM01001866.1,1,2769,1.81928e-05,149311663,0.981003
D.kanapiae,152203088,VNJM01002981.1,1,2768,1.81862e-05,149314431,0.981021
D.kanapiae,152203088,VNJM01001762.1,1,2768,1.81862e-05,149317199,0.981039
D.kanapiae,152203088,VNJM01001172.1,1,2763,1.81534e-05,149319962,0.981057
D.kanapiae,152203088,VNJM01000618.1,1,2761,1.81402e-05,149322723,0.981076
D.kanapiae,152203088,VNJM01002425.1,1,2760,1.81337e-05,149325483,0.981094
D.kanapiae,152203088,VNJM01002159.1,1,2760,1.81337e-05,149328243,0.981112
D.kanapiae,152203088,VNJM01001055.1,1,2759,1.81271e-05,149331002,0.98113
D.kanapiae,152203088,VNJM01002629.1,1,2754,1.80942e-05,149333756,0.981148
D.kanapiae,152203088,VNJM01000850.1,1,2753,1.80877e-05,149336509,0.981166
D.kanapiae,152203088,VNJM01000078.1,1,2751,1.80745e-05,149339260,0.981184
D.kanapiae,152203088,VNJM01002098.1,1,2748,1.80548e-05,149342008,0.981202
D.kanapiae,152203088,VNJM01001308.1,1,2747,1.80483e-05,149344755,0.98122
D.kanapiae,152203088,VNJM01001126.1,1,2746,1.80417e-05,149347501,0.981238
D.kanapiae,152203088,VNJM01002843.1,1,2745,1.80351e-05,149350246,0.981256
D.kanapiae,152203088,VNJM01002167.1,1,2745,1.80351e-05,149352991,0.981274
D.kanapiae,152203088,VNJM01003054.1,1,2744,1.80285e-05,149355735,0.981292
D.kanapiae,152203088,VNJM01000856.1,1,2743,1.8022e-05,149358478,0.98131
D.kanapiae,152203088,VNJM01001517.1,1,2742,1.80154e-05,149361220,0.981328
D.kanapiae,152203088,VNJM01000159.1,1,2742,1.80154e-05,149363962,0.981346
D.kanapiae,152203088,VNJM01002690.1,1,2741,1.80088e-05,149366703,0.981364
D.kanapiae,152203088,VNJM01002915.1,1,2740,1.80023e-05,149369443,0.981382
D.kanapiae,152203088,VNJM01002200.1,1,2740,1.80023e-05,149372183,0.9814
D.kanapiae,152203088,VNJM01000965.1,1,2739,1.79957e-05,149374922,0.981418
D.kanapiae,152203088,VNJM01000250.1,1,2738,1.79891e-05,149377660,0.981436
D.kanapiae,152203088,VNJM01001620.1,1,2737,1.79826e-05,149380397,0.981454
D.kanapiae,152203088,VNJM01001935.1,1,2735,1.79694e-05,149383132,0.981472
D.kanapiae,152203088,VNJM01000791.1,1,2734,1.79628e-05,149385866,0.98149
D.kanapiae,152203088,VNJM01000235.1,1,2733,1.79563e-05,149388599,0.981508
D.kanapiae,152203088,VNJM01003557.1,1,2731,1.79431e-05,149391330,0.981526
D.kanapiae,152203088,VNJM01002519.1,1,2731,1.79431e-05,149394061,0.981544
D.kanapiae,152203088,VNJM01000066.1,1,2731,1.79431e-05,149396792,0.981562
D.kanapiae,152203088,VNJM01002616.1,1,2729,1.793e-05,149399521,0.98158
D.kanapiae,152203088,VNJM01001934.1,1,2729,1.793e-05,149402250,0.981598
D.kanapiae,152203088,VNJM01001364.1,1,2727,1.79169e-05,149404977,0.981616
D.kanapiae,152203088,VNJM01003570.1,1,2726,1.79103e-05,149407703,0.981634
D.kanapiae,152203088,VNJM01002459.1,1,2725,1.79037e-05,149410428,0.981652
D.kanapiae,152203088,VNJM01003221.1,1,2724,1.78971e-05,149413152,0.98167
D.kanapiae,152203088,VNJM01001824.1,1,2723,1.78906e-05,149415875,0.981688
D.kanapiae,152203088,VNJM01001682.1,1,2722,1.7884e-05,149418597,0.981705
D.kanapiae,152203088,VNJM01003560.1,1,2719,1.78643e-05,149421316,0.981723
D.kanapiae,152203088,VNJM01003458.1,1,2718,1.78577e-05,149424034,0.981741
D.kanapiae,152203088,VNJM01002803.1,1,2718,1.78577e-05,149426752,0.981759
D.kanapiae,152203088,VNJM01001145.1,1,2718,1.78577e-05,149429470,0.981777
D.kanapiae,152203088,VNJM01001711.1,1,2716,1.78446e-05,149432186,0.981795
D.kanapiae,152203088,VNJM01001286.1,1,2713,1.78249e-05,149434899,0.981813
D.kanapiae,152203088,VNJM01003583.1,1,2710,1.78052e-05,149437609,0.98183
D.kanapiae,152203088,VNJM01002685.1,1,2710,1.78052e-05,149440319,0.981848
D.kanapiae,152203088,VNJM01001312.1,1,2710,1.78052e-05,149443029,0.981866
D.kanapiae,152203088,VNJM01000996.1,1,2710,1.78052e-05,149445739,0.981884
D.kanapiae,152203088,VNJM01002531.1,1,2709,1.77986e-05,149448448,0.981902
D.kanapiae,152203088,VNJM01001132.1,1,2705,1.77723e-05,149451153,0.981919
D.kanapiae,152203088,VNJM01001277.1,1,2704,1.77657e-05,149453857,0.981937
D.kanapiae,152203088,VNJM01001045.1,1,2701,1.7746e-05,149456558,0.981955
D.kanapiae,152203088,VNJM01000641.1,1,2701,1.7746e-05,149459259,0.981973
D.kanapiae,152203088,VNJM01001850.1,1,2699,1.77329e-05,149461958,0.98199
D.kanapiae,152203088,VNJM01002677.1,1,2698,1.77263e-05,149464656,0.982008
D.kanapiae,152203088,VNJM01000560.1,1,2694,1.77e-05,149467350,0.982026
D.kanapiae,152203088,VNJM01003046.1,1,2690,1.76738e-05,149470040,0.982043
D.kanapiae,152203088,VNJM01000265.1,1,2690,1.76738e-05,149472730,0.982061
D.kanapiae,152203088,VNJM01002639.1,1,2689,1.76672e-05,149475419,0.982079
D.kanapiae,152203088,VNJM01000130.1,1,2689,1.76672e-05,149478108,0.982096
D.kanapiae,152203088,VNJM01001547.1,1,2687,1.7654e-05,149480795,0.982114
D.kanapiae,152203088,VNJM01000785.1,1,2684,1.76343e-05,149483479,0.982132
D.kanapiae,152203088,VNJM01000169.1,1,2682,1.76212e-05,149486161,0.982149
D.kanapiae,152203088,VNJM01001847.1,1,2678,1.75949e-05,149488839,0.982167
D.kanapiae,152203088,VNJM01001736.1,1,2675,1.75752e-05,149491514,0.982185
D.kanapiae,152203088,VNJM01001685.1,1,2675,1.75752e-05,149494189,0.982202
D.kanapiae,152203088,VNJM01001449.1,1,2674,1.75686e-05,149496863,0.98222
D.kanapiae,152203088,VNJM01001539.1,1,2673,1.75621e-05,149499536,0.982237
D.kanapiae,152203088,VNJM01000497.1,1,2672,1.75555e-05,149502208,0.982255
D.kanapiae,152203088,VNJM01001161.1,1,2671,1.75489e-05,149504879,0.982272
D.kanapiae,152203088,VNJM01000161.1,1,2667,1.75226e-05,149507546,0.98229
D.kanapiae,152203088,VNJM01002121.1,1,2666,1.75161e-05,149510212,0.982307
D.kanapiae,152203088,VNJM01001296.1,1,2661,1.74832e-05,149512873,0.982325
D.kanapiae,152203088,VNJM01000584.1,1,2660,1.74766e-05,149515533,0.982342
D.kanapiae,152203088,VNJM01000276.1,1,2660,1.74766e-05,149518193,0.98236
D.kanapiae,152203088,VNJM01000826.1,1,2659,1.74701e-05,149520852,0.982377
D.kanapiae,152203088,VNJM01002665.1,1,2656,1.74504e-05,149523508,0.982395
D.kanapiae,152203088,VNJM01001005.1,1,2655,1.74438e-05,149526163,0.982412
D.kanapiae,152203088,VNJM01000277.1,1,2652,1.74241e-05,149528815,0.98243
D.kanapiae,152203088,VNJM01000059.1,1,2650,1.74109e-05,149531465,0.982447
D.kanapiae,152203088,VNJM01003038.1,1,2649,1.74044e-05,149534114,0.982464
D.kanapiae,152203088,VNJM01000753.1,1,2648,1.73978e-05,149536762,0.982482
D.kanapiae,152203088,VNJM01001328.1,1,2644,1.73715e-05,149539406,0.982499
D.kanapiae,152203088,VNJM01000383.1,1,2644,1.73715e-05,149542050,0.982517
D.kanapiae,152203088,VNJM01003598.1,1,2641,1.73518e-05,149544691,0.982534
D.kanapiae,152203088,VNJM01002316.1,1,2641,1.73518e-05,149547332,0.982551
D.kanapiae,152203088,VNJM01002061.1,1,2641,1.73518e-05,149549973,0.982569
D.kanapiae,152203088,VNJM01000660.1,1,2641,1.73518e-05,149552614,0.982586
D.kanapiae,152203088,VNJM01001790.1,1,2638,1.73321e-05,149555252,0.982603
D.kanapiae,152203088,VNJM01000282.1,1,2638,1.73321e-05,149557890,0.982621
D.kanapiae,152203088,VNJM01003540.1,1,2637,1.73255e-05,149560527,0.982638
D.kanapiae,152203088,VNJM01000829.1,1,2637,1.73255e-05,149563164,0.982655
D.kanapiae,152203088,VNJM01002185.1,1,2636,1.7319e-05,149565800,0.982673
D.kanapiae,152203088,VNJM01000554.1,1,2627,1.72598e-05,149568427,0.98269
D.kanapiae,152203088,VNJM01001774.1,1,2626,1.72533e-05,149571053,0.982707
D.kanapiae,152203088,VNJM01002557.1,1,2622,1.7227e-05,149573675,0.982724
D.kanapiae,152203088,VNJM01001363.1,1,2622,1.7227e-05,149576297,0.982742
D.kanapiae,152203088,VNJM01002209.1,1,2619,1.72073e-05,149578916,0.982759
D.kanapiae,152203088,VNJM01002045.1,1,2618,1.72007e-05,149581534,0.982776
D.kanapiae,152203088,VNJM01002584.1,1,2615,1.7181e-05,149584149,0.982793
D.kanapiae,152203088,VNJM01002741.1,1,2611,1.71547e-05,149586760,0.98281
D.kanapiae,152203088,VNJM01003356.1,1,2610,1.71481e-05,149589370,0.982827
D.kanapiae,152203088,VNJM01000896.1,1,2610,1.71481e-05,149591980,0.982845
D.kanapiae,152203088,VNJM01002963.1,1,2609,1.71416e-05,149594589,0.982862
D.kanapiae,152203088,VNJM01001291.1,1,2606,1.71219e-05,149597195,0.982879
D.kanapiae,152203088,VNJM01001952.1,1,2605,1.71153e-05,149599800,0.982896
D.kanapiae,152203088,VNJM01001415.1,1,2605,1.71153e-05,149602405,0.982913
D.kanapiae,152203088,VNJM01001401.1,1,2604,1.71087e-05,149605009,0.98293
D.kanapiae,152203088,VNJM01001303.1,1,2603,1.71021e-05,149607612,0.982947
D.kanapiae,152203088,VNJM01002747.1,1,2601,1.7089e-05,149610213,0.982964
D.kanapiae,152203088,VNJM01001306.1,1,2601,1.7089e-05,149612814,0.982981
D.kanapiae,152203088,VNJM01003635.1,1,2600,1.70824e-05,149615414,0.982999
D.kanapiae,152203088,VNJM01002767.1,1,2599,1.70759e-05,149618013,0.983016
D.kanapiae,152203088,VNJM01001223.1,1,2598,1.70693e-05,149620611,0.983033
D.kanapiae,152203088,VNJM01001764.1,1,2592,1.70299e-05,149623203,0.98305
D.kanapiae,152203088,VNJM01001735.1,1,2592,1.70299e-05,149625795,0.983067
D.kanapiae,152203088,VNJM01000525.1,1,2590,1.70167e-05,149628385,0.983084
D.kanapiae,152203088,VNJM01003321.1,1,2587,1.6997e-05,149630972,0.983101
D.kanapiae,152203088,VNJM01003020.1,1,2587,1.6997e-05,149633559,0.983118
D.kanapiae,152203088,VNJM01000479.1,1,2587,1.6997e-05,149636146,0.983135
D.kanapiae,152203088,VNJM01002702.1,1,2586,1.69905e-05,149638732,0.983152
D.kanapiae,152203088,VNJM01001841.1,1,2586,1.69905e-05,149641318,0.983169
D.kanapiae,152203088,VNJM01002720.1,1,2585,1.69839e-05,149643903,0.983186
D.kanapiae,152203088,VNJM01000845.1,1,2584,1.69773e-05,149646487,0.983203
D.kanapiae,152203088,VNJM01003052.1,1,2579,1.69445e-05,149649066,0.98322
D.kanapiae,152203088,VNJM01000422.1,1,2579,1.69445e-05,149651645,0.983237
D.kanapiae,152203088,VNJM01001234.1,1,2577,1.69313e-05,149654222,0.983254
D.kanapiae,152203088,VNJM01001294.1,1,2574,1.69116e-05,149656796,0.98327
D.kanapiae,152203088,VNJM01003460.1,1,2573,1.6905e-05,149659369,0.983287
D.kanapiae,152203088,VNJM01000192.1,1,2572,1.68985e-05,149661941,0.983304
D.kanapiae,152203088,VNJM01002912.1,1,2571,1.68919e-05,149664512,0.983321
D.kanapiae,152203088,VNJM01003545.1,1,2569,1.68788e-05,149667081,0.983338
D.kanapiae,152203088,VNJM01001704.1,1,2569,1.68788e-05,149669650,0.983355
D.kanapiae,152203088,VNJM01001345.1,1,2568,1.68722e-05,149672218,0.983372
D.kanapiae,152203088,VNJM01000324.1,1,2568,1.68722e-05,149674786,0.983389
D.kanapiae,152203088,VNJM01001878.1,1,2567,1.68656e-05,149677353,0.983405
D.kanapiae,152203088,VNJM01001872.1,1,2566,1.68591e-05,149679919,0.983422
D.kanapiae,152203088,VNJM01003445.1,1,2565,1.68525e-05,149682484,0.983439
D.kanapiae,152203088,VNJM01000852.1,1,2559,1.68131e-05,149685043,0.983456
D.kanapiae,152203088,VNJM01000513.1,1,2559,1.68131e-05,149687602,0.983473
D.kanapiae,152203088,VNJM01001653.1,1,2558,1.68065e-05,149690160,0.98349
D.kanapiae,152203088,VNJM01001446.1,1,2556,1.67934e-05,149692716,0.983506
D.kanapiae,152203088,VNJM01002897.1,1,2554,1.67802e-05,149695270,0.983523
D.kanapiae,152203088,VNJM01001358.1,1,2552,1.67671e-05,149697822,0.98354
D.kanapiae,152203088,VNJM01003571.1,1,2551,1.67605e-05,149700373,0.983557
D.kanapiae,152203088,VNJM01000944.1,1,2551,1.67605e-05,149702924,0.983574
D.kanapiae,152203088,VNJM01002438.1,1,2550,1.67539e-05,149705474,0.98359
D.kanapiae,152203088,VNJM01003401.1,1,2549,1.67474e-05,149708023,0.983607
D.kanapiae,152203088,VNJM01002365.1,1,2549,1.67474e-05,149710572,0.983624
D.kanapiae,152203088,VNJM01003626.1,1,2547,1.67342e-05,149713119,0.98364
D.kanapiae,152203088,VNJM01001053.1,1,2547,1.67342e-05,149715666,0.983657
D.kanapiae,152203088,VNJM01003423.1,1,2545,1.67211e-05,149718211,0.983674
D.kanapiae,152203088,VNJM01003083.1,1,2544,1.67145e-05,149720755,0.983691
D.kanapiae,152203088,VNJM01003300.1,1,2543,1.67079e-05,149723298,0.983707
D.kanapiae,152203088,VNJM01000533.1,1,2543,1.67079e-05,149725841,0.983724
D.kanapiae,152203088,VNJM01000786.1,1,2541,1.66948e-05,149728382,0.983741
D.kanapiae,152203088,VNJM01002904.1,1,2534,1.66488e-05,149730916,0.983757
D.kanapiae,152203088,VNJM01003085.1,1,2533,1.66422e-05,149733449,0.983774
D.kanapiae,152203088,VNJM01000673.1,1,2531,1.66291e-05,149735980,0.983791
D.kanapiae,152203088,VNJM01000399.1,1,2529,1.6616e-05,149738509,0.983807
D.kanapiae,152203088,VNJM01003285.1,1,2525,1.65897e-05,149741034,0.983824
D.kanapiae,152203088,VNJM01003086.1,1,2523,1.65765e-05,149743557,0.98384
D.kanapiae,152203088,VNJM01000813.1,1,2522,1.657e-05,149746079,0.983857
D.kanapiae,152203088,VNJM01000557.1,1,2521,1.65634e-05,149748600,0.983874
D.kanapiae,152203088,VNJM01002883.1,1,2518,1.65437e-05,149751118,0.98389
D.kanapiae,152203088,VNJM01001957.1,1,2518,1.65437e-05,149753636,0.983907
D.kanapiae,152203088,VNJM01002910.1,1,2516,1.65305e-05,149756152,0.983923
D.kanapiae,152203088,VNJM01003464.1,1,2513,1.65108e-05,149758665,0.98394
D.kanapiae,152203088,VNJM01002283.1,1,2513,1.65108e-05,149761178,0.983956
D.kanapiae,152203088,VNJM01000135.1,1,2511,1.64977e-05,149763689,0.983973
D.kanapiae,152203088,VNJM01000253.1,1,2505,1.64583e-05,149766194,0.983989
D.kanapiae,152203088,VNJM01000165.1,1,2504,1.64517e-05,149768698,0.984006
D.kanapiae,152203088,VNJM01001732.1,1,2503,1.64451e-05,149771201,0.984022
D.kanapiae,152203088,VNJM01002819.1,1,2499,1.64189e-05,149773700,0.984039
D.kanapiae,152203088,VNJM01002778.1,1,2499,1.64189e-05,149776199,0.984055
D.kanapiae,152203088,VNJM01003447.1,1,2497,1.64057e-05,149778696,0.984071
D.kanapiae,152203088,VNJM01000180.1,1,2496,1.63991e-05,149781192,0.984088
D.kanapiae,152203088,VNJM01002827.1,1,2494,1.6386e-05,149783686,0.984104
D.kanapiae,152203088,VNJM01000530.1,1,2494,1.6386e-05,149786180,0.984121
D.kanapiae,152203088,VNJM01002569.1,1,2490,1.63597e-05,149788670,0.984137
D.kanapiae,152203088,VNJM01000694.1,1,2489,1.63532e-05,149791159,0.984153
D.kanapiae,152203088,VNJM01002224.1,1,2486,1.63334e-05,149793645,0.98417
D.kanapiae,152203088,VNJM01001951.1,1,2485,1.63269e-05,149796130,0.984186
D.kanapiae,152203088,VNJM01000859.1,1,2480,1.6294e-05,149798610,0.984202
D.kanapiae,152203088,VNJM01001224.1,1,2478,1.62809e-05,149801088,0.984218
D.kanapiae,152203088,VNJM01002295.1,1,2477,1.62743e-05,149803565,0.984235
D.kanapiae,152203088,VNJM01002078.1,1,2477,1.62743e-05,149806042,0.984251
D.kanapiae,152203088,VNJM01003148.1,1,2475,1.62612e-05,149808517,0.984267
D.kanapiae,152203088,VNJM01001262.1,1,2475,1.62612e-05,149810992,0.984284
D.kanapiae,152203088,VNJM01001867.1,1,2474,1.62546e-05,149813466,0.9843
D.kanapiae,152203088,VNJM01001765.1,1,2473,1.6248e-05,149815939,0.984316
D.kanapiae,152203088,VNJM01000651.1,1,2471,1.62349e-05,149818410,0.984332
D.kanapiae,152203088,VNJM01002287.1,1,2468,1.62152e-05,149820878,0.984348
D.kanapiae,152203088,VNJM01003155.1,1,2467,1.62086e-05,149823345,0.984365
D.kanapiae,152203088,VNJM01003314.1,1,2466,1.6202e-05,149825811,0.984381
D.kanapiae,152203088,VNJM01000469.1,1,2466,1.6202e-05,149828277,0.984397
D.kanapiae,152203088,VNJM01002501.1,1,2464,1.61889e-05,149830741,0.984413
D.kanapiae,152203088,VNJM01001984.1,1,2464,1.61889e-05,149833205,0.984429
D.kanapiae,152203088,VNJM01000268.1,1,2463,1.61823e-05,149835668,0.984446
D.kanapiae,152203088,VNJM01001910.1,1,2458,1.61495e-05,149838126,0.984462
D.kanapiae,152203088,VNJM01003198.1,1,2457,1.61429e-05,149840583,0.984478
D.kanapiae,152203088,VNJM01001538.1,1,2457,1.61429e-05,149843040,0.984494
D.kanapiae,152203088,VNJM01000251.1,1,2457,1.61429e-05,149845497,0.98451
D.kanapiae,152203088,VNJM01000894.1,1,2454,1.61232e-05,149847951,0.984526
D.kanapiae,152203088,VNJM01003336.1,1,2452,1.61101e-05,149850403,0.984542
D.kanapiae,152203088,VNJM01001439.1,1,2450,1.60969e-05,149852853,0.984559
D.kanapiae,152203088,VNJM01003422.1,1,2448,1.60838e-05,149855301,0.984575
D.kanapiae,152203088,VNJM01000270.1,1,2447,1.60772e-05,149857748,0.984591
D.kanapiae,152203088,VNJM01001714.1,1,2443,1.60509e-05,149860191,0.984607
D.kanapiae,152203088,VNJM01000010.1,1,2443,1.60509e-05,149862634,0.984623
D.kanapiae,152203088,VNJM01003084.1,1,2441,1.60378e-05,149865075,0.984639
D.kanapiae,152203088,VNJM01002564.1,1,2440,1.60312e-05,149867515,0.984655
D.kanapiae,152203088,VNJM01001999.1,1,2437,1.60115e-05,149869952,0.984671
D.kanapiae,152203088,VNJM01001393.1,1,2436,1.60049e-05,149872388,0.984687
D.kanapiae,152203088,VNJM01000264.1,1,2436,1.60049e-05,149874824,0.984703
D.kanapiae,152203088,VNJM01002082.1,1,2434,1.59918e-05,149877258,0.984719
D.kanapiae,152203088,VNJM01000775.1,1,2432,1.59787e-05,149879690,0.984735
D.kanapiae,152203088,VNJM01002442.1,1,2429,1.59589e-05,149882119,0.984751
D.kanapiae,152203088,VNJM01000648.1,1,2428,1.59524e-05,149884547,0.984767
D.kanapiae,152203088,VNJM01003398.1,1,2427,1.59458e-05,149886974,0.984783
D.kanapiae,152203088,VNJM01000543.1,1,2427,1.59458e-05,149889401,0.984799
D.kanapiae,152203088,VNJM01001930.1,1,2426,1.59392e-05,149891827,0.984815
D.kanapiae,152203088,VNJM01000710.1,1,2426,1.59392e-05,149894253,0.984831
D.kanapiae,152203088,VNJM01000702.1,1,2426,1.59392e-05,149896679,0.984847
D.kanapiae,152203088,VNJM01002189.1,1,2423,1.59195e-05,149899102,0.984862
D.kanapiae,152203088,VNJM01002795.1,1,2422,1.59129e-05,149901524,0.984878
D.kanapiae,152203088,VNJM01003283.1,1,2421,1.59064e-05,149903945,0.984894
D.kanapiae,152203088,VNJM01000140.1,1,2421,1.59064e-05,149906366,0.98491
D.kanapiae,152203088,VNJM01003161.1,1,2420,1.58998e-05,149908786,0.984926
D.kanapiae,152203088,VNJM01002972.1,1,2418,1.58867e-05,149911204,0.984942
D.kanapiae,152203088,VNJM01003076.1,1,2415,1.5867e-05,149913619,0.984958
D.kanapiae,152203088,VNJM01001681.1,1,2415,1.5867e-05,149916034,0.984974
D.kanapiae,152203088,VNJM01000226.1,1,2415,1.5867e-05,149918449,0.98499
D.kanapiae,152203088,VNJM01000023.1,1,2415,1.5867e-05,149920864,0.985005
D.kanapiae,152203088,VNJM01001839.1,1,2413,1.58538e-05,149923277,0.985021
D.kanapiae,152203088,VNJM01001505.1,1,2413,1.58538e-05,149925690,0.985037
D.kanapiae,152203088,VNJM01001772.1,1,2410,1.58341e-05,149928100,0.985053
D.kanapiae,152203088,VNJM01002546.1,1,2409,1.58275e-05,149930509,0.985069
D.kanapiae,152203088,VNJM01001418.1,1,2408,1.5821e-05,149932917,0.985085
D.kanapiae,152203088,VNJM01002524.1,1,2405,1.58013e-05,149935322,0.9851
D.kanapiae,152203088,VNJM01002849.1,1,2404,1.57947e-05,149937726,0.985116
D.kanapiae,152203088,VNJM01001575.1,1,2404,1.57947e-05,149940130,0.985132
D.kanapiae,152203088,VNJM01002464.1,1,2403,1.57881e-05,149942533,0.985148
D.kanapiae,152203088,VNJM01002576.1,1,2400,1.57684e-05,149944933,0.985164
D.kanapiae,152203088,VNJM01001170.1,1,2400,1.57684e-05,149947333,0.985179
D.kanapiae,152203088,VNJM01003574.1,1,2397,1.57487e-05,149949730,0.985195
D.kanapiae,152203088,VNJM01000690.1,1,2395,1.57356e-05,149952125,0.985211
D.kanapiae,152203088,VNJM01003066.1,1,2391,1.57093e-05,149954516,0.985227
D.kanapiae,152203088,VNJM01002397.1,1,2389,1.56961e-05,149956905,0.985242
D.kanapiae,152203088,VNJM01002375.1,1,2387,1.5683e-05,149959292,0.985258
D.kanapiae,152203088,VNJM01002108.1,1,2387,1.5683e-05,149961679,0.985274
D.kanapiae,152203088,VNJM01001124.1,1,2385,1.56699e-05,149964064,0.985289
D.kanapiae,152203088,VNJM01000620.1,1,2385,1.56699e-05,149966449,0.985305
D.kanapiae,152203088,VNJM01000426.1,1,2385,1.56699e-05,149968834,0.985321
D.kanapiae,152203088,VNJM01002112.1,1,2383,1.56567e-05,149971217,0.985336
D.kanapiae,152203088,VNJM01002169.1,1,2382,1.56501e-05,149973599,0.985352
D.kanapiae,152203088,VNJM01001777.1,1,2380,1.5637e-05,149975979,0.985368
D.kanapiae,152203088,VNJM01001071.1,1,2377,1.56173e-05,149978356,0.985383
D.kanapiae,152203088,VNJM01001351.1,1,2376,1.56107e-05,149980732,0.985399
D.kanapiae,152203088,VNJM01000494.1,1,2374,1.55976e-05,149983106,0.985414
D.kanapiae,152203088,VNJM01000849.1,1,2372,1.55844e-05,149985478,0.98543
D.kanapiae,152203088,VNJM01000410.1,1,2368,1.55582e-05,149987846,0.985445
D.kanapiae,152203088,VNJM01002096.1,1,2367,1.55516e-05,149990213,0.985461
D.kanapiae,152203088,VNJM01000948.1,1,2367,1.55516e-05,149992580,0.985477
D.kanapiae,152203088,VNJM01000072.1,1,2366,1.5545e-05,149994946,0.985492
D.kanapiae,152203088,VNJM01003481.1,1,2364,1.55319e-05,149997310,0.985508
D.kanapiae,152203088,VNJM01002231.1,1,2364,1.55319e-05,149999674,0.985523
D.kanapiae,152203088,VNJM01003450.1,1,2362,1.55187e-05,150002036,0.985539
D.kanapiae,152203088,VNJM01000727.1,1,2361,1.55122e-05,150004397,0.985554
D.kanapiae,152203088,VNJM01001089.1,1,2359,1.5499e-05,150006756,0.98557
D.kanapiae,152203088,VNJM01002323.1,1,2357,1.54859e-05,150009113,0.985585
D.kanapiae,152203088,VNJM01002076.1,1,2357,1.54859e-05,150011470,0.985601
D.kanapiae,152203088,VNJM01001973.1,1,2357,1.54859e-05,150013827,0.985616
D.kanapiae,152203088,VNJM01001804.1,1,2355,1.54727e-05,150016182,0.985632
D.kanapiae,152203088,VNJM01001307.1,1,2353,1.54596e-05,150018535,0.985647
D.kanapiae,152203088,VNJM01000060.1,1,2353,1.54596e-05,150020888,0.985663
D.kanapiae,152203088,VNJM01001178.1,1,2352,1.5453e-05,150023240,0.985678
D.kanapiae,152203088,VNJM01000254.1,1,2352,1.5453e-05,150025592,0.985693
D.kanapiae,152203088,VNJM01002155.1,1,2350,1.54399e-05,150027942,0.985709
D.kanapiae,152203088,VNJM01001995.1,1,2350,1.54399e-05,150030292,0.985724
D.kanapiae,152203088,VNJM01000677.1,1,2350,1.54399e-05,150032642,0.98574
D.kanapiae,152203088,VNJM01003393.1,1,2349,1.54333e-05,150034991,0.985755
D.kanapiae,152203088,VNJM01001206.1,1,2349,1.54333e-05,150037340,0.985771
D.kanapiae,152203088,VNJM01001588.1,1,2347,1.54202e-05,150039687,0.985786
D.kanapiae,152203088,VNJM01003575.1,1,2342,1.53873e-05,150042029,0.985801
D.kanapiae,152203088,VNJM01003011.1,1,2340,1.53742e-05,150044369,0.985817
D.kanapiae,152203088,VNJM01002588.1,1,2339,1.53676e-05,150046708,0.985832
D.kanapiae,152203088,VNJM01003389.1,1,2338,1.53611e-05,150049046,0.985848
D.kanapiae,152203088,VNJM01001511.1,1,2338,1.53611e-05,150051384,0.985863
D.kanapiae,152203088,VNJM01001095.1,1,2336,1.53479e-05,150053720,0.985878
D.kanapiae,152203088,VNJM01002188.1,1,2334,1.53348e-05,150056054,0.985894
D.kanapiae,152203088,VNJM01003615.1,1,2333,1.53282e-05,150058387,0.985909
D.kanapiae,152203088,VNJM01003405.1,1,2333,1.53282e-05,150060720,0.985924
D.kanapiae,152203088,VNJM01002763.1,1,2333,1.53282e-05,150063053,0.98594
D.kanapiae,152203088,VNJM01002227.1,1,2332,1.53216e-05,150065385,0.985955
D.kanapiae,152203088,VNJM01003406.1,1,2331,1.53151e-05,150067716,0.98597
D.kanapiae,152203088,VNJM01003058.1,1,2331,1.53151e-05,150070047,0.985986
D.kanapiae,152203088,VNJM01002241.1,1,2330,1.53085e-05,150072377,0.986001
D.kanapiae,152203088,VNJM01001817.1,1,2327,1.52888e-05,150074704,0.986016
D.kanapiae,152203088,VNJM01001578.1,1,2327,1.52888e-05,150077031,0.986031
D.kanapiae,152203088,VNJM01002758.1,1,2325,1.52756e-05,150079356,0.986047
D.kanapiae,152203088,VNJM01000353.1,1,2325,1.52756e-05,150081681,0.986062
D.kanapiae,152203088,VNJM01001945.1,1,2324,1.52691e-05,150084005,0.986077
D.kanapiae,152203088,VNJM01000969.1,1,2324,1.52691e-05,150086329,0.986093
D.kanapiae,152203088,VNJM01000524.1,1,2324,1.52691e-05,150088653,0.986108
D.kanapiae,152203088,VNJM01002857.1,1,2323,1.52625e-05,150090976,0.986123
D.kanapiae,152203088,VNJM01003599.1,1,2322,1.52559e-05,150093298,0.986138
D.kanapiae,152203088,VNJM01001260.1,1,2322,1.52559e-05,150095620,0.986154
D.kanapiae,152203088,VNJM01000907.1,1,2322,1.52559e-05,150097942,0.986169
D.kanapiae,152203088,VNJM01003427.1,1,2320,1.52428e-05,150100262,0.986184
D.kanapiae,152203088,VNJM01001851.1,1,2320,1.52428e-05,150102582,0.986199
D.kanapiae,152203088,VNJM01002342.1,1,2319,1.52362e-05,150104901,0.986215
D.kanapiae,152203088,VNJM01001350.1,1,2319,1.52362e-05,150107220,0.98623
D.kanapiae,152203088,VNJM01001324.1,1,2319,1.52362e-05,150109539,0.986245
D.kanapiae,152203088,VNJM01002530.1,1,2318,1.52297e-05,150111857,0.98626
D.kanapiae,152203088,VNJM01001656.1,1,2318,1.52297e-05,150114175,0.986275
D.kanapiae,152203088,VNJM01000052.1,1,2315,1.52099e-05,150116490,0.986291
D.kanapiae,152203088,VNJM01002487.1,1,2314,1.52034e-05,150118804,0.986306
D.kanapiae,152203088,VNJM01001133.1,1,2314,1.52034e-05,150121118,0.986321
D.kanapiae,152203088,VNJM01000131.1,1,2310,1.51771e-05,150123428,0.986336
D.kanapiae,152203088,VNJM01001870.1,1,2309,1.51705e-05,150125737,0.986351
D.kanapiae,152203088,VNJM01001078.1,1,2308,1.51639e-05,150128045,0.986367
D.kanapiae,152203088,VNJM01003454.1,1,2305,1.51442e-05,150130350,0.986382
D.kanapiae,152203088,VNJM01002285.1,1,2305,1.51442e-05,150132655,0.986397
D.kanapiae,152203088,VNJM01002207.1,1,2304,1.51377e-05,150134959,0.986412
D.kanapiae,152203088,VNJM01000179.1,1,2304,1.51377e-05,150137263,0.986427
D.kanapiae,152203088,VNJM01002966.1,1,2303,1.51311e-05,150139566,0.986442
D.kanapiae,152203088,VNJM01001698.1,1,2302,1.51245e-05,150141868,0.986457
D.kanapiae,152203088,VNJM01003629.1,1,2301,1.5118e-05,150144169,0.986473
D.kanapiae,152203088,VNJM01000741.1,1,2301,1.5118e-05,150146470,0.986488
D.kanapiae,152203088,VNJM01001690.1,1,2297,1.50917e-05,150148767,0.986503
D.kanapiae,152203088,VNJM01000906.1,1,2297,1.50917e-05,150151064,0.986518
D.kanapiae,152203088,VNJM01003448.1,1,2295,1.50785e-05,150153359,0.986533
D.kanapiae,152203088,VNJM01001903.1,1,2295,1.50785e-05,150155654,0.986548
D.kanapiae,152203088,VNJM01000189.1,1,2295,1.50785e-05,150157949,0.986563
D.kanapiae,152203088,VNJM01002938.1,1,2294,1.5072e-05,150160243,0.986578
D.kanapiae,152203088,VNJM01002772.1,1,2294,1.5072e-05,150162537,0.986593
D.kanapiae,152203088,VNJM01002233.1,1,2294,1.5072e-05,150164831,0.986608
D.kanapiae,152203088,VNJM01002023.1,1,2294,1.5072e-05,150167125,0.986623
D.kanapiae,152203088,VNJM01002667.1,1,2293,1.50654e-05,150169418,0.986638
D.kanapiae,152203088,VNJM01001931.1,1,2292,1.50588e-05,150171710,0.986654
D.kanapiae,152203088,VNJM01001710.1,1,2291,1.50523e-05,150174001,0.986669
D.kanapiae,152203088,VNJM01003073.1,1,2289,1.50391e-05,150176290,0.986684
D.kanapiae,152203088,VNJM01002759.1,1,2289,1.50391e-05,150178579,0.986699
D.kanapiae,152203088,VNJM01002211.1,1,2288,1.50325e-05,150180867,0.986714
D.kanapiae,152203088,VNJM01001874.1,1,2287,1.5026e-05,150183154,0.986729
D.kanapiae,152203088,VNJM01000398.1,1,2286,1.50194e-05,150185440,0.986744
D.kanapiae,152203088,VNJM01003057.1,1,2284,1.50063e-05,150187724,0.986759
D.kanapiae,152203088,VNJM01001625.1,1,2284,1.50063e-05,150190008,0.986774
D.kanapiae,152203088,VNJM01001775.1,1,2283,1.49997e-05,150192291,0.986789
D.kanapiae,152203088,VNJM01001549.1,1,2281,1.49866e-05,150194572,0.986804
D.kanapiae,152203088,VNJM01000087.1,1,2281,1.49866e-05,150196853,0.986819
D.kanapiae,152203088,VNJM01000287.1,1,2270,1.49143e-05,150199123,0.986834
D.kanapiae,152203088,VNJM01003392.1,1,2266,1.4888e-05,150201389,0.986848
D.kanapiae,152203088,VNJM01003096.1,1,2266,1.4888e-05,150203655,0.986863
D.kanapiae,152203088,VNJM01000503.1,1,2266,1.4888e-05,150205921,0.986878
D.kanapiae,152203088,VNJM01001584.1,1,2265,1.48814e-05,150208186,0.986893
D.kanapiae,152203088,VNJM01000396.1,1,2265,1.48814e-05,150210451,0.986908
D.kanapiae,152203088,VNJM01003173.1,1,2260,1.48486e-05,150212711,0.986923
D.kanapiae,152203088,VNJM01000724.1,1,2259,1.4842e-05,150214970,0.986938
D.kanapiae,152203088,VNJM01000065.1,1,2257,1.48289e-05,150217227,0.986953
D.kanapiae,152203088,VNJM01000115.1,1,2256,1.48223e-05,150219483,0.986967
D.kanapiae,152203088,VNJM01001937.1,1,2255,1.48157e-05,150221738,0.986982
D.kanapiae,152203088,VNJM01002878.1,1,2253,1.48026e-05,150223991,0.986997
D.kanapiae,152203088,VNJM01000045.1,1,2253,1.48026e-05,150226244,0.987012
D.kanapiae,152203088,VNJM01000519.1,1,2252,1.4796e-05,150228496,0.987027
D.kanapiae,152203088,VNJM01000221.1,1,2250,1.47829e-05,150230746,0.987041
D.kanapiae,152203088,VNJM01000128.1,1,2248,1.47697e-05,150232994,0.987056
D.kanapiae,152203088,VNJM01000054.1,1,2248,1.47697e-05,150235242,0.987071
D.kanapiae,152203088,VNJM01002976.1,1,2247,1.47632e-05,150237489,0.987086
D.kanapiae,152203088,VNJM01001096.1,1,2246,1.47566e-05,150239735,0.9871
D.kanapiae,152203088,VNJM01000904.1,1,2245,1.475e-05,150241980,0.987115
D.kanapiae,152203088,VNJM01003612.1,1,2242,1.47303e-05,150244222,0.98713
D.kanapiae,152203088,VNJM01000991.1,1,2241,1.47237e-05,150246463,0.987145
D.kanapiae,152203088,VNJM01001938.1,1,2240,1.47172e-05,150248703,0.987159
D.kanapiae,152203088,VNJM01001836.1,1,2240,1.47172e-05,150250943,0.987174
D.kanapiae,152203088,VNJM01001602.1,1,2240,1.47172e-05,150253183,0.987189
D.kanapiae,152203088,VNJM01003188.1,1,2239,1.47106e-05,150255422,0.987204
D.kanapiae,152203088,VNJM01002478.1,1,2236,1.46909e-05,150257658,0.987218
D.kanapiae,152203088,VNJM01000671.1,1,2236,1.46909e-05,150259894,0.987233
D.kanapiae,152203088,VNJM01001099.1,1,2235,1.46843e-05,150262129,0.987248
D.kanapiae,152203088,VNJM01003274.1,1,2234,1.46778e-05,150264363,0.987262
D.kanapiae,152203088,VNJM01002289.1,1,2234,1.46778e-05,150266597,0.987277
D.kanapiae,152203088,VNJM01001726.1,1,2234,1.46778e-05,150268831,0.987292
D.kanapiae,152203088,VNJM01003216.1,1,2233,1.46712e-05,150271064,0.987306
D.kanapiae,152203088,VNJM01003317.1,1,2232,1.46646e-05,150273296,0.987321
D.kanapiae,152203088,VNJM01001963.1,1,2231,1.4658e-05,150275527,0.987336
D.kanapiae,152203088,VNJM01001654.1,1,2231,1.4658e-05,150277758,0.98735
D.kanapiae,152203088,VNJM01001230.1,1,2231,1.4658e-05,150279989,0.987365
D.kanapiae,152203088,VNJM01002220.1,1,2230,1.46515e-05,150282219,0.98738
D.kanapiae,152203088,VNJM01001697.1,1,2230,1.46515e-05,150284449,0.987394
D.kanapiae,152203088,VNJM01001822.1,1,2228,1.46383e-05,150286677,0.987409
D.kanapiae,152203088,VNJM01003044.1,1,2223,1.46055e-05,150288900,0.987423
D.kanapiae,152203088,VNJM01001321.1,1,2223,1.46055e-05,150291123,0.987438
D.kanapiae,152203088,VNJM01001236.1,1,2222,1.45989e-05,150293345,0.987453
D.kanapiae,152203088,VNJM01003568.1,1,2221,1.45923e-05,150295566,0.987467
D.kanapiae,152203088,VNJM01000593.1,1,2220,1.45858e-05,150297786,0.987482
D.kanapiae,152203088,VNJM01001915.1,1,2218,1.45726e-05,150300004,0.987496
D.kanapiae,152203088,VNJM01000895.1,1,2218,1.45726e-05,150302222,0.987511
D.kanapiae,152203088,VNJM01002445.1,1,2216,1.45595e-05,150304438,0.987526
D.kanapiae,152203088,VNJM01000652.1,1,2216,1.45595e-05,150306654,0.98754
D.kanapiae,152203088,VNJM01000582.1,1,2215,1.45529e-05,150308869,0.987555
D.kanapiae,152203088,VNJM01002368.1,1,2214,1.45464e-05,150311083,0.987569
D.kanapiae,152203088,VNJM01001895.1,1,2214,1.45464e-05,150313297,0.987584
D.kanapiae,152203088,VNJM01003441.1,1,2213,1.45398e-05,150315510,0.987598
D.kanapiae,152203088,VNJM01000162.1,1,2206,1.44938e-05,150317716,0.987613
D.kanapiae,152203088,VNJM01003183.1,1,2205,1.44872e-05,150319921,0.987627
D.kanapiae,152203088,VNJM01001961.1,1,2203,1.44741e-05,150322124,0.987642
D.kanapiae,152203088,VNJM01002446.1,1,2202,1.44675e-05,150324326,0.987656
D.kanapiae,152203088,VNJM01001805.1,1,2202,1.44675e-05,150326528,0.987671
D.kanapiae,152203088,VNJM01000447.1,1,2202,1.44675e-05,150328730,0.987685
D.kanapiae,152203088,VNJM01001886.1,1,2197,1.44347e-05,150330927,0.9877
D.kanapiae,152203088,VNJM01001173.1,1,2197,1.44347e-05,150333124,0.987714
D.kanapiae,152203088,VNJM01000195.1,1,2196,1.44281e-05,150335320,0.987728
D.kanapiae,152203088,VNJM01001572.1,1,2195,1.44215e-05,150337515,0.987743
D.kanapiae,152203088,VNJM01001165.1,1,2195,1.44215e-05,150339710,0.987757
D.kanapiae,152203088,VNJM01000429.1,1,2195,1.44215e-05,150341905,0.987772
D.kanapiae,152203088,VNJM01002623.1,1,2193,1.44084e-05,150344098,0.987786
D.kanapiae,152203088,VNJM01000599.1,1,2192,1.44018e-05,150346290,0.987801
D.kanapiae,152203088,VNJM01003018.1,1,2191,1.43952e-05,150348481,0.987815
D.kanapiae,152203088,VNJM01000909.1,1,2191,1.43952e-05,150350672,0.987829
D.kanapiae,152203088,VNJM01000137.1,1,2191,1.43952e-05,150352863,0.987844
D.kanapiae,152203088,VNJM01000603.1,1,2190,1.43887e-05,150355053,0.987858
D.kanapiae,152203088,VNJM01000263.1,1,2189,1.43821e-05,150357242,0.987872
D.kanapiae,152203088,VNJM01000536.1,1,2188,1.43755e-05,150359430,0.987887
D.kanapiae,152203088,VNJM01002423.1,1,2187,1.4369e-05,150361617,0.987901
D.kanapiae,152203088,VNJM01002280.1,1,2187,1.4369e-05,150363804,0.987916
D.kanapiae,152203088,VNJM01002370.1,1,2186,1.43624e-05,150365990,0.98793
D.kanapiae,152203088,VNJM01002380.1,1,2185,1.43558e-05,150368175,0.987944
D.kanapiae,152203088,VNJM01002081.1,1,2184,1.43492e-05,150370359,0.987959
D.kanapiae,152203088,VNJM01001883.1,1,2184,1.43492e-05,150372543,0.987973
D.kanapiae,152203088,VNJM01001442.1,1,2184,1.43492e-05,150374727,0.987987
D.kanapiae,152203088,VNJM01002813.1,1,2183,1.43427e-05,150376910,0.988002
D.kanapiae,152203088,VNJM01000658.1,1,2183,1.43427e-05,150379093,0.988016
D.kanapiae,152203088,VNJM01003431.1,1,2182,1.43361e-05,150381275,0.98803
D.kanapiae,152203088,VNJM01003236.1,1,2182,1.43361e-05,150383457,0.988045
D.kanapiae,152203088,VNJM01002318.1,1,2182,1.43361e-05,150385639,0.988059
D.kanapiae,152203088,VNJM01000134.1,1,2182,1.43361e-05,150387821,0.988073
D.kanapiae,152203088,VNJM01003189.1,1,2181,1.43295e-05,150390002,0.988088
D.kanapiae,152203088,VNJM01003178.1,1,2181,1.43295e-05,150392183,0.988102
D.kanapiae,152203088,VNJM01001544.1,1,2181,1.43295e-05,150394364,0.988116
D.kanapiae,152203088,VNJM01002239.1,1,2179,1.43164e-05,150396543,0.988131
D.kanapiae,152203088,VNJM01000088.1,1,2178,1.43098e-05,150398721,0.988145
D.kanapiae,152203088,VNJM01002206.1,1,2177,1.43033e-05,150400898,0.988159
D.kanapiae,152203088,VNJM01001974.1,1,2176,1.42967e-05,150403074,0.988174
D.kanapiae,152203088,VNJM01002620.1,1,2173,1.4277e-05,150405247,0.988188
D.kanapiae,152203088,VNJM01002592.1,1,2171,1.42638e-05,150407418,0.988202
D.kanapiae,152203088,VNJM01003566.1,1,2168,1.42441e-05,150409586,0.988216
D.kanapiae,152203088,VNJM01002652.1,1,2168,1.42441e-05,150411754,0.988231
D.kanapiae,152203088,VNJM01003625.1,1,2167,1.42376e-05,150413921,0.988245
D.kanapiae,152203088,VNJM01003513.1,1,2167,1.42376e-05,150416088,0.988259
D.kanapiae,152203088,VNJM01001816.1,1,2166,1.4231e-05,150418254,0.988273
D.kanapiae,152203088,VNJM01001020.1,1,2166,1.4231e-05,150420420,0.988288
D.kanapiae,152203088,VNJM01002107.1,1,2163,1.42113e-05,150422583,0.988302
D.kanapiae,152203088,VNJM01002034.1,1,2162,1.42047e-05,150424745,0.988316
D.kanapiae,152203088,VNJM01001334.1,1,2155,1.41587e-05,150426900,0.98833
D.kanapiae,152203088,VNJM01002184.1,1,2154,1.41521e-05,150429054,0.988344
D.kanapiae,152203088,VNJM01000828.1,1,2154,1.41521e-05,150431208,0.988358
D.kanapiae,152203088,VNJM01003511.1,1,2153,1.41456e-05,150433361,0.988373
D.kanapiae,152203088,VNJM01003001.1,1,2153,1.41456e-05,150435514,0.988387
D.kanapiae,152203088,VNJM01001365.1,1,2152,1.4139e-05,150437666,0.988401
D.kanapiae,152203088,VNJM01003275.1,1,2150,1.41259e-05,150439816,0.988415
D.kanapiae,152203088,VNJM01002718.1,1,2149,1.41193e-05,150441965,0.988429
D.kanapiae,152203088,VNJM01002406.1,1,2149,1.41193e-05,150444114,0.988443
D.kanapiae,152203088,VNJM01000331.1,1,2149,1.41193e-05,150446263,0.988457
D.kanapiae,152203088,VNJM01003036.1,1,2148,1.41127e-05,150448411,0.988471
D.kanapiae,152203088,VNJM01002528.1,1,2146,1.40996e-05,150450557,0.988486
D.kanapiae,152203088,VNJM01000122.1,1,2146,1.40996e-05,150452703,0.9885
D.kanapiae,152203088,VNJM01000467.1,1,2145,1.4093e-05,150454848,0.988514
D.kanapiae,152203088,VNJM01002040.1,1,2142,1.40733e-05,150456990,0.988528
D.kanapiae,152203088,VNJM01002662.1,1,2141,1.40667e-05,150459131,0.988542
D.kanapiae,152203088,VNJM01002545.1,1,2141,1.40667e-05,150461272,0.988556
D.kanapiae,152203088,VNJM01001968.1,1,2141,1.40667e-05,150463413,0.98857
D.kanapiae,152203088,VNJM01002644.1,1,2140,1.40602e-05,150465553,0.988584
D.kanapiae,152203088,VNJM01003097.1,1,2138,1.4047e-05,150467691,0.988598
D.kanapiae,152203088,VNJM01002483.1,1,2138,1.4047e-05,150469829,0.988612
D.kanapiae,152203088,VNJM01002104.1,1,2138,1.4047e-05,150471967,0.988626
D.kanapiae,152203088,VNJM01003428.1,1,2137,1.40405e-05,150474104,0.98864
D.kanapiae,152203088,VNJM01000590.1,1,2137,1.40405e-05,150476241,0.988654
D.kanapiae,152203088,VNJM01002439.1,1,2133,1.40142e-05,150478374,0.988668
D.kanapiae,152203088,VNJM01003156.1,1,2131,1.4001e-05,150480505,0.988682
D.kanapiae,152203088,VNJM01003338.1,1,2128,1.39813e-05,150482633,0.988696
D.kanapiae,152203088,VNJM01000050.1,1,2127,1.39747e-05,150484760,0.98871
D.kanapiae,152203088,VNJM01003313.1,1,2124,1.3955e-05,150486884,0.988724
D.kanapiae,152203088,VNJM01003136.1,1,2124,1.3955e-05,150489008,0.988738
D.kanapiae,152203088,VNJM01003531.1,1,2121,1.39353e-05,150491129,0.988752
D.kanapiae,152203088,VNJM01002191.1,1,2121,1.39353e-05,150493250,0.988766
D.kanapiae,152203088,VNJM01000338.1,1,2121,1.39353e-05,150495371,0.98878
D.kanapiae,152203088,VNJM01003261.1,1,2117,1.3909e-05,150497488,0.988794
D.kanapiae,152203088,VNJM01002862.1,1,2117,1.3909e-05,150499605,0.988808
D.kanapiae,152203088,VNJM01001929.1,1,2117,1.3909e-05,150501722,0.988822
D.kanapiae,152203088,VNJM01003133.1,1,2116,1.39025e-05,150503838,0.988836
D.kanapiae,152203088,VNJM01003193.1,1,2114,1.38893e-05,150505952,0.98885
D.kanapiae,152203088,VNJM01003123.1,1,2114,1.38893e-05,150508066,0.988863
D.kanapiae,152203088,VNJM01001066.1,1,2112,1.38762e-05,150510178,0.988877
D.kanapiae,152203088,VNJM01000716.1,1,2107,1.38433e-05,150512285,0.988891
D.kanapiae,152203088,VNJM01003289.1,1,2105,1.38302e-05,150514390,0.988905
D.kanapiae,152203088,VNJM01001106.1,1,2103,1.38171e-05,150516493,0.988919
D.kanapiae,152203088,VNJM01002114.1,1,2102,1.38105e-05,150518595,0.988933
D.kanapiae,152203088,VNJM01002797.1,1,2099,1.37908e-05,150520694,0.988946
D.kanapiae,152203088,VNJM01003270.1,1,2098,1.37842e-05,150522792,0.98896
D.kanapiae,152203088,VNJM01001659.1,1,2098,1.37842e-05,150524890,0.988974
D.kanapiae,152203088,VNJM01000184.1,1,2097,1.37776e-05,150526987,0.988988
D.kanapiae,152203088,VNJM01000076.1,1,2097,1.37776e-05,150529084,0.989002
D.kanapiae,152203088,VNJM01003582.1,1,2095,1.37645e-05,150531179,0.989015
D.kanapiae,152203088,VNJM01002361.1,1,2095,1.37645e-05,150533274,0.989029
D.kanapiae,152203088,VNJM01002128.1,1,2095,1.37645e-05,150535369,0.989043
D.kanapiae,152203088,VNJM01002995.1,1,2092,1.37448e-05,150537461,0.989057
D.kanapiae,152203088,VNJM01001947.1,1,2092,1.37448e-05,150539553,0.98907
D.kanapiae,152203088,VNJM01000176.1,1,2092,1.37448e-05,150541645,0.989084
D.kanapiae,152203088,VNJM01002836.1,1,2090,1.37317e-05,150543735,0.989098
D.kanapiae,152203088,VNJM01002419.1,1,2090,1.37317e-05,150545825,0.989112
D.kanapiae,152203088,VNJM01001826.1,1,2090,1.37317e-05,150547915,0.989125
D.kanapiae,152203088,VNJM01000939.1,1,2090,1.37317e-05,150550005,0.989139
D.kanapiae,152203088,VNJM01003590.1,1,2089,1.37251e-05,150552094,0.989153
D.kanapiae,152203088,VNJM01003617.1,1,2085,1.36988e-05,150554179,0.989166
D.kanapiae,152203088,VNJM01003215.1,1,2085,1.36988e-05,150556264,0.98918
D.kanapiae,152203088,VNJM01002374.1,1,2083,1.36857e-05,150558347,0.989194
D.kanapiae,152203088,VNJM01002275.1,1,2083,1.36857e-05,150560430,0.989207
D.kanapiae,152203088,VNJM01001320.1,1,2082,1.36791e-05,150562512,0.989221
D.kanapiae,152203088,VNJM01003484.1,1,2081,1.36725e-05,150564593,0.989235
D.kanapiae,152203088,VNJM01000546.1,1,2081,1.36725e-05,150566674,0.989248
D.kanapiae,152203088,VNJM01003550.1,1,2080,1.3666e-05,150568754,0.989262
D.kanapiae,152203088,VNJM01001814.1,1,2079,1.36594e-05,150570833,0.989276
D.kanapiae,152203088,VNJM01002551.1,1,2078,1.36528e-05,150572911,0.989289
D.kanapiae,152203088,VNJM01000225.1,1,2077,1.36462e-05,150574988,0.989303
D.kanapiae,152203088,VNJM01001702.1,1,2076,1.36397e-05,150577064,0.989317
D.kanapiae,152203088,VNJM01001421.1,1,2072,1.36134e-05,150579136,0.98933
D.kanapiae,152203088,VNJM01002506.1,1,2071,1.36068e-05,150581207,0.989344
D.kanapiae,152203088,VNJM01001068.1,1,2068,1.35871e-05,150583275,0.989358
D.kanapiae,152203088,VNJM01002925.1,1,2067,1.35805e-05,150585342,0.989371
D.kanapiae,152203088,VNJM01000639.1,1,2066,1.3574e-05,150587408,0.989385
D.kanapiae,152203088,VNJM01001304.1,1,2061,1.35411e-05,150589469,0.989398
D.kanapiae,152203088,VNJM01003157.1,1,2060,1.35345e-05,150591529,0.989412
D.kanapiae,152203088,VNJM01000758.1,1,2060,1.35345e-05,150593589,0.989425
D.kanapiae,152203088,VNJM01002565.1,1,2056,1.35083e-05,150595645,0.989439
D.kanapiae,152203088,VNJM01000547.1,1,2055,1.35017e-05,150597700,0.989452
D.kanapiae,152203088,VNJM01001545.1,1,2054,1.34951e-05,150599754,0.989466
D.kanapiae,152203088,VNJM01003535.1,1,2053,1.34886e-05,150601807,0.989479
D.kanapiae,152203088,VNJM01002465.1,1,2053,1.34886e-05,150603860,0.989493
D.kanapiae,152203088,VNJM01001169.1,1,2053,1.34886e-05,150605913,0.989506
D.kanapiae,152203088,VNJM01003499.1,1,2052,1.3482e-05,150607965,0.98952
D.kanapiae,152203088,VNJM01003114.1,1,2050,1.34688e-05,150610015,0.989533
D.kanapiae,152203088,VNJM01002660.1,1,2050,1.34688e-05,150612065,0.989547
D.kanapiae,152203088,VNJM01000769.1,1,2048,1.34557e-05,150614113,0.98956
D.kanapiae,152203088,VNJM01000401.1,1,2048,1.34557e-05,150616161,0.989574
D.kanapiae,152203088,VNJM01003533.1,1,2045,1.3436e-05,150618206,0.989587
D.kanapiae,152203088,VNJM01000048.1,1,2045,1.3436e-05,150620251,0.9896
D.kanapiae,152203088,VNJM01002615.1,1,2044,1.34294e-05,150622295,0.989614
D.kanapiae,152203088,VNJM01000103.1,1,2044,1.34294e-05,150624339,0.989627
D.kanapiae,152203088,VNJM01002415.1,1,2039,1.33966e-05,150626378,0.989641
D.kanapiae,152203088,VNJM01000511.1,1,2039,1.33966e-05,150628417,0.989654
D.kanapiae,152203088,VNJM01003358.1,1,2037,1.33834e-05,150630454,0.989668
D.kanapiae,152203088,VNJM01001730.1,1,2037,1.33834e-05,150632491,0.989681
D.kanapiae,152203088,VNJM01002941.1,1,2036,1.33769e-05,150634527,0.989694
D.kanapiae,152203088,VNJM01003402.1,1,2035,1.33703e-05,150636562,0.989708
D.kanapiae,152203088,VNJM01003003.1,1,2030,1.33374e-05,150638592,0.989721
D.kanapiae,152203088,VNJM01000691.1,1,2030,1.33374e-05,150640622,0.989734
D.kanapiae,152203088,VNJM01002784.1,1,2029,1.33309e-05,150642651,0.989748
D.kanapiae,152203088,VNJM01001501.1,1,2027,1.33177e-05,150644678,0.989761
D.kanapiae,152203088,VNJM01001300.1,1,2027,1.33177e-05,150646705,0.989774
D.kanapiae,152203088,VNJM01001228.1,1,2026,1.33112e-05,150648731,0.989788
D.kanapiae,152203088,VNJM01001707.1,1,2025,1.33046e-05,150650756,0.989801
D.kanapiae,152203088,VNJM01003541.1,1,2024,1.3298e-05,150652780,0.989814
D.kanapiae,152203088,VNJM01001403.1,1,2024,1.3298e-05,150654804,0.989828
D.kanapiae,152203088,VNJM01000897.1,1,2024,1.3298e-05,150656828,0.989841
D.kanapiae,152203088,VNJM01001595.1,1,2022,1.32849e-05,150658850,0.989854
D.kanapiae,152203088,VNJM01003002.1,1,2019,1.32652e-05,150660869,0.989867
D.kanapiae,152203088,VNJM01001919.1,1,2019,1.32652e-05,150662888,0.989881
D.kanapiae,152203088,VNJM01001675.1,1,2019,1.32652e-05,150664907,0.989894
D.kanapiae,152203088,VNJM01001672.1,1,2019,1.32652e-05,150666926,0.989907
D.kanapiae,152203088,VNJM01001592.1,1,2019,1.32652e-05,150668945,0.98992
D.kanapiae,152203088,VNJM01000083.1,1,2019,1.32652e-05,150670964,0.989934
D.kanapiae,152203088,VNJM01003439.1,1,2015,1.32389e-05,150672979,0.989947
D.kanapiae,152203088,VNJM01003418.1,1,2015,1.32389e-05,150674994,0.98996
D.kanapiae,152203088,VNJM01002872.1,1,2015,1.32389e-05,150677009,0.989973
D.kanapiae,152203088,VNJM01000867.1,1,2011,1.32126e-05,150679020,0.989987
D.kanapiae,152203088,VNJM01002663.1,1,2010,1.3206e-05,150681030,0.99
D.kanapiae,152203088,VNJM01001670.1,1,2010,1.3206e-05,150683040,0.990013
D.kanapiae,152203088,VNJM01001785.1,1,2009,1.31995e-05,150685049,0.990026
D.kanapiae,152203088,VNJM01001406.1,1,2007,1.31863e-05,150687056,0.990039
D.kanapiae,152203088,VNJM01002789.1,1,2006,1.31798e-05,150689062,0.990053
D.kanapiae,152203088,VNJM01002721.1,1,2006,1.31798e-05,150691068,0.990066
D.kanapiae,152203088,VNJM01003149.1,1,2005,1.31732e-05,150693073,0.990079
D.kanapiae,152203088,VNJM01001639.1,1,2005,1.31732e-05,150695078,0.990092
D.kanapiae,152203088,VNJM01003588.1,1,2004,1.31666e-05,150697082,0.990105
D.kanapiae,152203088,VNJM01001536.1,1,2004,1.31666e-05,150699086,0.990118
D.kanapiae,152203088,VNJM01000138.1,1,2004,1.31666e-05,150701090,0.990132
D.kanapiae,152203088,VNJM01001459.1,1,2003,1.316e-05,150703093,0.990145
D.kanapiae,152203088,VNJM01003194.1,1,2002,1.31535e-05,150705095,0.990158
D.kanapiae,152203088,VNJM01001776.1,1,2002,1.31535e-05,150707097,0.990171
D.kanapiae,152203088,VNJM01000348.1,1,2002,1.31535e-05,150709099,0.990184
D.kanapiae,152203088,VNJM01002601.1,1,2000,1.31403e-05,150711099,0.990197
D.kanapiae,152203088,VNJM01000093.1,1,2000,1.31403e-05,150713099,0.990211
D.kanapiae,152203088,VNJM01001831.1,1,1999,1.31338e-05,150715098,0.990224
D.kanapiae,152203088,VNJM01002213.1,1,1996,1.31141e-05,150717094,0.990237
D.kanapiae,152203088,VNJM01002190.1,1,1996,1.31141e-05,150719090,0.99025
D.kanapiae,152203088,VNJM01001666.1,1,1996,1.31141e-05,150721086,0.990263
D.kanapiae,152203088,VNJM01000819.1,1,1995,1.31075e-05,150723081,0.990276
D.kanapiae,152203088,VNJM01003306.1,1,1994,1.31009e-05,150725075,0.990289
D.kanapiae,152203088,VNJM01002596.1,1,1994,1.31009e-05,150727069,0.990302
D.kanapiae,152203088,VNJM01001056.1,1,1994,1.31009e-05,150729063,0.990315
D.kanapiae,152203088,VNJM01003322.1,1,1992,1.30878e-05,150731055,0.990328
D.kanapiae,152203088,VNJM01002782.1,1,1990,1.30746e-05,150733045,0.990342
D.kanapiae,152203088,VNJM01002572.1,1,1990,1.30746e-05,150735035,0.990355
D.kanapiae,152203088,VNJM01001832.1,1,1990,1.30746e-05,150737025,0.990368
D.kanapiae,152203088,VNJM01002351.1,1,1989,1.30681e-05,150739014,0.990381
D.kanapiae,152203088,VNJM01000171.1,1,1988,1.30615e-05,150741002,0.990394
D.kanapiae,152203088,VNJM01001226.1,1,1987,1.30549e-05,150742989,0.990407
D.kanapiae,152203088,VNJM01002398.1,1,1986,1.30484e-05,150744975,0.99042
D.kanapiae,152203088,VNJM01001808.1,1,1985,1.30418e-05,150746960,0.990433
D.kanapiae,152203088,VNJM01001474.1,1,1985,1.30418e-05,150748945,0.990446
D.kanapiae,152203088,VNJM01000450.1,1,1984,1.30352e-05,150750929,0.990459
D.kanapiae,152203088,VNJM01002646.1,1,1983,1.30286e-05,150752912,0.990472
D.kanapiae,152203088,VNJM01003293.1,1,1982,1.30221e-05,150754894,0.990485
D.kanapiae,152203088,VNJM01002359.1,1,1982,1.30221e-05,150756876,0.990498
D.kanapiae,152203088,VNJM01002281.1,1,1981,1.30155e-05,150758857,0.990511
D.kanapiae,152203088,VNJM01001749.1,1,1981,1.30155e-05,150760838,0.990524
D.kanapiae,152203088,VNJM01003559.1,1,1980,1.30089e-05,150762818,0.990537
D.kanapiae,152203088,VNJM01000389.1,1,1980,1.30089e-05,150764798,0.99055
D.kanapiae,152203088,VNJM01001392.1,1,1979,1.30024e-05,150766777,0.990563
D.kanapiae,152203088,VNJM01003265.1,1,1978,1.29958e-05,150768755,0.990576
D.kanapiae,152203088,VNJM01001391.1,1,1978,1.29958e-05,150770733,0.990589
D.kanapiae,152203088,VNJM01001960.1,1,1977,1.29892e-05,150772710,0.990602
D.kanapiae,152203088,VNJM01001441.1,1,1977,1.29892e-05,150774687,0.990615
D.kanapiae,152203088,VNJM01001398.1,1,1977,1.29892e-05,150776664,0.990628
D.kanapiae,152203088,VNJM01003264.1,1,1976,1.29827e-05,150778640,0.990641
D.kanapiae,152203088,VNJM01003228.1,1,1975,1.29761e-05,150780615,0.990654
D.kanapiae,152203088,VNJM01000330.1,1,1974,1.29695e-05,150782589,0.990667
D.kanapiae,152203088,VNJM01003296.1,1,1972,1.29564e-05,150784561,0.99068
D.kanapiae,152203088,VNJM01002895.1,1,1972,1.29564e-05,150786533,0.990693
D.kanapiae,152203088,VNJM01002245.1,1,1972,1.29564e-05,150788505,0.990706
D.kanapiae,152203088,VNJM01003022.1,1,1970,1.29432e-05,150790475,0.990719
D.kanapiae,152203088,VNJM01002683.1,1,1969,1.29367e-05,150792444,0.990732
D.kanapiae,152203088,VNJM01002520.1,1,1969,1.29367e-05,150794413,0.990745
D.kanapiae,152203088,VNJM01003592.1,1,1968,1.29301e-05,150796381,0.990758
D.kanapiae,152203088,VNJM01002630.1,1,1968,1.29301e-05,150798349,0.990771
D.kanapiae,152203088,VNJM01001597.1,1,1968,1.29301e-05,150800317,0.990784
D.kanapiae,152203088,VNJM01001395.1,1,1968,1.29301e-05,150802285,0.990796
D.kanapiae,152203088,VNJM01001093.1,1,1967,1.29235e-05,150804252,0.990809
D.kanapiae,152203088,VNJM01001131.1,1,1964,1.29038e-05,150806216,0.990822
D.kanapiae,152203088,VNJM01000721.1,1,1964,1.29038e-05,150808180,0.990835
D.kanapiae,152203088,VNJM01002093.1,1,1963,1.28972e-05,150810143,0.990848
D.kanapiae,152203088,VNJM01001389.1,1,1963,1.28972e-05,150812106,0.990861
D.kanapiae,152203088,VNJM01000070.1,1,1960,1.28775e-05,150814066,0.990874
D.kanapiae,152203088,VNJM01002467.1,1,1957,1.28578e-05,150816023,0.990887
D.kanapiae,152203088,VNJM01001456.1,1,1957,1.28578e-05,150817980,0.9909
D.kanapiae,152203088,VNJM01002261.1,1,1956,1.28513e-05,150819936,0.990912
D.kanapiae,152203088,VNJM01001833.1,1,1956,1.28513e-05,150821892,0.990925
D.kanapiae,152203088,VNJM01001388.1,1,1956,1.28513e-05,150823848,0.990938
D.kanapiae,152203088,VNJM01000089.1,1,1956,1.28513e-05,150825804,0.990951
D.kanapiae,152203088,VNJM01002979.1,1,1954,1.28381e-05,150827758,0.990964
D.kanapiae,152203088,VNJM01001721.1,1,1954,1.28381e-05,150829712,0.990977
D.kanapiae,152203088,VNJM01001559.1,1,1953,1.28315e-05,150831665,0.99099
D.kanapiae,152203088,VNJM01002474.1,1,1952,1.2825e-05,150833617,0.991002
D.kanapiae,152203088,VNJM01002202.1,1,1952,1.2825e-05,150835569,0.991015
D.kanapiae,152203088,VNJM01000862.1,1,1951,1.28184e-05,150837520,0.991028
D.kanapiae,152203088,VNJM01002581.1,1,1950,1.28118e-05,150839470,0.991041
D.kanapiae,152203088,VNJM01000068.1,1,1950,1.28118e-05,150841420,0.991054
D.kanapiae,152203088,VNJM01003271.1,1,1947,1.27921e-05,150843367,0.991066
D.kanapiae,152203088,VNJM01001118.1,1,1946,1.27855e-05,150845313,0.991079
D.kanapiae,152203088,VNJM01002709.1,1,1945,1.2779e-05,150847258,0.991092
D.kanapiae,152203088,VNJM01002635.1,1,1945,1.2779e-05,150849203,0.991105
D.kanapiae,152203088,VNJM01000500.1,1,1943,1.27658e-05,150851146,0.991118
D.kanapiae,152203088,VNJM01001397.1,1,1941,1.27527e-05,150853087,0.99113
D.kanapiae,152203088,VNJM01001787.1,1,1939,1.27396e-05,150855026,0.991143
D.kanapiae,152203088,VNJM01002960.1,1,1938,1.2733e-05,150856964,0.991156
D.kanapiae,152203088,VNJM01001457.1,1,1938,1.2733e-05,150858902,0.991168
D.kanapiae,152203088,VNJM01000726.1,1,1938,1.2733e-05,150860840,0.991181
D.kanapiae,152203088,VNJM01003584.1,1,1937,1.27264e-05,150862777,0.991194
D.kanapiae,152203088,VNJM01001688.1,1,1936,1.27198e-05,150864713,0.991207
D.kanapiae,152203088,VNJM01000224.1,1,1936,1.27198e-05,150866649,0.991219
D.kanapiae,152203088,VNJM01003331.1,1,1935,1.27133e-05,150868584,0.991232
D.kanapiae,152203088,VNJM01000521.1,1,1935,1.27133e-05,150870519,0.991245
D.kanapiae,152203088,VNJM01002624.1,1,1934,1.27067e-05,150872453,0.991258
D.kanapiae,152203088,VNJM01002260.1,1,1933,1.27001e-05,150874386,0.99127
D.kanapiae,152203088,VNJM01001613.1,1,1933,1.27001e-05,150876319,0.991283
D.kanapiae,152203088,VNJM01003585.1,1,1932,1.26936e-05,150878251,0.991296
D.kanapiae,152203088,VNJM01003169.1,1,1932,1.26936e-05,150880183,0.991308
D.kanapiae,152203088,VNJM01002659.1,1,1931,1.2687e-05,150882114,0.991321
D.kanapiae,152203088,VNJM01000743.1,1,1931,1.2687e-05,150884045,0.991334
D.kanapiae,152203088,VNJM01001119.1,1,1929,1.26739e-05,150885974,0.991346
D.kanapiae,152203088,VNJM01001786.1,1,1928,1.26673e-05,150887902,0.991359
D.kanapiae,152203088,VNJM01001480.1,1,1928,1.26673e-05,150889830,0.991372
D.kanapiae,152203088,VNJM01001120.1,1,1928,1.26673e-05,150891758,0.991384
D.kanapiae,152203088,VNJM01003103.1,1,1926,1.26541e-05,150893684,0.991397
D.kanapiae,152203088,VNJM01000900.1,1,1925,1.26476e-05,150895609,0.99141
D.kanapiae,152203088,VNJM01003312.1,1,1923,1.26344e-05,150897532,0.991422
D.kanapiae,152203088,VNJM01002845.1,1,1923,1.26344e-05,150899455,0.991435
D.kanapiae,152203088,VNJM01000352.1,1,1923,1.26344e-05,150901378,0.991448
D.kanapiae,152203088,VNJM01003019.1,1,1921,1.26213e-05,150903299,0.99146
D.kanapiae,152203088,VNJM01002566.1,1,1921,1.26213e-05,150905220,0.991473
D.kanapiae,152203088,VNJM01002373.1,1,1921,1.26213e-05,150907141,0.991485
D.kanapiae,152203088,VNJM01002604.1,1,1919,1.26082e-05,150909060,0.991498
D.kanapiae,152203088,VNJM01002344.1,1,1919,1.26082e-05,150910979,0.991511
D.kanapiae,152203088,VNJM01002627.1,1,1918,1.26016e-05,150912897,0.991523
D.kanapiae,152203088,VNJM01002766.1,1,1917,1.2595e-05,150914814,0.991536
D.kanapiae,152203088,VNJM01002547.1,1,1917,1.2595e-05,150916731,0.991548
D.kanapiae,152203088,VNJM01001123.1,1,1915,1.25819e-05,150918646,0.991561
D.kanapiae,152203088,VNJM01001769.1,1,1913,1.25687e-05,150920559,0.991574
D.kanapiae,152203088,VNJM01003434.1,1,1910,1.2549e-05,150922469,0.991586
D.kanapiae,152203088,VNJM01000238.1,1,1910,1.2549e-05,150924379,0.991599
D.kanapiae,152203088,VNJM01002123.1,1,1909,1.25425e-05,150926288,0.991611
D.kanapiae,152203088,VNJM01001082.1,1,1909,1.25425e-05,150928197,0.991624
D.kanapiae,152203088,VNJM01003229.1,1,1908,1.25359e-05,150930105,0.991636
D.kanapiae,152203088,VNJM01003034.1,1,1906,1.25227e-05,150932011,0.991649
D.kanapiae,152203088,VNJM01000004.1,1,1906,1.25227e-05,150933917,0.991661
D.kanapiae,152203088,VNJM01002457.1,1,1905,1.25162e-05,150935822,0.991674
D.kanapiae,152203088,VNJM01001196.1,1,1904,1.25096e-05,150937726,0.991686
D.kanapiae,152203088,VNJM01000569.1,1,1904,1.25096e-05,150939630,0.991699
D.kanapiae,152203088,VNJM01003107.1,1,1903,1.2503e-05,150941533,0.991711
D.kanapiae,152203088,VNJM01002420.1,1,1901,1.24899e-05,150943434,0.991724
D.kanapiae,152203088,VNJM01000974.1,1,1900,1.24833e-05,150945334,0.991736
D.kanapiae,152203088,VNJM01000892.1,1,1897,1.24636e-05,150947231,0.991749
D.kanapiae,152203088,VNJM01000464.1,1,1894,1.24439e-05,150949125,0.991761
D.kanapiae,152203088,VNJM01002920.1,1,1890,1.24176e-05,150951015,0.991774
D.kanapiae,152203088,VNJM01002997.1,1,1889,1.2411e-05,150952904,0.991786
D.kanapiae,152203088,VNJM01001041.1,1,1889,1.2411e-05,150954793,0.991798
D.kanapiae,152203088,VNJM01003424.1,1,1888,1.24045e-05,150956681,0.991811
D.kanapiae,152203088,VNJM01001608.1,1,1886,1.23913e-05,150958567,0.991823
D.kanapiae,152203088,VNJM01002479.1,1,1882,1.23651e-05,150960449,0.991836
D.kanapiae,152203088,VNJM01003276.1,1,1880,1.23519e-05,150962329,0.991848
D.kanapiae,152203088,VNJM01003503.1,1,1879,1.23453e-05,150964208,0.99186
D.kanapiae,152203088,VNJM01002540.1,1,1879,1.23453e-05,150966087,0.991873
D.kanapiae,152203088,VNJM01001097.1,1,1878,1.23388e-05,150967965,0.991885
D.kanapiae,152203088,VNJM01000390.1,1,1877,1.23322e-05,150969842,0.991897
D.kanapiae,152203088,VNJM01001115.1,1,1876,1.23256e-05,150971718,0.99191
D.kanapiae,152203088,VNJM01002006.1,1,1875,1.23191e-05,150973593,0.991922
D.kanapiae,152203088,VNJM01001171.1,1,1874,1.23125e-05,150975467,0.991934
D.kanapiae,152203088,VNJM01001121.1,1,1873,1.23059e-05,150977340,0.991947
D.kanapiae,152203088,VNJM01000452.1,1,1873,1.23059e-05,150979213,0.991959
D.kanapiae,152203088,VNJM01000951.1,1,1871,1.22928e-05,150981084,0.991971
D.kanapiae,152203088,VNJM01000728.1,1,1871,1.22928e-05,150982955,0.991984
D.kanapiae,152203088,VNJM01000453.1,1,1871,1.22928e-05,150984826,0.991996
D.kanapiae,152203088,VNJM01001116.1,1,1870,1.22862e-05,150986696,0.992008
D.kanapiae,152203088,VNJM01001374.1,1,1869,1.22796e-05,150988565,0.99202
D.kanapiae,152203088,VNJM01002788.1,1,1868,1.22731e-05,150990433,0.992033
D.kanapiae,152203088,VNJM01000369.1,1,1868,1.22731e-05,150992301,0.992045
D.kanapiae,152203088,VNJM01001616.1,1,1867,1.22665e-05,150994168,0.992057
D.kanapiae,152203088,VNJM01000056.1,1,1867,1.22665e-05,150996035,0.992069
D.kanapiae,152203088,VNJM01000873.1,1,1865,1.22534e-05,150997900,0.992082
D.kanapiae,152203088,VNJM01000604.1,1,1863,1.22402e-05,150999763,0.992094
D.kanapiae,152203088,VNJM01002143.1,1,1861,1.22271e-05,151001624,0.992106
D.kanapiae,152203088,VNJM01002466.1,1,1859,1.22139e-05,151003483,0.992118
D.kanapiae,152203088,VNJM01001720.1,1,1858,1.22074e-05,151005341,0.992131
D.kanapiae,152203088,VNJM01003636.1,1,1857,1.22008e-05,151007198,0.992143
D.kanapiae,152203088,VNJM01002640.1,1,1854,1.21811e-05,151009052,0.992155
D.kanapiae,152203088,VNJM01001202.1,1,1854,1.21811e-05,151010906,0.992167
D.kanapiae,152203088,VNJM01000378.1,1,1854,1.21811e-05,151012760,0.992179
D.kanapiae,152203088,VNJM01002163.1,1,1853,1.21745e-05,151014613,0.992192
D.kanapiae,152203088,VNJM01003247.1,1,1851,1.21614e-05,151016464,0.992204
D.kanapiae,152203088,VNJM01000092.1,1,1850,1.21548e-05,151018314,0.992216
D.kanapiae,152203088,VNJM01002687.1,1,1849,1.21482e-05,151020163,0.992228
D.kanapiae,152203088,VNJM01000731.1,1,1848,1.21417e-05,151022011,0.99224
D.kanapiae,152203088,VNJM01003579.1,1,1846,1.21285e-05,151023857,0.992252
D.kanapiae,152203088,VNJM01003506.1,1,1846,1.21285e-05,151025703,0.992264
D.kanapiae,152203088,VNJM01001271.1,1,1846,1.21285e-05,151027549,0.992277
D.kanapiae,152203088,VNJM01000145.1,1,1846,1.21285e-05,151029395,0.992289
D.kanapiae,152203088,VNJM01002936.1,1,1845,1.2122e-05,151031240,0.992301
D.kanapiae,152203088,VNJM01002461.1,1,1845,1.2122e-05,151033085,0.992313
D.kanapiae,152203088,VNJM01000777.1,1,1844,1.21154e-05,151034929,0.992325
D.kanapiae,152203088,VNJM01002585.1,1,1843,1.21088e-05,151036772,0.992337
D.kanapiae,152203088,VNJM01002222.1,1,1842,1.21023e-05,151038614,0.992349
D.kanapiae,152203088,VNJM01001729.1,1,1842,1.21023e-05,151040456,0.992361
D.kanapiae,152203088,VNJM01000781.1,1,1840,1.20891e-05,151042296,0.992373
D.kanapiae,152203088,VNJM01002194.1,1,1839,1.20825e-05,151044135,0.992385
D.kanapiae,152203088,VNJM01000626.1,1,1839,1.20825e-05,151045974,0.992398
D.kanapiae,152203088,VNJM01000046.1,1,1836,1.20628e-05,151047810,0.99241
D.kanapiae,152203088,VNJM01001413.1,1,1834,1.20497e-05,151049644,0.992422
D.kanapiae,152203088,VNJM01000589.1,1,1834,1.20497e-05,151051478,0.992434
D.kanapiae,152203088,VNJM01001708.1,1,1832,1.20365e-05,151053310,0.992446
D.kanapiae,152203088,VNJM01001784.1,1,1831,1.203e-05,151055141,0.992458
D.kanapiae,152203088,VNJM01000832.1,1,1831,1.203e-05,151056972,0.99247
D.kanapiae,152203088,VNJM01003339.1,1,1830,1.20234e-05,151058802,0.992482
D.kanapiae,152203088,VNJM01000605.1,1,1828,1.20103e-05,151060630,0.992494
D.kanapiae,152203088,VNJM01001709.1,1,1827,1.20037e-05,151062457,0.992506
D.kanapiae,152203088,VNJM01000387.1,1,1827,1.20037e-05,151064284,0.992518
D.kanapiae,152203088,VNJM01001601.1,1,1826,1.19971e-05,151066110,0.99253
D.kanapiae,152203088,VNJM01001637.1,1,1825,1.19906e-05,151067935,0.992542
D.kanapiae,152203088,VNJM01003273.1,1,1824,1.1984e-05,151069759,0.992554
D.kanapiae,152203088,VNJM01002611.1,1,1824,1.1984e-05,151071583,0.992566
D.kanapiae,152203088,VNJM01002548.1,1,1824,1.1984e-05,151073407,0.992578
D.kanapiae,152203088,VNJM01003303.1,1,1823,1.19774e-05,151075230,0.99259
D.kanapiae,152203088,VNJM01002543.1,1,1823,1.19774e-05,151077053,0.992602
D.kanapiae,152203088,VNJM01001768.1,1,1822,1.19708e-05,151078875,0.992614
D.kanapiae,152203088,VNJM01001443.1,1,1821,1.19643e-05,151080696,0.992626
D.kanapiae,152203088,VNJM01000914.1,1,1821,1.19643e-05,151082517,0.992638
D.kanapiae,152203088,VNJM01001971.1,1,1819,1.19511e-05,151084336,0.99265
D.kanapiae,152203088,VNJM01001948.1,1,1819,1.19511e-05,151086155,0.992662
D.kanapiae,152203088,VNJM01000563.1,1,1819,1.19511e-05,151087974,0.992674
D.kanapiae,152203088,VNJM01002744.1,1,1818,1.19446e-05,151089792,0.992685
D.kanapiae,152203088,VNJM01001075.1,1,1818,1.19446e-05,151091610,0.992697
D.kanapiae,152203088,VNJM01003309.1,1,1817,1.1938e-05,151093427,0.992709
D.kanapiae,152203088,VNJM01002447.1,1,1817,1.1938e-05,151095244,0.992721
D.kanapiae,152203088,VNJM01002092.1,1,1815,1.19249e-05,151097059,0.992733
D.kanapiae,152203088,VNJM01000675.1,1,1814,1.19183e-05,151098873,0.992745
D.kanapiae,152203088,VNJM01003266.1,1,1812,1.19051e-05,151100685,0.992757
D.kanapiae,152203088,VNJM01002067.1,1,1812,1.19051e-05,151102497,0.992769
D.kanapiae,152203088,VNJM01001417.1,1,1812,1.19051e-05,151104309,0.992781
D.kanapiae,152203088,VNJM01000645.1,1,1812,1.19051e-05,151106121,0.992793
D.kanapiae,152203088,VNJM01000999.1,1,1811,1.18986e-05,151107932,0.992805
D.kanapiae,152203088,VNJM01000147.1,1,1811,1.18986e-05,151109743,0.992817
D.kanapiae,152203088,VNJM01003238.1,1,1810,1.1892e-05,151111553,0.992828
D.kanapiae,152203088,VNJM01002764.1,1,1809,1.18854e-05,151113362,0.99284
D.kanapiae,152203088,VNJM01000868.1,1,1809,1.18854e-05,151115171,0.992852
D.kanapiae,152203088,VNJM01000212.1,1,1809,1.18854e-05,151116980,0.992864
D.kanapiae,152203088,VNJM01001663.1,1,1808,1.18789e-05,151118788,0.992876
D.kanapiae,152203088,VNJM01000872.1,1,1807,1.18723e-05,151120595,0.992888
D.kanapiae,152203088,VNJM01000610.1,1,1807,1.18723e-05,151122402,0.9929
D.kanapiae,152203088,VNJM01000373.1,1,1807,1.18723e-05,151124209,0.992912
D.kanapiae,152203088,VNJM01001811.1,1,1806,1.18657e-05,151126015,0.992923
D.kanapiae,152203088,VNJM01003451.1,1,1805,1.18592e-05,151127820,0.992935
D.kanapiae,152203088,VNJM01001665.1,1,1805,1.18592e-05,151129625,0.992947
D.kanapiae,152203088,VNJM01000871.1,1,1805,1.18592e-05,151131430,0.992959
D.kanapiae,152203088,VNJM01002448.1,1,1804,1.18526e-05,151133234,0.992971
D.kanapiae,152203088,VNJM01001419.1,1,1804,1.18526e-05,151135038,0.992983
D.kanapiae,152203088,VNJM01000880.1,1,1804,1.18526e-05,151136842,0.992995
D.kanapiae,152203088,VNJM01002921.1,1,1803,1.1846e-05,151138645,0.993006
D.kanapiae,152203088,VNJM01001806.1,1,1803,1.1846e-05,151140448,0.993018
D.kanapiae,152203088,VNJM01002985.1,1,1800,1.18263e-05,151142248,0.99303
D.kanapiae,152203088,VNJM01000218.1,1,1799,1.18197e-05,151144047,0.993042
D.kanapiae,152203088,VNJM01000328.1,1,1795,1.17935e-05,151145842,0.993054
D.kanapiae,152203088,VNJM01000091.1,1,1795,1.17935e-05,151147637,0.993066
D.kanapiae,152203088,VNJM01001566.1,1,1793,1.17803e-05,151149430,0.993077
D.kanapiae,152203088,VNJM01000216.1,1,1793,1.17803e-05,151151223,0.993089
D.kanapiae,152203088,VNJM01000051.1,1,1793,1.17803e-05,151153016,0.993101
D.kanapiae,152203088,VNJM01003558.1,1,1792,1.17737e-05,151154808,0.993113
D.kanapiae,152203088,VNJM01001519.1,1,1790,1.17606e-05,151156598,0.993124
D.kanapiae,152203088,VNJM01001201.1,1,1790,1.17606e-05,151158388,0.993136
D.kanapiae,152203088,VNJM01000611.1,1,1789,1.1754e-05,151160177,0.993148
D.kanapiae,152203088,VNJM01002340.1,1,1786,1.17343e-05,151161963,0.99316
D.kanapiae,152203088,VNJM01002864.1,1,1785,1.17278e-05,151163748,0.993171
D.kanapiae,152203088,VNJM01003628.1,1,1784,1.17212e-05,151165532,0.993183
D.kanapiae,152203088,VNJM01000987.1,1,1783,1.17146e-05,151167315,0.993195
D.kanapiae,152203088,VNJM01000208.1,1,1782,1.1708e-05,151169097,0.993207
D.kanapiae,152203088,VNJM01001944.1,1,1779,1.16883e-05,151170876,0.993218
D.kanapiae,152203088,VNJM01001342.1,1,1779,1.16883e-05,151172655,0.99323
D.kanapiae,152203088,VNJM01002038.1,1,1777,1.16752e-05,151174432,0.993242
D.kanapiae,152203088,VNJM01002824.1,1,1776,1.16686e-05,151176208,0.993253
D.kanapiae,152203088,VNJM01003286.1,1,1774,1.16555e-05,151177982,0.993265
D.kanapiae,152203088,VNJM01002455.1,1,1774,1.16555e-05,151179756,0.993277
D.kanapiae,152203088,VNJM01001976.1,1,1774,1.16555e-05,151181530,0.993288
D.kanapiae,152203088,VNJM01000824.1,1,1773,1.16489e-05,151183303,0.9933
D.kanapiae,152203088,VNJM01003288.1,1,1772,1.16423e-05,151185075,0.993311
D.kanapiae,152203088,VNJM01001671.1,1,1772,1.16423e-05,151186847,0.993323
D.kanapiae,152203088,VNJM01000720.1,1,1772,1.16423e-05,151188619,0.993335
D.kanapiae,152203088,VNJM01000343.1,1,1772,1.16423e-05,151190391,0.993346
D.kanapiae,152203088,VNJM01002823.1,1,1771,1.16358e-05,151192162,0.993358
D.kanapiae,152203088,VNJM01001683.1,1,1770,1.16292e-05,151193932,0.99337
D.kanapiae,152203088,VNJM01002647.1,1,1769,1.16226e-05,151195701,0.993381
D.kanapiae,152203088,VNJM01001600.1,1,1769,1.16226e-05,151197470,0.993393
D.kanapiae,152203088,VNJM01003217.1,1,1767,1.16095e-05,151199237,0.993405
D.kanapiae,152203088,VNJM01002736.1,1,1767,1.16095e-05,151201004,0.993416
D.kanapiae,152203088,VNJM01003563.1,1,1766,1.16029e-05,151202770,0.993428
D.kanapiae,152203088,VNJM01002358.1,1,1766,1.16029e-05,151204536,0.993439
D.kanapiae,152203088,VNJM01001725.1,1,1766,1.16029e-05,151206302,0.993451
D.kanapiae,152203088,VNJM01002486.1,1,1763,1.15832e-05,151208065,0.993463
D.kanapiae,152203088,VNJM01001546.1,1,1763,1.15832e-05,151209828,0.993474
D.kanapiae,152203088,VNJM01003144.1,1,1762,1.15766e-05,151211590,0.993486
D.kanapiae,152203088,VNJM01001991.1,1,1762,1.15766e-05,151213352,0.993497
D.kanapiae,152203088,VNJM01001434.1,1,1761,1.15701e-05,151215113,0.993509
D.kanapiae,152203088,VNJM01002930.1,1,1760,1.15635e-05,151216873,0.99352
D.kanapiae,152203088,VNJM01002975.1,1,1758,1.15504e-05,151218631,0.993532
D.kanapiae,152203088,VNJM01002142.1,1,1758,1.15504e-05,151220389,0.993544
D.kanapiae,152203088,VNJM01000615.1,1,1758,1.15504e-05,151222147,0.993555
D.kanapiae,152203088,VNJM01003311.1,1,1757,1.15438e-05,151223904,0.993567
D.kanapiae,152203088,VNJM01002638.1,1,1756,1.15372e-05,151225660,0.993578
D.kanapiae,152203088,VNJM01002186.1,1,1756,1.15372e-05,151227416,0.99359
D.kanapiae,152203088,VNJM01000136.1,1,1756,1.15372e-05,151229172,0.993601
D.kanapiae,152203088,VNJM01002577.1,1,1755,1.15306e-05,151230927,0.993613
D.kanapiae,152203088,VNJM01002320.1,1,1755,1.15306e-05,151232682,0.993624
D.kanapiae,152203088,VNJM01000044.1,1,1754,1.15241e-05,151234436,0.993636
D.kanapiae,152203088,VNJM01002926.1,1,1751,1.15044e-05,151236187,0.993647
D.kanapiae,152203088,VNJM01000988.1,1,1751,1.15044e-05,151237938,0.993659
D.kanapiae,152203088,VNJM01003512.1,1,1750,1.14978e-05,151239688,0.99367
D.kanapiae,152203088,VNJM01001130.1,1,1750,1.14978e-05,151241438,0.993682
D.kanapiae,152203088,VNJM01000878.1,1,1747,1.14781e-05,151243185,0.993693
D.kanapiae,152203088,VNJM01003263.1,1,1746,1.14715e-05,151244931,0.993705
D.kanapiae,152203088,VNJM01002089.1,1,1746,1.14715e-05,151246677,0.993716
D.kanapiae,152203088,VNJM01000616.1,1,1746,1.14715e-05,151248423,0.993728
D.kanapiae,152203088,VNJM01001103.1,1,1744,1.14584e-05,151250167,0.993739
D.kanapiae,152203088,VNJM01000132.1,1,1744,1.14584e-05,151251911,0.993751
D.kanapiae,152203088,VNJM01003209.1,1,1743,1.14518e-05,151253654,0.993762
D.kanapiae,152203088,VNJM01001059.1,1,1743,1.14518e-05,151255397,0.993774
D.kanapiae,152203088,VNJM01002943.1,1,1742,1.14452e-05,151257139,0.993785
D.kanapiae,152203088,VNJM01002838.1,1,1742,1.14452e-05,151258881,0.993796
D.kanapiae,152203088,VNJM01001618.1,1,1742,1.14452e-05,151260623,0.993808
D.kanapiae,152203088,VNJM01001175.1,1,1742,1.14452e-05,151262365,0.993819
D.kanapiae,152203088,VNJM01002664.1,1,1741,1.14387e-05,151264106,0.993831
D.kanapiae,152203088,VNJM01001489.1,1,1741,1.14387e-05,151265847,0.993842
D.kanapiae,152203088,VNJM01002360.1,1,1740,1.14321e-05,151267587,0.993854
D.kanapiae,152203088,VNJM01001917.1,1,1740,1.14321e-05,151269327,0.993865
D.kanapiae,152203088,VNJM01003187.1,1,1739,1.14255e-05,151271066,0.993876
D.kanapiae,152203088,VNJM01000408.1,1,1738,1.1419e-05,151272804,0.993888
D.kanapiae,152203088,VNJM01000385.1,1,1737,1.14124e-05,151274541,0.993899
D.kanapiae,152203088,VNJM01002004.1,1,1736,1.14058e-05,151276277,0.993911
D.kanapiae,152203088,VNJM01002587.1,1,1733,1.13861e-05,151278010,0.993922
D.kanapiae,152203088,VNJM01001127.1,1,1732,1.13795e-05,151279742,0.993933
D.kanapiae,152203088,VNJM01000613.1,1,1732,1.13795e-05,151281474,0.993945
D.kanapiae,152203088,VNJM01003272.1,1,1731,1.1373e-05,151283205,0.993956
D.kanapiae,152203088,VNJM01002414.1,1,1731,1.1373e-05,151284936,0.993968
D.kanapiae,152203088,VNJM01000210.1,1,1730,1.13664e-05,151286666,0.993979
D.kanapiae,152203088,VNJM01002841.1,1,1729,1.13598e-05,151288395,0.99399
D.kanapiae,152203088,VNJM01001461.1,1,1729,1.13598e-05,151290124,0.994002
D.kanapiae,152203088,VNJM01002489.1,1,1724,1.1327e-05,151291848,0.994013
D.kanapiae,152203088,VNJM01001422.1,1,1724,1.1327e-05,151293572,0.994024
D.kanapiae,152203088,VNJM01002031.1,1,1721,1.13073e-05,151295293,0.994036
D.kanapiae,152203088,VNJM01001502.1,1,1721,1.13073e-05,151297014,0.994047
D.kanapiae,152203088,VNJM01003290.1,1,1720,1.13007e-05,151298734,0.994058
D.kanapiae,152203088,VNJM01002984.1,1,1719,1.12941e-05,151300453,0.99407
D.kanapiae,152203088,VNJM01003397.1,1,1718,1.12876e-05,151302171,0.994081
D.kanapiae,152203088,VNJM01001820.1,1,1718,1.12876e-05,151303889,0.994092
D.kanapiae,152203088,VNJM01002436.1,1,1717,1.1281e-05,151305606,0.994103
D.kanapiae,152203088,VNJM01002080.1,1,1717,1.1281e-05,151307323,0.994115
D.kanapiae,152203088,VNJM01002041.1,1,1714,1.12613e-05,151309037,0.994126
D.kanapiae,152203088,VNJM01002879.1,1,1713,1.12547e-05,151310750,0.994137
D.kanapiae,152203088,VNJM01002668.1,1,1712,1.12481e-05,151312462,0.994148
D.kanapiae,152203088,VNJM01002480.1,1,1712,1.12481e-05,151314174,0.99416
D.kanapiae,152203088,VNJM01000062.1,1,1710,1.1235e-05,151315884,0.994171
D.kanapiae,152203088,VNJM01003304.1,1,1708,1.12218e-05,151317592,0.994182
D.kanapiae,152203088,VNJM01001694.1,1,1708,1.12218e-05,151319300,0.994193
D.kanapiae,152203088,VNJM01002899.1,1,1706,1.12087e-05,151321006,0.994205
D.kanapiae,152203088,VNJM01002684.1,1,1706,1.12087e-05,151322712,0.994216
D.kanapiae,152203088,VNJM01001100.1,1,1706,1.12087e-05,151324418,0.994227
D.kanapiae,152203088,VNJM01001166.1,1,1705,1.12021e-05,151326123,0.994238
D.kanapiae,152203088,VNJM01002889.1,1,1703,1.1189e-05,151327826,0.994249
D.kanapiae,152203088,VNJM01003419.1,1,1702,1.11824e-05,151329528,0.994261
D.kanapiae,152203088,VNJM01001533.1,1,1702,1.11824e-05,151331230,0.994272
D.kanapiae,152203088,VNJM01003243.1,1,1701,1.11759e-05,151332931,0.994283
D.kanapiae,152203088,VNJM01001812.1,1,1701,1.11759e-05,151334632,0.994294
D.kanapiae,152203088,VNJM01000735.1,1,1697,1.11496e-05,151336329,0.994305
D.kanapiae,152203088,VNJM01000098.1,1,1697,1.11496e-05,151338026,0.994316
D.kanapiae,152203088,VNJM01002324.1,1,1696,1.1143e-05,151339722,0.994328
D.kanapiae,152203088,VNJM01002729.1,1,1695,1.11364e-05,151341417,0.994339
D.kanapiae,152203088,VNJM01000372.1,1,1694,1.11299e-05,151343111,0.99435
D.kanapiae,152203088,VNJM01002669.1,1,1693,1.11233e-05,151344804,0.994361
D.kanapiae,152203088,VNJM01001180.1,1,1693,1.11233e-05,151346497,0.994372
D.kanapiae,152203088,VNJM01000737.1,1,1693,1.11233e-05,151348190,0.994383
D.kanapiae,152203088,VNJM01000016.1,1,1693,1.11233e-05,151349883,0.994394
D.kanapiae,152203088,VNJM01003214.1,1,1692,1.11167e-05,151351575,0.994405
D.kanapiae,152203088,VNJM01001177.1,1,1692,1.11167e-05,151353267,0.994417
D.kanapiae,152203088,VNJM01000323.1,1,1692,1.11167e-05,151354959,0.994428
D.kanapiae,152203088,VNJM01001464.1,1,1690,1.11036e-05,151356649,0.994439
D.kanapiae,152203088,VNJM01000968.1,1,1690,1.11036e-05,151358339,0.99445
D.kanapiae,152203088,VNJM01002707.1,1,1687,1.10839e-05,151360026,0.994461
D.kanapiae,152203088,VNJM01001996.1,1,1687,1.10839e-05,151361713,0.994472
D.kanapiae,152203088,VNJM01001122.1,1,1686,1.10773e-05,151363399,0.994483
D.kanapiae,152203088,VNJM01002119.1,1,1685,1.10707e-05,151365084,0.994494
D.kanapiae,152203088,VNJM01000865.1,1,1684,1.10642e-05,151366768,0.994505
D.kanapiae,152203088,VNJM01000646.1,1,1684,1.10642e-05,151368452,0.994516
D.kanapiae,152203088,VNJM01003162.1,1,1682,1.1051e-05,151370134,0.994527
D.kanapiae,152203088,VNJM01003124.1,1,1682,1.1051e-05,151371816,0.994538
D.kanapiae,152203088,VNJM01001376.1,1,1680,1.10379e-05,151373496,0.994549
D.kanapiae,152203088,VNJM01000975.1,1,1680,1.10379e-05,151375176,0.99456
D.kanapiae,152203088,VNJM01003226.1,1,1679,1.10313e-05,151376855,0.994572
D.kanapiae,152203088,VNJM01002074.1,1,1679,1.10313e-05,151378534,0.994583
D.kanapiae,152203088,VNJM01000842.1,1,1678,1.10247e-05,151380212,0.994594
D.kanapiae,152203088,VNJM01000617.1,1,1677,1.10182e-05,151381889,0.994605
D.kanapiae,152203088,VNJM01000406.1,1,1676,1.10116e-05,151383565,0.994616
D.kanapiae,152203088,VNJM01000642.1,1,1675,1.1005e-05,151385240,0.994627
D.kanapiae,152203088,VNJM01001706.1,1,1674,1.09985e-05,151386914,0.994638
D.kanapiae,152203088,VNJM01001657.1,1,1674,1.09985e-05,151388588,0.994649
D.kanapiae,152203088,VNJM01003186.1,1,1673,1.09919e-05,151390261,0.99466
D.kanapiae,152203088,VNJM01000876.1,1,1673,1.09919e-05,151391934,0.994671
D.kanapiae,152203088,VNJM01000129.1,1,1673,1.09919e-05,151393607,0.994682
D.kanapiae,152203088,VNJM01000936.1,1,1669,1.09656e-05,151395276,0.994693
D.kanapiae,152203088,VNJM01000578.1,1,1668,1.0959e-05,151396944,0.994703
D.kanapiae,152203088,VNJM01001965.1,1,1667,1.09525e-05,151398611,0.994714
D.kanapiae,152203088,VNJM01002847.1,1,1666,1.09459e-05,151400277,0.994725
D.kanapiae,152203088,VNJM01001410.1,1,1666,1.09459e-05,151401943,0.994736
D.kanapiae,152203088,VNJM01003530.1,1,1665,1.09393e-05,151403608,0.994747
D.kanapiae,152203088,VNJM01001390.1,1,1665,1.09393e-05,151405273,0.994758
D.kanapiae,152203088,VNJM01002929.1,1,1663,1.09262e-05,151406936,0.994769
D.kanapiae,152203088,VNJM01000187.1,1,1660,1.09065e-05,151408596,0.99478
D.kanapiae,152203088,VNJM01003016.1,1,1659,1.08999e-05,151410255,0.994791
D.kanapiae,152203088,VNJM01003426.1,1,1658,1.08933e-05,151411913,0.994802
D.kanapiae,152203088,VNJM01002362.1,1,1657,1.08868e-05,151413570,0.994813
D.kanapiae,152203088,VNJM01000341.1,1,1656,1.08802e-05,151415226,0.994824
D.kanapiae,152203088,VNJM01000870.1,1,1653,1.08605e-05,151416879,0.994834
D.kanapiae,152203088,VNJM01000178.1,1,1653,1.08605e-05,151418532,0.994845
D.kanapiae,152203088,VNJM01002653.1,1,1650,1.08408e-05,151420182,0.994856
D.kanapiae,152203088,VNJM01003307.1,1,1648,1.08276e-05,151421830,0.994867
D.kanapiae,152203088,VNJM01002409.1,1,1648,1.08276e-05,151423478,0.994878
D.kanapiae,152203088,VNJM01001416.1,1,1647,1.08211e-05,151425125,0.994889
D.kanapiae,152203088,VNJM01000967.1,1,1647,1.08211e-05,151426772,0.994899
D.kanapiae,152203088,VNJM01003390.1,1,1646,1.08145e-05,151428418,0.99491
D.kanapiae,152203088,VNJM01002942.1,1,1645,1.08079e-05,151430063,0.994921
D.kanapiae,152203088,VNJM01001425.1,1,1645,1.08079e-05,151431708,0.994932
D.kanapiae,152203088,VNJM01003411.1,1,1644,1.08014e-05,151433352,0.994943
D.kanapiae,152203088,VNJM01000875.1,1,1644,1.08014e-05,151434996,0.994954
D.kanapiae,152203088,VNJM01002866.1,1,1642,1.07882e-05,151436638,0.994964
D.kanapiae,152203088,VNJM01001215.1,1,1641,1.07816e-05,151438279,0.994975
D.kanapiae,152203088,VNJM01002594.1,1,1639,1.07685e-05,151439918,0.994986
D.kanapiae,152203088,VNJM01001705.1,1,1639,1.07685e-05,151441557,0.994997
D.kanapiae,152203088,VNJM01003528.1,1,1638,1.07619e-05,151443195,0.995007
D.kanapiae,152203088,VNJM01002029.1,1,1638,1.07619e-05,151444833,0.995018
D.kanapiae,152203088,VNJM01002785.1,1,1637,1.07554e-05,151446470,0.995029
D.kanapiae,152203088,VNJM01000041.1,1,1636,1.07488e-05,151448106,0.99504
D.kanapiae,152203088,VNJM01003578.1,1,1635,1.07422e-05,151449741,0.99505
D.kanapiae,152203088,VNJM01001718.1,1,1633,1.07291e-05,151451374,0.995061
D.kanapiae,152203088,VNJM01003213.1,1,1632,1.07225e-05,151453006,0.995072
D.kanapiae,152203088,VNJM01001396.1,1,1632,1.07225e-05,151454638,0.995083
D.kanapiae,152203088,VNJM01003461.1,1,1630,1.07094e-05,151456268,0.995093
D.kanapiae,152203088,VNJM01003354.1,1,1629,1.07028e-05,151457897,0.995104
D.kanapiae,152203088,VNJM01001245.1,1,1629,1.07028e-05,151459526,0.995115
D.kanapiae,152203088,VNJM01002888.1,1,1627,1.06897e-05,151461153,0.995125
D.kanapiae,152203088,VNJM01000507.1,1,1627,1.06897e-05,151462780,0.995136
D.kanapiae,152203088,VNJM01003474.1,1,1624,1.067e-05,151464404,0.995147
D.kanapiae,152203088,VNJM01003413.1,1,1624,1.067e-05,151466028,0.995157
D.kanapiae,152203088,VNJM01001741.1,1,1624,1.067e-05,151467652,0.995168
D.kanapiae,152203088,VNJM01003476.1,1,1623,1.06634e-05,151469275,0.995179
D.kanapiae,152203088,VNJM01001028.1,1,1623,1.06634e-05,151470898,0.995189
D.kanapiae,152203088,VNJM01000583.1,1,1623,1.06634e-05,151472521,0.9952
D.kanapiae,152203088,VNJM01003239.1,1,1622,1.06568e-05,151474143,0.995211
D.kanapiae,152203088,VNJM01000654.1,1,1622,1.06568e-05,151475765,0.995221
D.kanapiae,152203088,VNJM01000619.1,1,1622,1.06568e-05,151477387,0.995232
D.kanapiae,152203088,VNJM01002033.1,1,1619,1.06371e-05,151479006,0.995243
D.kanapiae,152203088,VNJM01001593.1,1,1618,1.06305e-05,151480624,0.995253
D.kanapiae,152203088,VNJM01000962.1,1,1616,1.06174e-05,151482240,0.995264
D.kanapiae,152203088,VNJM01000454.1,1,1616,1.06174e-05,151483856,0.995275
D.kanapiae,152203088,VNJM01002000.1,1,1615,1.06108e-05,151485471,0.995285
D.kanapiae,152203088,VNJM01001980.1,1,1615,1.06108e-05,151487086,0.995296
D.kanapiae,152203088,VNJM01001272.1,1,1615,1.06108e-05,151488701,0.995306
D.kanapiae,152203088,VNJM01002607.1,1,1614,1.06043e-05,151490315,0.995317
D.kanapiae,152203088,VNJM01003399.1,1,1611,1.05845e-05,151491926,0.995328
D.kanapiae,152203088,VNJM01001982.1,1,1610,1.0578e-05,151493536,0.995338
D.kanapiae,152203088,VNJM01002964.1,1,1608,1.05648e-05,151495144,0.995349
D.kanapiae,152203088,VNJM01002385.1,1,1608,1.05648e-05,151496752,0.995359
D.kanapiae,152203088,VNJM01000377.1,1,1608,1.05648e-05,151498360,0.99537
D.kanapiae,152203088,VNJM01002932.1,1,1607,1.05583e-05,151499967,0.99538
D.kanapiae,152203088,VNJM01000205.1,1,1605,1.05451e-05,151501572,0.995391
D.kanapiae,152203088,VNJM01002648.1,1,1603,1.0532e-05,151503175,0.995401
D.kanapiae,152203088,VNJM01002197.1,1,1603,1.0532e-05,151504778,0.995412
D.kanapiae,152203088,VNJM01001447.1,1,1603,1.0532e-05,151506381,0.995423
D.kanapiae,152203088,VNJM01000898.1,1,1603,1.0532e-05,151507984,0.995433
D.kanapiae,152203088,VNJM01000687.1,1,1603,1.0532e-05,151509587,0.995444
D.kanapiae,152203088,VNJM01002858.1,1,1601,1.05188e-05,151511188,0.995454
D.kanapiae,152203088,VNJM01001923.1,1,1600,1.05123e-05,151512788,0.995465
D.kanapiae,152203088,VNJM01001560.1,1,1599,1.05057e-05,151514387,0.995475
D.kanapiae,152203088,VNJM01003130.1,1,1598,1.04991e-05,151515985,0.995486
D.kanapiae,152203088,VNJM01002719.1,1,1598,1.04991e-05,151517583,0.995496
D.kanapiae,152203088,VNJM01003580.1,1,1595,1.04794e-05,151519178,0.995507
D.kanapiae,152203088,VNJM01003170.1,1,1595,1.04794e-05,151520773,0.995517
D.kanapiae,152203088,VNJM01002693.1,1,1595,1.04794e-05,151522368,0.995528
D.kanapiae,152203088,VNJM01001632.1,1,1595,1.04794e-05,151523963,0.995538
D.kanapiae,152203088,VNJM01002039.1,1,1594,1.04728e-05,151525557,0.995549
D.kanapiae,152203088,VNJM01000375.1,1,1590,1.04466e-05,151527147,0.995559
D.kanapiae,152203088,VNJM01003414.1,1,1589,1.044e-05,151528736,0.995569
D.kanapiae,152203088,VNJM01002973.1,1,1589,1.044e-05,151530325,0.99558
D.kanapiae,152203088,VNJM01002916.1,1,1589,1.044e-05,151531914,0.99559
D.kanapiae,152203088,VNJM01002054.1,1,1589,1.044e-05,151533503,0.995601
D.kanapiae,152203088,VNJM01002313.1,1,1588,1.04334e-05,151535091,0.995611
D.kanapiae,152203088,VNJM01002676.1,1,1583,1.04006e-05,151536674,0.995622
D.kanapiae,152203088,VNJM01000756.1,1,1581,1.03874e-05,151538255,0.995632
D.kanapiae,152203088,VNJM01003070.1,1,1579,1.03743e-05,151539834,0.995642
D.kanapiae,152203088,VNJM01000963.1,1,1577,1.03612e-05,151541411,0.995653
D.kanapiae,152203088,VNJM01003553.1,1,1576,1.03546e-05,151542987,0.995663
D.kanapiae,152203088,VNJM01002407.1,1,1576,1.03546e-05,151544563,0.995673
D.kanapiae,152203088,VNJM01003048.1,1,1575,1.0348e-05,151546138,0.995684
D.kanapiae,152203088,VNJM01001645.1,1,1575,1.0348e-05,151547713,0.995694
D.kanapiae,152203088,VNJM01001990.1,1,1574,1.03414e-05,151549287,0.995704
D.kanapiae,152203088,VNJM01002783.1,1,1573,1.03349e-05,151550860,0.995715
D.kanapiae,152203088,VNJM01002463.1,1,1573,1.03349e-05,151552433,0.995725
D.kanapiae,152203088,VNJM01001692.1,1,1573,1.03349e-05,151554006,0.995735
D.kanapiae,152203088,VNJM01000961.1,1,1570,1.03152e-05,151555576,0.995746
D.kanapiae,152203088,VNJM01002326.1,1,1569,1.03086e-05,151557145,0.995756
D.kanapiae,152203088,VNJM01001988.1,1,1569,1.03086e-05,151558714,0.995766
D.kanapiae,152203088,VNJM01000879.1,1,1564,1.02757e-05,151560278,0.995777
D.kanapiae,152203088,VNJM01002959.1,1,1557,1.02298e-05,151561835,0.995787
D.kanapiae,152203088,VNJM01000449.1,1,1555,1.02166e-05,151563390,0.995797
D.kanapiae,152203088,VNJM01001090.1,1,1553,1.02035e-05,151564943,0.995807
D.kanapiae,152203088,VNJM01003463.1,1,1552,1.01969e-05,151566495,0.995817
D.kanapiae,152203088,VNJM01002286.1,1,1551,1.01903e-05,151568046,0.995828
D.kanapiae,152203088,VNJM01001648.1,1,1550,1.01838e-05,151569596,0.995838
D.kanapiae,152203088,VNJM01000376.1,1,1546,1.01575e-05,151571142,0.995848
D.kanapiae,152203088,VNJM01002776.1,1,1545,1.01509e-05,151572687,0.995858
D.kanapiae,152203088,VNJM01002505.1,1,1545,1.01509e-05,151574232,0.995868
D.kanapiae,152203088,VNJM01003164.1,1,1543,1.01378e-05,151575775,0.995878
D.kanapiae,152203088,VNJM01000455.1,1,1542,1.01312e-05,151577317,0.995889
D.kanapiae,152203088,VNJM01000170.1,1,1542,1.01312e-05,151578859,0.995899
D.kanapiae,152203088,VNJM01000698.1,1,1540,1.01181e-05,151580399,0.995909
D.kanapiae,152203088,VNJM01000635.1,1,1540,1.01181e-05,151581939,0.995919
D.kanapiae,152203088,VNJM01003269.1,1,1538,1.01049e-05,151583477,0.995929
D.kanapiae,152203088,VNJM01002017.1,1,1537,1.00983e-05,151585014,0.995939
D.kanapiae,152203088,VNJM01001535.1,1,1537,1.00983e-05,151586551,0.995949
D.kanapiae,152203088,VNJM01000392.1,1,1537,1.00983e-05,151588088,0.995959
D.kanapiae,152203088,VNJM01001187.1,1,1536,1.00918e-05,151589624,0.995969
D.kanapiae,152203088,VNJM01000038.1,1,1536,1.00918e-05,151591160,0.99598
D.kanapiae,152203088,VNJM01003624.1,1,1531,1.00589e-05,151592691,0.99599
D.kanapiae,152203088,VNJM01001140.1,1,1530,1.00524e-05,151594221,0.996
D.kanapiae,152203088,VNJM01000827.1,1,1529,1.00458e-05,151595750,0.99601
D.kanapiae,152203088,VNJM01000266.1,1,1529,1.00458e-05,151597279,0.99602
D.kanapiae,152203088,VNJM01002249.1,1,1528,1.00392e-05,151598807,0.99603
D.kanapiae,152203088,VNJM01003536.1,1,1527,1.00326e-05,151600334,0.99604
D.kanapiae,152203088,VNJM01002962.1,1,1524,1.00129e-05,151601858,0.99605
D.kanapiae,152203088,VNJM01000435.1,1,1524,1.00129e-05,151603382,0.99606
D.kanapiae,152203088,VNJM01000094.1,1,1524,1.00129e-05,151604906,0.99607
D.kanapiae,152203088,VNJM01003410.1,1,1522,9.9998e-06,151606428,0.99608
D.kanapiae,152203088,VNJM01001507.1,1,1522,9.9998e-06,151607950,0.99609
D.kanapiae,152203088,VNJM01000712.1,1,1521,9.99323e-06,151609471,0.9961
D.kanapiae,152203088,VNJM01001138.1,1,1519,9.98009e-06,151610990,0.99611
D.kanapiae,152203088,VNJM01001612.1,1,1517,9.96695e-06,151612507,0.99612
D.kanapiae,152203088,VNJM01000356.1,1,1517,9.96695e-06,151614024,0.99613
D.kanapiae,152203088,VNJM01002502.1,1,1515,9.95381e-06,151615539,0.99614
D.kanapiae,152203088,VNJM01001203.1,1,1515,9.95381e-06,151617054,0.99615
D.kanapiae,152203088,VNJM01000124.1,1,1515,9.95381e-06,151618569,0.99616
D.kanapiae,152203088,VNJM01003552.1,1,1514,9.94724e-06,151620083,0.99617
D.kanapiae,152203088,VNJM01000670.1,1,1514,9.94724e-06,151621597,0.99618
D.kanapiae,152203088,VNJM01000552.1,1,1514,9.94724e-06,151623111,0.996189
D.kanapiae,152203088,VNJM01000190.1,1,1514,9.94724e-06,151624625,0.996199
D.kanapiae,152203088,VNJM01000899.1,1,1513,9.94067e-06,151626138,0.996209
D.kanapiae,152203088,VNJM01003323.1,1,1512,9.9341e-06,151627650,0.996219
D.kanapiae,152203088,VNJM01001450.1,1,1512,9.9341e-06,151629162,0.996229
D.kanapiae,152203088,VNJM01000649.1,1,1511,9.92753e-06,151630673,0.996239
D.kanapiae,152203088,VNJM01001499.1,1,1510,9.92096e-06,151632183,0.996249
D.kanapiae,152203088,VNJM01003223.1,1,1509,9.91438e-06,151633692,0.996259
D.kanapiae,152203088,VNJM01000893.1,1,1501,9.86182e-06,151635193,0.996269
D.kanapiae,152203088,VNJM01000705.1,1,1501,9.86182e-06,151636694,0.996279
D.kanapiae,152203088,VNJM01001455.1,1,1500,9.85525e-06,151638194,0.996289
D.kanapiae,152203088,VNJM01000732.1,1,1500,9.85525e-06,151639694,0.996298
D.kanapiae,152203088,VNJM01003210.1,1,1496,9.82897e-06,151641190,0.996308
D.kanapiae,152203088,VNJM01000644.1,1,1495,9.8224e-06,151642685,0.996318
D.kanapiae,152203088,VNJM01000964.1,1,1494,9.81583e-06,151644179,0.996328
D.kanapiae,152203088,VNJM01002431.1,1,1492,9.80269e-06,151645671,0.996338
D.kanapiae,152203088,VNJM01003495.1,1,1491,9.79612e-06,151647162,0.996347
D.kanapiae,152203088,VNJM01003380.1,1,1491,9.79612e-06,151648653,0.996357
D.kanapiae,152203088,VNJM01002768.1,1,1491,9.79612e-06,151650144,0.996367
D.kanapiae,152203088,VNJM01002325.1,1,1491,9.79612e-06,151651635,0.996377
D.kanapiae,152203088,VNJM01001378.1,1,1488,9.77641e-06,151653123,0.996387
D.kanapiae,152203088,VNJM01002800.1,1,1487,9.76984e-06,151654610,0.996396
D.kanapiae,152203088,VNJM01000891.1,1,1483,9.74356e-06,151656093,0.996406
D.kanapiae,152203088,VNJM01002586.1,1,1482,9.73699e-06,151657575,0.996416
D.kanapiae,152203088,VNJM01002247.1,1,1482,9.73699e-06,151659057,0.996426
D.kanapiae,152203088,VNJM01000863.1,1,1482,9.73699e-06,151660539,0.996435
D.kanapiae,152203088,VNJM01000380.1,1,1482,9.73699e-06,151662021,0.996445
D.kanapiae,152203088,VNJM01000608.1,1,1480,9.72385e-06,151663501,0.996455
D.kanapiae,152203088,VNJM01002328.1,1,1477,9.70414e-06,151664978,0.996465
D.kanapiae,152203088,VNJM01000632.1,1,1477,9.70414e-06,151666455,0.996474
D.kanapiae,152203088,VNJM01002842.1,1,1475,9.691e-06,151667930,0.996484
D.kanapiae,152203088,VNJM01003360.1,1,1474,9.68443e-06,151669404,0.996494
D.kanapiae,152203088,VNJM01001188.1,1,1471,9.66472e-06,151670875,0.996503
D.kanapiae,152203088,VNJM01001125.1,1,1471,9.66472e-06,151672346,0.996513
D.kanapiae,152203088,VNJM01000209.1,1,1471,9.66472e-06,151673817,0.996523
D.kanapiae,152203088,VNJM01002727.1,1,1469,9.65158e-06,151675286,0.996532
D.kanapiae,152203088,VNJM01002717.1,1,1469,9.65158e-06,151676755,0.996542
D.kanapiae,152203088,VNJM01000381.1,1,1469,9.65158e-06,151678224,0.996552
D.kanapiae,152203088,VNJM01002198.1,1,1468,9.64501e-06,151679692,0.996561
D.kanapiae,152203088,VNJM01000183.1,1,1468,9.64501e-06,151681160,0.996571
D.kanapiae,152203088,VNJM01000063.1,1,1468,9.64501e-06,151682628,0.99658
D.kanapiae,152203088,VNJM01000736.1,1,1467,9.63844e-06,151684095,0.99659
D.kanapiae,152203088,VNJM01001509.1,1,1465,9.6253e-06,151685560,0.9966
D.kanapiae,152203088,VNJM01001137.1,1,1465,9.6253e-06,151687025,0.996609
D.kanapiae,152203088,VNJM01003151.1,1,1463,9.61216e-06,151688488,0.996619
D.kanapiae,152203088,VNJM01002168.1,1,1461,9.59902e-06,151689949,0.996629
D.kanapiae,152203088,VNJM01000252.1,1,1459,9.58588e-06,151691408,0.996638
D.kanapiae,152203088,VNJM01002982.1,1,1458,9.57931e-06,151692866,0.996648
D.kanapiae,152203088,VNJM01001576.1,1,1458,9.57931e-06,151694324,0.996657
D.kanapiae,152203088,VNJM01002432.1,1,1457,9.57274e-06,151695781,0.996667
D.kanapiae,152203088,VNJM01001621.1,1,1457,9.57274e-06,151697238,0.996676
D.kanapiae,152203088,VNJM01000959.1,1,1456,9.56617e-06,151698694,0.996686
D.kanapiae,152203088,VNJM01003231.1,1,1455,9.5596e-06,151700149,0.996696
D.kanapiae,152203088,VNJM01002308.1,1,1455,9.5596e-06,151701604,0.996705
D.kanapiae,152203088,VNJM01000144.1,1,1454,9.55303e-06,151703058,0.996715
D.kanapiae,152203088,VNJM01001936.1,1,1453,9.54646e-06,151704511,0.996724
D.kanapiae,152203088,VNJM01002666.1,1,1452,9.53989e-06,151705963,0.996734
D.kanapiae,152203088,VNJM01000527.1,1,1452,9.53989e-06,151707415,0.996743
D.kanapiae,152203088,VNJM01002770.1,1,1451,9.53332e-06,151708866,0.996753
D.kanapiae,152203088,VNJM01000874.1,1,1451,9.53332e-06,151710317,0.996762
D.kanapiae,152203088,VNJM01000607.1,1,1451,9.53332e-06,151711768,0.996772
D.kanapiae,152203088,VNJM01001128.1,1,1448,9.5136e-06,151713216,0.996781
D.kanapiae,152203088,VNJM01000840.1,1,1448,9.5136e-06,151714664,0.996791
D.kanapiae,152203088,VNJM01000367.1,1,1448,9.5136e-06,151716112,0.9968
D.kanapiae,152203088,VNJM01003561.1,1,1443,9.48075e-06,151717555,0.99681
D.kanapiae,152203088,VNJM01002933.1,1,1443,9.48075e-06,151718998,0.996819
D.kanapiae,152203088,VNJM01001715.1,1,1443,9.48075e-06,151720441,0.996829
D.kanapiae,152203088,VNJM01002228.1,1,1441,9.46761e-06,151721882,0.996838
D.kanapiae,152203088,VNJM01000504.1,1,1438,9.4479e-06,151723320,0.996848
D.kanapiae,152203088,VNJM01001408.1,1,1437,9.44133e-06,151724757,0.996857
D.kanapiae,152203088,VNJM01002525.1,1,1432,9.40848e-06,151726189,0.996867
D.kanapiae,152203088,VNJM01002724.1,1,1430,9.39534e-06,151727619,0.996876
D.kanapiae,152203088,VNJM01000079.1,1,1430,9.39534e-06,151729049,0.996885
D.kanapiae,152203088,VNJM01000049.1,1,1430,9.39534e-06,151730479,0.996895
D.kanapiae,152203088,VNJM01003072.1,1,1429,9.38877e-06,151731908,0.996904
D.kanapiae,152203088,VNJM01000612.1,1,1428,9.3822e-06,151733336,0.996914
D.kanapiae,152203088,VNJM01003502.1,1,1423,9.34935e-06,151734759,0.996923
D.kanapiae,152203088,VNJM01000438.1,1,1419,9.32307e-06,151736178,0.996932
D.kanapiae,152203088,VNJM01000932.1,1,1418,9.3165e-06,151737596,0.996942
D.kanapiae,152203088,VNJM01000609.1,1,1418,9.3165e-06,151739014,0.996951
D.kanapiae,152203088,VNJM01003494.1,1,1417,9.30993e-06,151740431,0.99696
D.kanapiae,152203088,VNJM01000866.1,1,1417,9.30993e-06,151741848,0.99697
D.kanapiae,152203088,VNJM01002760.1,1,1415,9.29679e-06,151743263,0.996979
D.kanapiae,152203088,VNJM01003105.1,1,1414,9.29022e-06,151744677,0.996988
D.kanapiae,152203088,VNJM01000889.1,1,1414,9.29022e-06,151746091,0.996997
D.kanapiae,152203088,VNJM01000201.1,1,1414,9.29022e-06,151747505,0.997007
D.kanapiae,152203088,VNJM01003417.1,1,1413,9.28365e-06,151748918,0.997016
D.kanapiae,152203088,VNJM01000693.1,1,1411,9.27051e-06,151750329,0.997025
D.kanapiae,152203088,VNJM01003248.1,1,1410,9.26394e-06,151751739,0.997035
D.kanapiae,152203088,VNJM01002771.1,1,1406,9.23766e-06,151753145,0.997044
D.kanapiae,152203088,VNJM01001916.1,1,1406,9.23766e-06,151754551,0.997053
D.kanapiae,152203088,VNJM01001244.1,1,1405,9.23109e-06,151755956,0.997062
D.kanapiae,152203088,VNJM01001993.1,1,1404,9.22452e-06,151757360,0.997071
D.kanapiae,152203088,VNJM01001994.1,1,1402,9.21138e-06,151758762,0.997081
D.kanapiae,152203088,VNJM01002969.1,1,1399,9.19167e-06,151760161,0.99709
D.kanapiae,152203088,VNJM01003351.1,1,1398,9.1851e-06,151761559,0.997099
D.kanapiae,152203088,VNJM01001139.1,1,1397,9.17853e-06,151762956,0.997108
D.kanapiae,152203088,VNJM01000848.1,1,1396,9.17196e-06,151764352,0.997117
D.kanapiae,152203088,VNJM01001843.1,1,1394,9.15882e-06,151765746,0.997127
D.kanapiae,152203088,VNJM01000575.1,1,1394,9.15882e-06,151767140,0.997136
D.kanapiae,152203088,VNJM01003078.1,1,1392,9.14568e-06,151768532,0.997145
D.kanapiae,152203088,VNJM01001412.1,1,1392,9.14568e-06,151769924,0.997154
D.kanapiae,152203088,VNJM01001091.1,1,1392,9.14568e-06,151771316,0.997163
D.kanapiae,152203088,VNJM01000258.1,1,1391,9.1391e-06,151772707,0.997172
D.kanapiae,152203088,VNJM01003245.1,1,1390,9.13253e-06,151774097,0.997181
D.kanapiae,152203088,VNJM01003017.1,1,1390,9.13253e-06,151775487,0.997191
D.kanapiae,152203088,VNJM01001783.1,1,1389,9.12596e-06,151776876,0.9972
D.kanapiae,152203088,VNJM01001494.1,1,1389,9.12596e-06,151778265,0.997209
D.kanapiae,152203088,VNJM01000018.1,1,1389,9.12596e-06,151779654,0.997218
D.kanapiae,152203088,VNJM01001801.1,1,1387,9.11282e-06,151781041,0.997227
D.kanapiae,152203088,VNJM01003224.1,1,1386,9.10625e-06,151782427,0.997236
D.kanapiae,152203088,VNJM01002983.1,1,1385,9.09968e-06,151783812,0.997245
D.kanapiae,152203088,VNJM01003230.1,1,1384,9.09311e-06,151785196,0.997254
D.kanapiae,152203088,VNJM01000102.1,1,1383,9.08654e-06,151786579,0.997263
D.kanapiae,152203088,VNJM01003233.1,1,1380,9.06683e-06,151787959,0.997273
D.kanapiae,152203088,VNJM01001908.1,1,1380,9.06683e-06,151789339,0.997282
D.kanapiae,152203088,VNJM01000602.1,1,1380,9.06683e-06,151790719,0.997291
D.kanapiae,152203088,VNJM01003443.1,1,1378,9.05369e-06,151792097,0.9973
D.kanapiae,152203088,VNJM01002723.1,1,1378,9.05369e-06,151793475,0.997309
D.kanapiae,152203088,VNJM01001997.1,1,1378,9.05369e-06,151794853,0.997318
D.kanapiae,152203088,VNJM01001465.1,1,1377,9.04712e-06,151796230,0.997327
D.kanapiae,152203088,VNJM01003509.1,1,1373,9.02084e-06,151797603,0.997336
D.kanapiae,152203088,VNJM01002674.1,1,1373,9.02084e-06,151798976,0.997345
D.kanapiae,152203088,VNJM01001869.1,1,1372,9.01427e-06,151800348,0.997354
D.kanapiae,152203088,VNJM01000591.1,1,1371,9.0077e-06,151801719,0.997363
D.kanapiae,152203088,VNJM01002590.1,1,1367,8.98142e-06,151803086,0.997372
D.kanapiae,152203088,VNJM01003152.1,1,1363,8.95514e-06,151804449,0.997381
D.kanapiae,152203088,VNJM01003174.1,1,1361,8.942e-06,151805810,0.99739
D.kanapiae,152203088,VNJM01001652.1,1,1361,8.942e-06,151807171,0.997399
D.kanapiae,152203088,VNJM01002251.1,1,1360,8.93543e-06,151808531,0.997408
D.kanapiae,152203088,VNJM01002259.1,1,1359,8.92886e-06,151809890,0.997417
D.kanapiae,152203088,VNJM01001928.1,1,1359,8.92886e-06,151811249,0.997426
D.kanapiae,152203088,VNJM01002681.1,1,1358,8.92229e-06,151812607,0.997434
D.kanapiae,152203088,VNJM01001431.1,1,1357,8.91572e-06,151813964,0.997443
D.kanapiae,152203088,VNJM01001686.1,1,1356,8.90915e-06,151815320,0.997452
D.kanapiae,152203088,VNJM01003182.1,1,1354,8.89601e-06,151816674,0.997461
D.kanapiae,152203088,VNJM01001270.1,1,1354,8.89601e-06,151818028,0.99747
D.kanapiae,152203088,VNJM01001940.1,1,1353,8.88944e-06,151819381,0.997479
D.kanapiae,152203088,VNJM01001734.1,1,1353,8.88944e-06,151820734,0.997488
D.kanapiae,152203088,VNJM01003253.1,1,1352,8.88287e-06,151822086,0.997497
D.kanapiae,152203088,VNJM01003146.1,1,1352,8.88287e-06,151823438,0.997506
D.kanapiae,152203088,VNJM01002195.1,1,1347,8.85002e-06,151824785,0.997514
D.kanapiae,152203088,VNJM01002844.1,1,1346,8.84345e-06,151826131,0.997523
D.kanapiae,152203088,VNJM01001250.1,1,1346,8.84345e-06,151827477,0.997532
D.kanapiae,152203088,VNJM01000204.1,1,1345,8.83688e-06,151828822,0.997541
D.kanapiae,152203088,VNJM01000818.1,1,1342,8.81717e-06,151830164,0.99755
D.kanapiae,152203088,VNJM01000382.1,1,1341,8.8106e-06,151831505,0.997559
D.kanapiae,152203088,VNJM01003227.1,1,1335,8.77118e-06,151832840,0.997567
D.kanapiae,152203088,VNJM01000888.1,1,1335,8.77118e-06,151834175,0.997576
D.kanapiae,152203088,VNJM01002935.1,1,1334,8.76461e-06,151835509,0.997585
D.kanapiae,152203088,VNJM01002738.1,1,1334,8.76461e-06,151836843,0.997594
D.kanapiae,152203088,VNJM01001380.1,1,1334,8.76461e-06,151838177,0.997602
D.kanapiae,152203088,VNJM01000391.1,1,1334,8.76461e-06,151839511,0.997611
D.kanapiae,152203088,VNJM01001246.1,1,1333,8.75804e-06,151840844,0.99762
D.kanapiae,152203088,VNJM01002025.1,1,1332,8.75147e-06,151842176,0.997629
D.kanapiae,152203088,VNJM01002970.1,1,1330,8.73832e-06,151843506,0.997637
D.kanapiae,152203088,VNJM01003232.1,1,1329,8.73175e-06,151844835,0.997646
D.kanapiae,152203088,VNJM01000086.1,1,1328,8.72518e-06,151846163,0.997655
D.kanapiae,152203088,VNJM01003207.1,1,1326,8.71204e-06,151847489,0.997664
D.kanapiae,152203088,VNJM01002379.1,1,1326,8.71204e-06,151848815,0.997672
D.kanapiae,152203088,VNJM01002990.1,1,1325,8.70547e-06,151850140,0.997681
D.kanapiae,152203088,VNJM01001920.1,1,1325,8.70547e-06,151851465,0.99769
D.kanapiae,152203088,VNJM01000105.1,1,1325,8.70547e-06,151852790,0.997698
D.kanapiae,152203088,VNJM01000927.1,1,1324,8.6989e-06,151854114,0.997707
D.kanapiae,152203088,VNJM01000992.1,1,1321,8.67919e-06,151855435,0.997716
D.kanapiae,152203088,VNJM01002278.1,1,1320,8.67262e-06,151856755,0.997725
D.kanapiae,152203088,VNJM01001280.1,1,1320,8.67262e-06,151858075,0.997733
D.kanapiae,152203088,VNJM01000146.1,1,1317,8.65291e-06,151859392,0.997742
D.kanapiae,152203088,VNJM01001240.1,1,1316,8.64634e-06,151860708,0.997751
D.kanapiae,152203088,VNJM01000937.1,1,1315,8.63977e-06,151862023,0.997759
D.kanapiae,152203088,VNJM01000947.1,1,1314,8.6332e-06,151863337,0.997768
D.kanapiae,152203088,VNJM01000580.1,1,1311,8.61349e-06,151864648,0.997776
D.kanapiae,152203088,VNJM01001261.1,1,1310,8.60692e-06,151865958,0.997785
D.kanapiae,152203088,VNJM01001773.1,1,1309,8.60035e-06,151867267,0.997794
D.kanapiae,152203088,VNJM01001568.1,1,1308,8.59378e-06,151868575,0.997802
D.kanapiae,152203088,VNJM01002946.1,1,1307,8.58721e-06,151869882,0.997811
D.kanapiae,152203088,VNJM01001907.1,1,1307,8.58721e-06,151871189,0.997819
D.kanapiae,152203088,VNJM01002645.1,1,1305,8.57407e-06,151872494,0.997828
D.kanapiae,152203088,VNJM01000520.1,1,1305,8.57407e-06,151873799,0.997837
D.kanapiae,152203088,VNJM01000973.1,1,1304,8.5675e-06,151875103,0.997845
D.kanapiae,152203088,VNJM01002426.1,1,1299,8.53465e-06,151876402,0.997854
D.kanapiae,152203088,VNJM01000672.1,1,1297,8.52151e-06,151877699,0.997862
D.kanapiae,152203088,VNJM01003487.1,1,1295,8.50837e-06,151878994,0.997871
D.kanapiae,152203088,VNJM01002394.1,1,1294,8.5018e-06,151880288,0.997879
D.kanapiae,152203088,VNJM01000923.1,1,1294,8.5018e-06,151881582,0.997888
D.kanapiae,152203088,VNJM01000213.1,1,1292,8.48866e-06,151882874,0.997896
D.kanapiae,152203088,VNJM01002989.1,1,1291,8.48209e-06,151884165,0.997905
D.kanapiae,152203088,VNJM01002306.1,1,1291,8.48209e-06,151885456,0.997913
D.kanapiae,152203088,VNJM01000196.1,1,1291,8.48209e-06,151886747,0.997922
D.kanapiae,152203088,VNJM01003319.1,1,1289,8.46895e-06,151888036,0.99793
D.kanapiae,152203088,VNJM01001101.1,1,1289,8.46895e-06,151889325,0.997939
D.kanapiae,152203088,VNJM01000913.1,1,1288,8.46238e-06,151890613,0.997947
D.kanapiae,152203088,VNJM01002927.1,1,1287,8.45581e-06,151891900,0.997955
D.kanapiae,152203088,VNJM01002907.1,1,1287,8.45581e-06,151893187,0.997964
D.kanapiae,152203088,VNJM01003308.1,1,1284,8.4361e-06,151894471,0.997972
D.kanapiae,152203088,VNJM01001360.1,1,1284,8.4361e-06,151895755,0.997981
D.kanapiae,152203088,VNJM01000197.1,1,1284,8.4361e-06,151897039,0.997989
D.kanapiae,152203088,VNJM01003404.1,1,1281,8.41639e-06,151898320,0.997998
D.kanapiae,152203088,VNJM01002754.1,1,1281,8.41639e-06,151899601,0.998006
D.kanapiae,152203088,VNJM01002460.1,1,1280,8.40982e-06,151900881,0.998014
D.kanapiae,152203088,VNJM01001912.1,1,1280,8.40982e-06,151902161,0.998023
D.kanapiae,152203088,VNJM01001586.1,1,1280,8.40982e-06,151903441,0.998031
D.kanapiae,152203088,VNJM01003165.1,1,1279,8.40325e-06,151904720,0.99804
D.kanapiae,152203088,VNJM01002166.1,1,1279,8.40325e-06,151905999,0.998048
D.kanapiae,152203088,VNJM01000633.1,1,1278,8.39668e-06,151907277,0.998056
D.kanapiae,152203088,VNJM01003577.1,1,1277,8.39011e-06,151908554,0.998065
D.kanapiae,152203088,VNJM01000440.1,1,1277,8.39011e-06,151909831,0.998073
D.kanapiae,152203088,VNJM01000316.1,1,1277,8.39011e-06,151911108,0.998082
D.kanapiae,152203088,VNJM01000043.1,1,1275,8.37697e-06,151912383,0.99809
D.kanapiae,152203088,VNJM01003000.1,1,1273,8.36383e-06,151913656,0.998098
D.kanapiae,152203088,VNJM01001893.1,1,1272,8.35725e-06,151914928,0.998107
D.kanapiae,152203088,VNJM01000493.1,1,1272,8.35725e-06,151916200,0.998115
D.kanapiae,152203088,VNJM01000451.1,1,1272,8.35725e-06,151917472,0.998123
D.kanapiae,152203088,VNJM01000448.1,1,1267,8.3244e-06,151918739,0.998132
D.kanapiae,152203088,VNJM01000173.1,1,1265,8.31126e-06,151920004,0.99814
D.kanapiae,152203088,VNJM01002863.1,1,1264,8.30469e-06,151921268,0.998148
D.kanapiae,152203088,VNJM01000215.1,1,1263,8.29812e-06,151922531,0.998157
D.kanapiae,152203088,VNJM01001962.1,1,1262,8.29155e-06,151923793,0.998165
D.kanapiae,152203088,VNJM01002422.1,1,1260,8.27841e-06,151925053,0.998173
D.kanapiae,152203088,VNJM01002608.1,1,1259,8.27184e-06,151926312,0.998182
D.kanapiae,152203088,VNJM01001181.1,1,1255,8.24556e-06,151927567,0.99819
D.kanapiae,152203088,VNJM01002529.1,1,1254,8.23899e-06,151928821,0.998198
D.kanapiae,152203088,VNJM01002993.1,1,1251,8.21928e-06,151930072,0.998206
D.kanapiae,152203088,VNJM01001227.1,1,1250,8.21271e-06,151931322,0.998214
D.kanapiae,152203088,VNJM01002854.1,1,1248,8.19957e-06,151932570,0.998223
D.kanapiae,152203088,VNJM01002791.1,1,1248,8.19957e-06,151933818,0.998231
D.kanapiae,152203088,VNJM01002739.1,1,1248,8.19957e-06,151935066,0.998239
D.kanapiae,152203088,VNJM01000823.1,1,1248,8.19957e-06,151936314,0.998247
D.kanapiae,152203088,VNJM01001152.1,1,1244,8.17329e-06,151937558,0.998255
D.kanapiae,152203088,VNJM01002171.1,1,1243,8.16672e-06,151938801,0.998264
D.kanapiae,152203088,VNJM01002382.1,1,1239,8.14044e-06,151940040,0.998272
D.kanapiae,152203088,VNJM01001237.1,1,1239,8.14044e-06,151941279,0.99828
D.kanapiae,152203088,VNJM01003251.1,1,1238,8.13387e-06,151942517,0.998288
D.kanapiae,152203088,VNJM01003453.1,1,1237,8.1273e-06,151943754,0.998296
D.kanapiae,152203088,VNJM01003128.1,1,1236,8.12073e-06,151944990,0.998304
D.kanapiae,152203088,VNJM01001543.1,1,1235,8.11416e-06,151946225,0.998312
D.kanapiae,152203088,VNJM01003316.1,1,1229,8.07474e-06,151947454,0.99832
D.kanapiae,152203088,VNJM01002737.1,1,1229,8.07474e-06,151948683,0.998329
D.kanapiae,152203088,VNJM01000409.1,1,1226,8.05503e-06,151949909,0.998337
D.kanapiae,152203088,VNJM01002377.1,1,1224,8.04189e-06,151951133,0.998345
D.kanapiae,152203088,VNJM01001918.1,1,1223,8.03532e-06,151952356,0.998353
D.kanapiae,152203088,VNJM01000857.1,1,1221,8.02218e-06,151953577,0.998361
D.kanapiae,152203088,VNJM01000058.1,1,1221,8.02218e-06,151954798,0.998369
D.kanapiae,152203088,VNJM01001674.1,1,1220,8.01561e-06,151956018,0.998377
D.kanapiae,152203088,VNJM01001225.1,1,1219,8.00904e-06,151957237,0.998385
D.kanapiae,152203088,VNJM01002987.1,1,1217,7.9959e-06,151958454,0.998393
D.kanapiae,152203088,VNJM01001818.1,1,1217,7.9959e-06,151959671,0.998401
D.kanapiae,152203088,VNJM01002632.1,1,1215,7.98276e-06,151960886,0.998409
D.kanapiae,152203088,VNJM01000198.1,1,1215,7.98276e-06,151962101,0.998417
D.kanapiae,152203088,VNJM01003623.1,1,1212,7.96304e-06,151963313,0.998425
D.kanapiae,152203088,VNJM01001636.1,1,1212,7.96304e-06,151964525,0.998433
D.kanapiae,152203088,VNJM01002589.1,1,1211,7.95647e-06,151965736,0.998441
D.kanapiae,152203088,VNJM01001361.1,1,1211,7.95647e-06,151966947,0.998449
D.kanapiae,152203088,VNJM01003166.1,1,1210,7.9499e-06,151968157,0.998456
D.kanapiae,152203088,VNJM01000199.1,1,1210,7.9499e-06,151969367,0.998464
D.kanapiae,152203088,VNJM01000042.1,1,1209,7.94333e-06,151970576,0.998472
D.kanapiae,152203088,VNJM01001845.1,1,1208,7.93676e-06,151971784,0.99848
D.kanapiae,152203088,VNJM01002689.1,1,1206,7.92362e-06,151972990,0.998488
D.kanapiae,152203088,VNJM01002473.1,1,1201,7.89077e-06,151974191,0.998496
D.kanapiae,152203088,VNJM01000592.1,1,1201,7.89077e-06,151975392,0.998504
D.kanapiae,152203088,VNJM01001733.1,1,1200,7.8842e-06,151976592,0.998512
D.kanapiae,152203088,VNJM01000634.1,1,1200,7.8842e-06,151977792,0.99852
D.kanapiae,152203088,VNJM01000214.1,1,1200,7.8842e-06,151978992,0.998528
D.kanapiae,152203088,VNJM01001655.1,1,1199,7.87763e-06,151980191,0.998536
D.kanapiae,152203088,VNJM01000433.1,1,1199,7.87763e-06,151981390,0.998543
D.kanapiae,152203088,VNJM01001088.1,1,1198,7.87106e-06,151982588,0.998551
D.kanapiae,152203088,VNJM01000911.1,1,1196,7.85792e-06,151983784,0.998559
D.kanapiae,152203088,VNJM01000655.1,1,1196,7.85792e-06,151984980,0.998567
D.kanapiae,152203088,VNJM01003027.1,1,1194,7.84478e-06,151986174,0.998575
D.kanapiae,152203088,VNJM01002871.1,1,1194,7.84478e-06,151987368,0.998583
D.kanapiae,152203088,VNJM01003604.1,1,1190,7.8185e-06,151988558,0.998591
D.kanapiae,152203088,VNJM01002869.1,1,1189,7.81193e-06,151989747,0.998598
D.kanapiae,152203088,VNJM01000782.1,1,1189,7.81193e-06,151990936,0.998606
D.kanapiae,152203088,VNJM01001310.1,1,1187,7.79879e-06,151992123,0.998614
D.kanapiae,152203088,VNJM01001594.1,1,1185,7.78565e-06,151993308,0.998622
D.kanapiae,152203088,VNJM01001420.1,1,1183,7.77251e-06,151994491,0.998629
D.kanapiae,152203088,VNJM01000444.1,1,1183,7.77251e-06,151995674,0.998637
D.kanapiae,152203088,VNJM01000191.1,1,1183,7.77251e-06,151996857,0.998645
D.kanapiae,152203088,VNJM01001696.1,1,1182,7.76594e-06,151998039,0.998653
D.kanapiae,152203088,VNJM01001565.1,1,1181,7.75937e-06,151999220,0.998661
D.kanapiae,152203088,VNJM01001382.1,1,1181,7.75937e-06,152000401,0.998668
D.kanapiae,152203088,VNJM01000466.1,1,1180,7.7528e-06,152001581,0.998676
D.kanapiae,152203088,VNJM01002433.1,1,1179,7.74623e-06,152002760,0.998684
D.kanapiae,152203088,VNJM01002118.1,1,1178,7.73966e-06,152003938,0.998692
D.kanapiae,152203088,VNJM01002906.1,1,1177,7.73309e-06,152005115,0.998699
D.kanapiae,152203088,VNJM01000718.1,1,1177,7.73309e-06,152006292,0.998707
D.kanapiae,152203088,VNJM01000714.1,1,1176,7.72652e-06,152007468,0.998715
D.kanapiae,152203088,VNJM01002218.1,1,1173,7.70681e-06,152008641,0.998722
D.kanapiae,152203088,VNJM01000193.1,1,1173,7.70681e-06,152009814,0.99873
D.kanapiae,152203088,VNJM01000779.1,1,1172,7.70024e-06,152010986,0.998738
D.kanapiae,152203088,VNJM01001763.1,1,1169,7.68053e-06,152012155,0.998746
D.kanapiae,152203088,VNJM01000960.1,1,1169,7.68053e-06,152013324,0.998753
D.kanapiae,152203088,VNJM01002715.1,1,1168,7.67396e-06,152014492,0.998761
D.kanapiae,152203088,VNJM01001179.1,1,1167,7.66739e-06,152015659,0.998769
D.kanapiae,152203088,VNJM01000262.1,1,1162,7.63454e-06,152016821,0.998776
D.kanapiae,152203088,VNJM01001503.1,1,1161,7.62797e-06,152017982,0.998784
D.kanapiae,152203088,VNJM01003167.1,1,1160,7.6214e-06,152019142,0.998791
D.kanapiae,152203088,VNJM01002523.1,1,1158,7.60826e-06,152020300,0.998799
D.kanapiae,152203088,VNJM01001873.1,1,1157,7.60169e-06,152021457,0.998807
D.kanapiae,152203088,VNJM01000910.1,1,1157,7.60169e-06,152022614,0.998814
D.kanapiae,152203088,VNJM01000335.1,1,1157,7.60169e-06,152023771,0.998822
D.kanapiae,152203088,VNJM01002931.1,1,1155,7.58855e-06,152024926,0.998829
D.kanapiae,152203088,VNJM01003432.1,1,1152,7.56883e-06,152026078,0.998837
D.kanapiae,152203088,VNJM01000841.1,1,1150,7.55569e-06,152027228,0.998845
D.kanapiae,152203088,VNJM01000596.1,1,1150,7.55569e-06,152028378,0.998852
D.kanapiae,152203088,VNJM01000600.1,1,1149,7.54912e-06,152029527,0.99886
D.kanapiae,152203088,VNJM01003249.1,1,1147,7.53598e-06,152030674,0.998867
D.kanapiae,152203088,VNJM01003138.1,1,1147,7.53598e-06,152031821,0.998875
D.kanapiae,152203088,VNJM01001771.1,1,1147,7.53598e-06,152032968,0.998882
D.kanapiae,152203088,VNJM01000957.1,1,1147,7.53598e-06,152034115,0.99889
D.kanapiae,152203088,VNJM01003496.1,1,1145,7.52284e-06,152035260,0.998897
D.kanapiae,152203088,VNJM01003501.1,1,1144,7.51627e-06,152036404,0.998905
D.kanapiae,152203088,VNJM01002713.1,1,1144,7.51627e-06,152037548,0.998912
D.kanapiae,152203088,VNJM01001527.1,1,1144,7.51627e-06,152038692,0.99892
D.kanapiae,152203088,VNJM01001362.1,1,1142,7.50313e-06,152039834,0.998927
D.kanapiae,152203088,VNJM01002203.1,1,1140,7.48999e-06,152040974,0.998935
D.kanapiae,152203088,VNJM01001890.1,1,1140,7.48999e-06,152042114,0.998942
D.kanapiae,152203088,VNJM01001070.1,1,1140,7.48999e-06,152043254,0.99895
D.kanapiae,152203088,VNJM01001492.1,1,1139,7.48342e-06,152044393,0.998957
D.kanapiae,152203088,VNJM01003109.1,1,1136,7.46371e-06,152045529,0.998965
D.kanapiae,152203088,VNJM01001472.1,1,1136,7.46371e-06,152046665,0.998972
D.kanapiae,152203088,VNJM01000386.1,1,1136,7.46371e-06,152047801,0.99898
D.kanapiae,152203088,VNJM01003346.1,1,1135,7.45714e-06,152048936,0.998987
D.kanapiae,152203088,VNJM01001146.1,1,1135,7.45714e-06,152050071,0.998995
D.kanapiae,152203088,VNJM01000915.1,1,1135,7.45714e-06,152051206,0.999002
D.kanapiae,152203088,VNJM01001791.1,1,1131,7.43086e-06,152052337,0.99901
D.kanapiae,152203088,VNJM01001427.1,1,1131,7.43086e-06,152053468,0.999017
D.kanapiae,152203088,VNJM01000774.1,1,1130,7.42429e-06,152054598,0.999024
D.kanapiae,152203088,VNJM01000579.1,1,1130,7.42429e-06,152055728,0.999032
D.kanapiae,152203088,VNJM01003456.1,1,1129,7.41772e-06,152056857,0.999039
D.kanapiae,152203088,VNJM01003159.1,1,1129,7.41772e-06,152057986,0.999047
D.kanapiae,152203088,VNJM01000550.1,1,1129,7.41772e-06,152059115,0.999054
D.kanapiae,152203088,VNJM01002482.1,1,1128,7.41115e-06,152060243,0.999061
D.kanapiae,152203088,VNJM01002429.1,1,1128,7.41115e-06,152061371,0.999069
D.kanapiae,152203088,VNJM01002390.1,1,1128,7.41115e-06,152062499,0.999076
D.kanapiae,152203088,VNJM01000462.1,1,1128,7.41115e-06,152063627,0.999084
D.kanapiae,152203088,VNJM01000139.1,1,1128,7.41115e-06,152064755,0.999091
D.kanapiae,152203088,VNJM01000912.1,1,1127,7.40458e-06,152065882,0.999099
D.kanapiae,152203088,VNJM01003437.1,1,1125,7.39144e-06,152067007,0.999106
D.kanapiae,152203088,VNJM01001658.1,1,1125,7.39144e-06,152068132,0.999113
D.kanapiae,152203088,VNJM01001669.1,1,1124,7.38487e-06,152069256,0.999121
D.kanapiae,152203088,VNJM01000461.1,1,1123,7.3783e-06,152070379,0.999128
D.kanapiae,152203088,VNJM01000325.1,1,1123,7.3783e-06,152071502,0.999135
D.kanapiae,152203088,VNJM01002742.1,1,1121,7.36516e-06,152072623,0.999143
D.kanapiae,152203088,VNJM01001073.1,1,1120,7.35859e-06,152073743,0.99915
D.kanapiae,152203088,VNJM01003160.1,1,1119,7.35202e-06,152074862,0.999158
D.kanapiae,152203088,VNJM01000123.1,1,1119,7.35202e-06,152075981,0.999165
D.kanapiae,152203088,VNJM01002411.1,1,1118,7.34545e-06,152077099,0.999172
D.kanapiae,152203088,VNJM01000397.1,1,1118,7.34545e-06,152078217,0.99918
D.kanapiae,152203088,VNJM01000126.1,1,1118,7.34545e-06,152079335,0.999187
D.kanapiae,152203088,VNJM01003409.1,1,1116,7.33231e-06,152080451,0.999194
D.kanapiae,152203088,VNJM01003069.1,1,1116,7.33231e-06,152081567,0.999202
D.kanapiae,152203088,VNJM01000576.1,1,1115,7.32574e-06,152082682,0.999209
D.kanapiae,152203088,VNJM01002874.1,1,1114,7.31917e-06,152083796,0.999216
D.kanapiae,152203088,VNJM01001369.1,1,1109,7.28632e-06,152084905,0.999224
D.kanapiae,152203088,VNJM01001142.1,1,1109,7.28632e-06,152086014,0.999231
D.kanapiae,152203088,VNJM01000014.1,1,1107,7.27318e-06,152087121,0.999238
D.kanapiae,152203088,VNJM01002256.1,1,1106,7.26661e-06,152088227,0.999245
D.kanapiae,152203088,VNJM01000601.1,1,1105,7.26004e-06,152089332,0.999253
D.kanapiae,152203088,VNJM01003491.1,1,1103,7.2469e-06,152090435,0.99926
D.kanapiae,152203088,VNJM01001949.1,1,1103,7.2469e-06,152091538,0.999267
D.kanapiae,152203088,VNJM01000926.1,1,1103,7.2469e-06,152092641,0.999274
D.kanapiae,152203088,VNJM01000711.1,1,1100,7.22719e-06,152093741,0.999282
D.kanapiae,152203088,VNJM01002481.1,1,1098,7.21405e-06,152094839,0.999289
D.kanapiae,152203088,VNJM01001411.1,1,1098,7.21405e-06,152095937,0.999296
D.kanapiae,152203088,VNJM01003591.1,1,1097,7.20748e-06,152097034,0.999303
D.kanapiae,152203088,VNJM01003415.1,1,1097,7.20748e-06,152098131,0.99931
D.kanapiae,152203088,VNJM01001239.1,1,1097,7.20748e-06,152099228,0.999318
D.kanapiae,152203088,VNJM01002396.1,1,1096,7.20091e-06,152100324,0.999325
D.kanapiae,152203088,VNJM01000460.1,1,1096,7.20091e-06,152101420,0.999332
D.kanapiae,152203088,VNJM01001452.1,1,1095,7.19433e-06,152102515,0.999339
D.kanapiae,152203088,VNJM01000459.1,1,1095,7.19433e-06,152103610,0.999346
D.kanapiae,152203088,VNJM01000458.1,1,1095,7.19433e-06,152104705,0.999354
D.kanapiae,152203088,VNJM01003268.1,1,1094,7.18776e-06,152105799,0.999361
D.kanapiae,152203088,VNJM01000692.1,1,1094,7.18776e-06,152106893,0.999368
D.kanapiae,152203088,VNJM01002994.1,1,1093,7.18119e-06,152107986,0.999375
D.kanapiae,152203088,VNJM01002291.1,1,1092,7.17462e-06,152109078,0.999382
D.kanapiae,152203088,VNJM01000457.1,1,1092,7.17462e-06,152110170,0.99939
D.kanapiae,152203088,VNJM01000318.1,1,1090,7.16148e-06,152111260,0.999397
D.kanapiae,152203088,VNJM01003493.1,1,1089,7.15491e-06,152112349,0.999404
D.kanapiae,152203088,VNJM01000844.1,1,1089,7.15491e-06,152113438,0.999411
D.kanapiae,152203088,VNJM01000267.1,1,1088,7.14834e-06,152114526,0.999418
D.kanapiae,152203088,VNJM01002518.1,1,1087,7.14177e-06,152115613,0.999425
D.kanapiae,152203088,VNJM01002095.1,1,1087,7.14177e-06,152116700,0.999432
D.kanapiae,152203088,VNJM01002628.1,1,1086,7.1352e-06,152117786,0.99944
D.kanapiae,152203088,VNJM01000074.1,1,1084,7.12206e-06,152118870,0.999447
D.kanapiae,152203088,VNJM01002212.1,1,1083,7.11549e-06,152119953,0.999454
D.kanapiae,152203088,VNJM01000125.1,1,1081,7.10235e-06,152121034,0.999461
D.kanapiae,152203088,VNJM01002296.1,1,1080,7.09578e-06,152122114,0.999468
D.kanapiae,152203088,VNJM01001646.1,1,1080,7.09578e-06,152123194,0.999475
D.kanapiae,152203088,VNJM01000097.1,1,1080,7.09578e-06,152124274,0.999482
D.kanapiae,152203088,VNJM01001347.1,1,1078,7.08264e-06,152125352,0.999489
D.kanapiae,152203088,VNJM01001207.1,1,1078,7.08264e-06,152126430,0.999496
D.kanapiae,152203088,VNJM01001561.1,1,1074,7.05636e-06,152127504,0.999503
D.kanapiae,152203088,VNJM01000346.1,1,1074,7.05636e-06,152128578,0.99951
D.kanapiae,152203088,VNJM01002485.1,1,1073,7.04979e-06,152129651,0.999518
D.kanapiae,152203088,VNJM01000986.1,1,1070,7.03008e-06,152130721,0.999525
D.kanapiae,152203088,VNJM01002781.1,1,1068,7.01694e-06,152131789,0.999532
D.kanapiae,152203088,VNJM01001913.1,1,1068,7.01694e-06,152132857,0.999539
D.kanapiae,152203088,VNJM01000934.1,1,1068,7.01694e-06,152133925,0.999546
D.kanapiae,152203088,VNJM01000717.1,1,1068,7.01694e-06,152134993,0.999553
D.kanapiae,152203088,VNJM01001844.1,1,1063,6.98409e-06,152136056,0.99956
D.kanapiae,152203088,VNJM01003510.1,1,1062,6.97752e-06,152137118,0.999567
D.kanapiae,152203088,VNJM01003252.1,1,1062,6.97752e-06,152138180,0.999574
D.kanapiae,152203088,VNJM01001377.1,1,1061,6.97095e-06,152139241,0.999581
D.kanapiae,152203088,VNJM01001888.1,1,1060,6.96438e-06,152140301,0.999587
D.kanapiae,152203088,VNJM01001946.1,1,1059,6.95781e-06,152141360,0.999594
D.kanapiae,152203088,VNJM01000456.1,1,1059,6.95781e-06,152142419,0.999601
D.kanapiae,152203088,VNJM01002161.1,1,1058,6.95124e-06,152143477,0.999608
D.kanapiae,152203088,VNJM01000502.1,1,1056,6.9381e-06,152144533,0.999615
D.kanapiae,152203088,VNJM01002655.1,1,1054,6.92496e-06,152145587,0.999622
D.kanapiae,152203088,VNJM01002612.1,1,1054,6.92496e-06,152146641,0.999629
D.kanapiae,152203088,VNJM01001135.1,1,1053,6.91839e-06,152147694,0.999636
D.kanapiae,152203088,VNJM01001193.1,1,1049,6.89211e-06,152148743,0.999643
D.kanapiae,152203088,VNJM01001015.1,1,1048,6.88554e-06,152149791,0.99965
D.kanapiae,152203088,VNJM01003094.1,1,1046,6.8724e-06,152150837,0.999657
D.kanapiae,152203088,VNJM01002355.1,1,1046,6.8724e-06,152151883,0.999664
D.kanapiae,152203088,VNJM01003047.1,1,1045,6.86583e-06,152152928,0.99967
D.kanapiae,152203088,VNJM01000472.1,1,1044,6.85926e-06,152153972,0.999677
D.kanapiae,152203088,VNJM01003455.1,1,1043,6.85269e-06,152155015,0.999684
D.kanapiae,152203088,VNJM01002980.1,1,1043,6.85269e-06,152156058,0.999691
D.kanapiae,152203088,VNJM01001208.1,1,1042,6.84612e-06,152157100,0.999698
D.kanapiae,152203088,VNJM01000344.1,1,1040,6.83298e-06,152158140,0.999705
D.kanapiae,152203088,VNJM01000332.1,1,1039,6.82641e-06,152159179,0.999712
D.kanapiae,152203088,VNJM01003490.1,1,1038,6.81984e-06,152160217,0.999718
D.kanapiae,152203088,VNJM01003470.1,1,1038,6.81984e-06,152161255,0.999725
D.kanapiae,152203088,VNJM01003129.1,1,1036,6.8067e-06,152162291,0.999732
D.kanapiae,152203088,VNJM01001624.1,1,1036,6.8067e-06,152163327,0.999739
D.kanapiae,152203088,VNJM01001981.1,1,1033,6.78698e-06,152164360,0.999746
D.kanapiae,152203088,VNJM01001448.1,1,1032,6.78041e-06,152165392,0.999752
D.kanapiae,152203088,VNJM01001409.1,1,1032,6.78041e-06,152166424,0.999759
D.kanapiae,152203088,VNJM01002421.1,1,1031,6.77384e-06,152167455,0.999766
D.kanapiae,152203088,VNJM01002416.1,1,1031,6.77384e-06,152168486,0.999773
D.kanapiae,152203088,VNJM01002870.1,1,1030,6.76727e-06,152169516,0.999779
D.kanapiae,152203088,VNJM01003514.1,1,1029,6.7607e-06,152170545,0.999786
D.kanapiae,152203088,VNJM01002427.1,1,1028,6.75413e-06,152171573,0.999793
D.kanapiae,152203088,VNJM01002825.1,1,1027,6.74756e-06,152172600,0.9998
D.kanapiae,152203088,VNJM01003139.1,1,1025,6.73442e-06,152173625,0.999806
D.kanapiae,152203088,VNJM01002418.1,1,1025,6.73442e-06,152174650,0.999813
D.kanapiae,152203088,VNJM01000950.1,1,1025,6.73442e-06,152175675,0.99982
D.kanapiae,152203088,VNJM01000194.1,1,1025,6.73442e-06,152176700,0.999827
D.kanapiae,152203088,VNJM01000096.1,1,1025,6.73442e-06,152177725,0.999833
D.kanapiae,152203088,VNJM01001295.1,1,1024,6.72785e-06,152178749,0.99984
D.kanapiae,152203088,VNJM01000928.1,1,1024,6.72785e-06,152179773,0.999847
D.kanapiae,152203088,VNJM01002880.1,1,1023,6.72128e-06,152180796,0.999854
D.kanapiae,152203088,VNJM01001278.1,1,1023,6.72128e-06,152181819,0.99986
D.kanapiae,152203088,VNJM01000120.1,1,1023,6.72128e-06,152182842,0.999867
D.kanapiae,152203088,VNJM01000688.1,1,1022,6.71471e-06,152183864,0.999874
D.kanapiae,152203088,VNJM01001731.1,1,1020,6.70157e-06,152184884,0.99988
D.kanapiae,152203088,VNJM01003387.1,1,1019,6.695e-06,152185903,0.999887
D.kanapiae,152203088,VNJM01003498.1,1,1018,6.68843e-06,152186921,0.999894
D.kanapiae,152203088,VNJM01002008.1,1,1018,6.68843e-06,152187939,0.9999
D.kanapiae,152203088,VNJM01003287.1,1,1017,6.68186e-06,152188956,0.999907
D.kanapiae,152203088,VNJM01001052.1,1,1016,6.67529e-06,152189972,0.999914
D.kanapiae,152203088,VNJM01000953.1,1,1016,6.67529e-06,152190988,0.999921
D.kanapiae,152203088,VNJM01002535.1,1,1015,6.66872e-06,152192003,0.999927
D.kanapiae,152203088,VNJM01000704.1,1,1014,6.66215e-06,152193017,0.999934
D.kanapiae,152203088,VNJM01001155.1,1,1013,6.65558e-06,152194030,0.99994
D.kanapiae,152203088,VNJM01001635.1,1,1009,6.6293e-06,152195039,0.999947
D.kanapiae,152203088,VNJM01001143.1,1,1009,6.6293e-06,152196048,0.999954
D.kanapiae,152203088,VNJM01000064.1,1,1009,6.6293e-06,152197057,0.99996
D.kanapiae,152203088,VNJM01003014.1,1,1008,6.62273e-06,152198065,0.999967
D.kanapiae,152203088,VNJM01003497.1,1,1006,6.60959e-06,152199071,0.999974
D.kanapiae,152203088,VNJM01001327.1,1,1005,6.60302e-06,152200076,0.99998
D.kanapiae,152203088,VNJM01000881.1,1,1005,6.60302e-06,152201081,0.999987
D.kanapiae,152203088,VNJM01001634.1,1,1004,6.59645e-06,152202085,0.999993
D.kanapiae,152203088,VNJM01000260.1,1,1003,6.58988e-06,152203088,1
D.truncata,167897087,VNJQ01003259.1,1,830117,0.0049442,830117,0.0049442
D.truncata,167897087,VNJQ01003576.1,1,761956,0.00453823,1592073,0.00948243
D.truncata,167897087,VNJQ01007509.1,1,752321,0.00448085,2344394,0.0139633
D.truncata,167897087,VNJQ01000976.1,1,733471,0.00436857,3077865,0.0183319
D.truncata,167897087,VNJQ01003714.1,1,733008,0.00436582,3810873,0.0226977
D.truncata,167897087,VNJQ01006635.1,1,732138,0.00436064,4543011,0.0270583
D.truncata,167897087,VNJQ01007977.1,1,716826,0.00426944,5259837,0.0313277
D.truncata,167897087,VNJQ01004348.1,1,705367,0.00420119,5965204,0.0355289
D.truncata,167897087,VNJQ01003112.1,1,684177,0.00407498,6649381,0.0396039
D.truncata,167897087,VNJQ01004684.1,1,634436,0.00377872,7283817,0.0433826
D.truncata,167897087,VNJQ01003536.1,1,621556,0.00370201,7905373,0.0470846
D.truncata,167897087,VNJQ01004463.1,1,616745,0.00367335,8522118,0.050758
D.truncata,167897087,VNJQ01003926.1,1,606297,0.00361112,9128415,0.0543691
D.truncata,167897087,VNJQ01001843.1,1,539118,0.003211,9667533,0.0575801
D.truncata,167897087,VNJQ01005526.1,1,516131,0.00307409,10183664,0.0606542
D.truncata,167897087,VNJQ01007617.1,1,478697,0.00285113,10662361,0.0635053
D.truncata,167897087,VNJQ01003746.1,1,476899,0.00284042,11139260,0.0663458
D.truncata,167897087,VNJQ01001340.1,1,454753,0.00270852,11594013,0.0690543
D.truncata,167897087,VNJQ01003760.1,1,449902,0.00267963,12043915,0.0717339
D.truncata,167897087,VNJQ01002680.1,1,449787,0.00267894,12493702,0.0744129
D.truncata,167897087,VNJQ01000316.1,1,439962,0.00262043,12933664,0.0770333
D.truncata,167897087,VNJQ01006649.1,1,421364,0.00250966,13355028,0.0795429
D.truncata,167897087,VNJQ01000305.1,1,420875,0.00250674,13775903,0.0820497
D.truncata,167897087,VNJQ01000919.1,1,418902,0.00249499,14194805,0.0845447
D.truncata,167897087,VNJQ01004641.1,1,408653,0.00243395,14603458,0.0869786
D.truncata,167897087,VNJQ01002476.1,1,407851,0.00242917,15011309,0.0894078
D.truncata,167897087,VNJQ01005030.1,1,407263,0.00242567,15418572,0.0918335
D.truncata,167897087,VNJQ01000748.1,1,398812,0.00237534,15817384,0.0942088
D.truncata,167897087,VNJQ01004457.1,1,397014,0.00236463,16214398,0.0965734
D.truncata,167897087,VNJQ01006215.1,1,394343,0.00234872,16608741,0.0989222
D.truncata,167897087,VNJQ01006085.1,1,387876,0.0023102,16996617,0.101232
D.truncata,167897087,VNJQ01003295.1,1,382861,0.00228033,17379478,0.103513
D.truncata,167897087,VNJQ01006862.1,1,381584,0.00227273,17761062,0.105785
D.truncata,167897087,VNJQ01006859.1,1,378284,0.00225307,18139346,0.108038
D.truncata,167897087,VNJQ01001533.1,1,377649,0.00224929,18516995,0.110288
D.truncata,167897087,VNJQ01007519.1,1,374144,0.00222841,18891139,0.112516
D.truncata,167897087,VNJQ01002616.1,1,370715,0.00220799,19261854,0.114724
D.truncata,167897087,VNJQ01006054.1,1,368940,0.00219742,19630794,0.116922
D.truncata,167897087,VNJQ01004519.1,1,368927,0.00219734,19999721,0.119119
D.truncata,167897087,VNJQ01001069.1,1,368517,0.0021949,20368238,0.121314
D.truncata,167897087,VNJQ01005823.1,1,368077,0.00219228,20736315,0.123506
D.truncata,167897087,VNJQ01006283.1,1,361801,0.0021549,21098116,0.125661
D.truncata,167897087,VNJQ01005798.1,1,361183,0.00215122,21459299,0.127812
D.truncata,167897087,VNJQ01004862.1,1,360362,0.00214633,21819661,0.129959
D.truncata,167897087,VNJQ01006070.1,1,360033,0.00214437,22179694,0.132103
D.truncata,167897087,VNJQ01007695.1,1,353580,0.00210593,22533274,0.134209
D.truncata,167897087,VNJQ01001933.1,1,353266,0.00210406,22886540,0.136313
D.truncata,167897087,VNJQ01006965.1,1,347295,0.0020685,23233835,0.138381
D.truncata,167897087,VNJQ01004849.1,1,345587,0.00205833,23579422,0.14044
D.truncata,167897087,VNJQ01002234.1,1,342308,0.0020388,23921730,0.142479
D.truncata,167897087,VNJQ01006484.1,1,340708,0.00202927,24262438,0.144508
D.truncata,167897087,VNJQ01005553.1,1,339422,0.00202161,24601860,0.146529
D.truncata,167897087,VNJQ01006143.1,1,338880,0.00201838,24940740,0.148548
D.truncata,167897087,VNJQ01001892.1,1,338563,0.00201649,25279303,0.150564
D.truncata,167897087,VNJQ01002034.1,1,338500,0.00201612,25617803,0.15258
D.truncata,167897087,VNJQ01006737.1,1,337194,0.00200834,25954997,0.154589
D.truncata,167897087,VNJQ01000182.1,1,336573,0.00200464,26291570,0.156593
D.truncata,167897087,VNJQ01003658.1,1,335443,0.00199791,26627013,0.158591
D.truncata,167897087,VNJQ01007758.1,1,335379,0.00199753,26962392,0.160589
D.truncata,167897087,VNJQ01004118.1,1,335089,0.0019958,27297481,0.162585
D.truncata,167897087,VNJQ01006142.1,1,333472,0.00198617,27630953,0.164571
D.truncata,167897087,VNJQ01003121.1,1,332677,0.00198143,27963630,0.166552
D.truncata,167897087,VNJQ01005582.1,1,329235,0.00196093,28292865,0.168513
D.truncata,167897087,VNJQ01002900.1,1,329131,0.00196031,28621996,0.170473
D.truncata,167897087,VNJQ01005560.1,1,329124,0.00196027,28951120,0.172434
D.truncata,167897087,VNJQ01001175.1,1,326733,0.00194603,29277853,0.17438
D.truncata,167897087,VNJQ01001890.1,1,323883,0.00192906,29601736,0.176309
D.truncata,167897087,VNJQ01003022.1,1,319822,0.00190487,29921558,0.178214
D.truncata,167897087,VNJQ01005256.1,1,319021,0.0019001,30240579,0.180114
D.truncata,167897087,VNJQ01003813.1,1,317596,0.00189161,30558175,0.182005
D.truncata,167897087,VNJQ01005887.1,1,313253,0.00186574,30871428,0.183871
D.truncata,167897087,VNJQ01000208.1,1,310693,0.0018505,31182121,0.185722
D.truncata,167897087,VNJQ01004368.1,1,308009,0.00183451,31490130,0.187556
D.truncata,167897087,VNJQ01002787.1,1,307067,0.0018289,31797197,0.189385
D.truncata,167897087,VNJQ01001321.1,1,306593,0.00182608,32103790,0.191211
D.truncata,167897087,VNJQ01002711.1,1,306428,0.00182509,32410218,0.193036
D.truncata,167897087,VNJQ01007755.1,1,305593,0.00182012,32715811,0.194856
D.truncata,167897087,VNJQ01005323.1,1,305520,0.00181969,33021331,0.196676
D.truncata,167897087,VNJQ01002932.1,1,305146,0.00181746,33326477,0.198493
D.truncata,167897087,VNJQ01004341.1,1,304683,0.0018147,33631160,0.200308
D.truncata,167897087,VNJQ01001166.1,1,303722,0.00180898,33934882,0.202117
D.truncata,167897087,VNJQ01006216.1,1,301118,0.00179347,34236000,0.203911
D.truncata,167897087,VNJQ01005476.1,1,301004,0.00179279,34537004,0.205703
D.truncata,167897087,VNJQ01007591.1,1,300118,0.00178751,34837122,0.207491
D.truncata,167897087,VNJQ01007102.1,1,299644,0.00178469,35136766,0.209276
D.truncata,167897087,VNJQ01002603.1,1,298323,0.00177682,35435089,0.211052
D.truncata,167897087,VNJQ01005751.1,1,298080,0.00177537,35733169,0.212828
D.truncata,167897087,VNJQ01006300.1,1,296303,0.00176479,36029472,0.214593
D.truncata,167897087,VNJQ01000453.1,1,293842,0.00175013,36323314,0.216343
D.truncata,167897087,VNJQ01007754.1,1,293180,0.00174619,36616494,0.218089
D.truncata,167897087,VNJQ01007826.1,1,292398,0.00174153,36908892,0.21983
D.truncata,167897087,VNJQ01007948.1,1,292145,0.00174002,37201037,0.22157
D.truncata,167897087,VNJQ01000555.1,1,289500,0.00172427,37490537,0.223295
D.truncata,167897087,VNJQ01006946.1,1,288967,0.0017211,37779504,0.225016
D.truncata,167897087,VNJQ01002373.1,1,286888,0.00170871,38066392,0.226725
D.truncata,167897087,VNJQ01000295.1,1,282713,0.00168385,38349105,0.228408
D.truncata,167897087,VNJQ01000551.1,1,282555,0.00168291,38631660,0.230091
D.truncata,167897087,VNJQ01001021.1,1,282182,0.00168068,38913842,0.231772
D.truncata,167897087,VNJQ01004475.1,1,281910,0.00167906,39195752,0.233451
D.truncata,167897087,VNJQ01005002.1,1,277503,0.00165282,39473255,0.235104
D.truncata,167897087,VNJQ01003196.1,1,275944,0.00164353,39749199,0.236747
D.truncata,167897087,VNJQ01007739.1,1,275384,0.0016402,40024583,0.238388
D.truncata,167897087,VNJQ01003473.1,1,274378,0.0016342,40298961,0.240022
D.truncata,167897087,VNJQ01004541.1,1,274033,0.00163215,40572994,0.241654
D.truncata,167897087,VNJQ01002318.1,1,272679,0.00162408,40845673,0.243278
D.truncata,167897087,VNJQ01005729.1,1,272611,0.00162368,41118284,0.244902
D.truncata,167897087,VNJQ01006041.1,1,272449,0.00162271,41390733,0.246524
D.truncata,167897087,VNJQ01000290.1,1,270965,0.00161388,41661698,0.248138
D.truncata,167897087,VNJQ01004739.1,1,270669,0.00161211,41932367,0.24975
D.truncata,167897087,VNJQ01004440.1,1,267653,0.00159415,42200020,0.251345
D.truncata,167897087,VNJQ01004272.1,1,266902,0.00158968,42466922,0.252934
D.truncata,167897087,VNJQ01004190.1,1,265364,0.00158052,42732286,0.254515
D.truncata,167897087,VNJQ01004943.1,1,264456,0.00157511,42996742,0.25609
D.truncata,167897087,VNJQ01007466.1,1,263909,0.00157185,43260651,0.257662
D.truncata,167897087,VNJQ01003498.1,1,263815,0.00157129,43524466,0.259233
D.truncata,167897087,VNJQ01003365.1,1,262143,0.00156133,43786609,0.260794
D.truncata,167897087,VNJQ01005547.1,1,261727,0.00155885,44048336,0.262353
D.truncata,167897087,VNJQ01007619.1,1,259207,0.00154384,44307543,0.263897
D.truncata,167897087,VNJQ01001436.1,1,258995,0.00154258,44566538,0.26544
D.truncata,167897087,VNJQ01001789.1,1,257014,0.00153078,44823552,0.26697
D.truncata,167897087,VNJQ01004668.1,1,256116,0.00152543,45079668,0.268496
D.truncata,167897087,VNJQ01001011.1,1,254976,0.00151864,45334644,0.270014
D.truncata,167897087,VNJQ01005049.1,1,252438,0.00150353,45587082,0.271518
D.truncata,167897087,VNJQ01000189.1,1,251632,0.00149873,45838714,0.273017
D.truncata,167897087,VNJQ01007878.1,1,251496,0.00149792,46090210,0.274515
D.truncata,167897087,VNJQ01005065.1,1,250212,0.00149027,46340422,0.276005
D.truncata,167897087,VNJQ01002436.1,1,249160,0.001484,46589582,0.277489
D.truncata,167897087,VNJQ01004464.1,1,246466,0.00146796,46836048,0.278957
D.truncata,167897087,VNJQ01001537.1,1,245809,0.00146405,47081857,0.280421
D.truncata,167897087,VNJQ01000304.1,1,244988,0.00145916,47326845,0.28188
D.truncata,167897087,VNJQ01001196.1,1,243817,0.00145218,47570662,0.283332
D.truncata,167897087,VNJQ01001014.1,1,243074,0.00144776,47813736,0.28478
D.truncata,167897087,VNJQ01006284.1,1,241569,0.00143879,48055305,0.286219
D.truncata,167897087,VNJQ01004293.1,1,241283,0.00143709,48296588,0.287656
D.truncata,167897087,VNJQ01003747.1,1,239622,0.0014272,48536210,0.289083
D.truncata,167897087,VNJQ01001050.1,1,238337,0.00141954,48774547,0.290503
D.truncata,167897087,VNJQ01004204.1,1,237185,0.00141268,49011732,0.291915
D.truncata,167897087,VNJQ01004838.1,1,237164,0.00141256,49248896,0.293328
D.truncata,167897087,VNJQ01004601.1,1,235634,0.00140344,49484530,0.294731
D.truncata,167897087,VNJQ01004602.1,1,235102,0.00140027,49719632,0.296132
D.truncata,167897087,VNJQ01007521.1,1,234086,0.00139422,49953718,0.297526
D.truncata,167897087,VNJQ01004647.1,1,233997,0.00139369,50187715,0.29892
D.truncata,167897087,VNJQ01006793.1,1,233390,0.00139008,50421105,0.30031
D.truncata,167897087,VNJQ01005855.1,1,232342,0.00138384,50653447,0.301693
D.truncata,167897087,VNJQ01007088.1,1,231999,0.00138179,50885446,0.303075
D.truncata,167897087,VNJQ01005201.1,1,231829,0.00138078,51117275,0.304456
D.truncata,167897087,VNJQ01004993.1,1,231711,0.00138008,51348986,0.305836
D.truncata,167897087,VNJQ01007976.1,1,229807,0.00136874,51578793,0.307205
D.truncata,167897087,VNJQ01003292.1,1,228393,0.00136032,51807186,0.308565
D.truncata,167897087,VNJQ01005007.1,1,227958,0.00135772,52035144,0.309923
D.truncata,167897087,VNJQ01006490.1,1,227574,0.00135544,52262718,0.311278
D.truncata,167897087,VNJQ01003915.1,1,226943,0.00135168,52489661,0.31263
D.truncata,167897087,VNJQ01003038.1,1,226713,0.00135031,52716374,0.31398
D.truncata,167897087,VNJQ01005025.1,1,226564,0.00134942,52942938,0.31533
D.truncata,167897087,VNJQ01007691.1,1,225943,0.00134572,53168881,0.316675
D.truncata,167897087,VNJQ01004604.1,1,224078,0.00133462,53392959,0.31801
D.truncata,167897087,VNJQ01007805.1,1,223617,0.00133187,53616576,0.319342
D.truncata,167897087,VNJQ01002309.1,1,222082,0.00132273,53838658,0.320665
D.truncata,167897087,VNJQ01003896.1,1,221545,0.00131953,54060203,0.321984
D.truncata,167897087,VNJQ01006690.1,1,220336,0.00131233,54280539,0.323296
D.truncata,167897087,VNJQ01002400.1,1,219587,0.00130787,54500126,0.324604
D.truncata,167897087,VNJQ01004548.1,1,218882,0.00130367,54719008,0.325908
D.truncata,167897087,VNJQ01005837.1,1,217765,0.00129701,54936773,0.327205
D.truncata,167897087,VNJQ01003521.1,1,217433,0.00129504,55154206,0.3285
D.truncata,167897087,VNJQ01003161.1,1,216915,0.00129195,55371121,0.329792
D.truncata,167897087,VNJQ01001013.1,1,214076,0.00127504,55585197,0.331067
D.truncata,167897087,VNJQ01007174.1,1,213711,0.00127287,55798908,0.33234
D.truncata,167897087,VNJQ01001812.1,1,212545,0.00126592,56011453,0.333606
D.truncata,167897087,VNJQ01000941.1,1,211672,0.00126072,56223125,0.334867
D.truncata,167897087,VNJQ01002025.1,1,210711,0.001255,56433836,0.336122
D.truncata,167897087,VNJQ01006263.1,1,210112,0.00125143,56643948,0.337373
D.truncata,167897087,VNJQ01007974.1,1,208395,0.00124121,56852343,0.338614
D.truncata,167897087,VNJQ01000051.1,1,207099,0.00123349,57059442,0.339848
D.truncata,167897087,VNJQ01000795.1,1,206782,0.0012316,57266224,0.341079
D.truncata,167897087,VNJQ01003811.1,1,205300,0.00122277,57471524,0.342302
D.truncata,167897087,VNJQ01002978.1,1,204406,0.00121745,57675930,0.34352
D.truncata,167897087,VNJQ01004707.1,1,202668,0.0012071,57878598,0.344727
D.truncata,167897087,VNJQ01000584.1,1,200466,0.00119398,58079064,0.345921
D.truncata,167897087,VNJQ01004339.1,1,200372,0.00119342,58279436,0.347114
D.truncata,167897087,VNJQ01007750.1,1,200122,0.00119193,58479558,0.348306
D.truncata,167897087,VNJQ01004501.1,1,199536,0.00118844,58679094,0.349494
D.truncata,167897087,VNJQ01004855.1,1,199472,0.00118806,58878566,0.350682
D.truncata,167897087,VNJQ01006979.1,1,197586,0.00117683,59076152,0.351859
D.truncata,167897087,VNJQ01007030.1,1,197498,0.0011763,59273650,0.353036
D.truncata,167897087,VNJQ01000556.1,1,197409,0.00117577,59471059,0.354211
D.truncata,167897087,VNJQ01000702.1,1,196002,0.00116739,59667061,0.355379
D.truncata,167897087,VNJQ01007062.1,1,195687,0.00116552,59862748,0.356544
D.truncata,167897087,VNJQ01005298.1,1,195263,0.00116299,60058011,0.357707
D.truncata,167897087,VNJQ01003513.1,1,194872,0.00116066,60252883,0.358868
D.truncata,167897087,VNJQ01002972.1,1,194675,0.00115949,60447558,0.360027
D.truncata,167897087,VNJQ01006038.1,1,194648,0.00115933,60642206,0.361187
D.truncata,167897087,VNJQ01004121.1,1,194618,0.00115915,60836824,0.362346
D.truncata,167897087,VNJQ01007757.1,1,193855,0.00115461,61030679,0.363501
D.truncata,167897087,VNJQ01002070.1,1,193839,0.00115451,61224518,0.364655
D.truncata,167897087,VNJQ01006440.1,1,193658,0.00115343,61418176,0.365808
D.truncata,167897087,VNJQ01003897.1,1,193391,0.00115184,61611567,0.36696
D.truncata,167897087,VNJQ01004192.1,1,193384,0.0011518,61804951,0.368112
D.truncata,167897087,VNJQ01002083.1,1,193179,0.00115058,61998130,0.369263
D.truncata,167897087,VNJQ01008019.1,1,191935,0.00114317,62190065,0.370406
D.truncata,167897087,VNJQ01004606.1,1,191492,0.00114053,62381557,0.371546
D.truncata,167897087,VNJQ01003180.1,1,189512,0.00112874,62571069,0.372675
D.truncata,167897087,VNJQ01004340.1,1,188607,0.00112335,62759676,0.373798
D.truncata,167897087,VNJQ01001022.1,1,187994,0.0011197,62947670,0.374918
D.truncata,167897087,VNJQ01005840.1,1,187881,0.00111902,63135551,0.376037
D.truncata,167897087,VNJQ01004223.1,1,187259,0.00111532,63322810,0.377153
D.truncata,167897087,VNJQ01000530.1,1,187243,0.00111522,63510053,0.378268
D.truncata,167897087,VNJQ01007265.1,1,186846,0.00111286,63696899,0.379381
D.truncata,167897087,VNJQ01004335.1,1,186503,0.00111082,63883402,0.380491
D.truncata,167897087,VNJQ01004336.1,1,186474,0.00111064,64069876,0.381602
D.truncata,167897087,VNJQ01000974.1,1,185313,0.00110373,64255189,0.382706
D.truncata,167897087,VNJQ01006693.1,1,183959,0.00109567,64439148,0.383801
D.truncata,167897087,VNJQ01002556.1,1,183310,0.0010918,64622458,0.384893
D.truncata,167897087,VNJQ01005984.1,1,183207,0.00109119,64805665,0.385984
D.truncata,167897087,VNJQ01003954.1,1,183179,0.00109102,64988844,0.387075
D.truncata,167897087,VNJQ01006790.1,1,182766,0.00108856,65171610,0.388164
D.truncata,167897087,VNJQ01003812.1,1,182670,0.00108799,65354280,0.389252
D.truncata,167897087,VNJQ01003179.1,1,181984,0.0010839,65536264,0.390336
D.truncata,167897087,VNJQ01005558.1,1,181145,0.0010789,65717409,0.391415
D.truncata,167897087,VNJQ01006610.1,1,180485,0.00107497,65897894,0.39249
D.truncata,167897087,VNJQ01005320.1,1,179821,0.00107102,66077715,0.393561
D.truncata,167897087,VNJQ01003619.1,1,179645,0.00106997,66257360,0.394631
D.truncata,167897087,VNJQ01004065.1,1,178443,0.00106281,66435803,0.395694
D.truncata,167897087,VNJQ01001226.1,1,177093,0.00105477,66612896,0.396748
D.truncata,167897087,VNJQ01004624.1,1,176043,0.00104852,66788939,0.397797
D.truncata,167897087,VNJQ01001790.1,1,175775,0.00104692,66964714,0.398844
D.truncata,167897087,VNJQ01005042.1,1,175705,0.0010465,67140419,0.39989
D.truncata,167897087,VNJQ01000023.1,1,173652,0.00103428,67314071,0.400925
D.truncata,167897087,VNJQ01002685.1,1,172093,0.00102499,67486164,0.40195
D.truncata,167897087,VNJQ01005698.1,1,172071,0.00102486,67658235,0.402974
D.truncata,167897087,VNJQ01000973.1,1,171993,0.0010244,67830228,0.403999
D.truncata,167897087,VNJQ01001788.1,1,171830,0.00102342,68002058,0.405022
D.truncata,167897087,VNJQ01000553.1,1,171429,0.00102104,68173487,0.406043
D.truncata,167897087,VNJQ01006161.1,1,170711,0.00101676,68344198,0.40706
D.truncata,167897087,VNJQ01002971.1,1,170071,0.00101295,68514269,0.408073
D.truncata,167897087,VNJQ01007873.1,1,168924,0.00100612,68683193,0.409079
D.truncata,167897087,VNJQ01006612.1,1,168798,0.00100537,68851991,0.410084
D.truncata,167897087,VNJQ01005307.1,1,168064,0.00100099,69020055,0.411085
D.truncata,167897087,VNJQ01002976.1,1,167837,0.000999642,69187892,0.412085
D.truncata,167897087,VNJQ01004858.1,1,167724,0.000998969,69355616,0.413084
D.truncata,167897087,VNJQ01002814.1,1,167644,0.000998493,69523260,0.414083
D.truncata,167897087,VNJQ01004856.1,1,167237,0.000996069,69690497,0.415079
D.truncata,167897087,VNJQ01007283.1,1,166565,0.000992066,69857062,0.416071
D.truncata,167897087,VNJQ01005010.1,1,166177,0.000989755,70023239,0.41706
D.truncata,167897087,VNJQ01007612.1,1,165934,0.000988308,70189173,0.418049
D.truncata,167897087,VNJQ01002536.1,1,164732,0.000981149,70353905,0.41903
D.truncata,167897087,VNJQ01005647.1,1,164709,0.000981012,70518614,0.420011
D.truncata,167897087,VNJQ01003326.1,1,164348,0.000978862,70682962,0.42099
D.truncata,167897087,VNJQ01005232.1,1,163954,0.000976515,70846916,0.421966
D.truncata,167897087,VNJQ01007874.1,1,163901,0.000976199,71010817,0.422943
D.truncata,167897087,VNJQ01007356.1,1,163301,0.000972626,71174118,0.423915
D.truncata,167897087,VNJQ01007523.1,1,162570,0.000968272,71336688,0.424883
D.truncata,167897087,VNJQ01007522.1,1,162109,0.000965526,71498797,0.425849
D.truncata,167897087,VNJQ01000554.1,1,161811,0.000963751,71660608,0.426813
D.truncata,167897087,VNJQ01000975.1,1,161639,0.000962727,71822247,0.427775
D.truncata,167897087,VNJQ01003611.1,1,161553,0.000962214,71983800,0.428738
D.truncata,167897087,VNJQ01002350.1,1,160536,0.000956157,72144336,0.429694
D.truncata,167897087,VNJQ01007106.1,1,160446,0.000955621,72304782,0.430649
D.truncata,167897087,VNJQ01000863.1,1,160139,0.000953793,72464921,0.431603
D.truncata,167897087,VNJQ01000063.1,1,159655,0.00095091,72624576,0.432554
D.truncata,167897087,VNJQ01003963.1,1,159033,0.000947205,72783609,0.433501
D.truncata,167897087,VNJQ01006092.1,1,159003,0.000947027,72942612,0.434448
D.truncata,167897087,VNJQ01000300.1,1,158827,0.000945978,73101439,0.435394
D.truncata,167897087,VNJQ01006689.1,1,158699,0.000945216,73260138,0.43634
D.truncata,167897087,VNJQ01000549.1,1,158689,0.000945156,73418827,0.437285
D.truncata,167897087,VNJQ01004857.1,1,157950,0.000940755,73576777,0.438225
D.truncata,167897087,VNJQ01005121.1,1,157453,0.000937795,73734230,0.439163
D.truncata,167897087,VNJQ01001167.1,1,157303,0.000936901,73891533,0.4401
D.truncata,167897087,VNJQ01007240.1,1,156746,0.000933584,74048279,0.441034
D.truncata,167897087,VNJQ01008188.1,1,156575,0.000932565,74204854,0.441966
D.truncata,167897087,VNJQ01005767.1,1,156161,0.0009301,74361015,0.442896
D.truncata,167897087,VNJQ01006531.1,1,156142,0.000929986,74517157,0.443826
D.truncata,167897087,VNJQ01003807.1,1,155828,0.000928116,74672985,0.444755
D.truncata,167897087,VNJQ01006316.1,1,155731,0.000927538,74828716,0.445682
D.truncata,167897087,VNJQ01004343.1,1,155148,0.000924066,74983864,0.446606
D.truncata,167897087,VNJQ01005849.1,1,155016,0.00092328,75138880,0.447529
D.truncata,167897087,VNJQ01004942.1,1,154858,0.000922339,75293738,0.448452
D.truncata,167897087,VNJQ01000315.1,1,154707,0.000921439,75448445,0.449373
D.truncata,167897087,VNJQ01007474.1,1,153670,0.000915263,75602115,0.450288
D.truncata,167897087,VNJQ01004347.1,1,152646,0.000909164,75754761,0.451198
D.truncata,167897087,VNJQ01002014.1,1,151727,0.00090369,75906488,0.452101
D.truncata,167897087,VNJQ01001793.1,1,150691,0.00089752,76057179,0.452999
D.truncata,167897087,VNJQ01000165.1,1,149461,0.000890194,76206640,0.453889
D.truncata,167897087,VNJQ01004610.1,1,148691,0.000885608,76355331,0.454775
D.truncata,167897087,VNJQ01006141.1,1,147610,0.00087917,76502941,0.455654
D.truncata,167897087,VNJQ01007546.1,1,147206,0.000876763,76650147,0.456531
D.truncata,167897087,VNJQ01001314.1,1,146268,0.000871177,76796415,0.457402
D.truncata,167897087,VNJQ01004953.1,1,146100,0.000870176,76942515,0.458272
D.truncata,167897087,VNJQ01007491.1,1,145984,0.000869485,77088499,0.459141
D.truncata,167897087,VNJQ01002217.1,1,145476,0.000866459,77233975,0.460008
D.truncata,167897087,VNJQ01006786.1,1,145408,0.000866054,77379383,0.460874
D.truncata,167897087,VNJQ01003931.1,1,144933,0.000863225,77524316,0.461737
D.truncata,167897087,VNJQ01001016.1,1,144623,0.000861379,77668939,0.462598
D.truncata,167897087,VNJQ01002744.1,1,144288,0.000859384,77813227,0.463458
D.truncata,167897087,VNJQ01000301.1,1,144095,0.000858234,77957322,0.464316
D.truncata,167897087,VNJQ01008117.1,1,140102,0.000834452,78097424,0.465151
D.truncata,167897087,VNJQ01002041.1,1,139383,0.000830169,78236807,0.465981
D.truncata,167897087,VNJQ01005061.1,1,138737,0.000826322,78375544,0.466807
D.truncata,167897087,VNJQ01003573.1,1,138306,0.000823755,78513850,0.467631
D.truncata,167897087,VNJQ01005066.1,1,137932,0.000821527,78651782,0.468452
D.truncata,167897087,VNJQ01007986.1,1,137507,0.000818996,78789289,0.469271
D.truncata,167897087,VNJQ01000730.1,1,137481,0.000818841,78926770,0.47009
D.truncata,167897087,VNJQ01005879.1,1,137386,0.000818275,79064156,0.470908
D.truncata,167897087,VNJQ01004225.1,1,137316,0.000817858,79201472,0.471726
D.truncata,167897087,VNJQ01002229.1,1,136589,0.000813528,79338061,0.47254
D.truncata,167897087,VNJQ01004311.1,1,136024,0.000810163,79474085,0.47335
D.truncata,167897087,VNJQ01005231.1,1,135539,0.000807274,79609624,0.474157
D.truncata,167897087,VNJQ01003808.1,1,135262,0.000805624,79744886,0.474963
D.truncata,167897087,VNJQ01002818.1,1,135061,0.000804427,79879947,0.475767
D.truncata,167897087,VNJQ01003858.1,1,134941,0.000803713,80014888,0.476571
D.truncata,167897087,VNJQ01003265.1,1,134890,0.000803409,80149778,0.477374
D.truncata,167897087,VNJQ01001948.1,1,134748,0.000802563,80284526,0.478177
D.truncata,167897087,VNJQ01004154.1,1,134602,0.000801693,80419128,0.478979
D.truncata,167897087,VNJQ01000550.1,1,134363,0.00080027,80553491,0.479779
D.truncata,167897087,VNJQ01006158.1,1,134248,0.000799585,80687739,0.480579
D.truncata,167897087,VNJQ01004860.1,1,134019,0.000798221,80821758,0.481377
D.truncata,167897087,VNJQ01004705.1,1,133852,0.000797226,80955610,0.482174
D.truncata,167897087,VNJQ01003556.1,1,132802,0.000790973,81088412,0.482965
D.truncata,167897087,VNJQ01006788.1,1,132801,0.000790967,81221213,0.483756
D.truncata,167897087,VNJQ01000616.1,1,132382,0.000788471,81353595,0.484544
D.truncata,167897087,VNJQ01001546.1,1,132325,0.000788132,81485920,0.485333
D.truncata,167897087,VNJQ01001584.1,1,132302,0.000787995,81618222,0.486121
D.truncata,167897087,VNJQ01007414.1,1,132297,0.000787965,81750519,0.486909
D.truncata,167897087,VNJQ01005683.1,1,132165,0.000787179,81882684,0.487696
D.truncata,167897087,VNJQ01007421.1,1,131989,0.00078613,82014673,0.488482
D.truncata,167897087,VNJQ01007477.1,1,131978,0.000786065,82146651,0.489268
D.truncata,167897087,VNJQ01005299.1,1,131898,0.000785588,82278549,0.490053
D.truncata,167897087,VNJQ01003293.1,1,131263,0.000781806,82409812,0.490835
D.truncata,167897087,VNJQ01005103.1,1,130840,0.000779287,82540652,0.491615
D.truncata,167897087,VNJQ01004952.1,1,130558,0.000777607,82671210,0.492392
D.truncata,167897087,VNJQ01001792.1,1,130445,0.000776934,82801655,0.493169
D.truncata,167897087,VNJQ01004859.1,1,130063,0.000774659,82931718,0.493944
D.truncata,167897087,VNJQ01006787.1,1,129948,0.000773974,83061666,0.494718
D.truncata,167897087,VNJQ01001993.1,1,129201,0.000769525,83190867,0.495487
D.truncata,167897087,VNJQ01007749.1,1,129040,0.000768566,83319907,0.496256
D.truncata,167897087,VNJQ01005434.1,1,128831,0.000767321,83448738,0.497023
D.truncata,167897087,VNJQ01004861.1,1,128658,0.000766291,83577396,0.497789
D.truncata,167897087,VNJQ01006568.1,1,128005,0.000762402,83705401,0.498552
D.truncata,167897087,VNJQ01000139.1,1,127969,0.000762187,83833370,0.499314
D.truncata,167897087,VNJQ01006917.1,1,127470,0.000759215,83960840,0.500073
D.truncata,167897087,VNJQ01005276.1,1,127296,0.000758179,84088136,0.500831
D.truncata,167897087,VNJQ01004642.1,1,126577,0.000753896,84214713,0.501585
D.truncata,167897087,VNJQ01001893.1,1,126396,0.000752818,84341109,0.502338
D.truncata,167897087,VNJQ01007376.1,1,126003,0.000750478,84467112,0.503089
D.truncata,167897087,VNJQ01007014.1,1,125928,0.000750031,84593040,0.503839
D.truncata,167897087,VNJQ01001737.1,1,123811,0.000737422,84716851,0.504576
D.truncata,167897087,VNJQ01004891.1,1,123675,0.000736612,84840526,0.505313
D.truncata,167897087,VNJQ01006499.1,1,123599,0.000736159,84964125,0.506049
D.truncata,167897087,VNJQ01003743.1,1,122925,0.000732145,85087050,0.506781
D.truncata,167897087,VNJQ01002893.1,1,121451,0.000723366,85208501,0.507504
D.truncata,167897087,VNJQ01001797.1,1,120944,0.000720346,85329445,0.508225
D.truncata,167897087,VNJQ01002677.1,1,120052,0.000715033,85449497,0.50894
D.truncata,167897087,VNJQ01004863.1,1,119955,0.000714456,85569452,0.509654
D.truncata,167897087,VNJQ01002445.1,1,119777,0.000713395,85689229,0.510368
D.truncata,167897087,VNJQ01004522.1,1,119771,0.00071336,85809000,0.511081
D.truncata,167897087,VNJQ01006980.1,1,119717,0.000713038,85928717,0.511794
D.truncata,167897087,VNJQ01005549.1,1,119527,0.000711906,86048244,0.512506
D.truncata,167897087,VNJQ01005280.1,1,119474,0.000711591,86167718,0.513217
D.truncata,167897087,VNJQ01004962.1,1,119190,0.000709899,86286908,0.513927
D.truncata,167897087,VNJQ01004759.1,1,118998,0.000708756,86405906,0.514636
D.truncata,167897087,VNJQ01004854.1,1,118705,0.00070701,86524611,0.515343
D.truncata,167897087,VNJQ01000705.1,1,117464,0.000699619,86642075,0.516043
D.truncata,167897087,VNJQ01005008.1,1,117328,0.000698809,86759403,0.516742
D.truncata,167897087,VNJQ01002431.1,1,117323,0.000698779,86876726,0.51744
D.truncata,167897087,VNJQ01004888.1,1,117253,0.000698362,86993979,0.518139
D.truncata,167897087,VNJQ01003857.1,1,117032,0.000697046,87111011,0.518836
D.truncata,167897087,VNJQ01007520.1,1,116915,0.000696349,87227926,0.519532
D.truncata,167897087,VNJQ01005244.1,1,115199,0.000686129,87343125,0.520218
D.truncata,167897087,VNJQ01000336.1,1,114999,0.000684937,87458124,0.520903
D.truncata,167897087,VNJQ01005521.1,1,114533,0.000682162,87572657,0.521585
D.truncata,167897087,VNJQ01001509.1,1,114502,0.000681977,87687159,0.522267
D.truncata,167897087,VNJQ01001198.1,1,114345,0.000681042,87801504,0.522948
D.truncata,167897087,VNJQ01003660.1,1,114297,0.000680756,87915801,0.523629
D.truncata,167897087,VNJQ01001012.1,1,113209,0.000674276,88029010,0.524303
D.truncata,167897087,VNJQ01005752.1,1,112820,0.000671959,88141830,0.524975
D.truncata,167897087,VNJQ01005554.1,1,111509,0.000664151,88253339,0.525639
D.truncata,167897087,VNJQ01000157.1,1,111231,0.000662495,88364570,0.526302
D.truncata,167897087,VNJQ01000159.1,1,110999,0.000661113,88475569,0.526963
D.truncata,167897087,VNJQ01001258.1,1,110922,0.000660655,88586491,0.527624
D.truncata,167897087,VNJQ01005955.1,1,110757,0.000659672,88697248,0.528283
D.truncata,167897087,VNJQ01006375.1,1,110749,0.000659624,88807997,0.528943
D.truncata,167897087,VNJQ01002851.1,1,110681,0.000659219,88918678,0.529602
D.truncata,167897087,VNJQ01002501.1,1,110493,0.0006581,89029171,0.53026
D.truncata,167897087,VNJQ01001259.1,1,110103,0.000655777,89139274,0.530916
D.truncata,167897087,VNJQ01000404.1,1,109836,0.000654186,89249110,0.53157
D.truncata,167897087,VNJQ01005243.1,1,109675,0.000653228,89358785,0.532224
D.truncata,167897087,VNJQ01005561.1,1,109497,0.000652167,89468282,0.532876
D.truncata,167897087,VNJQ01006707.1,1,109442,0.00065184,89577724,0.533528
D.truncata,167897087,VNJQ01003039.1,1,109201,0.000650404,89686925,0.534178
D.truncata,167897087,VNJQ01001796.1,1,109103,0.000649821,89796028,0.534828
D.truncata,167897087,VNJQ01005753.1,1,108783,0.000647915,89904811,0.535476
D.truncata,167897087,VNJQ01003742.1,1,108478,0.000646098,90013289,0.536122
D.truncata,167897087,VNJQ01005878.1,1,108467,0.000646033,90121756,0.536768
D.truncata,167897087,VNJQ01005072.1,1,107772,0.000641893,90229528,0.53741
D.truncata,167897087,VNJQ01006696.1,1,107741,0.000641709,90337269,0.538051
D.truncata,167897087,VNJQ01000668.1,1,107725,0.000641613,90444994,0.538693
D.truncata,167897087,VNJQ01003757.1,1,107340,0.00063932,90552334,0.539332
D.truncata,167897087,VNJQ01001696.1,1,107067,0.000637694,90659401,0.53997
D.truncata,167897087,VNJQ01004145.1,1,106712,0.00063558,90766113,0.540606
D.truncata,167897087,VNJQ01003875.1,1,105913,0.000630821,90872026,0.541236
D.truncata,167897087,VNJQ01001151.1,1,105823,0.000630285,90977849,0.541867
D.truncata,167897087,VNJQ01007679.1,1,105822,0.000630279,91083671,0.542497
D.truncata,167897087,VNJQ01003953.1,1,105252,0.000626884,91188923,0.543124
D.truncata,167897087,VNJQ01003353.1,1,104939,0.00062502,91293862,0.543749
D.truncata,167897087,VNJQ01005339.1,1,103700,0.00061764,91397562,0.544367
D.truncata,167897087,VNJQ01000302.1,1,103346,0.000615532,91500908,0.544982
D.truncata,167897087,VNJQ01007760.1,1,103117,0.000614168,91604025,0.545596
D.truncata,167897087,VNJQ01001894.1,1,102793,0.000612238,91706818,0.546209
D.truncata,167897087,VNJQ01003754.1,1,102008,0.000607563,91808826,0.546816
D.truncata,167897087,VNJQ01000308.1,1,101979,0.00060739,91910805,0.547423
D.truncata,167897087,VNJQ01001791.1,1,101757,0.000606068,92012562,0.54803
D.truncata,167897087,VNJQ01001580.1,1,101474,0.000604382,92114036,0.548634
D.truncata,167897087,VNJQ01002201.1,1,101472,0.00060437,92215508,0.549238
D.truncata,167897087,VNJQ01006691.1,1,101196,0.000602726,92316704,0.549841
D.truncata,167897087,VNJQ01005464.1,1,101141,0.000602399,92417845,0.550443
D.truncata,167897087,VNJQ01001277.1,1,100949,0.000601255,92518794,0.551045
D.truncata,167897087,VNJQ01001256.1,1,100925,0.000601112,92619719,0.551646
D.truncata,167897087,VNJQ01006695.1,1,100669,0.000599588,92720388,0.552245
D.truncata,167897087,VNJQ01003449.1,1,100557,0.00059892,92820945,0.552844
D.truncata,167897087,VNJQ01001576.1,1,100449,0.000598277,92921394,0.553443
D.truncata,167897087,VNJQ01000707.1,1,100267,0.000597193,93021661,0.55404
D.truncata,167897087,VNJQ01000861.1,1,100000,0.000595603,93121661,0.554635
D.truncata,167897087,VNJQ01005264.1,1,99548,0.000592911,93221209,0.555228
D.truncata,167897087,VNJQ01000967.1,1,99402,0.000592041,93320611,0.55582
D.truncata,167897087,VNJQ01000303.1,1,99032,0.000589838,93419643,0.55641
D.truncata,167897087,VNJQ01000036.1,1,98911,0.000589117,93518554,0.556999
D.truncata,167897087,VNJQ01004346.1,1,98743,0.000588116,93617297,0.557587
D.truncata,167897087,VNJQ01003631.1,1,98716,0.000587955,93716013,0.558175
D.truncata,167897087,VNJQ01007250.1,1,98543,0.000586925,93814556,0.558762
D.truncata,167897087,VNJQ01001262.1,1,98537,0.000586889,93913093,0.559349
D.truncata,167897087,VNJQ01001311.1,1,97929,0.000583268,94011022,0.559932
D.truncata,167897087,VNJQ01004275.1,1,97824,0.000582643,94108846,0.560515
D.truncata,167897087,VNJQ01001684.1,1,97640,0.000581547,94206486,0.561097
D.truncata,167897087,VNJQ01005300.1,1,97613,0.000581386,94304099,0.561678
D.truncata,167897087,VNJQ01000094.1,1,97596,0.000581285,94401695,0.562259
D.truncata,167897087,VNJQ01003208.1,1,97567,0.000581112,94499262,0.56284
D.truncata,167897087,VNJQ01000703.1,1,97467,0.000580516,94596729,0.563421
D.truncata,167897087,VNJQ01000867.1,1,97442,0.000580367,94694171,0.564001
D.truncata,167897087,VNJQ01000544.1,1,97307,0.000579563,94791478,0.564581
D.truncata,167897087,VNJQ01001103.1,1,97147,0.00057861,94888625,0.565159
D.truncata,167897087,VNJQ01002368.1,1,97089,0.000578265,94985714,0.565738
D.truncata,167897087,VNJQ01004788.1,1,96922,0.00057727,95082636,0.566315
D.truncata,167897087,VNJQ01000024.1,1,96921,0.000577264,95179557,0.566892
D.truncata,167897087,VNJQ01003790.1,1,96196,0.000572946,95275753,0.567465
D.truncata,167897087,VNJQ01003554.1,1,95737,0.000570212,95371490,0.568035
D.truncata,167897087,VNJQ01003842.1,1,95370,0.000568027,95466860,0.568603
D.truncata,167897087,VNJQ01003294.1,1,95285,0.00056752,95562145,0.569171
D.truncata,167897087,VNJQ01001323.1,1,95153,0.000566734,95657298,0.569738
D.truncata,167897087,VNJQ01006288.1,1,94222,0.000561189,95751520,0.570299
D.truncata,167897087,VNJQ01007737.1,1,94127,0.000560623,95845647,0.570859
D.truncata,167897087,VNJQ01001570.1,1,93892,0.000559224,95939539,0.571419
D.truncata,167897087,VNJQ01001795.1,1,92700,0.000552124,96032239,0.571971
D.truncata,167897087,VNJQ01006685.1,1,92667,0.000551927,96124906,0.572523
D.truncata,167897087,VNJQ01002307.1,1,92515,0.000551022,96217421,0.573074
D.truncata,167897087,VNJQ01007746.1,1,92411,0.000550403,96309832,0.573624
D.truncata,167897087,VNJQ01000193.1,1,92247,0.000549426,96402079,0.574174
D.truncata,167897087,VNJQ01005229.1,1,92183,0.000549045,96494262,0.574723
D.truncata,167897087,VNJQ01006800.1,1,91942,0.000547609,96586204,0.57527
D.truncata,167897087,VNJQ01007817.1,1,91850,0.000547061,96678054,0.575817
D.truncata,167897087,VNJQ01000307.1,1,91694,0.000546132,96769748,0.576363
D.truncata,167897087,VNJQ01001926.1,1,91407,0.000544423,96861155,0.576908
D.truncata,167897087,VNJQ01000858.1,1,91391,0.000544327,96952546,0.577452
D.truncata,167897087,VNJQ01005305.1,1,91271,0.000543613,97043817,0.577996
D.truncata,167897087,VNJQ01004079.1,1,91039,0.000542231,97134856,0.578538
D.truncata,167897087,VNJQ01002994.1,1,90991,0.000541945,97225847,0.57908
D.truncata,167897087,VNJQ01001794.1,1,90973,0.000541838,97316820,0.579622
D.truncata,167897087,VNJQ01002849.1,1,90757,0.000540551,97407577,0.580162
D.truncata,167897087,VNJQ01000864.1,1,90451,0.000538729,97498028,0.580701
D.truncata,167897087,VNJQ01000865.1,1,90132,0.000536829,97588160,0.581238
D.truncata,167897087,VNJQ01000793.1,1,90087,0.000536561,97678247,0.581775
D.truncata,167897087,VNJQ01000866.1,1,90065,0.00053643,97768312,0.582311
D.truncata,167897087,VNJQ01003125.1,1,89969,0.000535858,97858281,0.582847
D.truncata,167897087,VNJQ01007478.1,1,89966,0.00053584,97948247,0.583383
D.truncata,167897087,VNJQ01005164.1,1,89925,0.000535596,98038172,0.583918
D.truncata,167897087,VNJQ01007239.1,1,89924,0.00053559,98128096,0.584454
D.truncata,167897087,VNJQ01001885.1,1,89605,0.00053369,98217701,0.584988
D.truncata,167897087,VNJQ01005563.1,1,89519,0.000533178,98307220,0.585521
D.truncata,167897087,VNJQ01000309.1,1,89511,0.00053313,98396731,0.586054
D.truncata,167897087,VNJQ01000306.1,1,88812,0.000528967,98485543,0.586583
D.truncata,167897087,VNJQ01002236.1,1,88638,0.000527931,98574181,0.587111
D.truncata,167897087,VNJQ01007090.1,1,88552,0.000527418,98662733,0.587638
D.truncata,167897087,VNJQ01003357.1,1,88544,0.000527371,98751277,0.588166
D.truncata,167897087,VNJQ01005532.1,1,88518,0.000527216,98839795,0.588693
D.truncata,167897087,VNJQ01004438.1,1,88462,0.000526882,98928257,0.58922
D.truncata,167897087,VNJQ01005474.1,1,88384,0.000526418,99016641,0.589746
D.truncata,167897087,VNJQ01001027.1,1,88000,0.000524131,99104641,0.59027
D.truncata,167897087,VNJQ01001923.1,1,87492,0.000521105,99192133,0.590791
D.truncata,167897087,VNJQ01007875.1,1,87483,0.000521051,99279616,0.591312
D.truncata,167897087,VNJQ01000212.1,1,87481,0.000521039,99367097,0.591833
D.truncata,167897087,VNJQ01000757.1,1,87385,0.000520468,99454482,0.592354
D.truncata,167897087,VNJQ01003204.1,1,87036,0.000518389,99541518,0.592872
D.truncata,167897087,VNJQ01006427.1,1,86781,0.00051687,99628299,0.593389
D.truncata,167897087,VNJQ01002411.1,1,86752,0.000516697,99715051,0.593906
D.truncata,167897087,VNJQ01003199.1,1,86737,0.000516608,99801788,0.594422
D.truncata,167897087,VNJQ01003549.1,1,86716,0.000516483,99888504,0.594939
D.truncata,167897087,VNJQ01002781.1,1,86551,0.0005155,99975055,0.595454
D.truncata,167897087,VNJQ01000299.1,1,86496,0.000515173,100061551,0.59597
D.truncata,167897087,VNJQ01001106.1,1,86228,0.000513577,100147779,0.596483
D.truncata,167897087,VNJQ01002139.1,1,86111,0.00051288,100233890,0.596996
D.truncata,167897087,VNJQ01004191.1,1,86071,0.000512641,100319961,0.597509
D.truncata,167897087,VNJQ01006765.1,1,85865,0.000511414,100405826,0.59802
D.truncata,167897087,VNJQ01003103.1,1,85779,0.000510902,100491605,0.598531
D.truncata,167897087,VNJQ01007130.1,1,85750,0.00051073,100577355,0.599042
D.truncata,167897087,VNJQ01003973.1,1,85430,0.000508824,100662785,0.599551
D.truncata,167897087,VNJQ01003197.1,1,85387,0.000508567,100748172,0.600059
D.truncata,167897087,VNJQ01006410.1,1,85341,0.000508294,100833513,0.600567
D.truncata,167897087,VNJQ01002879.1,1,85229,0.000507626,100918742,0.601075
D.truncata,167897087,VNJQ01004450.1,1,84928,0.000505834,101003670,0.601581
D.truncata,167897087,VNJQ01003854.1,1,84643,0.000504136,101088313,0.602085
D.truncata,167897087,VNJQ01000708.1,1,84312,0.000502165,101172625,0.602587
D.truncata,167897087,VNJQ01006773.1,1,84286,0.00050201,101256911,0.603089
D.truncata,167897087,VNJQ01004078.1,1,84163,0.000501277,101341074,0.60359
D.truncata,167897087,VNJQ01001897.1,1,83766,0.000498913,101424840,0.604089
D.truncata,167897087,VNJQ01004579.1,1,83635,0.000498133,101508475,0.604587
D.truncata,167897087,VNJQ01000314.1,1,83612,0.000497996,101592087,0.605085
D.truncata,167897087,VNJQ01002977.1,1,83468,0.000497138,101675555,0.605583
D.truncata,167897087,VNJQ01000322.1,1,83312,0.000496209,101758867,0.606079
D.truncata,167897087,VNJQ01003507.1,1,83289,0.000496072,101842156,0.606575
D.truncata,167897087,VNJQ01006104.1,1,83256,0.000495875,101925412,0.607071
D.truncata,167897087,VNJQ01005749.1,1,82968,0.00049416,102008380,0.607565
D.truncata,167897087,VNJQ01005606.1,1,82502,0.000491384,102090882,0.608056
D.truncata,167897087,VNJQ01005009.1,1,82422,0.000490908,102173304,0.608547
D.truncata,167897087,VNJQ01001186.1,1,82409,0.00049083,102255713,0.609038
D.truncata,167897087,VNJQ01003752.1,1,82109,0.000489044,102337822,0.609527
D.truncata,167897087,VNJQ01002048.1,1,81963,0.000488174,102419785,0.610015
D.truncata,167897087,VNJQ01004603.1,1,81122,0.000483165,102500907,0.610498
D.truncata,167897087,VNJQ01004926.1,1,80975,0.000482289,102581882,0.610981
D.truncata,167897087,VNJQ01002477.1,1,80694,0.000480616,102662576,0.611461
D.truncata,167897087,VNJQ01002655.1,1,80665,0.000480443,102743241,0.611942
D.truncata,167897087,VNJQ01005306.1,1,80462,0.000479234,102823703,0.612421
D.truncata,167897087,VNJQ01002614.1,1,80228,0.00047784,102903931,0.612899
D.truncata,167897087,VNJQ01005005.1,1,80151,0.000477382,102984082,0.613376
D.truncata,167897087,VNJQ01001783.1,1,80125,0.000477227,103064207,0.613853
D.truncata,167897087,VNJQ01005012.1,1,79926,0.000476042,103144133,0.614329
D.truncata,167897087,VNJQ01000158.1,1,79829,0.000475464,103223962,0.614805
D.truncata,167897087,VNJQ01001420.1,1,78876,0.000469788,103302838,0.615275
D.truncata,167897087,VNJQ01002228.1,1,78738,0.000468966,103381576,0.615744
D.truncata,167897087,VNJQ01000860.1,1,78506,0.000467584,103460082,0.616211
D.truncata,167897087,VNJQ01003182.1,1,78208,0.000465809,103538290,0.616677
D.truncata,167897087,VNJQ01004607.1,1,78104,0.00046519,103616394,0.617142
D.truncata,167897087,VNJQ01004605.1,1,77969,0.000464386,103694363,0.617607
D.truncata,167897087,VNJQ01004890.1,1,77918,0.000464082,103772281,0.618071
D.truncata,167897087,VNJQ01000615.1,1,77870,0.000463796,103850151,0.618535
D.truncata,167897087,VNJQ01005880.1,1,77716,0.000462879,103927867,0.618997
D.truncata,167897087,VNJQ01001511.1,1,77213,0.000459883,104005080,0.619457
D.truncata,167897087,VNJQ01005308.1,1,77157,0.000459549,104082237,0.619917
D.truncata,167897087,VNJQ01000641.1,1,77059,0.000458966,104159296,0.620376
D.truncata,167897087,VNJQ01004611.1,1,76787,0.000457346,104236083,0.620833
D.truncata,167897087,VNJQ01000153.1,1,76621,0.000456357,104312704,0.62129
D.truncata,167897087,VNJQ01002826.1,1,76404,0.000455064,104389108,0.621745
D.truncata,167897087,VNJQ01003713.1,1,76394,0.000455005,104465502,0.6222
D.truncata,167897087,VNJQ01000007.1,1,76387,0.000454963,104541889,0.622655
D.truncata,167897087,VNJQ01001107.1,1,75914,0.000452146,104617803,0.623107
D.truncata,167897087,VNJQ01003697.1,1,75751,0.000451175,104693554,0.623558
D.truncata,167897087,VNJQ01006663.1,1,74591,0.000444266,104768145,0.624002
D.truncata,167897087,VNJQ01001534.1,1,74521,0.000443849,104842666,0.624446
D.truncata,167897087,VNJQ01003240.1,1,74488,0.000443653,104917154,0.62489
D.truncata,167897087,VNJQ01000689.1,1,74192,0.00044189,104991346,0.625332
D.truncata,167897087,VNJQ01000704.1,1,74087,0.000441264,105065433,0.625773
D.truncata,167897087,VNJQ01001655.1,1,73766,0.000439352,105139199,0.626212
D.truncata,167897087,VNJQ01002239.1,1,73504,0.000437792,105212703,0.62665
D.truncata,167897087,VNJQ01003502.1,1,73315,0.000436666,105286018,0.627087
D.truncata,167897087,VNJQ01000859.1,1,73306,0.000436613,105359324,0.627523
D.truncata,167897087,VNJQ01003202.1,1,73221,0.000436106,105432545,0.627959
D.truncata,167897087,VNJQ01001332.1,1,72977,0.000434653,105505522,0.628394
D.truncata,167897087,VNJQ01000862.1,1,72837,0.000433819,105578359,0.628828
D.truncata,167897087,VNJQ01006304.1,1,72387,0.000431139,105650746,0.629259
D.truncata,167897087,VNJQ01002906.1,1,72235,0.000430234,105722981,0.629689
D.truncata,167897087,VNJQ01007983.1,1,71987,0.000428757,105794968,0.630118
D.truncata,167897087,VNJQ01004049.1,1,71894,0.000428203,105866862,0.630546
D.truncata,167897087,VNJQ01003206.1,1,71880,0.000428119,105938742,0.630974
D.truncata,167897087,VNJQ01005122.1,1,71749,0.000427339,106010491,0.631402
D.truncata,167897087,VNJQ01005557.1,1,71653,0.000426767,106082144,0.631828
D.truncata,167897087,VNJQ01006627.1,1,71599,0.000426446,106153743,0.632255
D.truncata,167897087,VNJQ01003892.1,1,71524,0.000425999,106225267,0.632681
D.truncata,167897087,VNJQ01001056.1,1,71369,0.000425076,106296636,0.633106
D.truncata,167897087,VNJQ01000936.1,1,71193,0.000424028,106367829,0.63353
D.truncata,167897087,VNJQ01006692.1,1,70992,0.00042283,106438821,0.633953
D.truncata,167897087,VNJQ01007482.1,1,70418,0.000419412,106509239,0.634372
D.truncata,167897087,VNJQ01001354.1,1,70382,0.000419197,106579621,0.634791
D.truncata,167897087,VNJQ01000279.1,1,70123,0.000417655,106649744,0.635209
D.truncata,167897087,VNJQ01001989.1,1,69864,0.000416112,106719608,0.635625
D.truncata,167897087,VNJQ01005035.1,1,69712,0.000415207,106789320,0.63604
D.truncata,167897087,VNJQ01004600.1,1,69517,0.000414045,106858837,0.636454
D.truncata,167897087,VNJQ01000552.1,1,69370,0.00041317,106928207,0.636868
D.truncata,167897087,VNJQ01007945.1,1,69325,0.000412902,106997532,0.63728
D.truncata,167897087,VNJQ01000341.1,1,69304,0.000412777,107066836,0.637693
D.truncata,167897087,VNJQ01000706.1,1,69168,0.000411967,107136004,0.638105
D.truncata,167897087,VNJQ01002667.1,1,69081,0.000411448,107205085,0.638517
D.truncata,167897087,VNJQ01007373.1,1,69058,0.000411311,107274143,0.638928
D.truncata,167897087,VNJQ01002414.1,1,68700,0.000409179,107342843,0.639337
D.truncata,167897087,VNJQ01003501.1,1,68634,0.000408786,107411477,0.639746
D.truncata,167897087,VNJQ01002371.1,1,68554,0.00040831,107480031,0.640154
D.truncata,167897087,VNJQ01001431.1,1,68465,0.00040778,107548496,0.640562
D.truncata,167897087,VNJQ01006752.1,1,68421,0.000407517,107616917,0.64097
D.truncata,167897087,VNJQ01000809.1,1,68137,0.000405826,107685054,0.641375
D.truncata,167897087,VNJQ01007692.1,1,68100,0.000405606,107753154,0.641781
D.truncata,167897087,VNJQ01006935.1,1,68082,0.000405498,107821236,0.642186
D.truncata,167897087,VNJQ01008102.1,1,67929,0.000404587,107889165,0.642591
D.truncata,167897087,VNJQ01006967.1,1,67855,0.000404146,107957020,0.642995
D.truncata,167897087,VNJQ01001306.1,1,67632,0.000402818,108024652,0.643398
D.truncata,167897087,VNJQ01001409.1,1,67568,0.000402437,108092220,0.6438
D.truncata,167897087,VNJQ01006694.1,1,67216,0.00040034,108159436,0.644201
D.truncata,167897087,VNJQ01003686.1,1,66558,0.000396421,108225994,0.644597
D.truncata,167897087,VNJQ01008042.1,1,66458,0.000395826,108292452,0.644993
D.truncata,167897087,VNJQ01006367.1,1,65691,0.000391258,108358143,0.645384
D.truncata,167897087,VNJQ01003514.1,1,65564,0.000390501,108423707,0.645775
D.truncata,167897087,VNJQ01005004.1,1,65460,0.000389882,108489167,0.646165
D.truncata,167897087,VNJQ01008167.1,1,65208,0.000388381,108554375,0.646553
D.truncata,167897087,VNJQ01001329.1,1,65189,0.000388268,108619564,0.646941
D.truncata,167897087,VNJQ01003011.1,1,64912,0.000386618,108684476,0.647328
D.truncata,167897087,VNJQ01006686.1,1,64695,0.000385325,108749171,0.647713
D.truncata,167897087,VNJQ01006589.1,1,64501,0.00038417,108813672,0.648097
D.truncata,167897087,VNJQ01006828.1,1,64398,0.000383556,108878070,0.648481
D.truncata,167897087,VNJQ01007472.1,1,64240,0.000382615,108942310,0.648864
D.truncata,167897087,VNJQ01002240.1,1,64059,0.000381537,109006369,0.649245
D.truncata,167897087,VNJQ01003503.1,1,63723,0.000379536,109070092,0.649625
D.truncata,167897087,VNJQ01003855.1,1,63695,0.000379369,109133787,0.650004
D.truncata,167897087,VNJQ01001895.1,1,63613,0.000378881,109197400,0.650383
D.truncata,167897087,VNJQ01002786.1,1,63409,0.000377666,109260809,0.650761
D.truncata,167897087,VNJQ01002956.1,1,63257,0.000376761,109324066,0.651137
D.truncata,167897087,VNJQ01005799.1,1,63204,0.000376445,109387270,0.651514
D.truncata,167897087,VNJQ01003360.1,1,62915,0.000374724,109450185,0.651889
D.truncata,167897087,VNJQ01006599.1,1,62788,0.000373967,109512973,0.652262
D.truncata,167897087,VNJQ01000666.1,1,62773,0.000373878,109575746,0.652636
D.truncata,167897087,VNJQ01002676.1,1,62711,0.000373509,109638457,0.65301
D.truncata,167897087,VNJQ01006712.1,1,62641,0.000373092,109701098,0.653383
D.truncata,167897087,VNJQ01007375.1,1,62633,0.000373044,109763731,0.653756
D.truncata,167897087,VNJQ01006653.1,1,62372,0.000371489,109826103,0.654128
D.truncata,167897087,VNJQ01007052.1,1,62306,0.000371096,109888409,0.654499
D.truncata,167897087,VNJQ01000037.1,1,62258,0.00037081,109950667,0.654869
D.truncata,167897087,VNJQ01007871.1,1,62083,0.000369768,110012750,0.655239
D.truncata,167897087,VNJQ01007273.1,1,62074,0.000369715,110074824,0.655609
D.truncata,167897087,VNJQ01003261.1,1,62053,0.000369589,110136877,0.655978
D.truncata,167897087,VNJQ01000699.1,1,61737,0.000367707,110198614,0.656346
D.truncata,167897087,VNJQ01007108.1,1,61698,0.000367475,110260312,0.656714
D.truncata,167897087,VNJQ01000557.1,1,61657,0.000367231,110321969,0.657081
D.truncata,167897087,VNJQ01007961.1,1,61358,0.00036545,110383327,0.657446
D.truncata,167897087,VNJQ01008206.1,1,61336,0.000365319,110444663,0.657812
D.truncata,167897087,VNJQ01001030.1,1,61325,0.000365254,110505988,0.658177
D.truncata,167897087,VNJQ01007475.1,1,61217,0.00036461,110567205,0.658542
D.truncata,167897087,VNJQ01003956.1,1,61071,0.000363741,110628276,0.658905
D.truncata,167897087,VNJQ01002415.1,1,61033,0.000363514,110689309,0.659269
D.truncata,167897087,VNJQ01004946.1,1,60963,0.000363097,110750272,0.659632
D.truncata,167897087,VNJQ01005011.1,1,60808,0.000362174,110811080,0.659994
D.truncata,167897087,VNJQ01004903.1,1,60771,0.000361954,110871851,0.660356
D.truncata,167897087,VNJQ01005247.1,1,60768,0.000361936,110932619,0.660718
D.truncata,167897087,VNJQ01006983.1,1,60763,0.000361906,110993382,0.66108
D.truncata,167897087,VNJQ01001558.1,1,60475,0.000360191,111053857,0.66144
D.truncata,167897087,VNJQ01000333.1,1,60305,0.000359178,111114162,0.661799
D.truncata,167897087,VNJQ01003569.1,1,60219,0.000358666,111174381,0.662158
D.truncata,167897087,VNJQ01001028.1,1,60036,0.000357576,111234417,0.662515
D.truncata,167897087,VNJQ01008195.1,1,60034,0.000357564,111294451,0.662873
D.truncata,167897087,VNJQ01001713.1,1,59854,0.000356492,111354305,0.66323
D.truncata,167897087,VNJQ01005003.1,1,59720,0.000355694,111414025,0.663585
D.truncata,167897087,VNJQ01007774.1,1,59508,0.000354431,111473533,0.66394
D.truncata,167897087,VNJQ01004427.1,1,59486,0.0003543,111533019,0.664294
D.truncata,167897087,VNJQ01003616.1,1,59394,0.000353752,111592413,0.664648
D.truncata,167897087,VNJQ01005310.1,1,59344,0.000353455,111651757,0.665001
D.truncata,167897087,VNJQ01000783.1,1,59066,0.000351799,111710823,0.665353
D.truncata,167897087,VNJQ01006366.1,1,58603,0.000349041,111769426,0.665702
D.truncata,167897087,VNJQ01000130.1,1,58503,0.000348446,111827929,0.66605
D.truncata,167897087,VNJQ01001549.1,1,58459,0.000348184,111886388,0.666399
D.truncata,167897087,VNJQ01002067.1,1,58365,0.000347624,111944753,0.666746
D.truncata,167897087,VNJQ01006439.1,1,58265,0.000347028,112003018,0.667093
D.truncata,167897087,VNJQ01001026.1,1,58213,0.000346718,112061231,0.66744
D.truncata,167897087,VNJQ01002684.1,1,58108,0.000346093,112119339,0.667786
D.truncata,167897087,VNJQ01007377.1,1,58073,0.000345885,112177412,0.668132
D.truncata,167897087,VNJQ01000195.1,1,57901,0.00034486,112235313,0.668477
D.truncata,167897087,VNJQ01002938.1,1,57895,0.000344824,112293208,0.668822
D.truncata,167897087,VNJQ01000312.1,1,57691,0.000343609,112350899,0.669165
D.truncata,167897087,VNJQ01000661.1,1,57670,0.000343484,112408569,0.669509
D.truncata,167897087,VNJQ01004342.1,1,57624,0.00034321,112466193,0.669852
D.truncata,167897087,VNJQ01005883.1,1,57608,0.000343115,112523801,0.670195
D.truncata,167897087,VNJQ01004748.1,1,57380,0.000341757,112581181,0.670537
D.truncata,167897087,VNJQ01001260.1,1,57191,0.000340631,112638372,0.670877
D.truncata,167897087,VNJQ01007991.1,1,57153,0.000340405,112695525,0.671218
D.truncata,167897087,VNJQ01004345.1,1,57097,0.000340071,112752622,0.671558
D.truncata,167897087,VNJQ01001257.1,1,56985,0.000339404,112809607,0.671897
D.truncata,167897087,VNJQ01003708.1,1,56845,0.00033857,112866452,0.672236
D.truncata,167897087,VNJQ01007524.1,1,56792,0.000338255,112923244,0.672574
D.truncata,167897087,VNJQ01006799.1,1,56783,0.000338201,112980027,0.672912
D.truncata,167897087,VNJQ01007941.1,1,56697,0.000337689,113036724,0.67325
D.truncata,167897087,VNJQ01001280.1,1,56407,0.000335962,113093131,0.673586
D.truncata,167897087,VNJQ01004350.1,1,56320,0.000335444,113149451,0.673921
D.truncata,167897087,VNJQ01005249.1,1,56307,0.000335366,113205758,0.674257
D.truncata,167897087,VNJQ01007501.1,1,56007,0.000333579,113261765,0.67459
D.truncata,167897087,VNJQ01000846.1,1,55809,0.0003324,113317574,0.674923
D.truncata,167897087,VNJQ01004828.1,1,55568,0.000330965,113373142,0.675254
D.truncata,167897087,VNJQ01003820.1,1,55412,0.000330036,113428554,0.675584
D.truncata,167897087,VNJQ01001020.1,1,55409,0.000330018,113483963,0.675914
D.truncata,167897087,VNJQ01002805.1,1,55373,0.000329803,113539336,0.676244
D.truncata,167897087,VNJQ01003263.1,1,55304,0.000329392,113594640,0.676573
D.truncata,167897087,VNJQ01003156.1,1,55074,0.000328022,113649714,0.676901
D.truncata,167897087,VNJQ01004351.1,1,54930,0.000327165,113704644,0.677228
D.truncata,167897087,VNJQ01006698.1,1,54920,0.000327105,113759564,0.677555
D.truncata,167897087,VNJQ01000146.1,1,54816,0.000326486,113814380,0.677882
D.truncata,167897087,VNJQ01006981.1,1,54761,0.000326158,113869141,0.678208
D.truncata,167897087,VNJQ01007497.1,1,54707,0.000325837,113923848,0.678534
D.truncata,167897087,VNJQ01000810.1,1,54614,0.000325283,113978462,0.678859
D.truncata,167897087,VNJQ01003110.1,1,54465,0.000324395,114032927,0.679183
D.truncata,167897087,VNJQ01005882.1,1,54352,0.000323722,114087279,0.679507
D.truncata,167897087,VNJQ01006771.1,1,54240,0.000323055,114141519,0.67983
D.truncata,167897087,VNJQ01000176.1,1,54237,0.000323037,114195756,0.680153
D.truncata,167897087,VNJQ01007988.1,1,54144,0.000322483,114249900,0.680476
D.truncata,167897087,VNJQ01006302.1,1,54096,0.000322197,114303996,0.680798
D.truncata,167897087,VNJQ01002678.1,1,53843,0.00032069,114357839,0.681119
D.truncata,167897087,VNJQ01001491.1,1,53766,0.000320232,114411605,0.681439
D.truncata,167897087,VNJQ01003258.1,1,53684,0.000319743,114465289,0.681759
D.truncata,167897087,VNJQ01001065.1,1,53628,0.00031941,114518917,0.682078
D.truncata,167897087,VNJQ01006856.1,1,53469,0.000318463,114572386,0.682397
D.truncata,167897087,VNJQ01000688.1,1,53468,0.000318457,114625854,0.682715
D.truncata,167897087,VNJQ01001774.1,1,53046,0.000315944,114678900,0.683031
D.truncata,167897087,VNJQ01004429.1,1,53035,0.000315878,114731935,0.683347
D.truncata,167897087,VNJQ01002028.1,1,52958,0.000315419,114784893,0.683662
D.truncata,167897087,VNJQ01003216.1,1,52897,0.000315056,114837790,0.683977
D.truncata,167897087,VNJQ01002389.1,1,52817,0.00031458,114890607,0.684292
D.truncata,167897087,VNJQ01001656.1,1,52562,0.000313061,114943169,0.684605
D.truncata,167897087,VNJQ01005366.1,1,52546,0.000312966,114995715,0.684918
D.truncata,167897087,VNJQ01003260.1,1,52415,0.000312185,115048130,0.68523
D.truncata,167897087,VNJQ01007514.1,1,52399,0.00031209,115100529,0.685542
D.truncata,167897087,VNJQ01001882.1,1,52363,0.000311876,115152892,0.685854
D.truncata,167897087,VNJQ01006459.1,1,52244,0.000311167,115205136,0.686165
D.truncata,167897087,VNJQ01001025.1,1,52095,0.000310279,115257231,0.686475
D.truncata,167897087,VNJQ01005870.1,1,52062,0.000310083,115309293,0.686786
D.truncata,167897087,VNJQ01003710.1,1,51728,0.000308093,115361021,0.687094
D.truncata,167897087,VNJQ01007778.1,1,51725,0.000308076,115412746,0.687402
D.truncata,167897087,VNJQ01007354.1,1,51615,0.00030742,115464361,0.687709
D.truncata,167897087,VNJQ01003128.1,1,51615,0.00030742,115515976,0.688017
D.truncata,167897087,VNJQ01001555.1,1,51412,0.000306211,115567388,0.688323
D.truncata,167897087,VNJQ01000003.1,1,51372,0.000305973,115618760,0.688629
D.truncata,167897087,VNJQ01000310.1,1,51340,0.000305783,115670100,0.688935
D.truncata,167897087,VNJQ01006697.1,1,51337,0.000305765,115721437,0.68924
D.truncata,167897087,VNJQ01003227.1,1,51329,0.000305717,115772766,0.689546
D.truncata,167897087,VNJQ01005435.1,1,51287,0.000305467,115824053,0.689851
D.truncata,167897087,VNJQ01005315.1,1,51203,0.000304967,115875256,0.690156
D.truncata,167897087,VNJQ01005133.1,1,51072,0.000304186,115926328,0.690461
D.truncata,167897087,VNJQ01005200.1,1,50996,0.000303734,115977324,0.690764
D.truncata,167897087,VNJQ01000854.1,1,50892,0.000303114,116028216,0.691067
D.truncata,167897087,VNJQ01002367.1,1,50428,0.000300351,116078644,0.691368
D.truncata,167897087,VNJQ01005055.1,1,50271,0.000299416,116128915,0.691667
D.truncata,167897087,VNJQ01006249.1,1,50237,0.000299213,116179152,0.691966
D.truncata,167897087,VNJQ01005001.1,1,50069,0.000298212,116229221,0.692265
D.truncata,167897087,VNJQ01003562.1,1,50063,0.000298177,116279284,0.692563
D.truncata,167897087,VNJQ01002370.1,1,50057,0.000298141,116329341,0.692861
D.truncata,167897087,VNJQ01002471.1,1,49967,0.000297605,116379308,0.693159
D.truncata,167897087,VNJQ01004997.1,1,49795,0.00029658,116429103,0.693455
D.truncata,167897087,VNJQ01003436.1,1,49746,0.000296289,116478849,0.693751
D.truncata,167897087,VNJQ01007773.1,1,49692,0.000295967,116528541,0.694047
D.truncata,167897087,VNJQ01006298.1,1,49649,0.000295711,116578190,0.694343
D.truncata,167897087,VNJQ01001601.1,1,49346,0.000293906,116627536,0.694637
D.truncata,167897087,VNJQ01000826.1,1,49203,0.000293055,116676739,0.69493
D.truncata,167897087,VNJQ01000749.1,1,49177,0.0002929,116725916,0.695223
D.truncata,167897087,VNJQ01005551.1,1,49155,0.000292769,116775071,0.695516
D.truncata,167897087,VNJQ01005531.1,1,49150,0.000292739,116824221,0.695809
D.truncata,167897087,VNJQ01003363.1,1,49057,0.000292185,116873278,0.696101
D.truncata,167897087,VNJQ01006154.1,1,49045,0.000292113,116922323,0.696393
D.truncata,167897087,VNJQ01002681.1,1,48803,0.000290672,116971126,0.696683
D.truncata,167897087,VNJQ01001592.1,1,48772,0.000290487,117019898,0.696974
D.truncata,167897087,VNJQ01004344.1,1,48727,0.000290219,117068625,0.697264
D.truncata,167897087,VNJQ01006372.1,1,48660,0.00028982,117117285,0.697554
D.truncata,167897087,VNJQ01003838.1,1,48660,0.00028982,117165945,0.697844
D.truncata,167897087,VNJQ01006056.1,1,48610,0.000289523,117214555,0.698133
D.truncata,167897087,VNJQ01002310.1,1,48598,0.000289451,117263153,0.698423
D.truncata,167897087,VNJQ01003960.1,1,48508,0.000288915,117311661,0.698712
D.truncata,167897087,VNJQ01001545.1,1,48505,0.000288897,117360166,0.699001
D.truncata,167897087,VNJQ01002076.1,1,48367,0.000288075,117408533,0.699289
D.truncata,167897087,VNJQ01003643.1,1,48163,0.00028686,117456696,0.699576
D.truncata,167897087,VNJQ01007109.1,1,47737,0.000284323,117504433,0.69986
D.truncata,167897087,VNJQ01001023.1,1,47690,0.000284043,117552123,0.700144
D.truncata,167897087,VNJQ01005188.1,1,47672,0.000283936,117599795,0.700428
D.truncata,167897087,VNJQ01006887.1,1,47574,0.000283352,117647369,0.700711
D.truncata,167897087,VNJQ01007949.1,1,47528,0.000283078,117694897,0.700994
D.truncata,167897087,VNJQ01005234.1,1,47528,0.000283078,117742425,0.701277
D.truncata,167897087,VNJQ01005262.1,1,47405,0.000282346,117789830,0.70156
D.truncata,167897087,VNJQ01001322.1,1,47291,0.000281667,117837121,0.701841
D.truncata,167897087,VNJQ01003426.1,1,47218,0.000281232,117884339,0.702123
D.truncata,167897087,VNJQ01007155.1,1,47192,0.000281077,117931531,0.702404
D.truncata,167897087,VNJQ01004445.1,1,47145,0.000280797,117978676,0.702684
D.truncata,167897087,VNJQ01005033.1,1,47062,0.000280303,118025738,0.702965
D.truncata,167897087,VNJQ01003189.1,1,47000,0.000279933,118072738,0.703245
D.truncata,167897087,VNJQ01003362.1,1,46995,0.000279904,118119733,0.703525
D.truncata,167897087,VNJQ01005566.1,1,46984,0.000279838,118166717,0.703804
D.truncata,167897087,VNJQ01003987.1,1,46939,0.00027957,118213656,0.704084
D.truncata,167897087,VNJQ01007690.1,1,46895,0.000279308,118260551,0.704363
D.truncata,167897087,VNJQ01006301.1,1,46758,0.000278492,118307309,0.704642
D.truncata,167897087,VNJQ01000645.1,1,46716,0.000278242,118354025,0.70492
D.truncata,167897087,VNJQ01008110.1,1,46563,0.000277331,118400588,0.705197
D.truncata,167897087,VNJQ01005313.1,1,46527,0.000277116,118447115,0.705475
D.truncata,167897087,VNJQ01001552.1,1,46349,0.000276056,118493464,0.705751
D.truncata,167897087,VNJQ01005272.1,1,46193,0.000275127,118539657,0.706026
D.truncata,167897087,VNJQ01001319.1,1,46062,0.000274347,118585719,0.7063
D.truncata,167897087,VNJQ01004462.1,1,46049,0.000274269,118631768,0.706574
D.truncata,167897087,VNJQ01002312.1,1,45941,0.000273626,118677709,0.706848
D.truncata,167897087,VNJQ01001551.1,1,45876,0.000273239,118723585,0.707121
D.truncata,167897087,VNJQ01007729.1,1,45845,0.000273054,118769430,0.707394
D.truncata,167897087,VNJQ01004614.1,1,45743,0.000272447,118815173,0.707667
D.truncata,167897087,VNJQ01003575.1,1,45731,0.000272375,118860904,0.707939
D.truncata,167897087,VNJQ01002235.1,1,45725,0.000272339,118906629,0.708211
D.truncata,167897087,VNJQ01001326.1,1,45504,0.000271023,118952133,0.708482
D.truncata,167897087,VNJQ01002784.1,1,45484,0.000270904,118997617,0.708753
D.truncata,167897087,VNJQ01005562.1,1,45465,0.000270791,119043082,0.709024
D.truncata,167897087,VNJQ01001643.1,1,45071,0.000268444,119088153,0.709293
D.truncata,167897087,VNJQ01000700.1,1,44720,0.000266354,119132873,0.709559
D.truncata,167897087,VNJQ01001324.1,1,44569,0.000265454,119177442,0.709824
D.truncata,167897087,VNJQ01006131.1,1,44557,0.000265383,119221999,0.71009
D.truncata,167897087,VNJQ01005311.1,1,44548,0.000265329,119266547,0.710355
D.truncata,167897087,VNJQ01001188.1,1,44511,0.000265109,119311058,0.71062
D.truncata,167897087,VNJQ01006303.1,1,44510,0.000265103,119355568,0.710885
D.truncata,167897087,VNJQ01002679.1,1,44480,0.000264924,119400048,0.71115
D.truncata,167897087,VNJQ01002102.1,1,44394,0.000264412,119444442,0.711415
D.truncata,167897087,VNJQ01004401.1,1,44271,0.000263679,119488713,0.711678
D.truncata,167897087,VNJQ01005175.1,1,44255,0.000263584,119532968,0.711942
D.truncata,167897087,VNJQ01007770.1,1,44226,0.000263411,119577194,0.712205
D.truncata,167897087,VNJQ01005304.1,1,44168,0.000263066,119621362,0.712468
D.truncata,167897087,VNJQ01008026.1,1,44149,0.000262953,119665511,0.712731
D.truncata,167897087,VNJQ01007424.1,1,44039,0.000262298,119709550,0.712994
D.truncata,167897087,VNJQ01001490.1,1,43908,0.000261517,119753458,0.713255
D.truncata,167897087,VNJQ01005548.1,1,43877,0.000261333,119797335,0.713516
D.truncata,167897087,VNJQ01005006.1,1,43874,0.000261315,119841209,0.713778
D.truncata,167897087,VNJQ01001807.1,1,43856,0.000261208,119885065,0.714039
D.truncata,167897087,VNJQ01004663.1,1,43782,0.000260767,119928847,0.7143
D.truncata,167897087,VNJQ01000127.1,1,43633,0.000259879,119972480,0.71456
D.truncata,167897087,VNJQ01007268.1,1,43591,0.000259629,120016071,0.714819
D.truncata,167897087,VNJQ01002806.1,1,43494,0.000259052,120059565,0.715078
D.truncata,167897087,VNJQ01000788.1,1,43478,0.000258956,120103043,0.715337
D.truncata,167897087,VNJQ01005181.1,1,43438,0.000258718,120146481,0.715596
D.truncata,167897087,VNJQ01000125.1,1,43339,0.000258128,120189820,0.715854
D.truncata,167897087,VNJQ01001702.1,1,43311,0.000257962,120233131,0.716112
D.truncata,167897087,VNJQ01007694.1,1,43125,0.000256854,120276256,0.716369
D.truncata,167897087,VNJQ01006278.1,1,43020,0.000256228,120319276,0.716625
D.truncata,167897087,VNJQ01000112.1,1,42873,0.000255353,120362149,0.716881
D.truncata,167897087,VNJQ01000396.1,1,42869,0.000255329,120405018,0.717136
D.truncata,167897087,VNJQ01002690.1,1,42865,0.000255305,120447883,0.717391
D.truncata,167897087,VNJQ01002395.1,1,42788,0.000254847,120490671,0.717646
D.truncata,167897087,VNJQ01007271.1,1,42621,0.000253852,120533292,0.7179
D.truncata,167897087,VNJQ01003074.1,1,42570,0.000253548,120575862,0.718153
D.truncata,167897087,VNJQ01001269.1,1,42504,0.000253155,120618366,0.718407
D.truncata,167897087,VNJQ01006984.1,1,42239,0.000251577,120660605,0.718658
D.truncata,167897087,VNJQ01003115.1,1,41974,0.000249998,120702579,0.718908
D.truncata,167897087,VNJQ01000334.1,1,41925,0.000249707,120744504,0.719158
D.truncata,167897087,VNJQ01002311.1,1,41884,0.000249462,120786388,0.719407
D.truncata,167897087,VNJQ01007998.1,1,41815,0.000249051,120828203,0.719656
D.truncata,167897087,VNJQ01007353.1,1,41747,0.000248646,120869950,0.719905
D.truncata,167897087,VNJQ01006374.1,1,41632,0.000247961,120911582,0.720153
D.truncata,167897087,VNJQ01005028.1,1,41601,0.000247777,120953183,0.720401
D.truncata,167897087,VNJQ01005312.1,1,41567,0.000247574,120994750,0.720648
D.truncata,167897087,VNJQ01001579.1,1,41515,0.000247265,121036265,0.720896
D.truncata,167897087,VNJQ01005309.1,1,41435,0.000246788,121077700,0.721142
D.truncata,167897087,VNJQ01005257.1,1,41414,0.000246663,121119114,0.721389
D.truncata,167897087,VNJQ01006369.1,1,41335,0.000246192,121160449,0.721635
D.truncata,167897087,VNJQ01007110.1,1,41274,0.000245829,121201723,0.721881
D.truncata,167897087,VNJQ01002304.1,1,41274,0.000245829,121242997,0.722127
D.truncata,167897087,VNJQ01003635.1,1,41248,0.000245674,121284245,0.722373
D.truncata,167897087,VNJQ01006430.1,1,41188,0.000245317,121325433,0.722618
D.truncata,167897087,VNJQ01002303.1,1,41177,0.000245251,121366610,0.722863
D.truncata,167897087,VNJQ01004357.1,1,41075,0.000244644,121407685,0.723108
D.truncata,167897087,VNJQ01000796.1,1,41070,0.000244614,121448755,0.723352
D.truncata,167897087,VNJQ01001320.1,1,40994,0.000244161,121489749,0.723597
D.truncata,167897087,VNJQ01005748.1,1,40923,0.000243739,121530672,0.72384
D.truncata,167897087,VNJQ01006991.1,1,40903,0.000243619,121571575,0.724084
D.truncata,167897087,VNJQ01005559.1,1,40848,0.000243292,121612423,0.724327
D.truncata,167897087,VNJQ01000950.1,1,40799,0.000243,121653222,0.72457
D.truncata,167897087,VNJQ01001593.1,1,40794,0.00024297,121694016,0.724813
D.truncata,167897087,VNJQ01002372.1,1,40715,0.0002425,121734731,0.725056
D.truncata,167897087,VNJQ01003902.1,1,40700,0.00024241,121775431,0.725298
D.truncata,167897087,VNJQ01003696.1,1,40624,0.000241958,121816055,0.72554
D.truncata,167897087,VNJQ01002314.1,1,40492,0.000241172,121856547,0.725781
D.truncata,167897087,VNJQ01004625.1,1,40467,0.000241023,121897014,0.726022
D.truncata,167897087,VNJQ01007515.1,1,40381,0.00024051,121937395,0.726263
D.truncata,167897087,VNJQ01001582.1,1,40339,0.00024026,121977734,0.726503
D.truncata,167897087,VNJQ01007112.1,1,40319,0.000240141,122018053,0.726743
D.truncata,167897087,VNJQ01003909.1,1,40088,0.000238765,122058141,0.726982
D.truncata,167897087,VNJQ01003899.1,1,40066,0.000238634,122098207,0.727221
D.truncata,167897087,VNJQ01005500.1,1,40019,0.000238354,122138226,0.727459
D.truncata,167897087,VNJQ01001613.1,1,39830,0.000237229,122178056,0.727696
D.truncata,167897087,VNJQ01000843.1,1,39662,0.000236228,122217718,0.727932
D.truncata,167897087,VNJQ01002458.1,1,39559,0.000235615,122257277,0.728168
D.truncata,167897087,VNJQ01006881.1,1,39501,0.000235269,122296778,0.728403
D.truncata,167897087,VNJQ01000883.1,1,39374,0.000234513,122336152,0.728638
D.truncata,167897087,VNJQ01001165.1,1,39312,0.000234143,122375464,0.728872
D.truncata,167897087,VNJQ01001029.1,1,39265,0.000233863,122414729,0.729106
D.truncata,167897087,VNJQ01006888.1,1,39208,0.000233524,122453937,0.729339
D.truncata,167897087,VNJQ01003522.1,1,39176,0.000233333,122493113,0.729573
D.truncata,167897087,VNJQ01005694.1,1,39124,0.000233024,122532237,0.729806
D.truncata,167897087,VNJQ01007111.1,1,39111,0.000232946,122571348,0.730039
D.truncata,167897087,VNJQ01001427.1,1,39071,0.000232708,122610419,0.730271
D.truncata,167897087,VNJQ01008001.1,1,39069,0.000232696,122649488,0.730504
D.truncata,167897087,VNJQ01006274.1,1,39063,0.00023266,122688551,0.730737
D.truncata,167897087,VNJQ01007107.1,1,39058,0.000232631,122727609,0.730969
D.truncata,167897087,VNJQ01004745.1,1,39025,0.000232434,122766634,0.731202
D.truncata,167897087,VNJQ01003822.1,1,38955,0.000232017,122805589,0.731434
D.truncata,167897087,VNJQ01002845.1,1,38954,0.000232011,122844543,0.731666
D.truncata,167897087,VNJQ01000640.1,1,38905,0.000231719,122883448,0.731897
D.truncata,167897087,VNJQ01002609.1,1,38886,0.000231606,122922334,0.732129
D.truncata,167897087,VNJQ01000961.1,1,38858,0.000231439,122961192,0.73236
D.truncata,167897087,VNJQ01006789.1,1,38568,0.000229712,122999760,0.73259
D.truncata,167897087,VNJQ01007481.1,1,38514,0.000229391,123038274,0.73282
D.truncata,167897087,VNJQ01006370.1,1,38482,0.0002292,123076756,0.733049
D.truncata,167897087,VNJQ01006837.1,1,38449,0.000229003,123115205,0.733278
D.truncata,167897087,VNJQ01000243.1,1,38333,0.000228312,123153538,0.733506
D.truncata,167897087,VNJQ01006368.1,1,38309,0.00022817,123191847,0.733734
D.truncata,167897087,VNJQ01004479.1,1,38285,0.000228027,123230132,0.733962
D.truncata,167897087,VNJQ01001281.1,1,38122,0.000227056,123268254,0.734189
D.truncata,167897087,VNJQ01005015.1,1,37958,0.000226079,123306212,0.734415
D.truncata,167897087,VNJQ01006079.1,1,37889,0.000225668,123344101,0.734641
D.truncata,167897087,VNJQ01006096.1,1,37853,0.000225454,123381954,0.734867
D.truncata,167897087,VNJQ01007410.1,1,37789,0.000225072,123419743,0.735092
D.truncata,167897087,VNJQ01007973.1,1,37773,0.000224977,123457516,0.735317
D.truncata,167897087,VNJQ01002934.1,1,37759,0.000224894,123495275,0.735541
D.truncata,167897087,VNJQ01000321.1,1,37732,0.000224733,123533007,0.735766
D.truncata,167897087,VNJQ01007740.1,1,37693,0.000224501,123570700,0.735991
D.truncata,167897087,VNJQ01006429.1,1,37663,0.000224322,123608363,0.736215
D.truncata,167897087,VNJQ01006299.1,1,37641,0.000224191,123646004,0.736439
D.truncata,167897087,VNJQ01002880.1,1,37506,0.000223387,123683510,0.736663
D.truncata,167897087,VNJQ01008100.1,1,37462,0.000223125,123720972,0.736886
D.truncata,167897087,VNJQ01002068.1,1,37448,0.000223041,123758420,0.737109
D.truncata,167897087,VNJQ01007253.1,1,37419,0.000222869,123795839,0.737332
D.truncata,167897087,VNJQ01001246.1,1,37360,0.000222517,123833199,0.737554
D.truncata,167897087,VNJQ01004172.1,1,37178,0.000221433,123870377,0.737776
D.truncata,167897087,VNJQ01004207.1,1,37158,0.000221314,123907535,0.737997
D.truncata,167897087,VNJQ01004093.1,1,37126,0.000221124,123944661,0.738218
D.truncata,167897087,VNJQ01002086.1,1,37123,0.000221106,123981784,0.738439
D.truncata,167897087,VNJQ01005609.1,1,37118,0.000221076,124018902,0.73866
D.truncata,167897087,VNJQ01002153.1,1,37087,0.000220891,124055989,0.738881
D.truncata,167897087,VNJQ01005869.1,1,37078,0.000220838,124093067,0.739102
D.truncata,167897087,VNJQ01002969.1,1,37032,0.000220564,124130099,0.739323
D.truncata,167897087,VNJQ01000311.1,1,36957,0.000220117,124167056,0.739543
D.truncata,167897087,VNJQ01004619.1,1,36914,0.000219861,124203970,0.739763
D.truncata,167897087,VNJQ01002356.1,1,36702,0.000218598,124240672,0.739981
D.truncata,167897087,VNJQ01002850.1,1,36604,0.000218015,124277276,0.740199
D.truncata,167897087,VNJQ01007674.1,1,36449,0.000217091,124313725,0.740416
D.truncata,167897087,VNJQ01003548.1,1,36417,0.000216901,124350142,0.740633
D.truncata,167897087,VNJQ01006553.1,1,36288,0.000216132,124386430,0.740849
D.truncata,167897087,VNJQ01004540.1,1,36273,0.000216043,124422703,0.741065
D.truncata,167897087,VNJQ01001994.1,1,36223,0.000215745,124458926,0.741281
D.truncata,167897087,VNJQ01001312.1,1,36223,0.000215745,124495149,0.741497
D.truncata,167897087,VNJQ01000255.1,1,36172,0.000215441,124531321,0.741712
D.truncata,167897087,VNJQ01005871.1,1,36079,0.000214888,124567400,0.741927
D.truncata,167897087,VNJQ01004843.1,1,35978,0.000214286,124603378,0.742141
D.truncata,167897087,VNJQ01001201.1,1,35888,0.00021375,124639266,0.742355
D.truncata,167897087,VNJQ01005556.1,1,35873,0.000213661,124675139,0.742569
D.truncata,167897087,VNJQ01006061.1,1,35862,0.000213595,124711001,0.742782
D.truncata,167897087,VNJQ01005533.1,1,35711,0.000212696,124746712,0.742995
D.truncata,167897087,VNJQ01007609.1,1,35510,0.000211499,124782222,0.743207
D.truncata,167897087,VNJQ01001024.1,1,35478,0.000211308,124817700,0.743418
D.truncata,167897087,VNJQ01004387.1,1,35433,0.00021104,124853133,0.743629
D.truncata,167897087,VNJQ01004751.1,1,35390,0.000210784,124888523,0.74384
D.truncata,167897087,VNJQ01003198.1,1,35237,0.000209873,124923760,0.74405
D.truncata,167897087,VNJQ01006711.1,1,35189,0.000209587,124958949,0.744259
D.truncata,167897087,VNJQ01004706.1,1,35163,0.000209432,124994112,0.744469
D.truncata,167897087,VNJQ01005223.1,1,35096,0.000209033,125029208,0.744678
D.truncata,167897087,VNJQ01005178.1,1,35093,0.000209015,125064301,0.744887
D.truncata,167897087,VNJQ01007446.1,1,35088,0.000208985,125099389,0.745096
D.truncata,167897087,VNJQ01003200.1,1,35009,0.000208515,125134398,0.745304
D.truncata,167897087,VNJQ01000132.1,1,34811,0.000207335,125169209,0.745511
D.truncata,167897087,VNJQ01007411.1,1,34541,0.000205727,125203750,0.745717
D.truncata,167897087,VNJQ01005692.1,1,34441,0.000205132,125238191,0.745922
D.truncata,167897087,VNJQ01002231.1,1,34410,0.000204947,125272601,0.746127
D.truncata,167897087,VNJQ01003613.1,1,34344,0.000204554,125306945,0.746332
D.truncata,167897087,VNJQ01000385.1,1,34289,0.000204226,125341234,0.746536
D.truncata,167897087,VNJQ01001325.1,1,34180,0.000203577,125375414,0.74674
D.truncata,167897087,VNJQ01007412.1,1,34138,0.000203327,125409552,0.746943
D.truncata,167897087,VNJQ01002097.1,1,34100,0.000203101,125443652,0.747146
D.truncata,167897087,VNJQ01003570.1,1,34083,0.000202999,125477735,0.747349
D.truncata,167897087,VNJQ01004165.1,1,34074,0.000202946,125511809,0.747552
D.truncata,167897087,VNJQ01006055.1,1,33954,0.000202231,125545763,0.747754
D.truncata,167897087,VNJQ01008069.1,1,33921,0.000202034,125579684,0.747956
D.truncata,167897087,VNJQ01002631.1,1,33884,0.000201814,125613568,0.748158
D.truncata,167897087,VNJQ01005032.1,1,33783,0.000201213,125647351,0.748359
D.truncata,167897087,VNJQ01005584.1,1,33723,0.000200855,125681074,0.74856
D.truncata,167897087,VNJQ01002907.1,1,33696,0.000200694,125714770,0.748761
D.truncata,167897087,VNJQ01004791.1,1,33639,0.000200355,125748409,0.748961
D.truncata,167897087,VNJQ01007372.1,1,33599,0.000200117,125782008,0.749161
D.truncata,167897087,VNJQ01002574.1,1,33517,0.000199628,125815525,0.749361
D.truncata,167897087,VNJQ01000442.1,1,33440,0.00019917,125848965,0.74956
D.truncata,167897087,VNJQ01004447.1,1,33430,0.00019911,125882395,0.749759
D.truncata,167897087,VNJQ01007883.1,1,33367,0.000198735,125915762,0.749958
D.truncata,167897087,VNJQ01005758.1,1,33268,0.000198145,125949030,0.750156
D.truncata,167897087,VNJQ01001255.1,1,33260,0.000198098,125982290,0.750354
D.truncata,167897087,VNJQ01004494.1,1,33148,0.00019743,126015438,0.750552
D.truncata,167897087,VNJQ01005192.1,1,33134,0.000197347,126048572,0.750749
D.truncata,167897087,VNJQ01007024.1,1,33063,0.000196924,126081635,0.750946
D.truncata,167897087,VNJQ01004046.1,1,33062,0.000196918,126114697,0.751143
D.truncata,167897087,VNJQ01001577.1,1,33062,0.000196918,126147759,0.75134
D.truncata,167897087,VNJQ01003516.1,1,33027,0.00019671,126180786,0.751536
D.truncata,167897087,VNJQ01004996.1,1,32954,0.000196275,126213740,0.751733
D.truncata,167897087,VNJQ01005564.1,1,32915,0.000196043,126246655,0.751929
D.truncata,167897087,VNJQ01004424.1,1,32913,0.000196031,126279568,0.752125
D.truncata,167897087,VNJQ01001596.1,1,32762,0.000195131,126312330,0.75232
D.truncata,167897087,VNJQ01002838.1,1,32744,0.000195024,126345074,0.752515
D.truncata,167897087,VNJQ01001540.1,1,32727,0.000194923,126377801,0.75271
D.truncata,167897087,VNJQ01007266.1,1,32648,0.000194452,126410449,0.752904
D.truncata,167897087,VNJQ01007816.1,1,32630,0.000194345,126443079,0.753099
D.truncata,167897087,VNJQ01004648.1,1,32614,0.00019425,126475693,0.753293
D.truncata,167897087,VNJQ01007533.1,1,32463,0.000193351,126508156,0.753486
D.truncata,167897087,VNJQ01002375.1,1,32442,0.000193226,126540598,0.75368
D.truncata,167897087,VNJQ01005997.1,1,32371,0.000192803,126572969,0.753872
D.truncata,167897087,VNJQ01005884.1,1,32363,0.000192755,126605332,0.754065
D.truncata,167897087,VNJQ01006535.1,1,32362,0.000192749,126637694,0.754258
D.truncata,167897087,VNJQ01006792.1,1,32275,0.000192231,126669969,0.75445
D.truncata,167897087,VNJQ01007374.1,1,32187,0.000191707,126702156,0.754642
D.truncata,167897087,VNJQ01004686.1,1,32060,0.00019095,126734216,0.754833
D.truncata,167897087,VNJQ01004224.1,1,31913,0.000190075,126766129,0.755023
D.truncata,167897087,VNJQ01003203.1,1,31884,0.000189902,126798013,0.755213
D.truncata,167897087,VNJQ01000539.1,1,31770,0.000189223,126829783,0.755402
D.truncata,167897087,VNJQ01007379.1,1,31725,0.000188955,126861508,0.755591
D.truncata,167897087,VNJQ01007581.1,1,31701,0.000188812,126893209,0.75578
D.truncata,167897087,VNJQ01007238.1,1,31653,0.000188526,126924862,0.755968
D.truncata,167897087,VNJQ01006824.1,1,31653,0.000188526,126956515,0.756157
D.truncata,167897087,VNJQ01003201.1,1,31637,0.000188431,126988152,0.756345
D.truncata,167897087,VNJQ01006163.1,1,31626,0.000188365,127019778,0.756534
D.truncata,167897087,VNJQ01002423.1,1,31549,0.000187907,127051327,0.756721
D.truncata,167897087,VNJQ01002997.1,1,31490,0.000187555,127082817,0.756909
D.truncata,167897087,VNJQ01007696.1,1,31475,0.000187466,127114292,0.757096
D.truncata,167897087,VNJQ01003359.1,1,31425,0.000187168,127145717,0.757284
D.truncata,167897087,VNJQ01007984.1,1,31411,0.000187085,127177128,0.757471
D.truncata,167897087,VNJQ01004558.1,1,31266,0.000186221,127208394,0.757657
D.truncata,167897087,VNJQ01005712.1,1,31239,0.00018606,127239633,0.757843
D.truncata,167897087,VNJQ01007378.1,1,31238,0.000186054,127270871,0.758029
D.truncata,167897087,VNJQ01007947.1,1,31139,0.000185465,127302010,0.758215
D.truncata,167897087,VNJQ01002481.1,1,30999,0.000184631,127333009,0.758399
D.truncata,167897087,VNJQ01002369.1,1,30874,0.000183886,127363883,0.758583
D.truncata,167897087,VNJQ01002443.1,1,30870,0.000183863,127394753,0.758767
D.truncata,167897087,VNJQ01006437.1,1,30826,0.000183601,127425579,0.758951
D.truncata,167897087,VNJQ01007525.1,1,30799,0.00018344,127456378,0.759134
D.truncata,167897087,VNJQ01004645.1,1,30795,0.000183416,127487173,0.759317
D.truncata,167897087,VNJQ01007380.1,1,30763,0.000183225,127517936,0.759501
D.truncata,167897087,VNJQ01000040.1,1,30736,0.000183065,127548672,0.759684
D.truncata,167897087,VNJQ01000631.1,1,30723,0.000182987,127579395,0.759867
D.truncata,167897087,VNJQ01003758.1,1,30670,0.000182671,127610065,0.760049
D.truncata,167897087,VNJQ01000285.1,1,30591,0.000182201,127640656,0.760232
D.truncata,167897087,VNJQ01008063.1,1,30578,0.000182123,127671234,0.760414
D.truncata,167897087,VNJQ01007269.1,1,30535,0.000181867,127701769,0.760596
D.truncata,167897087,VNJQ01004518.1,1,30506,0.000181695,127732275,0.760777
D.truncata,167897087,VNJQ01000171.1,1,30506,0.000181695,127762781,0.760959
D.truncata,167897087,VNJQ01005867.1,1,30410,0.000181123,127793191,0.76114
D.truncata,167897087,VNJQ01003535.1,1,30392,0.000181016,127823583,0.761321
D.truncata,167897087,VNJQ01000731.1,1,30342,0.000180718,127853925,0.761502
D.truncata,167897087,VNJQ01006204.1,1,30300,0.000180468,127884225,0.761682
D.truncata,167897087,VNJQ01001261.1,1,30264,0.000180253,127914489,0.761862
D.truncata,167897087,VNJQ01003484.1,1,30245,0.00018014,127944734,0.762043
D.truncata,167897087,VNJQ01006893.1,1,30140,0.000179515,127974874,0.762222
D.truncata,167897087,VNJQ01007018.1,1,30031,0.000178866,128004905,0.762401
D.truncata,167897087,VNJQ01000172.1,1,29922,0.000178216,128034827,0.762579
D.truncata,167897087,VNJQ01003104.1,1,29892,0.000178038,128064719,0.762757
D.truncata,167897087,VNJQ01001687.1,1,29889,0.00017802,128094608,0.762935
D.truncata,167897087,VNJQ01007002.1,1,29848,0.000177776,128124456,0.763113
D.truncata,167897087,VNJQ01004173.1,1,29786,0.000177406,128154242,0.76329
D.truncata,167897087,VNJQ01003750.1,1,29779,0.000177365,128184021,0.763468
D.truncata,167897087,VNJQ01003405.1,1,29691,0.00017684,128213712,0.763645
D.truncata,167897087,VNJQ01003558.1,1,29637,0.000176519,128243349,0.763821
D.truncata,167897087,VNJQ01006533.1,1,29633,0.000176495,128272982,0.763998
D.truncata,167897087,VNJQ01000039.1,1,29549,0.000175995,128302531,0.764174
D.truncata,167897087,VNJQ01006356.1,1,29507,0.000175745,128332038,0.764349
D.truncata,167897087,VNJQ01003102.1,1,29480,0.000175584,128361518,0.764525
D.truncata,167897087,VNJQ01007236.1,1,29479,0.000175578,128390997,0.764701
D.truncata,167897087,VNJQ01000087.1,1,29466,0.0001755,128420463,0.764876
D.truncata,167897087,VNJQ01005183.1,1,29457,0.000175447,128449920,0.765052
D.truncata,167897087,VNJQ01000516.1,1,29410,0.000175167,128479330,0.765227
D.truncata,167897087,VNJQ01003361.1,1,29240,0.000174154,128508570,0.765401
D.truncata,167897087,VNJQ01005381.1,1,29214,0.000173999,128537784,0.765575
D.truncata,167897087,VNJQ01004781.1,1,29194,0.00017388,128566978,0.765749
D.truncata,167897087,VNJQ01006228.1,1,29167,0.00017372,128596145,0.765922
D.truncata,167897087,VNJQ01007647.1,1,29115,0.00017341,128625260,0.766096
D.truncata,167897087,VNJQ01003024.1,1,29033,0.000172921,128654293,0.766269
D.truncata,167897087,VNJQ01007614.1,1,29025,0.000172874,128683318,0.766442
D.truncata,167897087,VNJQ01007367.1,1,28965,0.000172516,128712283,0.766614
D.truncata,167897087,VNJQ01007416.1,1,28950,0.000172427,128741233,0.766787
D.truncata,167897087,VNJQ01008087.1,1,28925,0.000172278,128770158,0.766959
D.truncata,167897087,VNJQ01002189.1,1,28909,0.000172183,128799067,0.767131
D.truncata,167897087,VNJQ01006938.1,1,28905,0.000172159,128827972,0.767303
D.truncata,167897087,VNJQ01003316.1,1,28902,0.000172141,128856874,0.767475
D.truncata,167897087,VNJQ01007646.1,1,28877,0.000171992,128885751,0.767647
D.truncata,167897087,VNJQ01007644.1,1,28873,0.000171968,128914624,0.767819
D.truncata,167897087,VNJQ01004609.1,1,28870,0.000171951,128943494,0.767991
D.truncata,167897087,VNJQ01004765.1,1,28721,0.000171063,128972215,0.768162
D.truncata,167897087,VNJQ01002037.1,1,28692,0.00017089,129000907,0.768333
D.truncata,167897087,VNJQ01002036.1,1,28685,0.000170849,129029592,0.768504
D.truncata,167897087,VNJQ01003894.1,1,28579,0.000170217,129058171,0.768674
D.truncata,167897087,VNJQ01001068.1,1,28547,0.000170027,129086718,0.768844
D.truncata,167897087,VNJQ01008194.1,1,28546,0.000170021,129115264,0.769014
D.truncata,167897087,VNJQ01006807.1,1,28518,0.000169854,129143782,0.769184
D.truncata,167897087,VNJQ01006388.1,1,28449,0.000169443,129172231,0.769354
D.truncata,167897087,VNJQ01006741.1,1,28374,0.000168996,129200605,0.769523
D.truncata,167897087,VNJQ01005450.1,1,28252,0.00016827,129228857,0.769691
D.truncata,167897087,VNJQ01000579.1,1,28248,0.000168246,129257105,0.769859
D.truncata,167897087,VNJQ01001407.1,1,28238,0.000168186,129285343,0.770027
D.truncata,167897087,VNJQ01007851.1,1,28210,0.00016802,129313553,0.770195
D.truncata,167897087,VNJQ01001263.1,1,28189,0.000167895,129341742,0.770363
D.truncata,167897087,VNJQ01004133.1,1,28127,0.000167525,129369869,0.770531
D.truncata,167897087,VNJQ01007272.1,1,28086,0.000167281,129397955,0.770698
D.truncata,167897087,VNJQ01004927.1,1,28055,0.000167096,129426010,0.770865
D.truncata,167897087,VNJQ01006791.1,1,28048,0.000167055,129454058,0.771032
D.truncata,167897087,VNJQ01002848.1,1,27981,0.000166656,129482039,0.771199
D.truncata,167897087,VNJQ01002035.1,1,27946,0.000166447,129509985,0.771365
D.truncata,167897087,VNJQ01007270.1,1,27890,0.000166114,129537875,0.771531
D.truncata,167897087,VNJQ01001195.1,1,27847,0.000165858,129565722,0.771697
D.truncata,167897087,VNJQ01008136.1,1,27836,0.000165792,129593558,0.771863
D.truncata,167897087,VNJQ01006625.1,1,27826,0.000165732,129621384,0.772029
D.truncata,167897087,VNJQ01006487.1,1,27815,0.000165667,129649199,0.772194
D.truncata,167897087,VNJQ01003117.1,1,27805,0.000165607,129677004,0.77236
D.truncata,167897087,VNJQ01005805.1,1,27756,0.000165316,129704760,0.772525
D.truncata,167897087,VNJQ01004599.1,1,27713,0.000165059,129732473,0.77269
D.truncata,167897087,VNJQ01000471.1,1,27630,0.000164565,129760103,0.772855
D.truncata,167897087,VNJQ01001203.1,1,27593,0.000164345,129787696,0.773019
D.truncata,167897087,VNJQ01007985.1,1,27589,0.000164321,129815285,0.773184
D.truncata,167897087,VNJQ01006492.1,1,27545,0.000164059,129842830,0.773348
D.truncata,167897087,VNJQ01005644.1,1,27535,0.000163999,129870365,0.773512
D.truncata,167897087,VNJQ01004651.1,1,27527,0.000163952,129897892,0.773676
D.truncata,167897087,VNJQ01001110.1,1,27444,0.000163457,129925336,0.773839
D.truncata,167897087,VNJQ01004163.1,1,27431,0.00016338,129952767,0.774003
D.truncata,167897087,VNJQ01000692.1,1,27382,0.000163088,129980149,0.774166
D.truncata,167897087,VNJQ01008088.1,1,27372,0.000163028,130007521,0.774329
D.truncata,167897087,VNJQ01007264.1,1,27278,0.000162469,130034799,0.774491
D.truncata,167897087,VNJQ01002561.1,1,27277,0.000162463,130062076,0.774654
D.truncata,167897087,VNJQ01003195.1,1,27260,0.000162361,130089336,0.774816
D.truncata,167897087,VNJQ01007651.1,1,27258,0.000162349,130116594,0.774978
D.truncata,167897087,VNJQ01006945.1,1,27201,0.00016201,130143795,0.77514
D.truncata,167897087,VNJQ01006309.1,1,27157,0.000161748,130170952,0.775302
D.truncata,167897087,VNJQ01007652.1,1,27141,0.000161653,130198093,0.775464
D.truncata,167897087,VNJQ01007220.1,1,27122,0.000161539,130225215,0.775625
D.truncata,167897087,VNJQ01002913.1,1,27079,0.000161283,130252294,0.775787
D.truncata,167897087,VNJQ01005250.1,1,27014,0.000160896,130279308,0.775947
D.truncata,167897087,VNJQ01001477.1,1,26933,0.000160414,130306241,0.776108
D.truncata,167897087,VNJQ01007641.1,1,26889,0.000160152,130333130,0.776268
D.truncata,167897087,VNJQ01003358.1,1,26856,0.000159955,130359986,0.776428
D.truncata,167897087,VNJQ01003212.1,1,26707,0.000159068,130386693,0.776587
D.truncata,167897087,VNJQ01001370.1,1,26700,0.000159026,130413393,0.776746
D.truncata,167897087,VNJQ01004961.1,1,26608,0.000158478,130440001,0.776904
D.truncata,167897087,VNJQ01005873.1,1,26521,0.00015796,130466522,0.777062
D.truncata,167897087,VNJQ01002534.1,1,26464,0.00015762,130492986,0.77722
D.truncata,167897087,VNJQ01008156.1,1,26418,0.000157346,130519404,0.777377
D.truncata,167897087,VNJQ01007404.1,1,26411,0.000157305,130545815,0.777535
D.truncata,167897087,VNJQ01003364.1,1,26379,0.000157114,130572194,0.777692
D.truncata,167897087,VNJQ01003331.1,1,26306,0.000156679,130598500,0.777849
D.truncata,167897087,VNJQ01004498.1,1,26237,0.000156268,130624737,0.778005
D.truncata,167897087,VNJQ01005205.1,1,26223,0.000156185,130650960,0.778161
D.truncata,167897087,VNJQ01004523.1,1,26205,0.000156078,130677165,0.778317
D.truncata,167897087,VNJQ01005645.1,1,26077,0.000155315,130703242,0.778472
D.truncata,167897087,VNJQ01005124.1,1,26001,0.000154863,130729243,0.778627
D.truncata,167897087,VNJQ01005580.1,1,25991,0.000154803,130755234,0.778782
D.truncata,167897087,VNJQ01002124.1,1,25988,0.000154785,130781222,0.778937
D.truncata,167897087,VNJQ01007877.1,1,25934,0.000154464,130807156,0.779091
D.truncata,167897087,VNJQ01002098.1,1,25914,0.000154345,130833070,0.779246
D.truncata,167897087,VNJQ01003454.1,1,25894,0.000154225,130858964,0.7794
D.truncata,167897087,VNJQ01003494.1,1,25879,0.000154136,130884843,0.779554
D.truncata,167897087,VNJQ01007242.1,1,25870,0.000154082,130910713,0.779708
D.truncata,167897087,VNJQ01001988.1,1,25854,0.000153987,130936567,0.779862
D.truncata,167897087,VNJQ01007282.1,1,25837,0.000153886,130962404,0.780016
D.truncata,167897087,VNJQ01001469.1,1,25829,0.000153838,130988233,0.78017
D.truncata,167897087,VNJQ01005031.1,1,25818,0.000153773,131014051,0.780324
D.truncata,167897087,VNJQ01004847.1,1,25814,0.000153749,131039865,0.780477
D.truncata,167897087,VNJQ01007925.1,1,25792,0.000153618,131065657,0.780631
D.truncata,167897087,VNJQ01003517.1,1,25598,0.000152462,131091255,0.780783
D.truncata,167897087,VNJQ01000226.1,1,25476,0.000151736,131116731,0.780935
D.truncata,167897087,VNJQ01007946.1,1,25454,0.000151605,131142185,0.781087
D.truncata,167897087,VNJQ01004958.1,1,25408,0.000151331,131167593,0.781238
D.truncata,167897087,VNJQ01003119.1,1,25372,0.000151116,131192965,0.781389
D.truncata,167897087,VNJQ01005770.1,1,25359,0.000151039,131218324,0.78154
D.truncata,167897087,VNJQ01005296.1,1,25336,0.000150902,131243660,0.781691
D.truncata,167897087,VNJQ01000955.1,1,25311,0.000150753,131268971,0.781842
D.truncata,167897087,VNJQ01007950.1,1,25205,0.000150122,131294176,0.781992
D.truncata,167897087,VNJQ01000047.1,1,25117,0.000149598,131319293,0.782142
D.truncata,167897087,VNJQ01005861.1,1,25114,0.00014958,131344407,0.782291
D.truncata,167897087,VNJQ01005635.1,1,25052,0.00014921,131369459,0.78244
D.truncata,167897087,VNJQ01003177.1,1,24994,0.000148865,131394453,0.782589
D.truncata,167897087,VNJQ01008140.1,1,24976,0.000148758,131419429,0.782738
D.truncata,167897087,VNJQ01001947.1,1,24944,0.000148567,131444373,0.782887
D.truncata,167897087,VNJQ01006377.1,1,24934,0.000148508,131469307,0.783035
D.truncata,167897087,VNJQ01005227.1,1,24902,0.000148317,131494209,0.783183
D.truncata,167897087,VNJQ01003944.1,1,24713,0.000147191,131518922,0.783331
D.truncata,167897087,VNJQ01004580.1,1,24694,0.000147078,131543616,0.783478
D.truncata,167897087,VNJQ01001594.1,1,24679,0.000146989,131568295,0.783625
D.truncata,167897087,VNJQ01005661.1,1,24657,0.000146858,131592952,0.783772
D.truncata,167897087,VNJQ01007127.1,1,24607,0.00014656,131617559,0.783918
D.truncata,167897087,VNJQ01006703.1,1,24568,0.000146328,131642127,0.784064
D.truncata,167897087,VNJQ01003823.1,1,24549,0.000146215,131666676,0.784211
D.truncata,167897087,VNJQ01006442.1,1,24510,0.000145982,131691186,0.784357
D.truncata,167897087,VNJQ01001589.1,1,24471,0.00014575,131715657,0.784502
D.truncata,167897087,VNJQ01003057.1,1,24448,0.000145613,131740105,0.784648
D.truncata,167897087,VNJQ01007597.1,1,24436,0.000145542,131764541,0.784793
D.truncata,167897087,VNJQ01000387.1,1,24395,0.000145297,131788936,0.784939
D.truncata,167897087,VNJQ01007284.1,1,24390,0.000145268,131813326,0.785084
D.truncata,167897087,VNJQ01002878.1,1,24388,0.000145256,131837714,0.785229
D.truncata,167897087,VNJQ01004416.1,1,24371,0.000145154,131862085,0.785374
D.truncata,167897087,VNJQ01002564.1,1,24356,0.000145065,131886441,0.78552
D.truncata,167897087,VNJQ01003759.1,1,24339,0.000144964,131910780,0.785664
D.truncata,167897087,VNJQ01006554.1,1,24306,0.000144767,131935086,0.785809
D.truncata,167897087,VNJQ01001507.1,1,24256,0.000144469,131959342,0.785954
D.truncata,167897087,VNJQ01007550.1,1,24246,0.00014441,131983588,0.786098
D.truncata,167897087,VNJQ01007512.1,1,24176,0.000143993,132007764,0.786242
D.truncata,167897087,VNJQ01004177.1,1,24146,0.000143814,132031910,0.786386
D.truncata,167897087,VNJQ01002697.1,1,24139,0.000143773,132056049,0.78653
D.truncata,167897087,VNJQ01004507.1,1,24098,0.000143528,132080147,0.786673
D.truncata,167897087,VNJQ01000156.1,1,24008,0.000142992,132104155,0.786816
D.truncata,167897087,VNJQ01001581.1,1,23903,0.000142367,132128058,0.786959
D.truncata,167897087,VNJQ01005034.1,1,23897,0.000142331,132151955,0.787101
D.truncata,167897087,VNJQ01008203.1,1,23796,0.00014173,132175751,0.787243
D.truncata,167897087,VNJQ01004630.1,1,23739,0.00014139,132199490,0.787384
D.truncata,167897087,VNJQ01000059.1,1,23718,0.000141265,132223208,0.787525
D.truncata,167897087,VNJQ01007870.1,1,23703,0.000141176,132246911,0.787667
D.truncata,167897087,VNJQ01005158.1,1,23640,0.000140801,132270551,0.787807
D.truncata,167897087,VNJQ01000352.1,1,23630,0.000140741,132294181,0.787948
D.truncata,167897087,VNJQ01004683.1,1,23623,0.000140699,132317804,0.788089
D.truncata,167897087,VNJQ01000546.1,1,23617,0.000140664,132341421,0.788229
D.truncata,167897087,VNJQ01007990.1,1,23607,0.000140604,132365028,0.78837
D.truncata,167897087,VNJQ01006673.1,1,23575,0.000140413,132388603,0.78851
D.truncata,167897087,VNJQ01005210.1,1,23573,0.000140401,132412176,0.788651
D.truncata,167897087,VNJQ01003336.1,1,23519,0.00014008,132435695,0.788791
D.truncata,167897087,VNJQ01004023.1,1,23408,0.000139419,132459103,0.78893
D.truncata,167897087,VNJQ01000035.1,1,23351,0.000139079,132482454,0.789069
D.truncata,167897087,VNJQ01006267.1,1,23322,0.000138907,132505776,0.789208
D.truncata,167897087,VNJQ01001755.1,1,23288,0.000138704,132529064,0.789347
D.truncata,167897087,VNJQ01002141.1,1,23244,0.000138442,132552308,0.789485
D.truncata,167897087,VNJQ01005876.1,1,23205,0.00013821,132575513,0.789624
D.truncata,167897087,VNJQ01003033.1,1,23193,0.000138138,132598706,0.789762
D.truncata,167897087,VNJQ01007943.1,1,23173,0.000138019,132621879,0.7899
D.truncata,167897087,VNJQ01007480.1,1,23145,0.000137852,132645024,0.790038
D.truncata,167897087,VNJQ01003709.1,1,23056,0.000137322,132668080,0.790175
D.truncata,167897087,VNJQ01006386.1,1,23047,0.000137269,132691127,0.790312
D.truncata,167897087,VNJQ01006725.1,1,23015,0.000137078,132714142,0.790449
D.truncata,167897087,VNJQ01005215.1,1,23015,0.000137078,132737157,0.790586
D.truncata,167897087,VNJQ01005688.1,1,23000,0.000136989,132760157,0.790723
D.truncata,167897087,VNJQ01005235.1,1,22970,0.00013681,132783127,0.79086
D.truncata,167897087,VNJQ01005425.1,1,22906,0.000136429,132806033,0.790997
D.truncata,167897087,VNJQ01000995.1,1,22894,0.000136357,132828927,0.791133
D.truncata,167897087,VNJQ01002705.1,1,22825,0.000135946,132851752,0.791269
D.truncata,167897087,VNJQ01002923.1,1,22822,0.000135929,132874574,0.791405
D.truncata,167897087,VNJQ01000072.1,1,22818,0.000135905,132897392,0.791541
D.truncata,167897087,VNJQ01007869.1,1,22676,0.000135059,132920068,0.791676
D.truncata,167897087,VNJQ01003711.1,1,22597,0.000134588,132942665,0.79181
D.truncata,167897087,VNJQ01003483.1,1,22584,0.000134511,132965249,0.791945
D.truncata,167897087,VNJQ01005508.1,1,22391,0.000133361,132987640,0.792078
D.truncata,167897087,VNJQ01003891.1,1,22358,0.000133165,133009998,0.792211
D.truncata,167897087,VNJQ01002925.1,1,22299,0.000132814,133032297,0.792344
D.truncata,167897087,VNJQ01001731.1,1,22282,0.000132712,133054579,0.792477
D.truncata,167897087,VNJQ01005552.1,1,22264,0.000132605,133076843,0.79261
D.truncata,167897087,VNJQ01003264.1,1,22207,0.000132266,133099050,0.792742
D.truncata,167897087,VNJQ01004880.1,1,22182,0.000132117,133121232,0.792874
D.truncata,167897087,VNJQ01007938.1,1,22170,0.000132045,133143402,0.793006
D.truncata,167897087,VNJQ01003946.1,1,22165,0.000132015,133165567,0.793138
D.truncata,167897087,VNJQ01007369.1,1,22155,0.000131956,133187722,0.79327
D.truncata,167897087,VNJQ01000245.1,1,22148,0.000131914,133209870,0.793402
D.truncata,167897087,VNJQ01001001.1,1,22125,0.000131777,133231995,0.793534
D.truncata,167897087,VNJQ01002576.1,1,22120,0.000131747,133254115,0.793665
D.truncata,167897087,VNJQ01006067.1,1,22117,0.00013173,133276232,0.793797
D.truncata,167897087,VNJQ01000509.1,1,22094,0.000131593,133298326,0.793929
D.truncata,167897087,VNJQ01002394.1,1,22066,0.000131426,133320392,0.79406
D.truncata,167897087,VNJQ01003266.1,1,22058,0.000131378,133342450,0.794192
D.truncata,167897087,VNJQ01001213.1,1,22056,0.000131366,133364506,0.794323
D.truncata,167897087,VNJQ01000250.1,1,22051,0.000131336,133386557,0.794454
D.truncata,167897087,VNJQ01001230.1,1,22006,0.000131068,133408563,0.794585
D.truncata,167897087,VNJQ01007715.1,1,21996,0.000131009,133430559,0.794716
D.truncata,167897087,VNJQ01000574.1,1,21941,0.000130681,133452500,0.794847
D.truncata,167897087,VNJQ01007642.1,1,21937,0.000130657,133474437,0.794978
D.truncata,167897087,VNJQ01003012.1,1,21917,0.000130538,133496354,0.795108
D.truncata,167897087,VNJQ01001827.1,1,21823,0.000129978,133518177,0.795238
D.truncata,167897087,VNJQ01003276.1,1,21781,0.000129728,133539958,0.795368
D.truncata,167897087,VNJQ01006679.1,1,21705,0.000129276,133561663,0.795497
D.truncata,167897087,VNJQ01005983.1,1,21701,0.000129252,133583364,0.795626
D.truncata,167897087,VNJQ01002766.1,1,21663,0.000129025,133605027,0.795755
D.truncata,167897087,VNJQ01003582.1,1,21640,0.000128888,133626667,0.795884
D.truncata,167897087,VNJQ01006035.1,1,21611,0.000128716,133648278,0.796013
D.truncata,167897087,VNJQ01006739.1,1,21566,0.000128448,133669844,0.796142
D.truncata,167897087,VNJQ01003879.1,1,21529,0.000128227,133691373,0.79627
D.truncata,167897087,VNJQ01002250.1,1,21481,0.000127941,133712854,0.796398
D.truncata,167897087,VNJQ01003923.1,1,21460,0.000127816,133734314,0.796526
D.truncata,167897087,VNJQ01005885.1,1,21428,0.000127626,133755742,0.796653
D.truncata,167897087,VNJQ01001587.1,1,21399,0.000127453,133777141,0.796781
D.truncata,167897087,VNJQ01002172.1,1,21370,0.00012728,133798511,0.796908
D.truncata,167897087,VNJQ01003406.1,1,21351,0.000127167,133819862,0.797035
D.truncata,167897087,VNJQ01005755.1,1,21338,0.00012709,133841200,0.797162
D.truncata,167897087,VNJQ01004437.1,1,21327,0.000127024,133862527,0.797289
D.truncata,167897087,VNJQ01001117.1,1,21304,0.000126887,133883831,0.797416
D.truncata,167897087,VNJQ01007643.1,1,21291,0.00012681,133905122,0.797543
D.truncata,167897087,VNJQ01007989.1,1,21288,0.000126792,133926410,0.79767
D.truncata,167897087,VNJQ01004098.1,1,21288,0.000126792,133947698,0.797796
D.truncata,167897087,VNJQ01003893.1,1,21279,0.000126738,133968977,0.797923
D.truncata,167897087,VNJQ01001041.1,1,21277,0.000126726,133990254,0.79805
D.truncata,167897087,VNJQ01003055.1,1,21274,0.000126709,134011528,0.798177
D.truncata,167897087,VNJQ01001863.1,1,21274,0.000126709,134032802,0.798303
D.truncata,167897087,VNJQ01005466.1,1,21269,0.000126679,134054071,0.79843
D.truncata,167897087,VNJQ01007987.1,1,21266,0.000126661,134075337,0.798557
D.truncata,167897087,VNJQ01002052.1,1,21250,0.000126566,134096587,0.798683
D.truncata,167897087,VNJQ01003702.1,1,21246,0.000126542,134117833,0.79881
D.truncata,167897087,VNJQ01000794.1,1,21199,0.000126262,134139032,0.798936
D.truncata,167897087,VNJQ01007570.1,1,21192,0.00012622,134160224,0.799062
D.truncata,167897087,VNJQ01007065.1,1,21192,0.00012622,134181416,0.799188
D.truncata,167897087,VNJQ01007891.1,1,21186,0.000126184,134202602,0.799315
D.truncata,167897087,VNJQ01007876.1,1,21179,0.000126143,134223781,0.799441
D.truncata,167897087,VNJQ01005586.1,1,21177,0.000126131,134244958,0.799567
D.truncata,167897087,VNJQ01000029.1,1,21176,0.000126125,134266134,0.799693
D.truncata,167897087,VNJQ01003050.1,1,21171,0.000126095,134287305,0.799819
D.truncata,167897087,VNJQ01003707.1,1,21096,0.000125648,134308401,0.799945
D.truncata,167897087,VNJQ01004534.1,1,21092,0.000125625,134329493,0.80007
D.truncata,167897087,VNJQ01003836.1,1,21019,0.00012519,134350512,0.800196
D.truncata,167897087,VNJQ01004468.1,1,20986,0.000124993,134371498,0.800321
D.truncata,167897087,VNJQ01003028.1,1,20889,0.000124415,134392387,0.800445
D.truncata,167897087,VNJQ01000126.1,1,20871,0.000124308,134413258,0.800569
D.truncata,167897087,VNJQ01003170.1,1,20864,0.000124267,134434122,0.800694
D.truncata,167897087,VNJQ01002644.1,1,20857,0.000124225,134454979,0.800818
D.truncata,167897087,VNJQ01006869.1,1,20832,0.000124076,134475811,0.800942
D.truncata,167897087,VNJQ01005336.1,1,20823,0.000124022,134496634,0.801066
D.truncata,167897087,VNJQ01006453.1,1,20788,0.000123814,134517422,0.80119
D.truncata,167897087,VNJQ01004103.1,1,20772,0.000123719,134538194,0.801313
D.truncata,167897087,VNJQ01007154.1,1,20754,0.000123611,134558948,0.801437
D.truncata,167897087,VNJQ01002243.1,1,20746,0.000123564,134579694,0.801561
D.truncata,167897087,VNJQ01004760.1,1,20742,0.00012354,134600436,0.801684
D.truncata,167897087,VNJQ01002425.1,1,20731,0.000123474,134621167,0.801808
D.truncata,167897087,VNJQ01005237.1,1,20717,0.000123391,134641884,0.801931
D.truncata,167897087,VNJQ01002999.1,1,20712,0.000123361,134662596,0.802054
D.truncata,167897087,VNJQ01006155.1,1,20707,0.000123332,134683303,0.802178
D.truncata,167897087,VNJQ01004356.1,1,20662,0.000123063,134703965,0.802301
D.truncata,167897087,VNJQ01005954.1,1,20623,0.000122831,134724588,0.802424
D.truncata,167897087,VNJQ01008174.1,1,20609,0.000122748,134745197,0.802546
D.truncata,167897087,VNJQ01001887.1,1,20597,0.000122676,134765794,0.802669
D.truncata,167897087,VNJQ01005062.1,1,20584,0.000122599,134786378,0.802792
D.truncata,167897087,VNJQ01005060.1,1,20579,0.000122569,134806957,0.802914
D.truncata,167897087,VNJQ01004629.1,1,20574,0.000122539,134827531,0.803037
D.truncata,167897087,VNJQ01002966.1,1,20540,0.000122337,134848071,0.803159
D.truncata,167897087,VNJQ01005877.1,1,20525,0.000122248,134868596,0.803281
D.truncata,167897087,VNJQ01008179.1,1,20503,0.000122116,134889099,0.803403
D.truncata,167897087,VNJQ01003541.1,1,20502,0.000122111,134909601,0.803526
D.truncata,167897087,VNJQ01000676.1,1,20468,0.000121908,134930069,0.803647
D.truncata,167897087,VNJQ01002006.1,1,20467,0.000121902,134950536,0.803769
D.truncata,167897087,VNJQ01008212.1,1,20465,0.00012189,134971001,0.803891
D.truncata,167897087,VNJQ01004999.1,1,20412,0.000121574,134991413,0.804013
D.truncata,167897087,VNJQ01004425.1,1,20411,0.000121569,135011824,0.804134
D.truncata,167897087,VNJQ01001591.1,1,20383,0.000121402,135032207,0.804256
D.truncata,167897087,VNJQ01007562.1,1,20379,0.000121378,135052586,0.804377
D.truncata,167897087,VNJQ01004769.1,1,20364,0.000121289,135072950,0.804498
D.truncata,167897087,VNJQ01007058.1,1,20276,0.000120764,135093226,0.804619
D.truncata,167897087,VNJQ01004039.1,1,20276,0.000120764,135113502,0.80474
D.truncata,167897087,VNJQ01001588.1,1,20248,0.000120598,135133750,0.804861
D.truncata,167897087,VNJQ01000913.1,1,20232,0.000120502,135153982,0.804981
D.truncata,167897087,VNJQ01001842.1,1,20229,0.000120485,135174211,0.805102
D.truncata,167897087,VNJQ01001590.1,1,20225,0.000120461,135194436,0.805222
D.truncata,167897087,VNJQ01004575.1,1,20212,0.000120383,135214648,0.805342
D.truncata,167897087,VNJQ01000684.1,1,20207,0.000120353,135234855,0.805463
D.truncata,167897087,VNJQ01003895.1,1,20202,0.000120324,135255057,0.805583
D.truncata,167897087,VNJQ01002683.1,1,20198,0.0001203,135275255,0.805703
D.truncata,167897087,VNJQ01003094.1,1,20195,0.000120282,135295450,0.805824
D.truncata,167897087,VNJQ01007937.1,1,20166,0.000120109,135315616,0.805944
D.truncata,167897087,VNJQ01006040.1,1,20166,0.000120109,135335782,0.806064
D.truncata,167897087,VNJQ01006408.1,1,20106,0.000119752,135355888,0.806184
D.truncata,167897087,VNJQ01000222.1,1,20084,0.000119621,135375972,0.806303
D.truncata,167897087,VNJQ01001489.1,1,20062,0.00011949,135396034,0.806423
D.truncata,167897087,VNJQ01002939.1,1,20027,0.000119281,135416061,0.806542
D.truncata,167897087,VNJQ01001519.1,1,19956,0.000118859,135436017,0.806661
D.truncata,167897087,VNJQ01003799.1,1,19913,0.000118602,135455930,0.80678
D.truncata,167897087,VNJQ01001007.1,1,19888,0.000118454,135475818,0.806898
D.truncata,167897087,VNJQ01003955.1,1,19880,0.000118406,135495698,0.807016
D.truncata,167897087,VNJQ01008075.1,1,19815,0.000118019,135515513,0.807134
D.truncata,167897087,VNJQ01000411.1,1,19812,0.000118001,135535325,0.807252
D.truncata,167897087,VNJQ01001051.1,1,19792,0.000117882,135555117,0.80737
D.truncata,167897087,VNJQ01002924.1,1,19731,0.000117518,135574848,0.807488
D.truncata,167897087,VNJQ01006120.1,1,19724,0.000117477,135594572,0.807605
D.truncata,167897087,VNJQ01002039.1,1,19716,0.000117429,135614288,0.807723
D.truncata,167897087,VNJQ01002779.1,1,19715,0.000117423,135634003,0.80784
D.truncata,167897087,VNJQ01000797.1,1,19710,0.000117393,135653713,0.807958
D.truncata,167897087,VNJQ01006815.1,1,19700,0.000117334,135673413,0.808075
D.truncata,167897087,VNJQ01005365.1,1,19653,0.000117054,135693066,0.808192
D.truncata,167897087,VNJQ01001864.1,1,19632,0.000116929,135712698,0.808309
D.truncata,167897087,VNJQ01000118.1,1,19620,0.000116857,135732318,0.808426
D.truncata,167897087,VNJQ01004428.1,1,19612,0.00011681,135751930,0.808542
D.truncata,167897087,VNJQ01004909.1,1,19596,0.000116714,135771526,0.808659
D.truncata,167897087,VNJQ01003900.1,1,19588,0.000116667,135791114,0.808776
D.truncata,167897087,VNJQ01000463.1,1,19586,0.000116655,135810700,0.808893
D.truncata,167897087,VNJQ01001148.1,1,19585,0.000116649,135830285,0.809009
D.truncata,167897087,VNJQ01005943.1,1,19576,0.000116595,135849861,0.809126
D.truncata,167897087,VNJQ01006117.1,1,19544,0.000116405,135869405,0.809242
D.truncata,167897087,VNJQ01000190.1,1,19495,0.000116113,135888900,0.809358
D.truncata,167897087,VNJQ01004631.1,1,19485,0.000116053,135908385,0.809474
D.truncata,167897087,VNJQ01004515.1,1,19409,0.000115601,135927794,0.80959
D.truncata,167897087,VNJQ01004273.1,1,19407,0.000115589,135947201,0.809706
D.truncata,167897087,VNJQ01001348.1,1,19345,0.000115219,135966546,0.809821
D.truncata,167897087,VNJQ01004495.1,1,19313,0.000115029,135985859,0.809936
D.truncata,167897087,VNJQ01004277.1,1,19310,0.000115011,136005169,0.810051
D.truncata,167897087,VNJQ01005833.1,1,19272,0.000114785,136024441,0.810166
D.truncata,167897087,VNJQ01004764.1,1,19239,0.000114588,136043680,0.81028
D.truncata,167897087,VNJQ01004931.1,1,19198,0.000114344,136062878,0.810395
D.truncata,167897087,VNJQ01000494.1,1,19177,0.000114219,136082055,0.810509
D.truncata,167897087,VNJQ01000187.1,1,19177,0.000114219,136101232,0.810623
D.truncata,167897087,VNJQ01000928.1,1,19078,0.000113629,136120310,0.810737
D.truncata,167897087,VNJQ01003767.1,1,19038,0.000113391,136139348,0.81085
D.truncata,167897087,VNJQ01000929.1,1,19028,0.000113331,136158376,0.810963
D.truncata,167897087,VNJQ01000461.1,1,19016,0.00011326,136177392,0.811077
D.truncata,167897087,VNJQ01001917.1,1,19004,0.000113188,136196396,0.81119
D.truncata,167897087,VNJQ01006953.1,1,18951,0.000112873,136215347,0.811303
D.truncata,167897087,VNJQ01000240.1,1,18925,0.000112718,136234272,0.811415
D.truncata,167897087,VNJQ01005626.1,1,18892,0.000112521,136253164,0.811528
D.truncata,167897087,VNJQ01003824.1,1,18871,0.000112396,136272035,0.81164
D.truncata,167897087,VNJQ01004608.1,1,18861,0.000112337,136290896,0.811753
D.truncata,167897087,VNJQ01000642.1,1,18780,0.000111854,136309676,0.811864
D.truncata,167897087,VNJQ01008171.1,1,18778,0.000111842,136328454,0.811976
D.truncata,167897087,VNJQ01004442.1,1,18725,0.000111527,136347179,0.812088
D.truncata,167897087,VNJQ01003555.1,1,18668,0.000111187,136365847,0.812199
D.truncata,167897087,VNJQ01004902.1,1,18650,0.00011108,136384497,0.81231
D.truncata,167897087,VNJQ01001972.1,1,18634,0.000110985,136403131,0.812421
D.truncata,167897087,VNJQ01005468.1,1,18628,0.000110949,136421759,0.812532
D.truncata,167897087,VNJQ01003297.1,1,18622,0.000110913,136440381,0.812643
D.truncata,167897087,VNJQ01001535.1,1,18594,0.000110746,136458975,0.812754
D.truncata,167897087,VNJQ01006994.1,1,18593,0.00011074,136477568,0.812864
D.truncata,167897087,VNJQ01001199.1,1,18566,0.00011058,136496134,0.812975
D.truncata,167897087,VNJQ01000294.1,1,18564,0.000110568,136514698,0.813086
D.truncata,167897087,VNJQ01006861.1,1,18532,0.000110377,136533230,0.813196
D.truncata,167897087,VNJQ01005251.1,1,18485,0.000110097,136551715,0.813306
D.truncata,167897087,VNJQ01006576.1,1,18477,0.00011005,136570192,0.813416
D.truncata,167897087,VNJQ01004144.1,1,18472,0.00011002,136588664,0.813526
D.truncata,167897087,VNJQ01003223.1,1,18459,0.000109942,136607123,0.813636
D.truncata,167897087,VNJQ01004898.1,1,18415,0.00010968,136625538,0.813746
D.truncata,167897087,VNJQ01000447.1,1,18317,0.000109097,136643855,0.813855
D.truncata,167897087,VNJQ01003712.1,1,18311,0.000109061,136662166,0.813964
D.truncata,167897087,VNJQ01006865.1,1,18303,0.000109013,136680469,0.814073
D.truncata,167897087,VNJQ01000637.1,1,18292,0.000108948,136698761,0.814182
D.truncata,167897087,VNJQ01004948.1,1,18268,0.000108805,136717029,0.814291
D.truncata,167897087,VNJQ01003026.1,1,18261,0.000108763,136735290,0.814399
D.truncata,167897087,VNJQ01007223.1,1,18221,0.000108525,136753511,0.814508
D.truncata,167897087,VNJQ01008092.1,1,18220,0.000108519,136771731,0.814616
D.truncata,167897087,VNJQ01004944.1,1,18198,0.000108388,136789929,0.814725
D.truncata,167897087,VNJQ01007800.1,1,18169,0.000108215,136808098,0.814833
D.truncata,167897087,VNJQ01007978.1,1,18148,0.00010809,136826246,0.814941
D.truncata,167897087,VNJQ01001787.1,1,18133,0.000108001,136844379,0.815049
D.truncata,167897087,VNJQ01001296.1,1,18122,0.000107935,136862501,0.815157
D.truncata,167897087,VNJQ01000488.1,1,18108,0.000107852,136880609,0.815265
D.truncata,167897087,VNJQ01007593.1,1,18102,0.000107816,136898711,0.815373
D.truncata,167897087,VNJQ01004949.1,1,18062,0.000107578,136916773,0.81548
D.truncata,167897087,VNJQ01000026.1,1,18004,0.000107232,136934777,0.815588
D.truncata,167897087,VNJQ01000397.1,1,17998,0.000107197,136952775,0.815695
D.truncata,167897087,VNJQ01003975.1,1,17978,0.000107077,136970753,0.815802
D.truncata,167897087,VNJQ01004615.1,1,17966,0.000107006,136988719,0.815909
D.truncata,167897087,VNJQ01003919.1,1,17955,0.000106941,137006674,0.816016
D.truncata,167897087,VNJQ01000727.1,1,17943,0.000106869,137024617,0.816123
D.truncata,167897087,VNJQ01001823.1,1,17941,0.000106857,137042558,0.81623
D.truncata,167897087,VNJQ01007863.1,1,17940,0.000106851,137060498,0.816336
D.truncata,167897087,VNJQ01007339.1,1,17933,0.000106809,137078431,0.816443
D.truncata,167897087,VNJQ01004885.1,1,17869,0.000106428,137096300,0.81655
D.truncata,167897087,VNJQ01005113.1,1,17855,0.000106345,137114155,0.816656
D.truncata,167897087,VNJQ01000273.1,1,17829,0.00010619,137131984,0.816762
D.truncata,167897087,VNJQ01006217.1,1,17805,0.000106047,137149789,0.816868
D.truncata,167897087,VNJQ01005233.1,1,17797,0.000105999,137167586,0.816974
D.truncata,167897087,VNJQ01003753.1,1,17795,0.000105988,137185381,0.81708
D.truncata,167897087,VNJQ01003595.1,1,17784,0.000105922,137203165,0.817186
D.truncata,167897087,VNJQ01001703.1,1,17784,0.000105922,137220949,0.817292
D.truncata,167897087,VNJQ01003756.1,1,17777,0.00010588,137238726,0.817398
D.truncata,167897087,VNJQ01001510.1,1,17767,0.000105821,137256493,0.817504
D.truncata,167897087,VNJQ01006003.1,1,17709,0.000105475,137274202,0.817609
D.truncata,167897087,VNJQ01007551.1,1,17706,0.000105457,137291908,0.817715
D.truncata,167897087,VNJQ01007639.1,1,17686,0.000105338,137309594,0.81782
D.truncata,167897087,VNJQ01006547.1,1,17657,0.000105166,137327251,0.817925
D.truncata,167897087,VNJQ01004892.1,1,17636,0.000105041,137344887,0.81803
D.truncata,167897087,VNJQ01007028.1,1,17619,0.000104939,137362506,0.818135
D.truncata,167897087,VNJQ01001284.1,1,17576,0.000104683,137380082,0.81824
D.truncata,167897087,VNJQ01002935.1,1,17559,0.000104582,137397641,0.818344
D.truncata,167897087,VNJQ01004381.1,1,17541,0.000104475,137415182,0.818449
D.truncata,167897087,VNJQ01001283.1,1,17519,0.000104344,137432701,0.818553
D.truncata,167897087,VNJQ01003887.1,1,17470,0.000104052,137450171,0.818657
D.truncata,167897087,VNJQ01002021.1,1,17459,0.000103986,137467630,0.818761
D.truncata,167897087,VNJQ01000719.1,1,17406,0.000103671,137485036,0.818865
D.truncata,167897087,VNJQ01006118.1,1,17404,0.000103659,137502440,0.818969
D.truncata,167897087,VNJQ01001288.1,1,17401,0.000103641,137519841,0.819072
D.truncata,167897087,VNJQ01001825.1,1,17390,0.000103575,137537231,0.819176
D.truncata,167897087,VNJQ01006203.1,1,17384,0.00010354,137554615,0.819279
D.truncata,167897087,VNJQ01007471.1,1,17355,0.000103367,137571970,0.819383
D.truncata,167897087,VNJQ01008176.1,1,17342,0.000103289,137589312,0.819486
D.truncata,167897087,VNJQ01005893.1,1,17333,0.000103236,137606645,0.819589
D.truncata,167897087,VNJQ01000962.1,1,17300,0.000103039,137623945,0.819692
D.truncata,167897087,VNJQ01003952.1,1,17296,0.000103015,137641241,0.819795
D.truncata,167897087,VNJQ01007296.1,1,17282,0.000102932,137658523,0.819898
D.truncata,167897087,VNJQ01000646.1,1,17272,0.000102873,137675795,0.820001
D.truncata,167897087,VNJQ01006042.1,1,17217,0.000102545,137693012,0.820104
D.truncata,167897087,VNJQ01003787.1,1,17202,0.000102456,137710214,0.820206
D.truncata,167897087,VNJQ01007510.1,1,17198,0.000102432,137727412,0.820309
D.truncata,167897087,VNJQ01006978.1,1,17191,0.00010239,137744603,0.820411
D.truncata,167897087,VNJQ01000738.1,1,17176,0.000102301,137761779,0.820513
D.truncata,167897087,VNJQ01007312.1,1,17157,0.000102188,137778936,0.820615
D.truncata,167897087,VNJQ01003037.1,1,17157,0.000102188,137796093,0.820718
D.truncata,167897087,VNJQ01000596.1,1,17126,0.000102003,137813219,0.82082
D.truncata,167897087,VNJQ01003749.1,1,17108,0.000101896,137830327,0.820921
D.truncata,167897087,VNJQ01003596.1,1,17104,0.000101872,137847431,0.821023
D.truncata,167897087,VNJQ01001345.1,1,17098,0.000101836,137864529,0.821125
D.truncata,167897087,VNJQ01002950.1,1,17076,0.000101705,137881605,0.821227
D.truncata,167897087,VNJQ01001371.1,1,16956,0.00010099,137898561,0.821328
D.truncata,167897087,VNJQ01002973.1,1,16931,0.000100842,137915492,0.821429
D.truncata,167897087,VNJQ01007420.1,1,16930,0.000100836,137932422,0.82153
D.truncata,167897087,VNJQ01002700.1,1,16926,0.000100812,137949348,0.82163
D.truncata,167897087,VNJQ01005330.1,1,16924,0.0001008,137966272,0.821731
D.truncata,167897087,VNJQ01003160.1,1,16919,0.00010077,137983191,0.821832
D.truncata,167897087,VNJQ01002955.1,1,16911,0.000100722,138000102,0.821933
D.truncata,167897087,VNJQ01002130.1,1,16909,0.000100711,138017011,0.822033
D.truncata,167897087,VNJQ01003988.1,1,16903,0.000100675,138033914,0.822134
D.truncata,167897087,VNJQ01004746.1,1,16887,0.000100579,138050801,0.822235
D.truncata,167897087,VNJQ01002064.1,1,16864,0.000100442,138067665,0.822335
D.truncata,167897087,VNJQ01004753.1,1,16799,0.000100055,138084464,0.822435
D.truncata,167897087,VNJQ01001222.1,1,16798,0.000100049,138101262,0.822535
D.truncata,167897087,VNJQ01007156.1,1,16776,9.99184e-05,138118038,0.822635
D.truncata,167897087,VNJQ01004678.1,1,16768,9.98707e-05,138134806,0.822735
D.truncata,167897087,VNJQ01003617.1,1,16752,9.97754e-05,138151558,0.822835
D.truncata,167897087,VNJQ01000696.1,1,16735,9.96742e-05,138168293,0.822934
D.truncata,167897087,VNJQ01001338.1,1,16714,9.95491e-05,138185007,0.823034
D.truncata,167897087,VNJQ01000686.1,1,16711,9.95312e-05,138201718,0.823134
D.truncata,167897087,VNJQ01000960.1,1,16693,9.9424e-05,138218411,0.823233
D.truncata,167897087,VNJQ01008133.1,1,16671,9.9293e-05,138235082,0.823332
D.truncata,167897087,VNJQ01006389.1,1,16665,9.92572e-05,138251747,0.823431
D.truncata,167897087,VNJQ01000614.1,1,16661,9.92334e-05,138268408,0.823531
D.truncata,167897087,VNJQ01003130.1,1,16653,9.91858e-05,138285061,0.82363
D.truncata,167897087,VNJQ01002968.1,1,16648,9.9156e-05,138301709,0.823729
D.truncata,167897087,VNJQ01001824.1,1,16641,9.91143e-05,138318350,0.823828
D.truncata,167897087,VNJQ01005207.1,1,16636,9.90845e-05,138334986,0.823927
D.truncata,167897087,VNJQ01002984.1,1,16636,9.90845e-05,138351622,0.824026
D.truncata,167897087,VNJQ01004028.1,1,16628,9.90369e-05,138368250,0.824125
D.truncata,167897087,VNJQ01007152.1,1,16579,9.8745e-05,138384829,0.824224
D.truncata,167897087,VNJQ01000079.1,1,16571,9.86974e-05,138401400,0.824323
D.truncata,167897087,VNJQ01003901.1,1,16569,9.86855e-05,138417969,0.824422
D.truncata,167897087,VNJQ01007159.1,1,16523,9.84115e-05,138434492,0.82452
D.truncata,167897087,VNJQ01006706.1,1,16492,9.82268e-05,138450984,0.824618
D.truncata,167897087,VNJQ01003735.1,1,16491,9.82209e-05,138467475,0.824716
D.truncata,167897087,VNJQ01000747.1,1,16483,9.81732e-05,138483958,0.824815
D.truncata,167897087,VNJQ01006982.1,1,16482,9.81673e-05,138500440,0.824913
D.truncata,167897087,VNJQ01007741.1,1,16476,9.81315e-05,138516916,0.825011
D.truncata,167897087,VNJQ01004377.1,1,16470,9.80958e-05,138533386,0.825109
D.truncata,167897087,VNJQ01003013.1,1,16466,9.8072e-05,138549852,0.825207
D.truncata,167897087,VNJQ01005657.1,1,16444,9.79409e-05,138566296,0.825305
D.truncata,167897087,VNJQ01000417.1,1,16424,9.78218e-05,138582720,0.825403
D.truncata,167897087,VNJQ01002581.1,1,16407,9.77206e-05,138599127,0.8255
D.truncata,167897087,VNJQ01003594.1,1,16384,9.75836e-05,138615511,0.825598
D.truncata,167897087,VNJQ01002628.1,1,16371,9.75062e-05,138631882,0.825696
D.truncata,167897087,VNJQ01006187.1,1,16363,9.74585e-05,138648245,0.825793
D.truncata,167897087,VNJQ01005872.1,1,16362,9.74526e-05,138664607,0.82589
D.truncata,167897087,VNJQ01003262.1,1,16353,9.7399e-05,138680960,0.825988
D.truncata,167897087,VNJQ01003886.1,1,16351,9.7387e-05,138697311,0.826085
D.truncata,167897087,VNJQ01004036.1,1,16349,9.73751e-05,138713660,0.826183
D.truncata,167897087,VNJQ01003609.1,1,16324,9.72262e-05,138729984,0.82628
D.truncata,167897087,VNJQ01006384.1,1,16320,9.72024e-05,138746304,0.826377
D.truncata,167897087,VNJQ01007196.1,1,16297,9.70654e-05,138762601,0.826474
D.truncata,167897087,VNJQ01000958.1,1,16285,9.69939e-05,138778886,0.826571
D.truncata,167897087,VNJQ01006234.1,1,16278,9.69522e-05,138795164,0.826668
D.truncata,167897087,VNJQ01002374.1,1,16269,9.68986e-05,138811433,0.826765
D.truncata,167897087,VNJQ01000844.1,1,16258,9.68331e-05,138827691,0.826862
D.truncata,167897087,VNJQ01004349.1,1,16203,9.65055e-05,138843894,0.826958
D.truncata,167897087,VNJQ01000669.1,1,16190,9.64281e-05,138860084,0.827055
D.truncata,167897087,VNJQ01005265.1,1,16183,9.63864e-05,138876267,0.827151
D.truncata,167897087,VNJQ01007866.1,1,16177,9.63507e-05,138892444,0.827247
D.truncata,167897087,VNJQ01000363.1,1,16174,9.63328e-05,138908618,0.827344
D.truncata,167897087,VNJQ01007922.1,1,16163,9.62673e-05,138924781,0.82744
D.truncata,167897087,VNJQ01003043.1,1,16163,9.62673e-05,138940944,0.827536
D.truncata,167897087,VNJQ01006330.1,1,16143,9.61482e-05,138957087,0.827633
D.truncata,167897087,VNJQ01004448.1,1,16135,9.61005e-05,138973222,0.827729
D.truncata,167897087,VNJQ01003296.1,1,16132,9.60827e-05,138989354,0.827825
D.truncata,167897087,VNJQ01002737.1,1,16131,9.60767e-05,139005485,0.827921
D.truncata,167897087,VNJQ01003425.1,1,16098,9.58802e-05,139021583,0.828017
D.truncata,167897087,VNJQ01005523.1,1,16061,9.56598e-05,139037644,0.828112
D.truncata,167897087,VNJQ01000965.1,1,16060,9.56538e-05,139053704,0.828208
D.truncata,167897087,VNJQ01001845.1,1,16058,9.56419e-05,139069762,0.828304
D.truncata,167897087,VNJQ01001821.1,1,16016,9.53918e-05,139085778,0.828399
D.truncata,167897087,VNJQ01002473.1,1,16011,9.5362e-05,139101789,0.828494
D.truncata,167897087,VNJQ01005226.1,1,15986,9.52131e-05,139117775,0.82859
D.truncata,167897087,VNJQ01007025.1,1,15979,9.51714e-05,139133754,0.828685
D.truncata,167897087,VNJQ01005671.1,1,15902,9.47128e-05,139149656,0.828779
D.truncata,167897087,VNJQ01005236.1,1,15862,9.44745e-05,139165518,0.828874
D.truncata,167897087,VNJQ01003504.1,1,15851,9.4409e-05,139181369,0.828968
D.truncata,167897087,VNJQ01005763.1,1,15828,9.4272e-05,139197197,0.829063
D.truncata,167897087,VNJQ01003511.1,1,15817,9.42065e-05,139213014,0.829157
D.truncata,167897087,VNJQ01003356.1,1,15813,9.41827e-05,139228827,0.829251
D.truncata,167897087,VNJQ01001456.1,1,15809,9.41589e-05,139244636,0.829345
D.truncata,167897087,VNJQ01005239.1,1,15782,9.39981e-05,139260418,0.829439
D.truncata,167897087,VNJQ01003032.1,1,15778,9.39742e-05,139276196,0.829533
D.truncata,167897087,VNJQ01002709.1,1,15772,9.39385e-05,139291968,0.829627
D.truncata,167897087,VNJQ01001883.1,1,15767,9.39087e-05,139307735,0.829721
D.truncata,167897087,VNJQ01004830.1,1,15766,9.39028e-05,139323501,0.829815
D.truncata,167897087,VNJQ01001628.1,1,15762,9.38789e-05,139339263,0.829909
D.truncata,167897087,VNJQ01007043.1,1,15760,9.3867e-05,139355023,0.830003
D.truncata,167897087,VNJQ01001859.1,1,15756,9.38432e-05,139370779,0.830096
D.truncata,167897087,VNJQ01002348.1,1,15743,9.37658e-05,139386522,0.83019
D.truncata,167897087,VNJQ01006575.1,1,15718,9.36169e-05,139402240,0.830284
D.truncata,167897087,VNJQ01004271.1,1,15718,9.36169e-05,139417958,0.830377
D.truncata,167897087,VNJQ01005367.1,1,15704,9.35335e-05,139433662,0.830471
D.truncata,167897087,VNJQ01006073.1,1,15686,9.34263e-05,139449348,0.830564
D.truncata,167897087,VNJQ01005438.1,1,15679,9.33846e-05,139465027,0.830658
D.truncata,167897087,VNJQ01001719.1,1,15655,9.32416e-05,139480682,0.830751
D.truncata,167897087,VNJQ01004391.1,1,15639,9.31463e-05,139496321,0.830844
D.truncata,167897087,VNJQ01005302.1,1,15624,9.3057e-05,139511945,0.830937
D.truncata,167897087,VNJQ01005619.1,1,15618,9.30213e-05,139527563,0.83103
D.truncata,167897087,VNJQ01005886.1,1,15598,9.29021e-05,139543161,0.831123
D.truncata,167897087,VNJQ01006438.1,1,15596,9.28902e-05,139558757,0.831216
D.truncata,167897087,VNJQ01003755.1,1,15565,9.27056e-05,139574322,0.831309
D.truncata,167897087,VNJQ01002908.1,1,15545,9.25865e-05,139589867,0.831401
D.truncata,167897087,VNJQ01005024.1,1,15538,9.25448e-05,139605405,0.831494
D.truncata,167897087,VNJQ01006916.1,1,15535,9.25269e-05,139620940,0.831586
D.truncata,167897087,VNJQ01001934.1,1,15535,9.25269e-05,139636475,0.831679
D.truncata,167897087,VNJQ01004800.1,1,15488,9.2247e-05,139651963,0.831771
D.truncata,167897087,VNJQ01003087.1,1,15470,9.21398e-05,139667433,0.831863
D.truncata,167897087,VNJQ01005221.1,1,15466,9.2116e-05,139682899,0.831955
D.truncata,167897087,VNJQ01002066.1,1,15460,9.20802e-05,139698359,0.832048
D.truncata,167897087,VNJQ01007193.1,1,15448,9.20087e-05,139713807,0.83214
D.truncata,167897087,VNJQ01004455.1,1,15418,9.18301e-05,139729225,0.832231
D.truncata,167897087,VNJQ01004740.1,1,15414,9.18062e-05,139744639,0.832323
D.truncata,167897087,VNJQ01001818.1,1,15398,9.17109e-05,139760037,0.832415
D.truncata,167897087,VNJQ01000021.1,1,15345,9.13953e-05,139775382,0.832506
D.truncata,167897087,VNJQ01000135.1,1,15341,9.13714e-05,139790723,0.832598
D.truncata,167897087,VNJQ01006461.1,1,15297,9.11094e-05,139806020,0.832689
D.truncata,167897087,VNJQ01004150.1,1,15255,9.08592e-05,139821275,0.83278
D.truncata,167897087,VNJQ01000853.1,1,15251,9.08354e-05,139836526,0.83287
D.truncata,167897087,VNJQ01004827.1,1,15242,9.07818e-05,139851768,0.832961
D.truncata,167897087,VNJQ01000160.1,1,15237,9.0752e-05,139867005,0.833052
D.truncata,167897087,VNJQ01000347.1,1,15217,9.06329e-05,139882222,0.833143
D.truncata,167897087,VNJQ01002486.1,1,15216,9.06269e-05,139897438,0.833233
D.truncata,167897087,VNJQ01000959.1,1,15203,9.05495e-05,139912641,0.833324
D.truncata,167897087,VNJQ01006852.1,1,15198,9.05197e-05,139927839,0.833414
D.truncata,167897087,VNJQ01003097.1,1,15185,9.04423e-05,139943024,0.833505
D.truncata,167897087,VNJQ01002981.1,1,15180,9.04125e-05,139958204,0.833595
D.truncata,167897087,VNJQ01007558.1,1,15176,9.03887e-05,139973380,0.833686
D.truncata,167897087,VNJQ01002185.1,1,15174,9.03768e-05,139988554,0.833776
D.truncata,167897087,VNJQ01006763.1,1,15156,9.02696e-05,140003710,0.833866
D.truncata,167897087,VNJQ01006569.1,1,15147,9.0216e-05,140018857,0.833956
D.truncata,167897087,VNJQ01001739.1,1,15142,9.01862e-05,140033999,0.834047
D.truncata,167897087,VNJQ01007203.1,1,15125,9.00849e-05,140049124,0.834137
D.truncata,167897087,VNJQ01006889.1,1,15116,9.00313e-05,140064240,0.834227
D.truncata,167897087,VNJQ01004734.1,1,15098,8.99241e-05,140079338,0.834317
D.truncata,167897087,VNJQ01001981.1,1,15087,8.98586e-05,140094425,0.834407
D.truncata,167897087,VNJQ01003519.1,1,15078,8.9805e-05,140109503,0.834496
D.truncata,167897087,VNJQ01005342.1,1,15062,8.97097e-05,140124565,0.834586
D.truncata,167897087,VNJQ01003550.1,1,15059,8.96918e-05,140139624,0.834676
D.truncata,167897087,VNJQ01005796.1,1,15053,8.96561e-05,140154677,0.834765
D.truncata,167897087,VNJQ01003488.1,1,15018,8.94477e-05,140169695,0.834855
D.truncata,167897087,VNJQ01007091.1,1,15015,8.94298e-05,140184710,0.834944
D.truncata,167897087,VNJQ01006751.1,1,15011,8.9406e-05,140199721,0.835034
D.truncata,167897087,VNJQ01005827.1,1,14991,8.92868e-05,140214712,0.835123
D.truncata,167897087,VNJQ01002230.1,1,14979,8.92154e-05,140229691,0.835212
D.truncata,167897087,VNJQ01005176.1,1,14956,8.90784e-05,140244647,0.835301
D.truncata,167897087,VNJQ01004834.1,1,14952,8.90546e-05,140259599,0.83539
D.truncata,167897087,VNJQ01007511.1,1,14949,8.90367e-05,140274548,0.835479
D.truncata,167897087,VNJQ01001180.1,1,14947,8.90248e-05,140289495,0.835568
D.truncata,167897087,VNJQ01001254.1,1,14942,8.8995e-05,140304437,0.835657
D.truncata,167897087,VNJQ01004332.1,1,14940,8.89831e-05,140319377,0.835746
D.truncata,167897087,VNJQ01005522.1,1,14938,8.89712e-05,140334315,0.835835
D.truncata,167897087,VNJQ01003252.1,1,14936,8.89593e-05,140349251,0.835924
D.truncata,167897087,VNJQ01007561.1,1,14931,8.89295e-05,140364182,0.836013
D.truncata,167897087,VNJQ01004521.1,1,14923,8.88818e-05,140379105,0.836102
D.truncata,167897087,VNJQ01003453.1,1,14911,8.88104e-05,140394016,0.836191
D.truncata,167897087,VNJQ01000964.1,1,14910,8.88044e-05,140408926,0.83628
D.truncata,167897087,VNJQ01001484.1,1,14898,8.87329e-05,140423824,0.836368
D.truncata,167897087,VNJQ01006571.1,1,14887,8.86674e-05,140438711,0.836457
D.truncata,167897087,VNJQ01001100.1,1,14870,8.85662e-05,140453581,0.836546
D.truncata,167897087,VNJQ01000966.1,1,14794,8.81135e-05,140468375,0.836634
D.truncata,167897087,VNJQ01001209.1,1,14792,8.81016e-05,140483167,0.836722
D.truncata,167897087,VNJQ01003017.1,1,14788,8.80778e-05,140497955,0.83681
D.truncata,167897087,VNJQ01008028.1,1,14778,8.80182e-05,140512733,0.836898
D.truncata,167897087,VNJQ01003025.1,1,14770,8.79706e-05,140527503,0.836986
D.truncata,167897087,VNJQ01005246.1,1,14756,8.78872e-05,140542259,0.837074
D.truncata,167897087,VNJQ01005776.1,1,14753,8.78693e-05,140557012,0.837162
D.truncata,167897087,VNJQ01005515.1,1,14730,8.77323e-05,140571742,0.837249
D.truncata,167897087,VNJQ01002918.1,1,14692,8.7506e-05,140586434,0.837337
D.truncata,167897087,VNJQ01005427.1,1,14678,8.74226e-05,140601112,0.837424
D.truncata,167897087,VNJQ01001168.1,1,14678,8.74226e-05,140615790,0.837512
D.truncata,167897087,VNJQ01008137.1,1,14669,8.7369e-05,140630459,0.837599
D.truncata,167897087,VNJQ01004520.1,1,14659,8.73094e-05,140645118,0.837686
D.truncata,167897087,VNJQ01007119.1,1,14653,8.72737e-05,140659771,0.837774
D.truncata,167897087,VNJQ01000219.1,1,14640,8.71963e-05,140674411,0.837861
D.truncata,167897087,VNJQ01002565.1,1,14633,8.71546e-05,140689044,0.837948
D.truncata,167897087,VNJQ01005219.1,1,14609,8.70116e-05,140703653,0.838035
D.truncata,167897087,VNJQ01005830.1,1,14601,8.6964e-05,140718254,0.838122
D.truncata,167897087,VNJQ01000512.1,1,14551,8.66662e-05,140732805,0.838209
D.truncata,167897087,VNJQ01002572.1,1,14527,8.65232e-05,140747332,0.838295
D.truncata,167897087,VNJQ01000791.1,1,14521,8.64875e-05,140761853,0.838382
D.truncata,167897087,VNJQ01002174.1,1,14498,8.63505e-05,140776351,0.838468
D.truncata,167897087,VNJQ01006948.1,1,14485,8.62731e-05,140790836,0.838554
D.truncata,167897087,VNJQ01000386.1,1,14476,8.62195e-05,140805312,0.838641
D.truncata,167897087,VNJQ01000882.1,1,14474,8.62076e-05,140819786,0.838727
D.truncata,167897087,VNJQ01001502.1,1,14469,8.61778e-05,140834255,0.838813
D.truncata,167897087,VNJQ01000163.1,1,14465,8.6154e-05,140848720,0.838899
D.truncata,167897087,VNJQ01004430.1,1,14460,8.61242e-05,140863180,0.838985
D.truncata,167897087,VNJQ01004472.1,1,14403,8.57847e-05,140877583,0.839071
D.truncata,167897087,VNJQ01000111.1,1,14394,8.57311e-05,140891977,0.839157
D.truncata,167897087,VNJQ01002026.1,1,14390,8.57073e-05,140906367,0.839242
D.truncata,167897087,VNJQ01006485.1,1,14377,8.56298e-05,140920744,0.839328
D.truncata,167897087,VNJQ01001627.1,1,14350,8.5469e-05,140935094,0.839414
D.truncata,167897087,VNJQ01004471.1,1,14324,8.53142e-05,140949418,0.839499
D.truncata,167897087,VNJQ01004035.1,1,14311,8.52367e-05,140963729,0.839584
D.truncata,167897087,VNJQ01001708.1,1,14310,8.52308e-05,140978039,0.839669
D.truncata,167897087,VNJQ01007134.1,1,14308,8.52189e-05,140992347,0.839755
D.truncata,167897087,VNJQ01007210.1,1,14295,8.51414e-05,141006642,0.83984
D.truncata,167897087,VNJQ01001292.1,1,14290,8.51117e-05,141020932,0.839925
D.truncata,167897087,VNJQ01004945.1,1,14280,8.50521e-05,141035212,0.84001
D.truncata,167897087,VNJQ01003048.1,1,14276,8.50283e-05,141049488,0.840095
D.truncata,167897087,VNJQ01006139.1,1,14233,8.47722e-05,141063721,0.84018
D.truncata,167897087,VNJQ01002161.1,1,14202,8.45875e-05,141077923,0.840264
D.truncata,167897087,VNJQ01005217.1,1,14195,8.45458e-05,141092118,0.840349
D.truncata,167897087,VNJQ01005596.1,1,14190,8.45161e-05,141106308,0.840433
D.truncata,167897087,VNJQ01006588.1,1,14173,8.44148e-05,141120481,0.840518
D.truncata,167897087,VNJQ01001880.1,1,14172,8.44088e-05,141134653,0.840602
D.truncata,167897087,VNJQ01002227.1,1,14166,8.43731e-05,141148819,0.840687
D.truncata,167897087,VNJQ01000398.1,1,14166,8.43731e-05,141162985,0.840771
D.truncata,167897087,VNJQ01003214.1,1,14165,8.43672e-05,141177150,0.840855
D.truncata,167897087,VNJQ01005707.1,1,14156,8.43136e-05,141191306,0.84094
D.truncata,167897087,VNJQ01001943.1,1,14153,8.42957e-05,141205459,0.841024
D.truncata,167897087,VNJQ01008210.1,1,14151,8.42838e-05,141219610,0.841108
D.truncata,167897087,VNJQ01006069.1,1,14130,8.41587e-05,141233740,0.841192
D.truncata,167897087,VNJQ01002031.1,1,14126,8.41349e-05,141247866,0.841276
D.truncata,167897087,VNJQ01000032.1,1,14064,8.37656e-05,141261930,0.84136
D.truncata,167897087,VNJQ01006886.1,1,14046,8.36584e-05,141275976,0.841444
D.truncata,167897087,VNJQ01004525.1,1,14005,8.34142e-05,141289981,0.841527
D.truncata,167897087,VNJQ01002635.1,1,14001,8.33904e-05,141303982,0.841611
D.truncata,167897087,VNJQ01007860.1,1,14000,8.33844e-05,141317982,0.841694
D.truncata,167897087,VNJQ01000479.1,1,14000,8.33844e-05,141331982,0.841777
D.truncata,167897087,VNJQ01002870.1,1,13989,8.33189e-05,141345971,0.841861
D.truncata,167897087,VNJQ01006976.1,1,13976,8.32415e-05,141359947,0.841944
D.truncata,167897087,VNJQ01000407.1,1,13946,8.30628e-05,141373893,0.842027
D.truncata,167897087,VNJQ01006618.1,1,13944,8.30509e-05,141387837,0.84211
D.truncata,167897087,VNJQ01001786.1,1,13937,8.30092e-05,141401774,0.842193
D.truncata,167897087,VNJQ01002087.1,1,13931,8.29734e-05,141415705,0.842276
D.truncata,167897087,VNJQ01001606.1,1,13927,8.29496e-05,141429632,0.842359
D.truncata,167897087,VNJQ01000997.1,1,13857,8.25327e-05,141443489,0.842442
D.truncata,167897087,VNJQ01005346.1,1,13837,8.24136e-05,141457326,0.842524
D.truncata,167897087,VNJQ01006184.1,1,13812,8.22647e-05,141471138,0.842606
D.truncata,167897087,VNJQ01004042.1,1,13787,8.21158e-05,141484925,0.842688
D.truncata,167897087,VNJQ01007473.1,1,13782,8.2086e-05,141498707,0.84277
D.truncata,167897087,VNJQ01005349.1,1,13762,8.19669e-05,141512469,0.842852
D.truncata,167897087,VNJQ01006138.1,1,13759,8.1949e-05,141526228,0.842934
D.truncata,167897087,VNJQ01004695.1,1,13747,8.18775e-05,141539975,0.843016
D.truncata,167897087,VNJQ01002701.1,1,13737,8.1818e-05,141553712,0.843098
D.truncata,167897087,VNJQ01005341.1,1,13725,8.17465e-05,141567437,0.84318
D.truncata,167897087,VNJQ01000389.1,1,13708,8.16453e-05,141581145,0.843261
D.truncata,167897087,VNJQ01004896.1,1,13707,8.16393e-05,141594852,0.843343
D.truncata,167897087,VNJQ01005791.1,1,13706,8.16333e-05,141608558,0.843425
D.truncata,167897087,VNJQ01005501.1,1,13671,8.14249e-05,141622229,0.843506
D.truncata,167897087,VNJQ01002349.1,1,13665,8.13891e-05,141635894,0.843588
D.truncata,167897087,VNJQ01004034.1,1,13664,8.13832e-05,141649558,0.843669
D.truncata,167897087,VNJQ01003298.1,1,13650,8.12998e-05,141663208,0.84375
D.truncata,167897087,VNJQ01001085.1,1,13650,8.12998e-05,141676858,0.843832
D.truncata,167897087,VNJQ01008086.1,1,13613,8.10794e-05,141690471,0.843913
D.truncata,167897087,VNJQ01004460.1,1,13607,8.10437e-05,141704078,0.843994
D.truncata,167897087,VNJQ01000392.1,1,13582,8.08948e-05,141717660,0.844075
D.truncata,167897087,VNJQ01001248.1,1,13566,8.07995e-05,141731226,0.844155
D.truncata,167897087,VNJQ01000154.1,1,13564,8.07876e-05,141744790,0.844236
D.truncata,167897087,VNJQ01007151.1,1,13527,8.05672e-05,141758317,0.844317
D.truncata,167897087,VNJQ01007916.1,1,13526,8.05613e-05,141771843,0.844397
D.truncata,167897087,VNJQ01002975.1,1,13522,8.05374e-05,141785365,0.844478
D.truncata,167897087,VNJQ01000671.1,1,13520,8.05255e-05,141798885,0.844558
D.truncata,167897087,VNJQ01007621.1,1,13501,8.04124e-05,141812386,0.844639
D.truncata,167897087,VNJQ01002816.1,1,13500,8.04064e-05,141825886,0.844719
D.truncata,167897087,VNJQ01004146.1,1,13476,8.02635e-05,141839362,0.844799
D.truncata,167897087,VNJQ01004491.1,1,13474,8.02515e-05,141852836,0.84488
D.truncata,167897087,VNJQ01006394.1,1,13450,8.01086e-05,141866286,0.84496
D.truncata,167897087,VNJQ01005377.1,1,13433,8.00073e-05,141879719,0.84504
D.truncata,167897087,VNJQ01000141.1,1,13427,7.99716e-05,141893146,0.84512
D.truncata,167897087,VNJQ01008023.1,1,13410,7.98704e-05,141906556,0.8452
D.truncata,167897087,VNJQ01005252.1,1,13403,7.98287e-05,141919959,0.845279
D.truncata,167897087,VNJQ01002472.1,1,13395,7.9781e-05,141933354,0.845359
D.truncata,167897087,VNJQ01003308.1,1,13385,7.97215e-05,141946739,0.845439
D.truncata,167897087,VNJQ01003669.1,1,13382,7.97036e-05,141960121,0.845519
D.truncata,167897087,VNJQ01004443.1,1,13365,7.96023e-05,141973486,0.845598
D.truncata,167897087,VNJQ01006424.1,1,13364,7.95964e-05,141986850,0.845678
D.truncata,167897087,VNJQ01001111.1,1,13363,7.95904e-05,142000213,0.845757
D.truncata,167897087,VNJQ01008208.1,1,13337,7.94356e-05,142013550,0.845837
D.truncata,167897087,VNJQ01000038.1,1,13328,7.9382e-05,142026878,0.845916
D.truncata,167897087,VNJQ01003313.1,1,13327,7.9376e-05,142040205,0.845996
D.truncata,167897087,VNJQ01002911.1,1,13314,7.92986e-05,142053519,0.846075
D.truncata,167897087,VNJQ01006451.1,1,13306,7.92509e-05,142066825,0.846154
D.truncata,167897087,VNJQ01003122.1,1,13306,7.92509e-05,142080131,0.846233
D.truncata,167897087,VNJQ01004633.1,1,13297,7.91973e-05,142093428,0.846313
D.truncata,167897087,VNJQ01007263.1,1,13285,7.91259e-05,142106713,0.846392
D.truncata,167897087,VNJQ01002084.1,1,13278,7.90842e-05,142119991,0.846471
D.truncata,167897087,VNJQ01005824.1,1,13268,7.90246e-05,142133259,0.84655
D.truncata,167897087,VNJQ01006362.1,1,13267,7.90186e-05,142146526,0.846629
D.truncata,167897087,VNJQ01006376.1,1,13266,7.90127e-05,142159792,0.846708
D.truncata,167897087,VNJQ01000249.1,1,13263,7.89948e-05,142173055,0.846787
D.truncata,167897087,VNJQ01001101.1,1,13262,7.89889e-05,142186317,0.846866
D.truncata,167897087,VNJQ01001294.1,1,13260,7.8977e-05,142199577,0.846945
D.truncata,167897087,VNJQ01004778.1,1,13254,7.89412e-05,142212831,0.847024
D.truncata,167897087,VNJQ01001508.1,1,13229,7.87923e-05,142226060,0.847103
D.truncata,167897087,VNJQ01002719.1,1,13227,7.87804e-05,142239287,0.847181
D.truncata,167897087,VNJQ01001461.1,1,13181,7.85064e-05,142252468,0.84726
D.truncata,167897087,VNJQ01006646.1,1,13180,7.85005e-05,142265648,0.847338
D.truncata,167897087,VNJQ01008103.1,1,13169,7.8435e-05,142278817,0.847417
D.truncata,167897087,VNJQ01001005.1,1,13157,7.83635e-05,142291974,0.847495
D.truncata,167897087,VNJQ01000942.1,1,13156,7.83575e-05,142305130,0.847574
D.truncata,167897087,VNJQ01005248.1,1,13149,7.83158e-05,142318279,0.847652
D.truncata,167897087,VNJQ01007351.1,1,13135,7.82324e-05,142331414,0.84773
D.truncata,167897087,VNJQ01002494.1,1,13125,7.81729e-05,142344539,0.847808
D.truncata,167897087,VNJQ01002284.1,1,13109,7.80776e-05,142357648,0.847886
D.truncata,167897087,VNJQ01003997.1,1,13102,7.80359e-05,142370750,0.847964
D.truncata,167897087,VNJQ01004435.1,1,13090,7.79644e-05,142383840,0.848042
D.truncata,167897087,VNJQ01006526.1,1,13086,7.79406e-05,142396926,0.84812
D.truncata,167897087,VNJQ01008073.1,1,13077,7.7887e-05,142410003,0.848198
D.truncata,167897087,VNJQ01000847.1,1,13071,7.78513e-05,142423074,0.848276
D.truncata,167897087,VNJQ01007386.1,1,13068,7.78334e-05,142436142,0.848354
D.truncata,167897087,VNJQ01000402.1,1,13051,7.77321e-05,142449193,0.848432
D.truncata,167897087,VNJQ01002456.1,1,13007,7.74701e-05,142462200,0.848509
D.truncata,167897087,VNJQ01001439.1,1,13003,7.74463e-05,142475203,0.848587
D.truncata,167897087,VNJQ01000562.1,1,13000,7.74284e-05,142488203,0.848664
D.truncata,167897087,VNJQ01002463.1,1,12999,7.74224e-05,142501202,0.848741
D.truncata,167897087,VNJQ01007735.1,1,12996,7.74046e-05,142514198,0.848819
D.truncata,167897087,VNJQ01006915.1,1,12993,7.73867e-05,142527191,0.848896
D.truncata,167897087,VNJQ01003530.1,1,12993,7.73867e-05,142540184,0.848974
D.truncata,167897087,VNJQ01007327.1,1,12981,7.73152e-05,142553165,0.849051
D.truncata,167897087,VNJQ01003520.1,1,12976,7.72854e-05,142566141,0.849128
D.truncata,167897087,VNJQ01007099.1,1,12973,7.72676e-05,142579114,0.849205
D.truncata,167897087,VNJQ01007055.1,1,12950,7.71306e-05,142592064,0.849283
D.truncata,167897087,VNJQ01001121.1,1,12947,7.71127e-05,142605011,0.84936
D.truncata,167897087,VNJQ01000155.1,1,12944,7.70948e-05,142617955,0.849437
D.truncata,167897087,VNJQ01001532.1,1,12933,7.70293e-05,142630888,0.849514
D.truncata,167897087,VNJQ01004183.1,1,12931,7.70174e-05,142643819,0.849591
D.truncata,167897087,VNJQ01003740.1,1,12922,7.69638e-05,142656741,0.849668
D.truncata,167897087,VNJQ01003317.1,1,12914,7.69162e-05,142669655,0.849745
D.truncata,167897087,VNJQ01002930.1,1,12914,7.69162e-05,142682569,0.849822
D.truncata,167897087,VNJQ01002518.1,1,12892,7.67851e-05,142695461,0.849898
D.truncata,167897087,VNJQ01005301.1,1,12887,7.67554e-05,142708348,0.849975
D.truncata,167897087,VNJQ01002899.1,1,12878,7.67017e-05,142721226,0.850052
D.truncata,167897087,VNJQ01002459.1,1,12873,7.6672e-05,142734099,0.850129
D.truncata,167897087,VNJQ01003151.1,1,12858,7.65826e-05,142746957,0.850205
D.truncata,167897087,VNJQ01001539.1,1,12847,7.65171e-05,142759804,0.850282
D.truncata,167897087,VNJQ01002708.1,1,12840,7.64754e-05,142772644,0.850358
D.truncata,167897087,VNJQ01000194.1,1,12805,7.6267e-05,142785449,0.850434
D.truncata,167897087,VNJQ01006947.1,1,12803,7.6255e-05,142798252,0.850511
D.truncata,167897087,VNJQ01000444.1,1,12793,7.61955e-05,142811045,0.850587
D.truncata,167897087,VNJQ01000952.1,1,12782,7.613e-05,142823827,0.850663
D.truncata,167897087,VNJQ01000711.1,1,12772,7.60704e-05,142836599,0.850739
D.truncata,167897087,VNJQ01001465.1,1,12745,7.59096e-05,142849344,0.850815
D.truncata,167897087,VNJQ01004767.1,1,12743,7.58977e-05,142862087,0.850891
D.truncata,167897087,VNJQ01004646.1,1,12726,7.57964e-05,142874813,0.850967
D.truncata,167897087,VNJQ01007209.1,1,12725,7.57905e-05,142887538,0.851042
D.truncata,167897087,VNJQ01003801.1,1,12707,7.56833e-05,142900245,0.851118
D.truncata,167897087,VNJQ01000078.1,1,12680,7.55225e-05,142912925,0.851194
D.truncata,167897087,VNJQ01001727.1,1,12679,7.55165e-05,142925604,0.851269
D.truncata,167897087,VNJQ01006532.1,1,12669,7.54569e-05,142938273,0.851345
D.truncata,167897087,VNJQ01003621.1,1,12618,7.51532e-05,142950891,0.85142
D.truncata,167897087,VNJQ01001154.1,1,12618,7.51532e-05,142963509,0.851495
D.truncata,167897087,VNJQ01000762.1,1,12611,7.51115e-05,142976120,0.85157
D.truncata,167897087,VNJQ01006841.1,1,12606,7.50817e-05,142988726,0.851645
D.truncata,167897087,VNJQ01002588.1,1,12606,7.50817e-05,143001332,0.85172
D.truncata,167897087,VNJQ01006313.1,1,12585,7.49566e-05,143013917,0.851795
D.truncata,167897087,VNJQ01005141.1,1,12583,7.49447e-05,143026500,0.85187
D.truncata,167897087,VNJQ01001086.1,1,12556,7.47839e-05,143039056,0.851945
D.truncata,167897087,VNJQ01007147.1,1,12552,7.47601e-05,143051608,0.85202
D.truncata,167897087,VNJQ01005378.1,1,12541,7.46946e-05,143064149,0.852094
D.truncata,167897087,VNJQ01000169.1,1,12541,7.46946e-05,143076690,0.852169
D.truncata,167897087,VNJQ01005267.1,1,12540,7.46886e-05,143089230,0.852244
D.truncata,167897087,VNJQ01008032.1,1,12530,7.4629e-05,143101760,0.852318
D.truncata,167897087,VNJQ01004222.1,1,12525,7.45993e-05,143114285,0.852393
D.truncata,167897087,VNJQ01002834.1,1,12509,7.4504e-05,143126794,0.852467
D.truncata,167897087,VNJQ01003693.1,1,12498,7.44385e-05,143139292,0.852542
D.truncata,167897087,VNJQ01006937.1,1,12488,7.43789e-05,143151780,0.852616
D.truncata,167897087,VNJQ01004164.1,1,12454,7.41764e-05,143164234,0.85269
D.truncata,167897087,VNJQ01006406.1,1,12441,7.4099e-05,143176675,0.852764
D.truncata,167897087,VNJQ01008043.1,1,12440,7.4093e-05,143189115,0.852839
D.truncata,167897087,VNJQ01008199.1,1,12437,7.40751e-05,143201552,0.852913
D.truncata,167897087,VNJQ01002759.1,1,12435,7.40632e-05,143213987,0.852987
D.truncata,167897087,VNJQ01001955.1,1,12426,7.40096e-05,143226413,0.853061
D.truncata,167897087,VNJQ01006482.1,1,12409,7.39084e-05,143238822,0.853135
D.truncata,167897087,VNJQ01001640.1,1,12397,7.38369e-05,143251219,0.853208
D.truncata,167897087,VNJQ01000907.1,1,12395,7.3825e-05,143263614,0.853282
D.truncata,167897087,VNJQ01005137.1,1,12384,7.37595e-05,143275998,0.853356
D.truncata,167897087,VNJQ01003132.1,1,12375,7.37059e-05,143288373,0.85343
D.truncata,167897087,VNJQ01000263.1,1,12373,7.3694e-05,143300746,0.853503
D.truncata,167897087,VNJQ01001531.1,1,12366,7.36523e-05,143313112,0.853577
D.truncata,167897087,VNJQ01000582.1,1,12360,7.36165e-05,143325472,0.853651
D.truncata,167897087,VNJQ01000152.1,1,12353,7.35748e-05,143337825,0.853724
D.truncata,167897087,VNJQ01006559.1,1,12347,7.35391e-05,143350172,0.853798
D.truncata,167897087,VNJQ01000464.1,1,12340,7.34974e-05,143362512,0.853871
D.truncata,167897087,VNJQ01006486.1,1,12338,7.34855e-05,143374850,0.853945
D.truncata,167897087,VNJQ01006312.1,1,12332,7.34498e-05,143387182,0.854018
D.truncata,167897087,VNJQ01005600.1,1,12325,7.34081e-05,143399507,0.854092
D.truncata,167897087,VNJQ01007718.1,1,12321,7.33842e-05,143411828,0.854165
D.truncata,167897087,VNJQ01001652.1,1,12318,7.33664e-05,143424146,0.854238
D.truncata,167897087,VNJQ01006122.1,1,12307,7.33009e-05,143436453,0.854312
D.truncata,167897087,VNJQ01000733.1,1,12300,7.32592e-05,143448753,0.854385
D.truncata,167897087,VNJQ01006441.1,1,12298,7.32473e-05,143461051,0.854458
D.truncata,167897087,VNJQ01004998.1,1,12291,7.32056e-05,143473342,0.854531
D.truncata,167897087,VNJQ01006785.1,1,12290,7.31996e-05,143485632,0.854605
D.truncata,167897087,VNJQ01007177.1,1,12269,7.30745e-05,143497901,0.854678
D.truncata,167897087,VNJQ01000885.1,1,12262,7.30328e-05,143510163,0.854751
D.truncata,167897087,VNJQ01006562.1,1,12252,7.29733e-05,143522415,0.854824
D.truncata,167897087,VNJQ01006031.1,1,12248,7.29494e-05,143534663,0.854897
D.truncata,167897087,VNJQ01005944.1,1,12240,7.29018e-05,143546903,0.85497
D.truncata,167897087,VNJQ01002817.1,1,12240,7.29018e-05,143559143,0.855042
D.truncata,167897087,VNJQ01003935.1,1,12238,7.28899e-05,143571381,0.855115
D.truncata,167897087,VNJQ01003748.1,1,12228,7.28303e-05,143583609,0.855188
D.truncata,167897087,VNJQ01007812.1,1,12227,7.28244e-05,143595836,0.855261
D.truncata,167897087,VNJQ01005324.1,1,12217,7.27648e-05,143608053,0.855334
D.truncata,167897087,VNJQ01006957.1,1,12208,7.27112e-05,143620261,0.855407
D.truncata,167897087,VNJQ01000545.1,1,12199,7.26576e-05,143632460,0.855479
D.truncata,167897087,VNJQ01002703.1,1,12188,7.25921e-05,143644648,0.855552
D.truncata,167897087,VNJQ01003403.1,1,12177,7.25266e-05,143656825,0.855624
D.truncata,167897087,VNJQ01004694.1,1,12142,7.23181e-05,143668967,0.855697
D.truncata,167897087,VNJQ01005655.1,1,12132,7.22585e-05,143681099,0.855769
D.truncata,167897087,VNJQ01006740.1,1,12130,7.22466e-05,143693229,0.855841
D.truncata,167897087,VNJQ01005506.1,1,12110,7.21275e-05,143705339,0.855913
D.truncata,167897087,VNJQ01006973.1,1,12095,7.20382e-05,143717434,0.855985
D.truncata,167897087,VNJQ01002032.1,1,12087,7.19905e-05,143729521,0.856057
D.truncata,167897087,VNJQ01002145.1,1,12074,7.19131e-05,143741595,0.856129
D.truncata,167897087,VNJQ01000418.1,1,12021,7.15974e-05,143753616,0.856201
D.truncata,167897087,VNJQ01001875.1,1,12011,7.15379e-05,143765627,0.856272
D.truncata,167897087,VNJQ01002751.1,1,12010,7.15319e-05,143777637,0.856344
D.truncata,167897087,VNJQ01000454.1,1,11997,7.14545e-05,143789634,0.856415
D.truncata,167897087,VNJQ01004024.1,1,11988,7.14009e-05,143801622,0.856487
D.truncata,167897087,VNJQ01003467.1,1,11985,7.1383e-05,143813607,0.856558
D.truncata,167897087,VNJQ01002152.1,1,11978,7.13413e-05,143825585,0.856629
D.truncata,167897087,VNJQ01000034.1,1,11965,7.12639e-05,143837550,0.856701
D.truncata,167897087,VNJQ01001945.1,1,11952,7.11865e-05,143849502,0.856772
D.truncata,167897087,VNJQ01006798.1,1,11948,7.11626e-05,143861450,0.856843
D.truncata,167897087,VNJQ01002942.1,1,11938,7.11031e-05,143873388,0.856914
D.truncata,167897087,VNJQ01001009.1,1,11934,7.10793e-05,143885322,0.856985
D.truncata,167897087,VNJQ01005174.1,1,11933,7.10733e-05,143897255,0.857056
D.truncata,167897087,VNJQ01007422.1,1,11932,7.10673e-05,143909187,0.857127
D.truncata,167897087,VNJQ01001530.1,1,11923,7.10137e-05,143921110,0.857198
D.truncata,167897087,VNJQ01003805.1,1,11922,7.10078e-05,143933032,0.857269
D.truncata,167897087,VNJQ01002754.1,1,11918,7.0984e-05,143944950,0.85734
D.truncata,167897087,VNJQ01000505.1,1,11900,7.08768e-05,143956850,0.857411
D.truncata,167897087,VNJQ01006331.1,1,11887,7.07993e-05,143968737,0.857482
D.truncata,167897087,VNJQ01002136.1,1,11886,7.07934e-05,143980623,0.857553
D.truncata,167897087,VNJQ01006279.1,1,11876,7.07338e-05,143992499,0.857624
D.truncata,167897087,VNJQ01007346.1,1,11875,7.07279e-05,144004374,0.857694
D.truncata,167897087,VNJQ01004048.1,1,11859,7.06326e-05,144016233,0.857765
D.truncata,167897087,VNJQ01007461.1,1,11857,7.06206e-05,144028090,0.857836
D.truncata,167897087,VNJQ01001234.1,1,11853,7.05968e-05,144039943,0.857906
D.truncata,167897087,VNJQ01000610.1,1,11851,7.05849e-05,144051794,0.857977
D.truncata,167897087,VNJQ01007415.1,1,11850,7.05789e-05,144063644,0.858047
D.truncata,167897087,VNJQ01007294.1,1,11845,7.05492e-05,144075489,0.858118
D.truncata,167897087,VNJQ01001869.1,1,11844,7.05432e-05,144087333,0.858188
D.truncata,167897087,VNJQ01000258.1,1,11842,7.05313e-05,144099175,0.858259
D.truncata,167897087,VNJQ01002831.1,1,11841,7.05253e-05,144111016,0.858329
D.truncata,167897087,VNJQ01004155.1,1,11838,7.05075e-05,144122854,0.8584
D.truncata,167897087,VNJQ01001227.1,1,11832,7.04717e-05,144134686,0.85847
D.truncata,167897087,VNJQ01006944.1,1,11822,7.04122e-05,144146508,0.858541
D.truncata,167897087,VNJQ01007096.1,1,11812,7.03526e-05,144158320,0.858611
D.truncata,167897087,VNJQ01005976.1,1,11805,7.03109e-05,144170125,0.858682
D.truncata,167897087,VNJQ01008002.1,1,11800,7.02811e-05,144181925,0.858752
D.truncata,167897087,VNJQ01006572.1,1,11791,7.02275e-05,144193716,0.858822
D.truncata,167897087,VNJQ01008064.1,1,11784,7.01859e-05,144205500,0.858892
D.truncata,167897087,VNJQ01004002.1,1,11781,7.0168e-05,144217281,0.858962
D.truncata,167897087,VNJQ01000485.1,1,11773,7.01203e-05,144229054,0.859032
D.truncata,167897087,VNJQ01005054.1,1,11771,7.01084e-05,144240825,0.859103
D.truncata,167897087,VNJQ01005022.1,1,11764,7.00667e-05,144252589,0.859173
D.truncata,167897087,VNJQ01007395.1,1,11756,7.00191e-05,144264345,0.859243
D.truncata,167897087,VNJQ01003461.1,1,11746,6.99595e-05,144276091,0.859313
D.truncata,167897087,VNJQ01004037.1,1,11743,6.99417e-05,144287834,0.859383
D.truncata,167897087,VNJQ01002989.1,1,11733,6.98821e-05,144299567,0.859452
D.truncata,167897087,VNJQ01003009.1,1,11723,6.98225e-05,144311290,0.859522
D.truncata,167897087,VNJQ01003482.1,1,11714,6.97689e-05,144323004,0.859592
D.truncata,167897087,VNJQ01007132.1,1,11701,6.96915e-05,144334705,0.859662
D.truncata,167897087,VNJQ01000914.1,1,11695,6.96558e-05,144346400,0.859731
D.truncata,167897087,VNJQ01003933.1,1,11685,6.95962e-05,144358085,0.859801
D.truncata,167897087,VNJQ01002760.1,1,11675,6.95366e-05,144369760,0.859871
D.truncata,167897087,VNJQ01003537.1,1,11666,6.9483e-05,144381426,0.85994
D.truncata,167897087,VNJQ01002333.1,1,11655,6.94175e-05,144393081,0.860009
D.truncata,167897087,VNJQ01005785.1,1,11651,6.93937e-05,144404732,0.860079
D.truncata,167897087,VNJQ01004532.1,1,11644,6.9352e-05,144416376,0.860148
D.truncata,167897087,VNJQ01007872.1,1,11638,6.93163e-05,144428014,0.860218
D.truncata,167897087,VNJQ01003664.1,1,11630,6.92686e-05,144439644,0.860287
D.truncata,167897087,VNJQ01002802.1,1,11628,6.92567e-05,144451272,0.860356
D.truncata,167897087,VNJQ01004446.1,1,11621,6.9215e-05,144462893,0.860425
D.truncata,167897087,VNJQ01000239.1,1,11619,6.92031e-05,144474512,0.860494
D.truncata,167897087,VNJQ01006398.1,1,11607,6.91316e-05,144486119,0.860564
D.truncata,167897087,VNJQ01007488.1,1,11605,6.91197e-05,144497724,0.860633
D.truncata,167897087,VNJQ01001232.1,1,11597,6.90721e-05,144509321,0.860702
D.truncata,167897087,VNJQ01002135.1,1,11569,6.89053e-05,144520890,0.860771
D.truncata,167897087,VNJQ01006687.1,1,11556,6.88279e-05,144532446,0.86084
D.truncata,167897087,VNJQ01007160.1,1,11539,6.87266e-05,144543985,0.860908
D.truncata,167897087,VNJQ01006642.1,1,11521,6.86194e-05,144555506,0.860977
D.truncata,167897087,VNJQ01003194.1,1,11517,6.85956e-05,144567023,0.861045
D.truncata,167897087,VNJQ01002980.1,1,11505,6.85241e-05,144578528,0.861114
D.truncata,167897087,VNJQ01002704.1,1,11505,6.85241e-05,144590033,0.861182
D.truncata,167897087,VNJQ01007837.1,1,11485,6.8405e-05,144601518,0.861251
D.truncata,167897087,VNJQ01005187.1,1,11473,6.83335e-05,144612991,0.861319
D.truncata,167897087,VNJQ01004152.1,1,11453,6.82144e-05,144624444,0.861387
D.truncata,167897087,VNJQ01000993.1,1,11450,6.81965e-05,144635894,0.861456
D.truncata,167897087,VNJQ01000956.1,1,11445,6.81668e-05,144647339,0.861524
D.truncata,167897087,VNJQ01004444.1,1,11442,6.81489e-05,144658781,0.861592
D.truncata,167897087,VNJQ01004505.1,1,11439,6.8131e-05,144670220,0.86166
D.truncata,167897087,VNJQ01007429.1,1,11435,6.81072e-05,144681655,0.861728
D.truncata,167897087,VNJQ01004243.1,1,11431,6.80834e-05,144693086,0.861796
D.truncata,167897087,VNJQ01000022.1,1,11430,6.80774e-05,144704516,0.861864
D.truncata,167897087,VNJQ01001524.1,1,11403,6.79166e-05,144715919,0.861932
D.truncata,167897087,VNJQ01001879.1,1,11391,6.78451e-05,144727310,0.862
D.truncata,167897087,VNJQ01000693.1,1,11384,6.78034e-05,144738694,0.862068
D.truncata,167897087,VNJQ01004932.1,1,11373,6.77379e-05,144750067,0.862136
D.truncata,167897087,VNJQ01001206.1,1,11366,6.76962e-05,144761433,0.862203
D.truncata,167897087,VNJQ01000221.1,1,11364,6.76843e-05,144772797,0.862271
D.truncata,167897087,VNJQ01001615.1,1,11359,6.76545e-05,144784156,0.862339
D.truncata,167897087,VNJQ01000848.1,1,11341,6.75473e-05,144795497,0.862406
D.truncata,167897087,VNJQ01003042.1,1,11329,6.74759e-05,144806826,0.862474
D.truncata,167897087,VNJQ01006403.1,1,11326,6.7458e-05,144818152,0.862541
D.truncata,167897087,VNJQ01007417.1,1,11322,6.74342e-05,144829474,0.862609
D.truncata,167897087,VNJQ01006245.1,1,11308,6.73508e-05,144840782,0.862676
D.truncata,167897087,VNJQ01003124.1,1,11306,6.73389e-05,144852088,0.862743
D.truncata,167897087,VNJQ01004317.1,1,11295,6.72734e-05,144863383,0.862811
D.truncata,167897087,VNJQ01005430.1,1,11282,6.71959e-05,144874665,0.862878
D.truncata,167897087,VNJQ01000725.1,1,11273,6.71423e-05,144885938,0.862945
D.truncata,167897087,VNJQ01002573.1,1,11255,6.70351e-05,144897193,0.863012
D.truncata,167897087,VNJQ01000199.1,1,11255,6.70351e-05,144908448,0.863079
D.truncata,167897087,VNJQ01007026.1,1,11242,6.69577e-05,144919690,0.863146
D.truncata,167897087,VNJQ01005314.1,1,11241,6.69517e-05,144930931,0.863213
D.truncata,167897087,VNJQ01004196.1,1,11240,6.69458e-05,144942171,0.86328
D.truncata,167897087,VNJQ01000602.1,1,11221,6.68326e-05,144953392,0.863347
D.truncata,167897087,VNJQ01007246.1,1,11216,6.68028e-05,144964608,0.863413
D.truncata,167897087,VNJQ01000033.1,1,11211,6.6773e-05,144975819,0.86348
D.truncata,167897087,VNJQ01004355.1,1,11209,6.67611e-05,144987028,0.863547
D.truncata,167897087,VNJQ01000881.1,1,11201,6.67135e-05,144998229,0.863614
D.truncata,167897087,VNJQ01001672.1,1,11198,6.66956e-05,145009427,0.86368
D.truncata,167897087,VNJQ01007212.1,1,11185,6.66182e-05,145020612,0.863747
D.truncata,167897087,VNJQ01008101.1,1,11178,6.65765e-05,145031790,0.863814
D.truncata,167897087,VNJQ01004047.1,1,11175,6.65586e-05,145042965,0.86388
D.truncata,167897087,VNJQ01005379.1,1,11145,6.63799e-05,145054110,0.863947
D.truncata,167897087,VNJQ01003478.1,1,11135,6.63204e-05,145065245,0.864013
D.truncata,167897087,VNJQ01004790.1,1,11133,6.63085e-05,145076378,0.864079
D.truncata,167897087,VNJQ01000331.1,1,11129,6.62847e-05,145087507,0.864145
D.truncata,167897087,VNJQ01005402.1,1,11122,6.6243e-05,145098629,0.864212
D.truncata,167897087,VNJQ01005218.1,1,11112,6.61834e-05,145109741,0.864278
D.truncata,167897087,VNJQ01005106.1,1,11102,6.61238e-05,145120843,0.864344
D.truncata,167897087,VNJQ01004662.1,1,11099,6.6106e-05,145131942,0.86441
D.truncata,167897087,VNJQ01007328.1,1,11094,6.60762e-05,145143036,0.864476
D.truncata,167897087,VNJQ01005019.1,1,11094,6.60762e-05,145154130,0.864542
D.truncata,167897087,VNJQ01006868.1,1,11093,6.60702e-05,145165223,0.864608
D.truncata,167897087,VNJQ01004747.1,1,11090,6.60524e-05,145176313,0.864674
D.truncata,167897087,VNJQ01005197.1,1,11083,6.60107e-05,145187396,0.86474
D.truncata,167897087,VNJQ01003257.1,1,11081,6.59988e-05,145198477,0.864806
D.truncata,167897087,VNJQ01006850.1,1,11079,6.59869e-05,145209556,0.864872
D.truncata,167897087,VNJQ01004449.1,1,11068,6.59213e-05,145220624,0.864938
D.truncata,167897087,VNJQ01003744.1,1,11062,6.58856e-05,145231686,0.865004
D.truncata,167897087,VNJQ01002706.1,1,11054,6.58379e-05,145242740,0.86507
D.truncata,167897087,VNJQ01001544.1,1,11054,6.58379e-05,145253794,0.865136
D.truncata,167897087,VNJQ01003399.1,1,11053,6.5832e-05,145264847,0.865202
D.truncata,167897087,VNJQ01007706.1,1,11032,6.57069e-05,145275879,0.865267
D.truncata,167897087,VNJQ01007529.1,1,11023,6.56533e-05,145286902,0.865333
D.truncata,167897087,VNJQ01001710.1,1,11005,6.55461e-05,145297907,0.865399
D.truncata,167897087,VNJQ01005839.1,1,10978,6.53853e-05,145308885,0.865464
D.truncata,167897087,VNJQ01007243.1,1,10958,6.52662e-05,145319843,0.865529
D.truncata,167897087,VNJQ01004940.1,1,10957,6.52602e-05,145330800,0.865595
D.truncata,167897087,VNJQ01007150.1,1,10954,6.52423e-05,145341754,0.86566
D.truncata,167897087,VNJQ01004102.1,1,10949,6.52126e-05,145352703,0.865725
D.truncata,167897087,VNJQ01006435.1,1,10947,6.52007e-05,145363650,0.86579
D.truncata,167897087,VNJQ01006460.1,1,10945,6.51887e-05,145374595,0.865855
D.truncata,167897087,VNJQ01006214.1,1,10942,6.51709e-05,145385537,0.865921
D.truncata,167897087,VNJQ01006432.1,1,10940,6.5159e-05,145396477,0.865986
D.truncata,167897087,VNJQ01006721.1,1,10930,6.50994e-05,145407407,0.866051
D.truncata,167897087,VNJQ01006769.1,1,10926,6.50756e-05,145418333,0.866116
D.truncata,167897087,VNJQ01002482.1,1,10921,6.50458e-05,145429254,0.866181
D.truncata,167897087,VNJQ01001207.1,1,10911,6.49862e-05,145440165,0.866246
D.truncata,167897087,VNJQ01002927.1,1,10908,6.49684e-05,145451073,0.866311
D.truncata,167897087,VNJQ01006207.1,1,10891,6.48671e-05,145461964,0.866376
D.truncata,167897087,VNJQ01001586.1,1,10884,6.48254e-05,145472848,0.866441
D.truncata,167897087,VNJQ01002888.1,1,10883,6.48195e-05,145483731,0.866505
D.truncata,167897087,VNJQ01007771.1,1,10875,6.47718e-05,145494606,0.86657
D.truncata,167897087,VNJQ01002462.1,1,10858,6.46706e-05,145505464,0.866635
D.truncata,167897087,VNJQ01002133.1,1,10849,6.4617e-05,145516313,0.866699
D.truncata,167897087,VNJQ01003344.1,1,10845,6.45931e-05,145527158,0.866764
D.truncata,167897087,VNJQ01005398.1,1,10840,6.45634e-05,145537998,0.866829
D.truncata,167897087,VNJQ01001040.1,1,10840,6.45634e-05,145548838,0.866893
D.truncata,167897087,VNJQ01004203.1,1,10835,6.45336e-05,145559673,0.866958
D.truncata,167897087,VNJQ01004240.1,1,10832,6.45157e-05,145570505,0.867022
D.truncata,167897087,VNJQ01003056.1,1,10821,6.44502e-05,145581326,0.867087
D.truncata,167897087,VNJQ01003233.1,1,10819,6.44383e-05,145592145,0.867151
D.truncata,167897087,VNJQ01002945.1,1,10806,6.43609e-05,145602951,0.867215
D.truncata,167897087,VNJQ01004957.1,1,10796,6.43013e-05,145613747,0.86728
D.truncata,167897087,VNJQ01007879.1,1,10789,6.42596e-05,145624536,0.867344
D.truncata,167897087,VNJQ01000178.1,1,10784,6.42298e-05,145635320,0.867408
D.truncata,167897087,VNJQ01007418.1,1,10773,6.41643e-05,145646093,0.867472
D.truncata,167897087,VNJQ01004733.1,1,10735,6.3938e-05,145656828,0.867536
D.truncata,167897087,VNJQ01001740.1,1,10732,6.39201e-05,145667560,0.8676
D.truncata,167897087,VNJQ01005595.1,1,10721,6.38546e-05,145678281,0.867664
D.truncata,167897087,VNJQ01000090.1,1,10708,6.37772e-05,145688989,0.867728
D.truncata,167897087,VNJQ01001389.1,1,10702,6.37414e-05,145699691,0.867792
D.truncata,167897087,VNJQ01004682.1,1,10696,6.37057e-05,145710387,0.867855
D.truncata,167897087,VNJQ01004004.1,1,10687,6.36521e-05,145721074,0.867919
D.truncata,167897087,VNJQ01002298.1,1,10681,6.36164e-05,145731755,0.867983
D.truncata,167897087,VNJQ01004851.1,1,10671,6.35568e-05,145742426,0.868046
D.truncata,167897087,VNJQ01004168.1,1,10664,6.35151e-05,145753090,0.86811
D.truncata,167897087,VNJQ01006124.1,1,10661,6.34972e-05,145763751,0.868173
D.truncata,167897087,VNJQ01003205.1,1,10660,6.34913e-05,145774411,0.868237
D.truncata,167897087,VNJQ01000587.1,1,10650,6.34317e-05,145785061,0.8683
D.truncata,167897087,VNJQ01005123.1,1,10648,6.34198e-05,145795709,0.868364
D.truncata,167897087,VNJQ01001187.1,1,10644,6.3396e-05,145806353,0.868427
D.truncata,167897087,VNJQ01007975.1,1,10643,6.339e-05,145816996,0.86849
D.truncata,167897087,VNJQ01000175.1,1,10636,6.33483e-05,145827632,0.868554
D.truncata,167897087,VNJQ01003763.1,1,10633,6.33305e-05,145838265,0.868617
D.truncata,167897087,VNJQ01007123.1,1,10632,6.33245e-05,145848897,0.86868
D.truncata,167897087,VNJQ01005099.1,1,10597,6.3116e-05,145859494,0.868743
D.truncata,167897087,VNJQ01001977.1,1,10589,6.30684e-05,145870083,0.868807
D.truncata,167897087,VNJQ01001336.1,1,10577,6.29969e-05,145880660,0.86887
D.truncata,167897087,VNJQ01005836.1,1,10571,6.29612e-05,145891231,0.868932
D.truncata,167897087,VNJQ01006253.1,1,10569,6.29493e-05,145901800,0.868995
D.truncata,167897087,VNJQ01006358.1,1,10568,6.29433e-05,145912368,0.869058
D.truncata,167897087,VNJQ01003557.1,1,10566,6.29314e-05,145922934,0.869121
D.truncata,167897087,VNJQ01000317.1,1,10557,6.28778e-05,145933491,0.869184
D.truncata,167897087,VNJQ01002382.1,1,10548,6.28242e-05,145944039,0.869247
D.truncata,167897087,VNJQ01004884.1,1,10525,6.26872e-05,145954564,0.86931
D.truncata,167897087,VNJQ01003439.1,1,10519,6.26515e-05,145965083,0.869372
D.truncata,167897087,VNJQ01002137.1,1,10516,6.26336e-05,145975599,0.869435
D.truncata,167897087,VNJQ01005422.1,1,10493,6.24966e-05,145986092,0.869497
D.truncata,167897087,VNJQ01000594.1,1,10489,6.24728e-05,145996581,0.86956
D.truncata,167897087,VNJQ01008056.1,1,10486,6.24549e-05,146007067,0.869622
D.truncata,167897087,VNJQ01004814.1,1,10483,6.24371e-05,146017550,0.869685
D.truncata,167897087,VNJQ01005934.1,1,10470,6.23596e-05,146028020,0.869747
D.truncata,167897087,VNJQ01006774.1,1,10467,6.23418e-05,146038487,0.86981
D.truncata,167897087,VNJQ01002090.1,1,10467,6.23418e-05,146048954,0.869872
D.truncata,167897087,VNJQ01007455.1,1,10454,6.22643e-05,146059408,0.869934
D.truncata,167897087,VNJQ01007759.1,1,10443,6.21988e-05,146069851,0.869996
D.truncata,167897087,VNJQ01006413.1,1,10443,6.21988e-05,146080294,0.870059
D.truncata,167897087,VNJQ01005355.1,1,10442,6.21929e-05,146090736,0.870121
D.truncata,167897087,VNJQ01000884.1,1,10417,6.2044e-05,146101153,0.870183
D.truncata,167897087,VNJQ01003238.1,1,10394,6.1907e-05,146111547,0.870245
D.truncata,167897087,VNJQ01003343.1,1,10392,6.18951e-05,146121939,0.870307
D.truncata,167897087,VNJQ01006943.1,1,10388,6.18712e-05,146132327,0.870368
D.truncata,167897087,VNJQ01003853.1,1,10387,6.18653e-05,146142714,0.87043
D.truncata,167897087,VNJQ01005023.1,1,10384,6.18474e-05,146153098,0.870492
D.truncata,167897087,VNJQ01005529.1,1,10382,6.18355e-05,146163480,0.870554
D.truncata,167897087,VNJQ01005792.1,1,10375,6.17938e-05,146173855,0.870616
D.truncata,167897087,VNJQ01004994.1,1,10375,6.17938e-05,146184230,0.870678
D.truncata,167897087,VNJQ01007504.1,1,10368,6.17521e-05,146194598,0.870739
D.truncata,167897087,VNJQ01005524.1,1,10367,6.17462e-05,146204965,0.870801
D.truncata,167897087,VNJQ01006718.1,1,10356,6.16806e-05,146215321,0.870863
D.truncata,167897087,VNJQ01006123.1,1,10350,6.16449e-05,146225671,0.870924
D.truncata,167897087,VNJQ01001479.1,1,10341,6.15913e-05,146236012,0.870986
D.truncata,167897087,VNJQ01000283.1,1,10341,6.15913e-05,146246353,0.871048
D.truncata,167897087,VNJQ01007840.1,1,10326,6.1502e-05,146256679,0.871109
D.truncata,167897087,VNJQ01007596.1,1,10302,6.1359e-05,146266981,0.87117
D.truncata,167897087,VNJQ01003898.1,1,10297,6.13292e-05,146277278,0.871232
D.truncata,167897087,VNJQ01002692.1,1,10297,6.13292e-05,146287575,0.871293
D.truncata,167897087,VNJQ01005779.1,1,10296,6.13233e-05,146297871,0.871354
D.truncata,167897087,VNJQ01006225.1,1,10291,6.12935e-05,146308162,0.871416
D.truncata,167897087,VNJQ01007184.1,1,10277,6.12101e-05,146318439,0.871477
D.truncata,167897087,VNJQ01008079.1,1,10270,6.11684e-05,146328709,0.871538
D.truncata,167897087,VNJQ01007189.1,1,10261,6.11148e-05,146338970,0.871599
D.truncata,167897087,VNJQ01004925.1,1,10256,6.1085e-05,146349226,0.87166
D.truncata,167897087,VNJQ01002735.1,1,10243,6.10076e-05,146359469,0.871721
D.truncata,167897087,VNJQ01006062.1,1,10214,6.08349e-05,146369683,0.871782
D.truncata,167897087,VNJQ01006970.1,1,10203,6.07694e-05,146379886,0.871843
D.truncata,167897087,VNJQ01000789.1,1,10203,6.07694e-05,146390089,0.871904
D.truncata,167897087,VNJQ01005064.1,1,10200,6.07515e-05,146400289,0.871964
D.truncata,167897087,VNJQ01000364.1,1,10163,6.05311e-05,146410452,0.872025
D.truncata,167897087,VNJQ01000673.1,1,10161,6.05192e-05,146420613,0.872085
D.truncata,167897087,VNJQ01002833.1,1,10155,6.04835e-05,146430768,0.872146
D.truncata,167897087,VNJQ01003291.1,1,10141,6.04001e-05,146440909,0.872206
D.truncata,167897087,VNJQ01001435.1,1,10120,6.0275e-05,146451029,0.872267
D.truncata,167897087,VNJQ01000600.1,1,10116,6.02512e-05,146461145,0.872327
D.truncata,167897087,VNJQ01006286.1,1,10111,6.02214e-05,146471256,0.872387
D.truncata,167897087,VNJQ01002608.1,1,10095,6.01261e-05,146481351,0.872447
D.truncata,167897087,VNJQ01002225.1,1,10095,6.01261e-05,146491446,0.872507
D.truncata,167897087,VNJQ01001770.1,1,10095,6.01261e-05,146501541,0.872567
D.truncata,167897087,VNJQ01007087.1,1,10070,5.99772e-05,146511611,0.872627
D.truncata,167897087,VNJQ01003648.1,1,10062,5.99296e-05,146521673,0.872687
D.truncata,167897087,VNJQ01002531.1,1,10061,5.99236e-05,146531734,0.872747
D.truncata,167897087,VNJQ01005182.1,1,10057,5.98998e-05,146541791,0.872807
D.truncata,167897087,VNJQ01006924.1,1,10051,5.98641e-05,146551842,0.872867
D.truncata,167897087,VNJQ01001494.1,1,10051,5.98641e-05,146561893,0.872927
D.truncata,167897087,VNJQ01005240.1,1,10047,5.98402e-05,146571940,0.872987
D.truncata,167897087,VNJQ01008052.1,1,10043,5.98164e-05,146581983,0.873047
D.truncata,167897087,VNJQ01000857.1,1,10035,5.97688e-05,146592018,0.873106
D.truncata,167897087,VNJQ01002666.1,1,10033,5.97568e-05,146602051,0.873166
D.truncata,167897087,VNJQ01001668.1,1,10030,5.9739e-05,146612081,0.873226
D.truncata,167897087,VNJQ01003228.1,1,10029,5.9733e-05,146622110,0.873286
D.truncata,167897087,VNJQ01007340.1,1,10028,5.97271e-05,146632138,0.873345
D.truncata,167897087,VNJQ01007363.1,1,10021,5.96854e-05,146642159,0.873405
D.truncata,167897087,VNJQ01004066.1,1,10015,5.96496e-05,146652174,0.873465
D.truncata,167897087,VNJQ01007258.1,1,10010,5.96199e-05,146662184,0.873524
D.truncata,167897087,VNJQ01002347.1,1,9996,5.95365e-05,146672180,0.873584
D.truncata,167897087,VNJQ01004793.1,1,9992,5.95126e-05,146682172,0.873643
D.truncata,167897087,VNJQ01005913.1,1,9990,5.95007e-05,146692162,0.873703
D.truncata,167897087,VNJQ01004402.1,1,9972,5.93935e-05,146702134,0.873762
D.truncata,167897087,VNJQ01004731.1,1,9969,5.93757e-05,146712103,0.873822
D.truncata,167897087,VNJQ01000374.1,1,9967,5.93637e-05,146722070,0.873881
D.truncata,167897087,VNJQ01004174.1,1,9963,5.93399e-05,146732033,0.87394
D.truncata,167897087,VNJQ01003138.1,1,9955,5.92923e-05,146741988,0.874
D.truncata,167897087,VNJQ01003224.1,1,9952,5.92744e-05,146751940,0.874059
D.truncata,167897087,VNJQ01006993.1,1,9949,5.92565e-05,146761889,0.874118
D.truncata,167897087,VNJQ01006870.1,1,9944,5.92268e-05,146771833,0.874177
D.truncata,167897087,VNJQ01002809.1,1,9933,5.91612e-05,146781766,0.874237
D.truncata,167897087,VNJQ01008059.1,1,9932,5.91553e-05,146791698,0.874296
D.truncata,167897087,VNJQ01001692.1,1,9919,5.90779e-05,146801617,0.874355
D.truncata,167897087,VNJQ01005546.1,1,9891,5.89111e-05,146811508,0.874414
D.truncata,167897087,VNJQ01001868.1,1,9886,5.88813e-05,146821394,0.874473
D.truncata,167897087,VNJQ01000548.1,1,9884,5.88694e-05,146831278,0.874531
D.truncata,167897087,VNJQ01003932.1,1,9872,5.87979e-05,146841150,0.87459
D.truncata,167897087,VNJQ01007298.1,1,9870,5.8786e-05,146851020,0.874649
D.truncata,167897087,VNJQ01007734.1,1,9867,5.87681e-05,146860887,0.874708
D.truncata,167897087,VNJQ01004372.1,1,9855,5.86967e-05,146870742,0.874766
D.truncata,167897087,VNJQ01006923.1,1,9841,5.86133e-05,146880583,0.874825
D.truncata,167897087,VNJQ01003668.1,1,9834,5.85716e-05,146890417,0.874884
D.truncata,167897087,VNJQ01002045.1,1,9834,5.85716e-05,146900251,0.874942
D.truncata,167897087,VNJQ01004124.1,1,9831,5.85537e-05,146910082,0.875001
D.truncata,167897087,VNJQ01006640.1,1,9829,5.85418e-05,146919911,0.875059
D.truncata,167897087,VNJQ01004715.1,1,9821,5.84942e-05,146929732,0.875118
D.truncata,167897087,VNJQ01001921.1,1,9819,5.84823e-05,146939551,0.875176
D.truncata,167897087,VNJQ01001850.1,1,9818,5.84763e-05,146949369,0.875235
D.truncata,167897087,VNJQ01007224.1,1,9807,5.84108e-05,146959176,0.875293
D.truncata,167897087,VNJQ01004508.1,1,9806,5.84048e-05,146968982,0.875352
D.truncata,167897087,VNJQ01003741.1,1,9803,5.8387e-05,146978785,0.87541
D.truncata,167897087,VNJQ01002100.1,1,9795,5.83393e-05,146988580,0.875468
D.truncata,167897087,VNJQ01003720.1,1,9794,5.83334e-05,146998374,0.875527
D.truncata,167897087,VNJQ01005202.1,1,9792,5.83214e-05,147008166,0.875585
D.truncata,167897087,VNJQ01000943.1,1,9786,5.82857e-05,147017952,0.875643
D.truncata,167897087,VNJQ01006885.1,1,9767,5.81725e-05,147027719,0.875701
D.truncata,167897087,VNJQ01003255.1,1,9767,5.81725e-05,147037486,0.87576
D.truncata,167897087,VNJQ01005338.1,1,9761,5.81368e-05,147047247,0.875818
D.truncata,167897087,VNJQ01007702.1,1,9758,5.81189e-05,147057005,0.875876
D.truncata,167897087,VNJQ01005270.1,1,9742,5.80236e-05,147066747,0.875934
D.truncata,167897087,VNJQ01003207.1,1,9735,5.79819e-05,147076482,0.875992
D.truncata,167897087,VNJQ01002199.1,1,9735,5.79819e-05,147086217,0.87605
D.truncata,167897087,VNJQ01004502.1,1,9690,5.77139e-05,147095907,0.876108
D.truncata,167897087,VNJQ01002022.1,1,9678,5.76425e-05,147105585,0.876165
D.truncata,167897087,VNJQ01001067.1,1,9674,5.76186e-05,147115259,0.876223
D.truncata,167897087,VNJQ01003445.1,1,9671,5.76008e-05,147124930,0.87628
D.truncata,167897087,VNJQ01003863.1,1,9667,5.75769e-05,147134597,0.876338
D.truncata,167897087,VNJQ01003002.1,1,9654,5.74995e-05,147144251,0.876395
D.truncata,167897087,VNJQ01007435.1,1,9652,5.74876e-05,147153903,0.876453
D.truncata,167897087,VNJQ01005286.1,1,9647,5.74578e-05,147163550,0.87651
D.truncata,167897087,VNJQ01004420.1,1,9645,5.74459e-05,147173195,0.876568
D.truncata,167897087,VNJQ01005017.1,1,9644,5.74399e-05,147182839,0.876625
D.truncata,167897087,VNJQ01002875.1,1,9641,5.74221e-05,147192480,0.876683
D.truncata,167897087,VNJQ01001873.1,1,9640,5.74161e-05,147202120,0.87674
D.truncata,167897087,VNJQ01002527.1,1,9636,5.73923e-05,147211756,0.876798
D.truncata,167897087,VNJQ01007658.1,1,9635,5.73863e-05,147221391,0.876855
D.truncata,167897087,VNJQ01007251.1,1,9624,5.73208e-05,147231015,0.876912
D.truncata,167897087,VNJQ01006715.1,1,9623,5.73149e-05,147240638,0.87697
D.truncata,167897087,VNJQ01002224.1,1,9614,5.72613e-05,147250252,0.877027
D.truncata,167897087,VNJQ01008072.1,1,9610,5.72374e-05,147259862,0.877084
D.truncata,167897087,VNJQ01005831.1,1,9607,5.72196e-05,147269469,0.877141
D.truncata,167897087,VNJQ01001741.1,1,9605,5.72077e-05,147279074,0.877199
D.truncata,167897087,VNJQ01002288.1,1,9594,5.71421e-05,147288668,0.877256
D.truncata,167897087,VNJQ01008189.1,1,9590,5.71183e-05,147298258,0.877313
D.truncata,167897087,VNJQ01006262.1,1,9588,5.71064e-05,147307846,0.87737
D.truncata,167897087,VNJQ01007161.1,1,9587,5.71005e-05,147317433,0.877427
D.truncata,167897087,VNJQ01000213.1,1,9584,5.70826e-05,147327017,0.877484
D.truncata,167897087,VNJQ01002276.1,1,9577,5.70409e-05,147336594,0.877541
D.truncata,167897087,VNJQ01008147.1,1,9575,5.7029e-05,147346169,0.877598
D.truncata,167897087,VNJQ01002519.1,1,9551,5.6886e-05,147355720,0.877655
D.truncata,167897087,VNJQ01004872.1,1,9545,5.68503e-05,147365265,0.877712
D.truncata,167897087,VNJQ01005189.1,1,9542,5.68324e-05,147374807,0.877769
D.truncata,167897087,VNJQ01000399.1,1,9539,5.68146e-05,147384346,0.877826
D.truncata,167897087,VNJQ01000746.1,1,9538,5.68086e-05,147393884,0.877882
D.truncata,167897087,VNJQ01006240.1,1,9537,5.68027e-05,147403421,0.877939
D.truncata,167897087,VNJQ01005353.1,1,9529,5.6755e-05,147412950,0.877996
D.truncata,167897087,VNJQ01004009.1,1,9529,5.6755e-05,147422479,0.878053
D.truncata,167897087,VNJQ01006452.1,1,9527,5.67431e-05,147432006,0.878109
D.truncata,167897087,VNJQ01002016.1,1,9524,5.67252e-05,147441530,0.878166
D.truncata,167897087,VNJQ01004538.1,1,9514,5.66657e-05,147451044,0.878223
D.truncata,167897087,VNJQ01001953.1,1,9511,5.66478e-05,147460555,0.878279
D.truncata,167897087,VNJQ01002455.1,1,9472,5.64155e-05,147470027,0.878336
D.truncata,167897087,VNJQ01006809.1,1,9468,5.63917e-05,147479495,0.878392
D.truncata,167897087,VNJQ01000728.1,1,9468,5.63917e-05,147488963,0.878449
D.truncata,167897087,VNJQ01004824.1,1,9467,5.63857e-05,147498430,0.878505
D.truncata,167897087,VNJQ01003034.1,1,9464,5.63679e-05,147507894,0.878561
D.truncata,167897087,VNJQ01000599.1,1,9456,5.63202e-05,147517350,0.878618
D.truncata,167897087,VNJQ01005569.1,1,9442,5.62368e-05,147526792,0.878674
D.truncata,167897087,VNJQ01000393.1,1,9439,5.6219e-05,147536231,0.87873
D.truncata,167897087,VNJQ01005206.1,1,9436,5.62011e-05,147545667,0.878786
D.truncata,167897087,VNJQ01006647.1,1,9434,5.61892e-05,147555101,0.878843
D.truncata,167897087,VNJQ01008205.1,1,9430,5.61654e-05,147564531,0.878899
D.truncata,167897087,VNJQ01000633.1,1,9409,5.60403e-05,147573940,0.878955
D.truncata,167897087,VNJQ01007953.1,1,9407,5.60284e-05,147583347,0.879011
D.truncata,167897087,VNJQ01001105.1,1,9405,5.60165e-05,147592752,0.879067
D.truncata,167897087,VNJQ01008200.1,1,9400,5.59867e-05,147602152,0.879123
D.truncata,167897087,VNJQ01007599.1,1,9399,5.59807e-05,147611551,0.879179
D.truncata,167897087,VNJQ01000831.1,1,9396,5.59629e-05,147620947,0.879235
D.truncata,167897087,VNJQ01001307.1,1,9394,5.59509e-05,147630341,0.879291
D.truncata,167897087,VNJQ01003113.1,1,9375,5.58378e-05,147639716,0.879347
D.truncata,167897087,VNJQ01002798.1,1,9371,5.5814e-05,147649087,0.879402
D.truncata,167897087,VNJQ01005537.1,1,9363,5.57663e-05,147658450,0.879458
D.truncata,167897087,VNJQ01001889.1,1,9362,5.57603e-05,147667812,0.879514
D.truncata,167897087,VNJQ01000528.1,1,9362,5.57603e-05,147677174,0.87957
D.truncata,167897087,VNJQ01006391.1,1,9360,5.57484e-05,147686534,0.879625
D.truncata,167897087,VNJQ01004407.1,1,9359,5.57425e-05,147695893,0.879681
D.truncata,167897087,VNJQ01002689.1,1,9358,5.57365e-05,147705251,0.879737
D.truncata,167897087,VNJQ01000394.1,1,9358,5.57365e-05,147714609,0.879793
D.truncata,167897087,VNJQ01004417.1,1,9356,5.57246e-05,147723965,0.879848
D.truncata,167897087,VNJQ01003903.1,1,9346,5.56651e-05,147733311,0.879904
D.truncata,167897087,VNJQ01005775.1,1,9345,5.56591e-05,147742656,0.87996
D.truncata,167897087,VNJQ01000166.1,1,9345,5.56591e-05,147752001,0.880015
D.truncata,167897087,VNJQ01003092.1,1,9338,5.56174e-05,147761339,0.880071
D.truncata,167897087,VNJQ01001538.1,1,9336,5.56055e-05,147770675,0.880126
D.truncata,167897087,VNJQ01007423.1,1,9335,5.55995e-05,147780010,0.880182
D.truncata,167897087,VNJQ01004134.1,1,9334,5.55936e-05,147789344,0.880238
D.truncata,167897087,VNJQ01004221.1,1,9327,5.55519e-05,147798671,0.880293
D.truncata,167897087,VNJQ01004016.1,1,9321,5.55162e-05,147807992,0.880349
D.truncata,167897087,VNJQ01005275.1,1,9315,5.54804e-05,147817307,0.880404
D.truncata,167897087,VNJQ01006395.1,1,9307,5.54328e-05,147826614,0.88046
D.truncata,167897087,VNJQ01007034.1,1,9306,5.54268e-05,147835920,0.880515
D.truncata,167897087,VNJQ01005597.1,1,9299,5.53851e-05,147845219,0.88057
D.truncata,167897087,VNJQ01005971.1,1,9290,5.53315e-05,147854509,0.880626
D.truncata,167897087,VNJQ01007126.1,1,9288,5.53196e-05,147863797,0.880681
D.truncata,167897087,VNJQ01001301.1,1,9286,5.53077e-05,147873083,0.880736
D.truncata,167897087,VNJQ01005565.1,1,9279,5.5266e-05,147882362,0.880792
D.truncata,167897087,VNJQ01003069.1,1,9275,5.52422e-05,147891637,0.880847
D.truncata,167897087,VNJQ01002383.1,1,9275,5.52422e-05,147900912,0.880902
D.truncata,167897087,VNJQ01002402.1,1,9267,5.51945e-05,147910179,0.880957
D.truncata,167897087,VNJQ01004787.1,1,9266,5.51886e-05,147919445,0.881013
D.truncata,167897087,VNJQ01006519.1,1,9265,5.51826e-05,147928710,0.881068
D.truncata,167897087,VNJQ01002108.1,1,9265,5.51826e-05,147937975,0.881123
D.truncata,167897087,VNJQ01007206.1,1,9263,5.51707e-05,147947238,0.881178
D.truncata,167897087,VNJQ01006672.1,1,9257,5.5135e-05,147956495,0.881233
D.truncata,167897087,VNJQ01005268.1,1,9252,5.51052e-05,147965747,0.881288
D.truncata,167897087,VNJQ01003408.1,1,9251,5.50992e-05,147974998,0.881343
D.truncata,167897087,VNJQ01004090.1,1,9246,5.50694e-05,147984244,0.881399
D.truncata,167897087,VNJQ01004043.1,1,9243,5.50516e-05,147993487,0.881454
D.truncata,167897087,VNJQ01007744.1,1,9228,5.49622e-05,148002715,0.881509
D.truncata,167897087,VNJQ01004456.1,1,9224,5.49384e-05,148011939,0.881563
D.truncata,167897087,VNJQ01006077.1,1,9220,5.49146e-05,148021159,0.881618
D.truncata,167897087,VNJQ01002103.1,1,9211,5.4861e-05,148030370,0.881673
D.truncata,167897087,VNJQ01006140.1,1,9207,5.48372e-05,148039577,0.881728
D.truncata,167897087,VNJQ01002630.1,1,9201,5.48014e-05,148048778,0.881783
D.truncata,167897087,VNJQ01003491.1,1,9194,5.47597e-05,148057972,0.881838
D.truncata,167897087,VNJQ01001657.1,1,9193,5.47538e-05,148067165,0.881892
D.truncata,167897087,VNJQ01001950.1,1,9188,5.4724e-05,148076353,0.881947
D.truncata,167897087,VNJQ01002563.1,1,9183,5.46942e-05,148085536,0.882002
D.truncata,167897087,VNJQ01004395.1,1,9178,5.46644e-05,148094714,0.882056
D.truncata,167897087,VNJQ01002429.1,1,9178,5.46644e-05,148103892,0.882111
D.truncata,167897087,VNJQ01006220.1,1,9177,5.46585e-05,148113069,0.882166
D.truncata,167897087,VNJQ01001221.1,1,9165,5.4587e-05,148122234,0.88222
D.truncata,167897087,VNJQ01007276.1,1,9161,5.45632e-05,148131395,0.882275
D.truncata,167897087,VNJQ01000779.1,1,9157,5.45394e-05,148140552,0.882329
D.truncata,167897087,VNJQ01007640.1,1,9156,5.45334e-05,148149708,0.882384
D.truncata,167897087,VNJQ01005650.1,1,9155,5.45274e-05,148158863,0.882439
D.truncata,167897087,VNJQ01005037.1,1,9143,5.4456e-05,148168006,0.882493
D.truncata,167897087,VNJQ01002111.1,1,9139,5.44322e-05,148177145,0.882547
D.truncata,167897087,VNJQ01002819.1,1,9137,5.44202e-05,148186282,0.882602
D.truncata,167897087,VNJQ01004251.1,1,9121,5.43249e-05,148195403,0.882656
D.truncata,167897087,VNJQ01001505.1,1,9120,5.4319e-05,148204523,0.882711
D.truncata,167897087,VNJQ01005260.1,1,9113,5.42773e-05,148213636,0.882765
D.truncata,167897087,VNJQ01007508.1,1,9107,5.42416e-05,148222743,0.882819
D.truncata,167897087,VNJQ01002387.1,1,9099,5.41939e-05,148231842,0.882873
D.truncata,167897087,VNJQ01007745.1,1,9095,5.41701e-05,148240937,0.882927
D.truncata,167897087,VNJQ01001295.1,1,9094,5.41641e-05,148250031,0.882982
D.truncata,167897087,VNJQ01005170.1,1,9091,5.41463e-05,148259122,0.883036
D.truncata,167897087,VNJQ01000912.1,1,9090,5.41403e-05,148268212,0.88309
D.truncata,167897087,VNJQ01004530.1,1,9086,5.41165e-05,148277298,0.883144
D.truncata,167897087,VNJQ01002890.1,1,9085,5.41105e-05,148286383,0.883198
D.truncata,167897087,VNJQ01003127.1,1,9084,5.41046e-05,148295467,0.883252
D.truncata,167897087,VNJQ01007532.1,1,9081,5.40867e-05,148304548,0.883306
D.truncata,167897087,VNJQ01005020.1,1,9076,5.40569e-05,148313624,0.88336
D.truncata,167897087,VNJQ01007419.1,1,9063,5.39795e-05,148322687,0.883414
D.truncata,167897087,VNJQ01007274.1,1,9061,5.39676e-05,148331748,0.883468
D.truncata,167897087,VNJQ01007709.1,1,9056,5.39378e-05,148340804,0.883522
D.truncata,167897087,VNJQ01001210.1,1,9056,5.39378e-05,148349860,0.883576
D.truncata,167897087,VNJQ01006768.1,1,9052,5.3914e-05,148358912,0.88363
D.truncata,167897087,VNJQ01007493.1,1,9046,5.38782e-05,148367958,0.883684
D.truncata,167897087,VNJQ01007552.1,1,9033,5.38008e-05,148376991,0.883738
D.truncata,167897087,VNJQ01006271.1,1,9029,5.3777e-05,148386020,0.883792
D.truncata,167897087,VNJQ01003976.1,1,9010,5.36638e-05,148395030,0.883845
D.truncata,167897087,VNJQ01001857.1,1,9003,5.36221e-05,148404033,0.883899
D.truncata,167897087,VNJQ01001458.1,1,8991,5.35507e-05,148413024,0.883952
D.truncata,167897087,VNJQ01006072.1,1,8989,5.35387e-05,148422013,0.884006
D.truncata,167897087,VNJQ01005263.1,1,8986,5.35209e-05,148430999,0.884059
D.truncata,167897087,VNJQ01003133.1,1,8969,5.34196e-05,148439968,0.884113
D.truncata,167897087,VNJQ01000586.1,1,8961,5.3372e-05,148448929,0.884166
D.truncata,167897087,VNJQ01006488.1,1,8960,5.3366e-05,148457889,0.88422
D.truncata,167897087,VNJQ01003134.1,1,8948,5.32946e-05,148466837,0.884273
D.truncata,167897087,VNJQ01007920.1,1,8945,5.32767e-05,148475782,0.884326
D.truncata,167897087,VNJQ01007993.1,1,8936,5.32231e-05,148484718,0.884379
D.truncata,167897087,VNJQ01008071.1,1,8929,5.31814e-05,148493647,0.884433
D.truncata,167897087,VNJQ01007385.1,1,8920,5.31278e-05,148502567,0.884486
D.truncata,167897087,VNJQ01005651.1,1,8919,5.31218e-05,148511486,0.884539
D.truncata,167897087,VNJQ01004397.1,1,8918,5.31159e-05,148520404,0.884592
D.truncata,167897087,VNJQ01006796.1,1,8896,5.29848e-05,148529300,0.884645
D.truncata,167897087,VNJQ01003290.1,1,8884,5.29134e-05,148538184,0.884698
D.truncata,167897087,VNJQ01007370.1,1,8881,5.28955e-05,148547065,0.884751
D.truncata,167897087,VNJQ01002905.1,1,8878,5.28776e-05,148555943,0.884804
D.truncata,167897087,VNJQ01001247.1,1,8869,5.2824e-05,148564812,0.884856
D.truncata,167897087,VNJQ01007168.1,1,8866,5.28062e-05,148573678,0.884909
D.truncata,167897087,VNJQ01006804.1,1,8865,5.28002e-05,148582543,0.884962
D.truncata,167897087,VNJQ01000948.1,1,8863,5.27883e-05,148591406,0.885015
D.truncata,167897087,VNJQ01003165.1,1,8861,5.27764e-05,148600267,0.885068
D.truncata,167897087,VNJQ01001228.1,1,8855,5.27406e-05,148609122,0.88512
D.truncata,167897087,VNJQ01001874.1,1,8850,5.27109e-05,148617972,0.885173
D.truncata,167897087,VNJQ01004661.1,1,8846,5.2687e-05,148626818,0.885226
D.truncata,167897087,VNJQ01001237.1,1,8846,5.2687e-05,148635664,0.885278
D.truncata,167897087,VNJQ01007280.1,1,8844,5.26751e-05,148644508,0.885331
D.truncata,167897087,VNJQ01000492.1,1,8843,5.26692e-05,148653351,0.885384
D.truncata,167897087,VNJQ01004685.1,1,8839,5.26453e-05,148662190,0.885436
D.truncata,167897087,VNJQ01007830.1,1,8838,5.26394e-05,148671028,0.885489
D.truncata,167897087,VNJQ01007201.1,1,8838,5.26394e-05,148679866,0.885542
D.truncata,167897087,VNJQ01006344.1,1,8836,5.26275e-05,148688702,0.885594
D.truncata,167897087,VNJQ01008125.1,1,8817,5.25143e-05,148697519,0.885647
D.truncata,167897087,VNJQ01003370.1,1,8809,5.24667e-05,148706328,0.885699
D.truncata,167897087,VNJQ01005809.1,1,8808,5.24607e-05,148715136,0.885752
D.truncata,167897087,VNJQ01000395.1,1,8798,5.24011e-05,148723934,0.885804
D.truncata,167897087,VNJQ01002808.1,1,8797,5.23952e-05,148732731,0.885857
D.truncata,167897087,VNJQ01005120.1,1,8789,5.23475e-05,148741520,0.885909
D.truncata,167897087,VNJQ01006137.1,1,8783,5.23118e-05,148750303,0.885961
D.truncata,167897087,VNJQ01005332.1,1,8779,5.2288e-05,148759082,0.886013
D.truncata,167897087,VNJQ01001243.1,1,8777,5.22761e-05,148767859,0.886066
D.truncata,167897087,VNJQ01002478.1,1,8775,5.22642e-05,148776634,0.886118
D.truncata,167897087,VNJQ01005696.1,1,8772,5.22463e-05,148785406,0.88617
D.truncata,167897087,VNJQ01003551.1,1,8772,5.22463e-05,148794178,0.886223
D.truncata,167897087,VNJQ01001723.1,1,8770,5.22344e-05,148802948,0.886275
D.truncata,167897087,VNJQ01006615.1,1,8769,5.22284e-05,148811717,0.886327
D.truncata,167897087,VNJQ01003835.1,1,8756,5.2151e-05,148820473,0.886379
D.truncata,167897087,VNJQ01003129.1,1,8749,5.21093e-05,148829222,0.886431
D.truncata,167897087,VNJQ01007818.1,1,8736,5.20319e-05,148837958,0.886483
D.truncata,167897087,VNJQ01003018.1,1,8735,5.20259e-05,148846693,0.886535
D.truncata,167897087,VNJQ01007821.1,1,8732,5.2008e-05,148855425,0.886587
D.truncata,167897087,VNJQ01002707.1,1,8729,5.19902e-05,148864154,0.886639
D.truncata,167897087,VNJQ01001536.1,1,8728,5.19842e-05,148872882,0.886691
D.truncata,167897087,VNJQ01004936.1,1,8725,5.19664e-05,148881607,0.886743
D.truncata,167897087,VNJQ01000388.1,1,8723,5.19544e-05,148890330,0.886795
D.truncata,167897087,VNJQ01007807.1,1,8716,5.19128e-05,148899046,0.886847
D.truncata,167897087,VNJQ01006371.1,1,8710,5.1877e-05,148907756,0.886899
D.truncata,167897087,VNJQ01001608.1,1,8709,5.18711e-05,148916465,0.886951
D.truncata,167897087,VNJQ01005847.1,1,8705,5.18472e-05,148925170,0.887003
D.truncata,167897087,VNJQ01002559.1,1,8698,5.18055e-05,148933868,0.887055
D.truncata,167897087,VNJQ01005687.1,1,8697,5.17996e-05,148942565,0.887106
D.truncata,167897087,VNJQ01006340.1,1,8693,5.17758e-05,148951258,0.887158
D.truncata,167897087,VNJQ01004227.1,1,8692,5.17698e-05,148959950,0.88721
D.truncata,167897087,VNJQ01001706.1,1,8690,5.17579e-05,148968640,0.887262
D.truncata,167897087,VNJQ01006705.1,1,8687,5.174e-05,148977327,0.887313
D.truncata,167897087,VNJQ01005777.1,1,8684,5.17222e-05,148986011,0.887365
D.truncata,167897087,VNJQ01002517.1,1,8676,5.16745e-05,148994687,0.887417
D.truncata,167897087,VNJQ01003785.1,1,8666,5.1615e-05,149003353,0.887468
D.truncata,167897087,VNJQ01006574.1,1,8661,5.15852e-05,149012014,0.88752
D.truncata,167897087,VNJQ01005322.1,1,8659,5.15733e-05,149020673,0.887572
D.truncata,167897087,VNJQ01004643.1,1,8653,5.15375e-05,149029326,0.887623
D.truncata,167897087,VNJQ01000004.1,1,8651,5.15256e-05,149037977,0.887675
D.truncata,167897087,VNJQ01006648.1,1,8643,5.1478e-05,149046620,0.887726
D.truncata,167897087,VNJQ01007944.1,1,8630,5.14005e-05,149055250,0.887777
D.truncata,167897087,VNJQ01007828.1,1,8630,5.14005e-05,149063880,0.887829
D.truncata,167897087,VNJQ01002710.1,1,8613,5.12993e-05,149072493,0.88788
D.truncata,167897087,VNJQ01001854.1,1,8605,5.12516e-05,149081098,0.887931
D.truncata,167897087,VNJQ01000898.1,1,8599,5.12159e-05,149089697,0.887983
D.truncata,167897087,VNJQ01001526.1,1,8595,5.11921e-05,149098292,0.888034
D.truncata,167897087,VNJQ01005509.1,1,8584,5.11266e-05,149106876,0.888085
D.truncata,167897087,VNJQ01001276.1,1,8577,5.10849e-05,149115453,0.888136
D.truncata,167897087,VNJQ01002474.1,1,8562,5.09955e-05,149124015,0.888187
D.truncata,167897087,VNJQ01002093.1,1,8549,5.09181e-05,149132564,0.888238
D.truncata,167897087,VNJQ01008139.1,1,8548,5.09121e-05,149141112,0.888289
D.truncata,167897087,VNJQ01005083.1,1,8529,5.0799e-05,149149641,0.88834
D.truncata,167897087,VNJQ01005289.1,1,8523,5.07632e-05,149158164,0.88839
D.truncata,167897087,VNJQ01001809.1,1,8513,5.07037e-05,149166677,0.888441
D.truncata,167897087,VNJQ01004836.1,1,8509,5.06799e-05,149175186,0.888492
D.truncata,167897087,VNJQ01006960.1,1,8508,5.06739e-05,149183694,0.888542
D.truncata,167897087,VNJQ01002126.1,1,8505,5.0656e-05,149192199,0.888593
D.truncata,167897087,VNJQ01003525.1,1,8504,5.06501e-05,149200703,0.888644
D.truncata,167897087,VNJQ01002733.1,1,8496,5.06024e-05,149209199,0.888694
D.truncata,167897087,VNJQ01000197.1,1,8484,5.0531e-05,149217683,0.888745
D.truncata,167897087,VNJQ01002627.1,1,8483,5.0525e-05,149226166,0.888795
D.truncata,167897087,VNJQ01000198.1,1,8480,5.05071e-05,149234646,0.888846
D.truncata,167897087,VNJQ01007567.1,1,8479,5.05012e-05,149243125,0.888896
D.truncata,167897087,VNJQ01001984.1,1,8473,5.04654e-05,149251598,0.888947
D.truncata,167897087,VNJQ01007730.1,1,8472,5.04595e-05,149260070,0.888997
D.truncata,167897087,VNJQ01007241.1,1,8464,5.04118e-05,149268534,0.889048
D.truncata,167897087,VNJQ01008099.1,1,8458,5.03761e-05,149276992,0.889098
D.truncata,167897087,VNJQ01006229.1,1,8454,5.03523e-05,149285446,0.889149
D.truncata,167897087,VNJQ01004913.1,1,8448,5.03165e-05,149293894,0.889199
D.truncata,167897087,VNJQ01004713.1,1,8447,5.03106e-05,149302341,0.889249
D.truncata,167897087,VNJQ01003246.1,1,8439,5.02629e-05,149310780,0.889299
D.truncata,167897087,VNJQ01004741.1,1,8436,5.02451e-05,149319216,0.88935
D.truncata,167897087,VNJQ01002712.1,1,8434,5.02332e-05,149327650,0.8894
D.truncata,167897087,VNJQ01000380.1,1,8434,5.02332e-05,149336084,0.88945
D.truncata,167897087,VNJQ01004235.1,1,8421,5.01557e-05,149344505,0.8895
D.truncata,167897087,VNJQ01007700.1,1,8414,5.0114e-05,149352919,0.88955
D.truncata,167897087,VNJQ01000401.1,1,8412,5.01021e-05,149361331,0.8896
D.truncata,167897087,VNJQ01001811.1,1,8411,5.00962e-05,149369742,0.889651
D.truncata,167897087,VNJQ01006952.1,1,8399,5.00247e-05,149378141,0.889701
D.truncata,167897087,VNJQ01007824.1,1,8390,4.99711e-05,149386531,0.889751
D.truncata,167897087,VNJQ01004189.1,1,8390,4.99711e-05,149394921,0.889801
D.truncata,167897087,VNJQ01003528.1,1,8386,4.99473e-05,149403307,0.889851
D.truncata,167897087,VNJQ01005727.1,1,8384,4.99354e-05,149411691,0.8899
D.truncata,167897087,VNJQ01002300.1,1,8380,4.99115e-05,149420071,0.88995
D.truncata,167897087,VNJQ01004469.1,1,8377,4.98937e-05,149428448,0.89
D.truncata,167897087,VNJQ01002024.1,1,8377,4.98937e-05,149436825,0.89005
D.truncata,167897087,VNJQ01008184.1,1,8373,4.98698e-05,149445198,0.8901
D.truncata,167897087,VNJQ01003040.1,1,8362,4.98043e-05,149453560,0.89015
D.truncata,167897087,VNJQ01002190.1,1,8362,4.98043e-05,149461922,0.8902
D.truncata,167897087,VNJQ01007204.1,1,8359,4.97865e-05,149470281,0.890249
D.truncata,167897087,VNJQ01007205.1,1,8357,4.97745e-05,149478638,0.890299
D.truncata,167897087,VNJQ01008129.1,1,8354,4.97567e-05,149486992,0.890349
D.truncata,167897087,VNJQ01003099.1,1,8354,4.97567e-05,149495346,0.890399
D.truncata,167897087,VNJQ01006512.1,1,8339,4.96673e-05,149503685,0.890448
D.truncata,167897087,VNJQ01006820.1,1,8331,4.96197e-05,149512016,0.890498
D.truncata,167897087,VNJQ01003116.1,1,8329,4.96078e-05,149520345,0.890548
D.truncata,167897087,VNJQ01007822.1,1,8328,4.96018e-05,149528673,0.890597
D.truncata,167897087,VNJQ01008116.1,1,8321,4.95601e-05,149536994,0.890647
D.truncata,167897087,VNJQ01002069.1,1,8321,4.95601e-05,149545315,0.890696
D.truncata,167897087,VNJQ01003231.1,1,8318,4.95423e-05,149553633,0.890746
D.truncata,167897087,VNJQ01001547.1,1,8318,4.95423e-05,149561951,0.890795
D.truncata,167897087,VNJQ01001059.1,1,8317,4.95363e-05,149570268,0.890845
D.truncata,167897087,VNJQ01000613.1,1,8317,4.95363e-05,149578585,0.890894
D.truncata,167897087,VNJQ01007981.1,1,8316,4.95303e-05,149586901,0.890944
D.truncata,167897087,VNJQ01007936.1,1,8310,4.94946e-05,149595211,0.890993
D.truncata,167897087,VNJQ01003047.1,1,8304,4.94589e-05,149603515,0.891043
D.truncata,167897087,VNJQ01004839.1,1,8299,4.94291e-05,149611814,0.891092
D.truncata,167897087,VNJQ01002191.1,1,8299,4.94291e-05,149620113,0.891142
D.truncata,167897087,VNJQ01001867.1,1,8299,4.94291e-05,149628412,0.891191
D.truncata,167897087,VNJQ01001139.1,1,8299,4.94291e-05,149636711,0.891241
D.truncata,167897087,VNJQ01000229.1,1,8291,4.93814e-05,149645002,0.89129
D.truncata,167897087,VNJQ01002232.1,1,8288,4.93636e-05,149653290,0.891339
D.truncata,167897087,VNJQ01005970.1,1,8284,4.93397e-05,149661574,0.891389
D.truncata,167897087,VNJQ01006846.1,1,8267,4.92385e-05,149669841,0.891438
D.truncata,167897087,VNJQ01002827.1,1,8267,4.92385e-05,149678108,0.891487
D.truncata,167897087,VNJQ01001688.1,1,8265,4.92266e-05,149686373,0.891536
D.truncata,167897087,VNJQ01003126.1,1,8253,4.91551e-05,149694626,0.891586
D.truncata,167897087,VNJQ01001732.1,1,8253,4.91551e-05,149702879,0.891635
D.truncata,167897087,VNJQ01003441.1,1,8251,4.91432e-05,149711130,0.891684
D.truncata,167897087,VNJQ01000069.1,1,8249,4.91313e-05,149719379,0.891733
D.truncata,167897087,VNJQ01005297.1,1,8246,4.91134e-05,149727625,0.891782
D.truncata,167897087,VNJQ01007634.1,1,8239,4.90717e-05,149735864,0.891831
D.truncata,167897087,VNJQ01006600.1,1,8239,4.90717e-05,149744103,0.89188
D.truncata,167897087,VNJQ01002926.1,1,8232,4.903e-05,149752335,0.891929
D.truncata,167897087,VNJQ01007526.1,1,8229,4.90122e-05,149760564,0.891978
D.truncata,167897087,VNJQ01001686.1,1,8227,4.90003e-05,149768791,0.892027
D.truncata,167897087,VNJQ01004919.1,1,8224,4.89824e-05,149777015,0.892076
D.truncata,167897087,VNJQ01003856.1,1,8224,4.89824e-05,149785239,0.892125
D.truncata,167897087,VNJQ01006607.1,1,8222,4.89705e-05,149793461,0.892174
D.truncata,167897087,VNJQ01006609.1,1,8214,4.89228e-05,149801675,0.892223
D.truncata,167897087,VNJQ01002044.1,1,8211,4.8905e-05,149809886,0.892272
D.truncata,167897087,VNJQ01005043.1,1,8204,4.88633e-05,149818090,0.892321
D.truncata,167897087,VNJQ01007549.1,1,8194,4.88037e-05,149826284,0.89237
D.truncata,167897087,VNJQ01000603.1,1,8193,4.87977e-05,149834477,0.892419
D.truncata,167897087,VNJQ01004493.1,1,8188,4.8768e-05,149842665,0.892467
D.truncata,167897087,VNJQ01004022.1,1,8163,4.86191e-05,149850828,0.892516
D.truncata,167897087,VNJQ01005685.1,1,8159,4.85952e-05,149858987,0.892565
D.truncata,167897087,VNJQ01006414.1,1,8152,4.85536e-05,149867139,0.892613
D.truncata,167897087,VNJQ01003232.1,1,8151,4.85476e-05,149875290,0.892662
D.truncata,167897087,VNJQ01007518.1,1,8149,4.85357e-05,149883439,0.89271
D.truncata,167897087,VNJQ01003490.1,1,8148,4.85297e-05,149891587,0.892759
D.truncata,167897087,VNJQ01007868.1,1,8142,4.8494e-05,149899729,0.892807
D.truncata,167897087,VNJQ01006951.1,1,8138,4.84702e-05,149907867,0.892856
D.truncata,167897087,VNJQ01004127.1,1,8133,4.84404e-05,149916000,0.892904
D.truncata,167897087,VNJQ01008157.1,1,8129,4.84166e-05,149924129,0.892953
D.truncata,167897087,VNJQ01000357.1,1,8119,4.8357e-05,149932248,0.893001
D.truncata,167897087,VNJQ01007333.1,1,8114,4.83272e-05,149940362,0.893049
D.truncata,167897087,VNJQ01003529.1,1,8113,4.83213e-05,149948475,0.893098
D.truncata,167897087,VNJQ01000168.1,1,8112,4.83153e-05,149956587,0.893146
D.truncata,167897087,VNJQ01006329.1,1,8111,4.83094e-05,149964698,0.893194
D.truncata,167897087,VNJQ01003329.1,1,8111,4.83094e-05,149972809,0.893242
D.truncata,167897087,VNJQ01001693.1,1,8109,4.82974e-05,149980918,0.893291
D.truncata,167897087,VNJQ01006379.1,1,8108,4.82915e-05,149989026,0.893339
D.truncata,167897087,VNJQ01006622.1,1,8105,4.82736e-05,149997131,0.893387
D.truncata,167897087,VNJQ01004496.1,1,8097,4.8226e-05,150005228,0.893436
D.truncata,167897087,VNJQ01001225.1,1,8095,4.82141e-05,150013323,0.893484
D.truncata,167897087,VNJQ01005224.1,1,8092,4.81962e-05,150021415,0.893532
D.truncata,167897087,VNJQ01001814.1,1,8090,4.81843e-05,150029505,0.89358
D.truncata,167897087,VNJQ01000729.1,1,8089,4.81783e-05,150037594,0.893628
D.truncata,167897087,VNJQ01005160.1,1,8084,4.81485e-05,150045678,0.893676
D.truncata,167897087,VNJQ01003604.1,1,8084,4.81485e-05,150053762,0.893725
D.truncata,167897087,VNJQ01004956.1,1,8081,4.81307e-05,150061843,0.893773
D.truncata,167897087,VNJQ01001341.1,1,8073,4.8083e-05,150069916,0.893821
D.truncata,167897087,VNJQ01004330.1,1,8067,4.80473e-05,150077983,0.893869
D.truncata,167897087,VNJQ01001685.1,1,8065,4.80354e-05,150086048,0.893917
D.truncata,167897087,VNJQ01000518.1,1,8061,4.80116e-05,150094109,0.893965
D.truncata,167897087,VNJQ01007467.1,1,8058,4.79937e-05,150102167,0.894013
D.truncata,167897087,VNJQ01006297.1,1,8054,4.79699e-05,150110221,0.894061
D.truncata,167897087,VNJQ01002008.1,1,8052,4.79579e-05,150118273,0.894109
D.truncata,167897087,VNJQ01003934.1,1,8050,4.7946e-05,150126323,0.894157
D.truncata,167897087,VNJQ01005672.1,1,8049,4.79401e-05,150134372,0.894205
D.truncata,167897087,VNJQ01004846.1,1,8049,4.79401e-05,150142421,0.894253
D.truncata,167897087,VNJQ01006849.1,1,8040,4.78865e-05,150150461,0.894301
D.truncata,167897087,VNJQ01004782.1,1,8038,4.78746e-05,150158499,0.894348
D.truncata,167897087,VNJQ01000383.1,1,8034,4.78507e-05,150166533,0.894396
D.truncata,167897087,VNJQ01008006.1,1,8028,4.7815e-05,150174561,0.894444
D.truncata,167897087,VNJQ01005889.1,1,8021,4.77733e-05,150182582,0.894492
D.truncata,167897087,VNJQ01003984.1,1,8020,4.77674e-05,150190602,0.89454
D.truncata,167897087,VNJQ01006182.1,1,8016,4.77435e-05,150198618,0.894587
D.truncata,167897087,VNJQ01001891.1,1,8009,4.77018e-05,150206627,0.894635
D.truncata,167897087,VNJQ01007798.1,1,8008,4.76959e-05,150214635,0.894683
D.truncata,167897087,VNJQ01000972.1,1,8007,4.76899e-05,150222642,0.89473
D.truncata,167897087,VNJQ01007083.1,1,8006,4.7684e-05,150230648,0.894778
D.truncata,167897087,VNJQ01002457.1,1,8002,4.76601e-05,150238650,0.894826
D.truncata,167897087,VNJQ01004278.1,1,7999,4.76423e-05,150246649,0.894873
D.truncata,167897087,VNJQ01003607.1,1,7994,4.76125e-05,150254643,0.894921
D.truncata,167897087,VNJQ01003717.1,1,7991,4.75946e-05,150262634,0.894969
D.truncata,167897087,VNJQ01002967.1,1,7988,4.75768e-05,150270622,0.895016
D.truncata,167897087,VNJQ01006534.1,1,7983,4.7547e-05,150278605,0.895064
D.truncata,167897087,VNJQ01000408.1,1,7973,4.74874e-05,150286578,0.895111
D.truncata,167897087,VNJQ01005933.1,1,7960,4.741e-05,150294538,0.895159
D.truncata,167897087,VNJQ01000560.1,1,7960,4.741e-05,150302498,0.895206
D.truncata,167897087,VNJQ01006717.1,1,7957,4.73921e-05,150310455,0.895254
D.truncata,167897087,VNJQ01004005.1,1,7950,4.73504e-05,150318405,0.895301
D.truncata,167897087,VNJQ01000880.1,1,7946,4.73266e-05,150326351,0.895348
D.truncata,167897087,VNJQ01006955.1,1,7938,4.7279e-05,150334289,0.895395
D.truncata,167897087,VNJQ01002682.1,1,7933,4.72492e-05,150342222,0.895443
D.truncata,167897087,VNJQ01002147.1,1,7930,4.72313e-05,150350152,0.89549
D.truncata,167897087,VNJQ01003423.1,1,7929,4.72254e-05,150358081,0.895537
D.truncata,167897087,VNJQ01001318.1,1,7925,4.72015e-05,150366006,0.895584
D.truncata,167897087,VNJQ01004027.1,1,7922,4.71837e-05,150373928,0.895632
D.truncata,167897087,VNJQ01006483.1,1,7919,4.71658e-05,150381847,0.895679
D.truncata,167897087,VNJQ01000001.1,1,7911,4.71181e-05,150389758,0.895726
D.truncata,167897087,VNJQ01005503.1,1,7905,4.70824e-05,150397663,0.895773
D.truncata,167897087,VNJQ01005334.1,1,7895,4.70229e-05,150405558,0.89582
D.truncata,167897087,VNJQ01006436.1,1,7885,4.69633e-05,150413443,0.895867
D.truncata,167897087,VNJQ01005797.1,1,7884,4.69573e-05,150421327,0.895914
D.truncata,167897087,VNJQ01004551.1,1,7884,4.69573e-05,150429211,0.895961
D.truncata,167897087,VNJQ01000349.1,1,7884,4.69573e-05,150437095,0.896008
D.truncata,167897087,VNJQ01002941.1,1,7874,4.68978e-05,150444969,0.896055
D.truncata,167897087,VNJQ01004960.1,1,7867,4.68561e-05,150452836,0.896102
D.truncata,167897087,VNJQ01005567.1,1,7866,4.68501e-05,150460702,0.896148
D.truncata,167897087,VNJQ01002982.1,1,7866,4.68501e-05,150468568,0.896195
D.truncata,167897087,VNJQ01003844.1,1,7862,4.68263e-05,150476430,0.896242
D.truncata,167897087,VNJQ01002332.1,1,7860,4.68144e-05,150484290,0.896289
D.truncata,167897087,VNJQ01000050.1,1,7853,4.67727e-05,150492143,0.896336
D.truncata,167897087,VNJQ01004912.1,1,7836,4.66714e-05,150499979,0.896382
D.truncata,167897087,VNJQ01003328.1,1,7822,4.65881e-05,150507801,0.896429
D.truncata,167897087,VNJQ01004639.1,1,7815,4.65464e-05,150515616,0.896475
D.truncata,167897087,VNJQ01005783.1,1,7805,4.64868e-05,150523421,0.896522
D.truncata,167897087,VNJQ01004526.1,1,7805,4.64868e-05,150531226,0.896568
D.truncata,167897087,VNJQ01001042.1,1,7795,4.64272e-05,150539021,0.896615
D.truncata,167897087,VNJQ01005967.1,1,7776,4.63141e-05,150546797,0.896661
D.truncata,167897087,VNJQ01007187.1,1,7745,4.61294e-05,150554542,0.896707
D.truncata,167897087,VNJQ01007216.1,1,7741,4.61056e-05,150562283,0.896753
D.truncata,167897087,VNJQ01006179.1,1,7739,4.60937e-05,150570022,0.896799
D.truncata,167897087,VNJQ01003139.1,1,7737,4.60818e-05,150577759,0.896846
D.truncata,167897087,VNJQ01006755.1,1,7735,4.60699e-05,150585494,0.896892
D.truncata,167897087,VNJQ01001459.1,1,7735,4.60699e-05,150593229,0.896938
D.truncata,167897087,VNJQ01003826.1,1,7726,4.60163e-05,150600955,0.896984
D.truncata,167897087,VNJQ01000687.1,1,7720,4.59805e-05,150608675,0.89703
D.truncata,167897087,VNJQ01000436.1,1,7715,4.59508e-05,150616390,0.897076
D.truncata,167897087,VNJQ01006277.1,1,7706,4.58972e-05,150624096,0.897122
D.truncata,167897087,VNJQ01005838.1,1,7696,4.58376e-05,150631792,0.897167
D.truncata,167897087,VNJQ01004283.1,1,7696,4.58376e-05,150639488,0.897213
D.truncata,167897087,VNJQ01006162.1,1,7690,4.58019e-05,150647178,0.897259
D.truncata,167897087,VNJQ01003992.1,1,7681,4.57483e-05,150654859,0.897305
D.truncata,167897087,VNJQ01003250.1,1,7659,4.56172e-05,150662518,0.89735
D.truncata,167897087,VNJQ01005851.1,1,7647,4.55458e-05,150670165,0.897396
D.truncata,167897087,VNJQ01003438.1,1,7644,4.55279e-05,150677809,0.897441
D.truncata,167897087,VNJQ01003148.1,1,7644,4.55279e-05,150685453,0.897487
D.truncata,167897087,VNJQ01001772.1,1,7639,4.54981e-05,150693092,0.897532
D.truncata,167897087,VNJQ01001108.1,1,7637,4.54862e-05,150700729,0.897578
D.truncata,167897087,VNJQ01004905.1,1,7636,4.54802e-05,150708365,0.897623
D.truncata,167897087,VNJQ01005864.1,1,7634,4.54683e-05,150715999,0.897669
D.truncata,167897087,VNJQ01008097.1,1,7619,4.5379e-05,150723618,0.897714
D.truncata,167897087,VNJQ01006764.1,1,7617,4.53671e-05,150731235,0.89776
D.truncata,167897087,VNJQ01007451.1,1,7612,4.53373e-05,150738847,0.897805
D.truncata,167897087,VNJQ01000008.1,1,7605,4.52956e-05,150746452,0.89785
D.truncata,167897087,VNJQ01007462.1,1,7596,4.5242e-05,150754048,0.897896
D.truncata,167897087,VNJQ01006053.1,1,7591,4.52122e-05,150761639,0.897941
D.truncata,167897087,VNJQ01007756.1,1,7588,4.51944e-05,150769227,0.897986
D.truncata,167897087,VNJQ01001568.1,1,7587,4.51884e-05,150776814,0.898031
D.truncata,167897087,VNJQ01000468.1,1,7587,4.51884e-05,150784401,0.898076
D.truncata,167897087,VNJQ01007426.1,1,7585,4.51765e-05,150791986,0.898122
D.truncata,167897087,VNJQ01000121.1,1,7576,4.51229e-05,150799562,0.898167
D.truncata,167897087,VNJQ01006039.1,1,7571,4.50931e-05,150807133,0.898212
D.truncata,167897087,VNJQ01006348.1,1,7569,4.50812e-05,150814702,0.898257
D.truncata,167897087,VNJQ01003667.1,1,7564,4.50514e-05,150822266,0.898302
D.truncata,167897087,VNJQ01006346.1,1,7562,4.50395e-05,150829828,0.898347
D.truncata,167897087,VNJQ01005917.1,1,7560,4.50276e-05,150837388,0.898392
D.truncata,167897087,VNJQ01002811.1,1,7556,4.50038e-05,150844944,0.898437
D.truncata,167897087,VNJQ01001454.1,1,7556,4.50038e-05,150852500,0.898482
D.truncata,167897087,VNJQ01004644.1,1,7554,4.49918e-05,150860054,0.898527
D.truncata,167897087,VNJQ01000061.1,1,7553,4.49859e-05,150867607,0.898572
D.truncata,167897087,VNJQ01001629.1,1,7551,4.4974e-05,150875158,0.898617
D.truncata,167897087,VNJQ01005504.1,1,7549,4.49621e-05,150882707,0.898662
D.truncata,167897087,VNJQ01004294.1,1,7548,4.49561e-05,150890255,0.898707
D.truncata,167897087,VNJQ01000895.1,1,7547,4.49502e-05,150897802,0.898752
D.truncata,167897087,VNJQ01007708.1,1,7542,4.49204e-05,150905344,0.898797
D.truncata,167897087,VNJQ01005731.1,1,7542,4.49204e-05,150912886,0.898842
D.truncata,167897087,VNJQ01000423.1,1,7540,4.49085e-05,150920426,0.898887
D.truncata,167897087,VNJQ01000328.1,1,7534,4.48727e-05,150927960,0.898931
D.truncata,167897087,VNJQ01002567.1,1,7533,4.48668e-05,150935493,0.898976
D.truncata,167897087,VNJQ01000131.1,1,7508,4.47179e-05,150943001,0.899021
D.truncata,167897087,VNJQ01008119.1,1,7500,4.46702e-05,150950501,0.899066
D.truncata,167897087,VNJQ01007803.1,1,7492,4.46226e-05,150957993,0.89911
D.truncata,167897087,VNJQ01003646.1,1,7492,4.46226e-05,150965485,0.899155
D.truncata,167897087,VNJQ01005056.1,1,7490,4.46107e-05,150972975,0.899199
D.truncata,167897087,VNJQ01006352.1,1,7485,4.45809e-05,150980460,0.899244
D.truncata,167897087,VNJQ01005483.1,1,7485,4.45809e-05,150987945,0.899289
D.truncata,167897087,VNJQ01007566.1,1,7479,4.45451e-05,150995424,0.899333
D.truncata,167897087,VNJQ01006360.1,1,7475,4.45213e-05,151002899,0.899378
D.truncata,167897087,VNJQ01007688.1,1,7471,4.44975e-05,151010370,0.899422
D.truncata,167897087,VNJQ01007245.1,1,7470,4.44915e-05,151017840,0.899467
D.truncata,167897087,VNJQ01001472.1,1,7465,4.44618e-05,151025305,0.899511
D.truncata,167897087,VNJQ01007819.1,1,7460,4.4432e-05,151032765,0.899556
D.truncata,167897087,VNJQ01002656.1,1,7460,4.4432e-05,151040225,0.8996
D.truncata,167897087,VNJQ01006977.1,1,7447,4.43546e-05,151047672,0.899644
D.truncata,167897087,VNJQ01003618.1,1,7445,4.43426e-05,151055117,0.899689
D.truncata,167897087,VNJQ01006797.1,1,7444,4.43367e-05,151062561,0.899733
D.truncata,167897087,VNJQ01001208.1,1,7443,4.43307e-05,151070004,0.899777
D.truncata,167897087,VNJQ01004915.1,1,7432,4.42652e-05,151077436,0.899822
D.truncata,167897087,VNJQ01005283.1,1,7429,4.42473e-05,151084865,0.899866
D.truncata,167897087,VNJQ01005295.1,1,7412,4.41461e-05,151092277,0.89991
D.truncata,167897087,VNJQ01002363.1,1,7409,4.41282e-05,151099686,0.899954
D.truncata,167897087,VNJQ01004813.1,1,7400,4.40746e-05,151107086,0.899998
D.truncata,167897087,VNJQ01005593.1,1,7399,4.40687e-05,151114485,0.900042
D.truncata,167897087,VNJQ01001428.1,1,7397,4.40568e-05,151121882,0.900086
D.truncata,167897087,VNJQ01004358.1,1,7384,4.39793e-05,151129266,0.90013
D.truncata,167897087,VNJQ01000514.1,1,7382,4.39674e-05,151136648,0.900174
D.truncata,167897087,VNJQ01007918.1,1,7380,4.39555e-05,151144028,0.900218
D.truncata,167897087,VNJQ01001853.1,1,7380,4.39555e-05,151151408,0.900262
D.truncata,167897087,VNJQ01003534.1,1,7377,4.39376e-05,151158785,0.900306
D.truncata,167897087,VNJQ01002461.1,1,7372,4.39078e-05,151166157,0.90035
D.truncata,167897087,VNJQ01007315.1,1,7370,4.38959e-05,151173527,0.900394
D.truncata,167897087,VNJQ01007569.1,1,7368,4.3884e-05,151180895,0.900438
D.truncata,167897087,VNJQ01000335.1,1,7368,4.3884e-05,151188263,0.900482
D.truncata,167897087,VNJQ01005766.1,1,7356,4.38126e-05,151195619,0.900526
D.truncata,167897087,VNJQ01002065.1,1,7343,4.37351e-05,151202962,0.900569
D.truncata,167897087,VNJQ01005016.1,1,7333,4.36756e-05,151210295,0.900613
D.truncata,167897087,VNJQ01003998.1,1,7331,4.36637e-05,151217626,0.900657
D.truncata,167897087,VNJQ01003186.1,1,7330,4.36577e-05,151224956,0.9007
D.truncata,167897087,VNJQ01004974.1,1,7324,4.3622e-05,151232280,0.900744
D.truncata,167897087,VNJQ01005481.1,1,7322,4.361e-05,151239602,0.900788
D.truncata,167897087,VNJQ01000665.1,1,7311,4.35445e-05,151246913,0.900831
D.truncata,167897087,VNJQ01000231.1,1,7306,4.35148e-05,151254219,0.900875
D.truncata,167897087,VNJQ01002983.1,1,7300,4.3479e-05,151261519,0.900918
D.truncata,167897087,VNJQ01002379.1,1,7299,4.34731e-05,151268818,0.900962
D.truncata,167897087,VNJQ01007003.1,1,7296,4.34552e-05,151276114,0.901005
D.truncata,167897087,VNJQ01004937.1,1,7294,4.34433e-05,151283408,0.901048
D.truncata,167897087,VNJQ01005271.1,1,7292,4.34314e-05,151290700,0.901092
D.truncata,167897087,VNJQ01005874.1,1,7287,4.34016e-05,151297987,0.901135
D.truncata,167897087,VNJQ01007122.1,1,7286,4.33956e-05,151305273,0.901179
D.truncata,167897087,VNJQ01003027.1,1,7283,4.33778e-05,151312556,0.901222
D.truncata,167897087,VNJQ01004001.1,1,7282,4.33718e-05,151319838,0.901265
D.truncata,167897087,VNJQ01006275.1,1,7279,4.33539e-05,151327117,0.901309
D.truncata,167897087,VNJQ01006472.1,1,7277,4.3342e-05,151334394,0.901352
D.truncata,167897087,VNJQ01001249.1,1,7271,4.33063e-05,151341665,0.901395
D.truncata,167897087,VNJQ01002362.1,1,7270,4.33003e-05,151348935,0.901439
D.truncata,167897087,VNJQ01000345.1,1,7269,4.32944e-05,151356204,0.901482
D.truncata,167897087,VNJQ01001920.1,1,7267,4.32825e-05,151363471,0.901525
D.truncata,167897087,VNJQ01004878.1,1,7253,4.31991e-05,151370724,0.901568
D.truncata,167897087,VNJQ01002979.1,1,7251,4.31872e-05,151377975,0.901612
D.truncata,167897087,VNJQ01002249.1,1,7243,4.31395e-05,151385218,0.901655
D.truncata,167897087,VNJQ01002731.1,1,7232,4.3074e-05,151392450,0.901698
D.truncata,167897087,VNJQ01006335.1,1,7230,4.30621e-05,151399680,0.901741
D.truncata,167897087,VNJQ01005467.1,1,7226,4.30383e-05,151406906,0.901784
D.truncata,167897087,VNJQ01001239.1,1,7226,4.30383e-05,151414132,0.901827
D.truncata,167897087,VNJQ01007252.1,1,7222,4.30144e-05,151421354,0.90187
D.truncata,167897087,VNJQ01005410.1,1,7222,4.30144e-05,151428576,0.901913
D.truncata,167897087,VNJQ01004254.1,1,7219,4.29966e-05,151435795,0.901956
D.truncata,167897087,VNJQ01004194.1,1,7217,4.29847e-05,151443012,0.901999
D.truncata,167897087,VNJQ01007788.1,1,7206,4.29191e-05,151450218,0.902042
D.truncata,167897087,VNJQ01005258.1,1,7206,4.29191e-05,151457424,0.902085
D.truncata,167897087,VNJQ01002651.1,1,7194,4.28477e-05,151464618,0.902128
D.truncata,167897087,VNJQ01006152.1,1,7189,4.28179e-05,151471807,0.902171
D.truncata,167897087,VNJQ01004640.1,1,7180,4.27643e-05,151478987,0.902213
D.truncata,167897087,VNJQ01001417.1,1,7174,4.27286e-05,151486161,0.902256
D.truncata,167897087,VNJQ01005666.1,1,7171,4.27107e-05,151493332,0.902299
D.truncata,167897087,VNJQ01004373.1,1,7164,4.2669e-05,151500496,0.902341
D.truncata,167897087,VNJQ01003861.1,1,7161,4.26511e-05,151507657,0.902384
D.truncata,167897087,VNJQ01000541.1,1,7160,4.26452e-05,151514817,0.902427
D.truncata,167897087,VNJQ01004687.1,1,7158,4.26333e-05,151521975,0.902469
D.truncata,167897087,VNJQ01003869.1,1,7153,4.26035e-05,151529128,0.902512
D.truncata,167897087,VNJQ01003862.1,1,7152,4.25975e-05,151536280,0.902555
D.truncata,167897087,VNJQ01003745.1,1,7148,4.25737e-05,151543428,0.902597
D.truncata,167897087,VNJQ01000241.1,1,7143,4.25439e-05,151550571,0.90264
D.truncata,167897087,VNJQ01007167.1,1,7136,4.25022e-05,151557707,0.902682
D.truncata,167897087,VNJQ01002526.1,1,7131,4.24724e-05,151564838,0.902725
D.truncata,167897087,VNJQ01000906.1,1,7129,4.24605e-05,151571967,0.902767
D.truncata,167897087,VNJQ01007921.1,1,7128,4.24546e-05,151579095,0.90281
D.truncata,167897087,VNJQ01000433.1,1,7124,4.24308e-05,151586219,0.902852
D.truncata,167897087,VNJQ01003688.1,1,7119,4.2401e-05,151593338,0.902894
D.truncata,167897087,VNJQ01006845.1,1,7118,4.2395e-05,151600456,0.902937
D.truncata,167897087,VNJQ01004655.1,1,7116,4.23831e-05,151607572,0.902979
D.truncata,167897087,VNJQ01002672.1,1,7114,4.23712e-05,151614686,0.903022
D.truncata,167897087,VNJQ01006273.1,1,7109,4.23414e-05,151621795,0.903064
D.truncata,167897087,VNJQ01007005.1,1,7102,4.22997e-05,151628897,0.903106
D.truncata,167897087,VNJQ01001252.1,1,7101,4.22938e-05,151635998,0.903148
D.truncata,167897087,VNJQ01001771.1,1,7093,4.22461e-05,151643091,0.903191
D.truncata,167897087,VNJQ01004680.1,1,7091,4.22342e-05,151650182,0.903233
D.truncata,167897087,VNJQ01007299.1,1,7090,4.22282e-05,151657272,0.903275
D.truncata,167897087,VNJQ01000649.1,1,7087,4.22104e-05,151664359,0.903317
D.truncata,167897087,VNJQ01000091.1,1,7087,4.22104e-05,151671446,0.90336
D.truncata,167897087,VNJQ01005436.1,1,7084,4.21925e-05,151678530,0.903402
D.truncata,167897087,VNJQ01001316.1,1,7084,4.21925e-05,151685614,0.903444
D.truncata,167897087,VNJQ01007815.1,1,7068,4.20972e-05,151692682,0.903486
D.truncata,167897087,VNJQ01004503.1,1,7068,4.20972e-05,151699750,0.903528
D.truncata,167897087,VNJQ01000009.1,1,7067,4.20913e-05,151706817,0.90357
D.truncata,167897087,VNJQ01004021.1,1,7056,4.20257e-05,151713873,0.903612
D.truncata,167897087,VNJQ01003795.1,1,7056,4.20257e-05,151720929,0.903654
D.truncata,167897087,VNJQ01001349.1,1,7056,4.20257e-05,151727985,0.903696
D.truncata,167897087,VNJQ01001749.1,1,7044,4.19543e-05,151735029,0.903738
D.truncata,167897087,VNJQ01000177.1,1,7040,4.19304e-05,151742069,0.90378
D.truncata,167897087,VNJQ01007584.1,1,7036,4.19066e-05,151749105,0.903822
D.truncata,167897087,VNJQ01003825.1,1,7033,4.18888e-05,151756138,0.903864
D.truncata,167897087,VNJQ01005343.1,1,7028,4.1859e-05,151763166,0.903906
D.truncata,167897087,VNJQ01005452.1,1,7025,4.18411e-05,151770191,0.903948
D.truncata,167897087,VNJQ01003158.1,1,7023,4.18292e-05,151777214,0.90399
D.truncata,167897087,VNJQ01005384.1,1,7017,4.17935e-05,151784231,0.904031
D.truncata,167897087,VNJQ01004040.1,1,7017,4.17935e-05,151791248,0.904073
D.truncata,167897087,VNJQ01008084.1,1,7012,4.17637e-05,151798260,0.904115
D.truncata,167897087,VNJQ01003304.1,1,7004,4.1716e-05,151805264,0.904157
D.truncata,167897087,VNJQ01003964.1,1,6989,4.16267e-05,151812253,0.904198
D.truncata,167897087,VNJQ01000685.1,1,6988,4.16207e-05,151819241,0.90424
D.truncata,167897087,VNJQ01001492.1,1,6987,4.16148e-05,151826228,0.904281
D.truncata,167897087,VNJQ01007133.1,1,6985,4.16029e-05,151833213,0.904323
D.truncata,167897087,VNJQ01000583.1,1,6983,4.1591e-05,151840196,0.904365
D.truncata,167897087,VNJQ01006843.1,1,6977,4.15552e-05,151847173,0.904406
D.truncata,167897087,VNJQ01004148.1,1,6973,4.15314e-05,151854146,0.904448
D.truncata,167897087,VNJQ01001384.1,1,6972,4.15254e-05,151861118,0.904489
D.truncata,167897087,VNJQ01005036.1,1,6971,4.15195e-05,151868089,0.904531
D.truncata,167897087,VNJQ01002337.1,1,6957,4.14361e-05,151875046,0.904572
D.truncata,167897087,VNJQ01005000.1,1,6956,4.14301e-05,151882002,0.904614
D.truncata,167897087,VNJQ01002883.1,1,6956,4.14301e-05,151888958,0.904655
D.truncata,167897087,VNJQ01007893.1,1,6955,4.14242e-05,151895913,0.904697
D.truncata,167897087,VNJQ01000723.1,1,6953,4.14123e-05,151902866,0.904738
D.truncata,167897087,VNJQ01006028.1,1,6949,4.13884e-05,151909815,0.904779
D.truncata,167897087,VNJQ01004114.1,1,6946,4.13706e-05,151916761,0.904821
D.truncata,167897087,VNJQ01000486.1,1,6938,4.13229e-05,151923699,0.904862
D.truncata,167897087,VNJQ01001156.1,1,6936,4.1311e-05,151930635,0.904903
D.truncata,167897087,VNJQ01001847.1,1,6934,4.12991e-05,151937569,0.904945
D.truncata,167897087,VNJQ01006063.1,1,6930,4.12753e-05,151944499,0.904986
D.truncata,167897087,VNJQ01001503.1,1,6930,4.12753e-05,151951429,0.905027
D.truncata,167897087,VNJQ01005457.1,1,6921,4.12217e-05,151958350,0.905068
D.truncata,167897087,VNJQ01005995.1,1,6919,4.12098e-05,151965269,0.90511
D.truncata,167897087,VNJQ01004230.1,1,6916,4.11919e-05,151972185,0.905151
D.truncata,167897087,VNJQ01004528.1,1,6915,4.11859e-05,151979100,0.905192
D.truncata,167897087,VNJQ01002435.1,1,6915,4.11859e-05,151986015,0.905233
D.truncata,167897087,VNJQ01001784.1,1,6913,4.1174e-05,151992928,0.905274
D.truncata,167897087,VNJQ01001485.1,1,6907,4.11383e-05,151999835,0.905315
D.truncata,167897087,VNJQ01000761.1,1,6905,4.11264e-05,152006740,0.905357
D.truncata,167897087,VNJQ01001841.1,1,6903,4.11145e-05,152013643,0.905398
D.truncata,167897087,VNJQ01003877.1,1,6898,4.10847e-05,152020541,0.905439
D.truncata,167897087,VNJQ01003469.1,1,6895,4.10668e-05,152027436,0.90548
D.truncata,167897087,VNJQ01007506.1,1,6893,4.10549e-05,152034329,0.905521
D.truncata,167897087,VNJQ01001778.1,1,6892,4.1049e-05,152041221,0.905562
D.truncata,167897087,VNJQ01006876.1,1,6879,4.09715e-05,152048100,0.905603
D.truncata,167897087,VNJQ01001855.1,1,6870,4.09179e-05,152054970,0.905644
D.truncata,167897087,VNJQ01007799.1,1,6868,4.0906e-05,152061838,0.905685
D.truncata,167897087,VNJQ01005723.1,1,6861,4.08643e-05,152068699,0.905726
D.truncata,167897087,VNJQ01002491.1,1,6855,4.08286e-05,152075554,0.905766
D.truncata,167897087,VNJQ01002756.1,1,6853,4.08167e-05,152082407,0.905807
D.truncata,167897087,VNJQ01006457.1,1,6849,4.07928e-05,152089256,0.905848
D.truncata,167897087,VNJQ01006745.1,1,6845,4.0769e-05,152096101,0.905889
D.truncata,167897087,VNJQ01006257.1,1,6837,4.07214e-05,152102938,0.90593
D.truncata,167897087,VNJQ01007157.1,1,6836,4.07154e-05,152109774,0.90597
D.truncata,167897087,VNJQ01005818.1,1,6836,4.07154e-05,152116610,0.906011
D.truncata,167897087,VNJQ01004122.1,1,6832,4.06916e-05,152123442,0.906052
D.truncata,167897087,VNJQ01003958.1,1,6825,4.06499e-05,152130267,0.906092
D.truncata,167897087,VNJQ01008049.1,1,6820,4.06201e-05,152137087,0.906133
D.truncata,167897087,VNJQ01001881.1,1,6820,4.06201e-05,152143907,0.906174
D.truncata,167897087,VNJQ01004120.1,1,6817,4.06023e-05,152150724,0.906214
D.truncata,167897087,VNJQ01002569.1,1,6817,4.06023e-05,152157541,0.906255
D.truncata,167897087,VNJQ01006801.1,1,6814,4.05844e-05,152164355,0.906295
D.truncata,167897087,VNJQ01006566.1,1,6813,4.05784e-05,152171168,0.906336
D.truncata,167897087,VNJQ01005844.1,1,6809,4.05546e-05,152177977,0.906377
D.truncata,167897087,VNJQ01003843.1,1,6808,4.05486e-05,152184785,0.906417
D.truncata,167897087,VNJQ01005942.1,1,6807,4.05427e-05,152191592,0.906458
D.truncata,167897087,VNJQ01000787.1,1,6803,4.05189e-05,152198395,0.906498
D.truncata,167897087,VNJQ01002813.1,1,6797,4.04831e-05,152205192,0.906539
D.truncata,167897087,VNJQ01005658.1,1,6795,4.04712e-05,152211987,0.906579
D.truncata,167897087,VNJQ01002279.1,1,6793,4.04593e-05,152218780,0.90662
D.truncata,167897087,VNJQ01001327.1,1,6790,4.04414e-05,152225570,0.90666
D.truncata,167897087,VNJQ01000790.1,1,6790,4.04414e-05,152232360,0.9067
D.truncata,167897087,VNJQ01007027.1,1,6788,4.04295e-05,152239148,0.906741
D.truncata,167897087,VNJQ01006895.1,1,6786,4.04176e-05,152245934,0.906781
D.truncata,167897087,VNJQ01004918.1,1,6785,4.04117e-05,152252719,0.906822
D.truncata,167897087,VNJQ01003802.1,1,6782,4.03938e-05,152259501,0.906862
D.truncata,167897087,VNJQ01004421.1,1,6781,4.03878e-05,152266282,0.906902
D.truncata,167897087,VNJQ01000134.1,1,6780,4.03819e-05,152273062,0.906943
D.truncata,167897087,VNJQ01007806.1,1,6773,4.03402e-05,152279835,0.906983
D.truncata,167897087,VNJQ01003440.1,1,6770,4.03223e-05,152286605,0.907024
D.truncata,167897087,VNJQ01008132.1,1,6768,4.03104e-05,152293373,0.907064
D.truncata,167897087,VNJQ01002342.1,1,6767,4.03045e-05,152300140,0.907104
D.truncata,167897087,VNJQ01005858.1,1,6766,4.02985e-05,152306906,0.907144
D.truncata,167897087,VNJQ01004660.1,1,6765,4.02925e-05,152313671,0.907185
D.truncata,167897087,VNJQ01008185.1,1,6762,4.02747e-05,152320433,0.907225
D.truncata,167897087,VNJQ01004126.1,1,6760,4.02628e-05,152327193,0.907265
D.truncata,167897087,VNJQ01004901.1,1,6758,4.02508e-05,152333951,0.907306
D.truncata,167897087,VNJQ01006770.1,1,6751,4.02092e-05,152340702,0.907346
D.truncata,167897087,VNJQ01002162.1,1,6749,4.01972e-05,152347451,0.907386
D.truncata,167897087,VNJQ01005335.1,1,6746,4.01794e-05,152354197,0.907426
D.truncata,167897087,VNJQ01006641.1,1,6743,4.01615e-05,152360940,0.907466
D.truncata,167897087,VNJQ01005538.1,1,6742,4.01556e-05,152367682,0.907506
D.truncata,167897087,VNJQ01006515.1,1,6741,4.01496e-05,152374423,0.907547
D.truncata,167897087,VNJQ01002063.1,1,6732,4.0096e-05,152381155,0.907587
D.truncata,167897087,VNJQ01001006.1,1,6732,4.0096e-05,152387887,0.907627
D.truncata,167897087,VNJQ01007565.1,1,6726,4.00603e-05,152394613,0.907667
D.truncata,167897087,VNJQ01003054.1,1,6723,4.00424e-05,152401336,0.907707
D.truncata,167897087,VNJQ01006956.1,1,6722,4.00364e-05,152408058,0.907747
D.truncata,167897087,VNJQ01003979.1,1,6721,4.00305e-05,152414779,0.907787
D.truncata,167897087,VNJQ01000542.1,1,6717,4.00067e-05,152421496,0.907827
D.truncata,167897087,VNJQ01007545.1,1,6716,4.00007e-05,152428212,0.907867
D.truncata,167897087,VNJQ01002233.1,1,6711,3.99709e-05,152434923,0.907907
D.truncata,167897087,VNJQ01004780.1,1,6710,3.9965e-05,152441633,0.907947
D.truncata,167897087,VNJQ01003185.1,1,6705,3.99352e-05,152448338,0.907987
D.truncata,167897087,VNJQ01004119.1,1,6704,3.99292e-05,152455042,0.908027
D.truncata,167897087,VNJQ01007080.1,1,6701,3.99114e-05,152461743,0.908067
D.truncata,167897087,VNJQ01003306.1,1,6701,3.99114e-05,152468444,0.908107
D.truncata,167897087,VNJQ01007307.1,1,6695,3.98756e-05,152475139,0.908146
D.truncata,167897087,VNJQ01004115.1,1,6691,3.98518e-05,152481830,0.908186
D.truncata,167897087,VNJQ01004616.1,1,6686,3.9822e-05,152488516,0.908226
D.truncata,167897087,VNJQ01005789.1,1,6683,3.98041e-05,152495199,0.908266
D.truncata,167897087,VNJQ01000149.1,1,6679,3.97803e-05,152501878,0.908306
D.truncata,167897087,VNJQ01001747.1,1,6677,3.97684e-05,152508555,0.908345
D.truncata,167897087,VNJQ01004792.1,1,6668,3.97148e-05,152515223,0.908385
D.truncata,167897087,VNJQ01004298.1,1,6663,3.9685e-05,152521886,0.908425
D.truncata,167897087,VNJQ01001192.1,1,6658,3.96552e-05,152528544,0.908465
D.truncata,167897087,VNJQ01007914.1,1,6651,3.96136e-05,152535195,0.908504
D.truncata,167897087,VNJQ01003274.1,1,6651,3.96136e-05,152541846,0.908544
D.truncata,167897087,VNJQ01001480.1,1,6646,3.95838e-05,152548492,0.908583
D.truncata,167897087,VNJQ01002773.1,1,6641,3.9554e-05,152555133,0.908623
D.truncata,167897087,VNJQ01001676.1,1,6629,3.94825e-05,152561762,0.908662
D.truncata,167897087,VNJQ01004675.1,1,6620,3.94289e-05,152568382,0.908702
D.truncata,167897087,VNJQ01002949.1,1,6620,3.94289e-05,152575002,0.908741
D.truncata,167897087,VNJQ01004537.1,1,6617,3.9411e-05,152581619,0.908781
D.truncata,167897087,VNJQ01002017.1,1,6615,3.93991e-05,152588234,0.90882
D.truncata,167897087,VNJQ01003471.1,1,6609,3.93634e-05,152594843,0.908859
D.truncata,167897087,VNJQ01000894.1,1,6597,3.92919e-05,152601440,0.908899
D.truncata,167897087,VNJQ01003324.1,1,6591,3.92562e-05,152608031,0.908938
D.truncata,167897087,VNJQ01002774.1,1,6581,3.91966e-05,152614612,0.908977
D.truncata,167897087,VNJQ01001200.1,1,6574,3.91549e-05,152621186,0.909016
D.truncata,167897087,VNJQ01006211.1,1,6568,3.91192e-05,152627754,0.909055
D.truncata,167897087,VNJQ01003552.1,1,6568,3.91192e-05,152634322,0.909095
D.truncata,167897087,VNJQ01003434.1,1,6558,3.90596e-05,152640880,0.909134
D.truncata,167897087,VNJQ01005138.1,1,6557,3.90537e-05,152647437,0.909173
D.truncata,167897087,VNJQ01003527.1,1,6555,3.90418e-05,152653992,0.909212
D.truncata,167897087,VNJQ01006921.1,1,6553,3.90299e-05,152660545,0.909251
D.truncata,167897087,VNJQ01001901.1,1,6549,3.9006e-05,152667094,0.90929
D.truncata,167897087,VNJQ01006476.1,1,6546,3.89882e-05,152673640,0.909329
D.truncata,167897087,VNJQ01006546.1,1,6545,3.89822e-05,152680185,0.909368
D.truncata,167897087,VNJQ01002195.1,1,6542,3.89643e-05,152686727,0.909407
D.truncata,167897087,VNJQ01001844.1,1,6539,3.89465e-05,152693266,0.909446
D.truncata,167897087,VNJQ01004216.1,1,6535,3.89227e-05,152699801,0.909485
D.truncata,167897087,VNJQ01002346.1,1,6532,3.89048e-05,152706333,0.909523
D.truncata,167897087,VNJQ01003456.1,1,6531,3.88988e-05,152712864,0.909562
D.truncata,167897087,VNJQ01001712.1,1,6527,3.8875e-05,152719391,0.909601
D.truncata,167897087,VNJQ01001426.1,1,6525,3.88631e-05,152725916,0.90964
D.truncata,167897087,VNJQ01001273.1,1,6523,3.88512e-05,152732439,0.909679
D.truncata,167897087,VNJQ01003890.1,1,6518,3.88214e-05,152738957,0.909718
D.truncata,167897087,VNJQ01004635.1,1,6517,3.88154e-05,152745474,0.909757
D.truncata,167897087,VNJQ01007012.1,1,6515,3.88035e-05,152751989,0.909795
D.truncata,167897087,VNJQ01003372.1,1,6514,3.87976e-05,152758503,0.909834
D.truncata,167897087,VNJQ01005242.1,1,6513,3.87916e-05,152765016,0.909873
D.truncata,167897087,VNJQ01007743.1,1,6509,3.87678e-05,152771525,0.909912
D.truncata,167897087,VNJQ01007295.1,1,6504,3.8738e-05,152778029,0.90995
D.truncata,167897087,VNJQ01004887.1,1,6503,3.87321e-05,152784532,0.909989
D.truncata,167897087,VNJQ01005327.1,1,6502,3.87261e-05,152791034,0.910028
D.truncata,167897087,VNJQ01005648.1,1,6495,3.86844e-05,152797529,0.910067
D.truncata,167897087,VNJQ01005768.1,1,6494,3.86785e-05,152804023,0.910105
D.truncata,167897087,VNJQ01002612.1,1,6490,3.86546e-05,152810513,0.910144
D.truncata,167897087,VNJQ01007707.1,1,6489,3.86487e-05,152817002,0.910183
D.truncata,167897087,VNJQ01002384.1,1,6483,3.86129e-05,152823485,0.910221
D.truncata,167897087,VNJQ01007896.1,1,6477,3.85772e-05,152829962,0.91026
D.truncata,167897087,VNJQ01005750.1,1,6477,3.85772e-05,152836439,0.910298
D.truncata,167897087,VNJQ01000256.1,1,6472,3.85474e-05,152842911,0.910337
D.truncata,167897087,VNJQ01001241.1,1,6469,3.85296e-05,152849380,0.910375
D.truncata,167897087,VNJQ01003553.1,1,6467,3.85176e-05,152855847,0.910414
D.truncata,167897087,VNJQ01004316.1,1,6461,3.84819e-05,152862308,0.910452
D.truncata,167897087,VNJQ01001876.1,1,6461,3.84819e-05,152868769,0.910491
D.truncata,167897087,VNJQ01002366.1,1,6459,3.847e-05,152875228,0.910529
D.truncata,167897087,VNJQ01007748.1,1,6451,3.84223e-05,152881679,0.910568
D.truncata,167897087,VNJQ01005941.1,1,6451,3.84223e-05,152888130,0.910606
D.truncata,167897087,VNJQ01003418.1,1,6451,3.84223e-05,152894581,0.910645
D.truncata,167897087,VNJQ01005617.1,1,6447,3.83985e-05,152901028,0.910683
D.truncata,167897087,VNJQ01006643.1,1,6437,3.8339e-05,152907465,0.910721
D.truncata,167897087,VNJQ01006101.1,1,6429,3.82913e-05,152913894,0.91076
D.truncata,167897087,VNJQ01003859.1,1,6429,3.82913e-05,152920323,0.910798
D.truncata,167897087,VNJQ01002995.1,1,6426,3.82734e-05,152926749,0.910836
D.truncata,167897087,VNJQ01004319.1,1,6423,3.82556e-05,152933172,0.910874
D.truncata,167897087,VNJQ01004453.1,1,6420,3.82377e-05,152939592,0.910913
D.truncata,167897087,VNJQ01004934.1,1,6418,3.82258e-05,152946010,0.910951
D.truncata,167897087,VNJQ01000292.1,1,6417,3.82198e-05,152952427,0.910989
D.truncata,167897087,VNJQ01006920.1,1,6416,3.82139e-05,152958843,0.911027
D.truncata,167897087,VNJQ01004533.1,1,6416,3.82139e-05,152965259,0.911066
D.truncata,167897087,VNJQ01006058.1,1,6414,3.8202e-05,152971673,0.911104
D.truncata,167897087,VNJQ01004649.1,1,6411,3.81841e-05,152978084,0.911142
D.truncata,167897087,VNJQ01001328.1,1,6410,3.81781e-05,152984494,0.91118
D.truncata,167897087,VNJQ01002800.1,1,6407,3.81603e-05,152990901,0.911218
D.truncata,167897087,VNJQ01003411.1,1,6404,3.81424e-05,152997305,0.911256
D.truncata,167897087,VNJQ01004125.1,1,6402,3.81305e-05,153003707,0.911295
D.truncata,167897087,VNJQ01003968.1,1,6402,3.81305e-05,153010109,0.911333
D.truncata,167897087,VNJQ01003067.1,1,6402,3.81305e-05,153016511,0.911371
D.truncata,167897087,VNJQ01003860.1,1,6392,3.80709e-05,153022903,0.911409
D.truncata,167897087,VNJQ01006840.1,1,6388,3.80471e-05,153029291,0.911447
D.truncata,167897087,VNJQ01001813.1,1,6379,3.79935e-05,153035670,0.911485
D.truncata,167897087,VNJQ01001866.1,1,6371,3.79459e-05,153042041,0.911523
D.truncata,167897087,VNJQ01002886.1,1,6369,3.7934e-05,153048410,0.911561
D.truncata,167897087,VNJQ01001634.1,1,6369,3.7934e-05,153054779,0.911599
D.truncata,167897087,VNJQ01001669.1,1,6367,3.7922e-05,153061146,0.911637
D.truncata,167897087,VNJQ01001528.1,1,6365,3.79101e-05,153067511,0.911675
D.truncata,167897087,VNJQ01000378.1,1,6359,3.78744e-05,153073870,0.911712
D.truncata,167897087,VNJQ01000798.1,1,6356,3.78565e-05,153080226,0.91175
D.truncata,167897087,VNJQ01004933.1,1,6354,3.78446e-05,153086580,0.911788
D.truncata,167897087,VNJQ01005073.1,1,6349,3.78148e-05,153092929,0.911826
D.truncata,167897087,VNJQ01005693.1,1,6346,3.7797e-05,153099275,0.911864
D.truncata,167897087,VNJQ01004719.1,1,6346,3.7797e-05,153105621,0.911902
D.truncata,167897087,VNJQ01006252.1,1,6343,3.77791e-05,153111964,0.911939
D.truncata,167897087,VNJQ01006522.1,1,6336,3.77374e-05,153118300,0.911977
D.truncata,167897087,VNJQ01001396.1,1,6335,3.77314e-05,153124635,0.912015
D.truncata,167897087,VNJQ01003460.1,1,6333,3.77195e-05,153130968,0.912053
D.truncata,167897087,VNJQ01007066.1,1,6331,3.77076e-05,153137299,0.91209
D.truncata,167897087,VNJQ01003560.1,1,6331,3.77076e-05,153143630,0.912128
D.truncata,167897087,VNJQ01007705.1,1,6329,3.76957e-05,153149959,0.912166
D.truncata,167897087,VNJQ01006676.1,1,6328,3.76898e-05,153156287,0.912203
D.truncata,167897087,VNJQ01002062.1,1,6326,3.76778e-05,153162613,0.912241
D.truncata,167897087,VNJQ01005403.1,1,6324,3.76659e-05,153168937,0.912279
D.truncata,167897087,VNJQ01002365.1,1,6323,3.766e-05,153175260,0.912316
D.truncata,167897087,VNJQ01006644.1,1,6319,3.76362e-05,153181579,0.912354
D.truncata,167897087,VNJQ01004692.1,1,6319,3.76362e-05,153187898,0.912392
D.truncata,167897087,VNJQ01003880.1,1,6319,3.76362e-05,153194217,0.912429
D.truncata,167897087,VNJQ01002593.1,1,6315,3.76123e-05,153200532,0.912467
D.truncata,167897087,VNJQ01001102.1,1,6313,3.76004e-05,153206845,0.912504
D.truncata,167897087,VNJQ01000459.1,1,6308,3.75706e-05,153213153,0.912542
D.truncata,167897087,VNJQ01000580.1,1,6303,3.75409e-05,153219456,0.91258
D.truncata,167897087,VNJQ01007129.1,1,6298,3.75111e-05,153225754,0.912617
D.truncata,167897087,VNJQ01005144.1,1,6295,3.74932e-05,153232049,0.912655
D.truncata,167897087,VNJQ01006411.1,1,6294,3.74872e-05,153238343,0.912692
D.truncata,167897087,VNJQ01005951.1,1,6293,3.74813e-05,153244636,0.91273
D.truncata,167897087,VNJQ01007486.1,1,6292,3.74753e-05,153250928,0.912767
D.truncata,167897087,VNJQ01007176.1,1,6276,3.738e-05,153257204,0.912804
D.truncata,167897087,VNJQ01003913.1,1,6274,3.73681e-05,153263478,0.912842
D.truncata,167897087,VNJQ01005819.1,1,6268,3.73324e-05,153269746,0.912879
D.truncata,167897087,VNJQ01002169.1,1,6268,3.73324e-05,153276014,0.912916
D.truncata,167897087,VNJQ01003947.1,1,6265,3.73145e-05,153282279,0.912954
D.truncata,167897087,VNJQ01003605.1,1,6265,3.73145e-05,153288544,0.912991
D.truncata,167897087,VNJQ01003283.1,1,6262,3.72967e-05,153294806,0.913028
D.truncata,167897087,VNJQ01004384.1,1,6261,3.72907e-05,153301067,0.913066
D.truncata,167897087,VNJQ01002238.1,1,6261,3.72907e-05,153307328,0.913103
D.truncata,167897087,VNJQ01005351.1,1,6245,3.71954e-05,153313573,0.91314
D.truncata,167897087,VNJQ01007971.1,1,6241,3.71716e-05,153319814,0.913177
D.truncata,167897087,VNJQ01004756.1,1,6235,3.71358e-05,153326049,0.913214
D.truncata,167897087,VNJQ01003864.1,1,6235,3.71358e-05,153332284,0.913252
D.truncata,167897087,VNJQ01004517.1,1,6233,3.71239e-05,153338517,0.913289
D.truncata,167897087,VNJQ01006280.1,1,6221,3.70525e-05,153344738,0.913326
D.truncata,167897087,VNJQ01006180.1,1,6215,3.70167e-05,153350953,0.913363
D.truncata,167897087,VNJQ01004833.1,1,6214,3.70108e-05,153357167,0.9134
D.truncata,167897087,VNJQ01000449.1,1,6212,3.69989e-05,153363379,0.913437
D.truncata,167897087,VNJQ01005605.1,1,6207,3.69691e-05,153369586,0.913474
D.truncata,167897087,VNJQ01000083.1,1,6197,3.69095e-05,153375783,0.913511
D.truncata,167897087,VNJQ01008173.1,1,6193,3.68857e-05,153381976,0.913548
D.truncata,167897087,VNJQ01004928.1,1,6187,3.685e-05,153388163,0.913584
D.truncata,167897087,VNJQ01001366.1,1,6169,3.67427e-05,153394332,0.913621
D.truncata,167897087,VNJQ01004242.1,1,6164,3.6713e-05,153400496,0.913658
D.truncata,167897087,VNJQ01003636.1,1,6164,3.6713e-05,153406660,0.913695
D.truncata,167897087,VNJQ01005640.1,1,6162,3.67011e-05,153412822,0.913731
D.truncata,167897087,VNJQ01002591.1,1,6160,3.66891e-05,153418982,0.913768
D.truncata,167897087,VNJQ01005993.1,1,6156,3.66653e-05,153425138,0.913805
D.truncata,167897087,VNJQ01005407.1,1,6150,3.66296e-05,153431288,0.913841
D.truncata,167897087,VNJQ01001044.1,1,6148,3.66177e-05,153437436,0.913878
D.truncata,167897087,VNJQ01000765.1,1,6147,3.66117e-05,153443583,0.913915
D.truncata,167897087,VNJQ01006847.1,1,6143,3.65879e-05,153449726,0.913951
D.truncata,167897087,VNJQ01005991.1,1,6141,3.6576e-05,153455867,0.913988
D.truncata,167897087,VNJQ01002241.1,1,6138,3.65581e-05,153462005,0.914024
D.truncata,167897087,VNJQ01002475.1,1,6136,3.65462e-05,153468141,0.914061
D.truncata,167897087,VNJQ01007656.1,1,6132,3.65224e-05,153474273,0.914097
D.truncata,167897087,VNJQ01004735.1,1,6131,3.65164e-05,153480404,0.914134
D.truncata,167897087,VNJQ01002343.1,1,6130,3.65105e-05,153486534,0.91417
D.truncata,167897087,VNJQ01000085.1,1,6128,3.64985e-05,153492662,0.914207
D.truncata,167897087,VNJQ01004730.1,1,6121,3.64569e-05,153498783,0.914243
D.truncata,167897087,VNJQ01004362.1,1,6118,3.6439e-05,153504901,0.91428
D.truncata,167897087,VNJQ01002626.1,1,6116,3.64271e-05,153511017,0.914316
D.truncata,167897087,VNJQ01001267.1,1,6111,3.63973e-05,153517128,0.914353
D.truncata,167897087,VNJQ01002420.1,1,6106,3.63675e-05,153523234,0.914389
D.truncata,167897087,VNJQ01002418.1,1,6105,3.63616e-05,153529339,0.914425
D.truncata,167897087,VNJQ01005793.1,1,6096,3.6308e-05,153535435,0.914462
D.truncata,167897087,VNJQ01006030.1,1,6095,3.6302e-05,153541530,0.914498
D.truncata,167897087,VNJQ01000140.1,1,6091,3.62782e-05,153547621,0.914534
D.truncata,167897087,VNJQ01002639.1,1,6084,3.62365e-05,153553705,0.91457
D.truncata,167897087,VNJQ01004867.1,1,6082,3.62246e-05,153559787,0.914607
D.truncata,167897087,VNJQ01002401.1,1,6082,3.62246e-05,153565869,0.914643
D.truncata,167897087,VNJQ01006564.1,1,6079,3.62067e-05,153571948,0.914679
D.truncata,167897087,VNJQ01003906.1,1,6077,3.61948e-05,153578025,0.914715
D.truncata,167897087,VNJQ01006664.1,1,6076,3.61888e-05,153584101,0.914751
D.truncata,167897087,VNJQ01004113.1,1,6076,3.61888e-05,153590177,0.914788
D.truncata,167897087,VNJQ01006270.1,1,6075,3.61829e-05,153596252,0.914824
D.truncata,167897087,VNJQ01002615.1,1,6071,3.61591e-05,153602323,0.91486
D.truncata,167897087,VNJQ01000598.1,1,6070,3.61531e-05,153608393,0.914896
D.truncata,167897087,VNJQ01006434.1,1,6067,3.61352e-05,153614460,0.914932
D.truncata,167897087,VNJQ01001925.1,1,6066,3.61293e-05,153620526,0.914968
D.truncata,167897087,VNJQ01003073.1,1,6061,3.60995e-05,153626587,0.915004
D.truncata,167897087,VNJQ01000918.1,1,6061,3.60995e-05,153632648,0.915041
D.truncata,167897087,VNJQ01004664.1,1,6058,3.60816e-05,153638706,0.915077
D.truncata,167897087,VNJQ01000200.1,1,6057,3.60757e-05,153644763,0.915113
D.truncata,167897087,VNJQ01007502.1,1,6056,3.60697e-05,153650819,0.915149
D.truncata,167897087,VNJQ01005782.1,1,6055,3.60638e-05,153656874,0.915185
D.truncata,167897087,VNJQ01006749.1,1,6051,3.60399e-05,153662925,0.915221
D.truncata,167897087,VNJQ01005603.1,1,6048,3.60221e-05,153668973,0.915257
D.truncata,167897087,VNJQ01000849.1,1,6046,3.60102e-05,153675019,0.915293
D.truncata,167897087,VNJQ01005807.1,1,6045,3.60042e-05,153681064,0.915329
D.truncata,167897087,VNJQ01002762.1,1,6045,3.60042e-05,153687109,0.915365
D.truncata,167897087,VNJQ01002613.1,1,6042,3.59863e-05,153693151,0.915401
D.truncata,167897087,VNJQ01003480.1,1,6039,3.59685e-05,153699190,0.915437
D.truncata,167897087,VNJQ01004376.1,1,6033,3.59327e-05,153705223,0.915473
D.truncata,167897087,VNJQ01001410.1,1,6027,3.5897e-05,153711250,0.915509
D.truncata,167897087,VNJQ01003045.1,1,6024,3.58791e-05,153717274,0.915545
D.truncata,167897087,VNJQ01007081.1,1,6022,3.58672e-05,153723296,0.91558
D.truncata,167897087,VNJQ01000933.1,1,6017,3.58374e-05,153729313,0.915616
D.truncata,167897087,VNJQ01001236.1,1,6015,3.58255e-05,153735328,0.915652
D.truncata,167897087,VNJQ01005285.1,1,6011,3.58017e-05,153741339,0.915688
D.truncata,167897087,VNJQ01008162.1,1,6010,3.57957e-05,153747349,0.915724
D.truncata,167897087,VNJQ01005375.1,1,6009,3.57898e-05,153753358,0.91576
D.truncata,167897087,VNJQ01002660.1,1,6004,3.576e-05,153759362,0.915795
D.truncata,167897087,VNJQ01004101.1,1,6003,3.5754e-05,153765365,0.915831
D.truncata,167897087,VNJQ01006733.1,1,5989,3.56707e-05,153771354,0.915867
D.truncata,167897087,VNJQ01005441.1,1,5986,3.56528e-05,153777340,0.915902
D.truncata,167897087,VNJQ01007776.1,1,5981,3.5623e-05,153783321,0.915938
D.truncata,167897087,VNJQ01005637.1,1,5981,3.5623e-05,153789302,0.915974
D.truncata,167897087,VNJQ01002665.1,1,5979,3.56111e-05,153795281,0.916009
D.truncata,167897087,VNJQ01004596.1,1,5977,3.55992e-05,153801258,0.916045
D.truncata,167897087,VNJQ01006013.1,1,5972,3.55694e-05,153807230,0.91608
D.truncata,167897087,VNJQ01005204.1,1,5969,3.55515e-05,153813199,0.916116
D.truncata,167897087,VNJQ01006528.1,1,5967,3.55396e-05,153819166,0.916151
D.truncata,167897087,VNJQ01001585.1,1,5964,3.55218e-05,153825130,0.916187
D.truncata,167897087,VNJQ01006449.1,1,5963,3.55158e-05,153831093,0.916223
D.truncata,167897087,VNJQ01003957.1,1,5962,3.55098e-05,153837055,0.916258
D.truncata,167897087,VNJQ01000354.1,1,5962,3.55098e-05,153843017,0.916294
D.truncata,167897087,VNJQ01000904.1,1,5960,3.54979e-05,153848977,0.916329
D.truncata,167897087,VNJQ01006842.1,1,5954,3.54622e-05,153854931,0.916365
D.truncata,167897087,VNJQ01007968.1,1,5946,3.54146e-05,153860877,0.9164
D.truncata,167897087,VNJQ01000196.1,1,5946,3.54146e-05,153866823,0.916435
D.truncata,167897087,VNJQ01005788.1,1,5942,3.53907e-05,153872765,0.916471
D.truncata,167897087,VNJQ01002046.1,1,5940,3.53788e-05,153878705,0.916506
D.truncata,167897087,VNJQ01000260.1,1,5937,3.53609e-05,153884642,0.916541
D.truncata,167897087,VNJQ01006928.1,1,5935,3.5349e-05,153890577,0.916577
D.truncata,167897087,VNJQ01004995.1,1,5931,3.53252e-05,153896508,0.916612
D.truncata,167897087,VNJQ01002896.1,1,5925,3.52895e-05,153902433,0.916647
D.truncata,167897087,VNJQ01002998.1,1,5924,3.52835e-05,153908357,0.916683
D.truncata,167897087,VNJQ01002895.1,1,5923,3.52776e-05,153914280,0.916718
D.truncata,167897087,VNJQ01006145.1,1,5920,3.52597e-05,153920200,0.916753
D.truncata,167897087,VNJQ01006605.1,1,5919,3.52537e-05,153926119,0.916789
D.truncata,167897087,VNJQ01008126.1,1,5918,3.52478e-05,153932037,0.916824
D.truncata,167897087,VNJQ01001432.1,1,5916,3.52359e-05,153937953,0.916859
D.truncata,167897087,VNJQ01002294.1,1,5910,3.52001e-05,153943863,0.916894
D.truncata,167897087,VNJQ01007712.1,1,5909,3.51942e-05,153949772,0.916929
D.truncata,167897087,VNJQ01005021.1,1,5909,3.51942e-05,153955681,0.916965
D.truncata,167897087,VNJQ01005386.1,1,5906,3.51763e-05,153961587,0.917
D.truncata,167897087,VNJQ01001525.1,1,5905,3.51704e-05,153967492,0.917035
D.truncata,167897087,VNJQ01002196.1,1,5902,3.51525e-05,153973394,0.91707
D.truncata,167897087,VNJQ01007620.1,1,5896,3.51167e-05,153979290,0.917105
D.truncata,167897087,VNJQ01007588.1,1,5896,3.51167e-05,153985186,0.91714
D.truncata,167897087,VNJQ01007364.1,1,5893,3.50989e-05,153991079,0.917175
D.truncata,167897087,VNJQ01001970.1,1,5893,3.50989e-05,153996972,0.917211
D.truncata,167897087,VNJQ01000106.1,1,5893,3.50989e-05,154002865,0.917246
D.truncata,167897087,VNJQ01000477.1,1,5884,3.50453e-05,154008749,0.917281
D.truncata,167897087,VNJQ01007531.1,1,5878,3.50095e-05,154014627,0.917316
D.truncata,167897087,VNJQ01005485.1,1,5876,3.49976e-05,154020503,0.917351
D.truncata,167897087,VNJQ01004563.1,1,5861,3.49083e-05,154026364,0.917386
D.truncata,167897087,VNJQ01007704.1,1,5858,3.48904e-05,154032222,0.91742
D.truncata,167897087,VNJQ01004385.1,1,5857,3.48845e-05,154038079,0.917455
D.truncata,167897087,VNJQ01006795.1,1,5856,3.48785e-05,154043935,0.91749
D.truncata,167897087,VNJQ01003086.1,1,5855,3.48726e-05,154049790,0.917525
D.truncata,167897087,VNJQ01000650.1,1,5852,3.48547e-05,154055642,0.91756
D.truncata,167897087,VNJQ01005987.1,1,5851,3.48487e-05,154061493,0.917595
D.truncata,167897087,VNJQ01001468.1,1,5844,3.4807e-05,154067337,0.91763
D.truncata,167897087,VNJQ01003310.1,1,5843,3.48011e-05,154073180,0.917664
D.truncata,167897087,VNJQ01003797.1,1,5842,3.47951e-05,154079022,0.917699
D.truncata,167897087,VNJQ01002863.1,1,5837,3.47653e-05,154084859,0.917734
D.truncata,167897087,VNJQ01002862.1,1,5837,3.47653e-05,154090696,0.917769
D.truncata,167897087,VNJQ01002011.1,1,5836,3.47594e-05,154096532,0.917803
D.truncata,167897087,VNJQ01005912.1,1,5832,3.47356e-05,154102364,0.917838
D.truncata,167897087,VNJQ01005416.1,1,5831,3.47296e-05,154108195,0.917873
D.truncata,167897087,VNJQ01007964.1,1,5828,3.47117e-05,154114023,0.917908
D.truncata,167897087,VNJQ01002801.1,1,5826,3.46998e-05,154119849,0.917942
D.truncata,167897087,VNJQ01007443.1,1,5824,3.46879e-05,154125673,0.917977
D.truncata,167897087,VNJQ01004965.1,1,5819,3.46581e-05,154131492,0.918012
D.truncata,167897087,VNJQ01000251.1,1,5819,3.46581e-05,154137311,0.918046
D.truncata,167897087,VNJQ01005352.1,1,5816,3.46403e-05,154143127,0.918081
D.truncata,167897087,VNJQ01001918.1,1,5812,3.46164e-05,154148939,0.918116
D.truncata,167897087,VNJQ01001412.1,1,5810,3.46045e-05,154154749,0.91815
D.truncata,167897087,VNJQ01004654.1,1,5808,3.45926e-05,154160557,0.918185
D.truncata,167897087,VNJQ01006272.1,1,5804,3.45688e-05,154166361,0.918219
D.truncata,167897087,VNJQ01003221.1,1,5799,3.4539e-05,154172160,0.918254
D.truncata,167897087,VNJQ01007505.1,1,5796,3.45211e-05,154177956,0.918288
D.truncata,167897087,VNJQ01003485.1,1,5796,3.45211e-05,154183752,0.918323
D.truncata,167897087,VNJQ01000893.1,1,5796,3.45211e-05,154189548,0.918357
D.truncata,167897087,VNJQ01006702.1,1,5787,3.44675e-05,154195335,0.918392
D.truncata,167897087,VNJQ01000921.1,1,5786,3.44616e-05,154201121,0.918426
D.truncata,167897087,VNJQ01002255.1,1,5784,3.44497e-05,154206905,0.918461
D.truncata,167897087,VNJQ01006701.1,1,5783,3.44437e-05,154212688,0.918495
D.truncata,167897087,VNJQ01003000.1,1,5783,3.44437e-05,154218471,0.91853
D.truncata,167897087,VNJQ01002453.1,1,5781,3.44318e-05,154224252,0.918564
D.truncata,167897087,VNJQ01001158.1,1,5779,3.44199e-05,154230031,0.918599
D.truncata,167897087,VNJQ01002965.1,1,5778,3.44139e-05,154235809,0.918633
D.truncata,167897087,VNJQ01006276.1,1,5756,3.42829e-05,154241565,0.918667
D.truncata,167897087,VNJQ01002727.1,1,5756,3.42829e-05,154247321,0.918702
D.truncata,167897087,VNJQ01005139.1,1,5753,3.4265e-05,154253074,0.918736
D.truncata,167897087,VNJQ01003929.1,1,5753,3.4265e-05,154258827,0.91877
D.truncata,167897087,VNJQ01000025.1,1,5752,3.42591e-05,154264579,0.918804
D.truncata,167897087,VNJQ01001675.1,1,5746,3.42233e-05,154270325,0.918839
D.truncata,167897087,VNJQ01002675.1,1,5743,3.42055e-05,154276068,0.918873
D.truncata,167897087,VNJQ01000818.1,1,5739,3.41817e-05,154281807,0.918907
D.truncata,167897087,VNJQ01006681.1,1,5738,3.41757e-05,154287545,0.918941
D.truncata,167897087,VNJQ01003375.1,1,5736,3.41638e-05,154293281,0.918975
D.truncata,167897087,VNJQ01006746.1,1,5727,3.41102e-05,154299008,0.919009
D.truncata,167897087,VNJQ01005498.1,1,5726,3.41042e-05,154304734,0.919044
D.truncata,167897087,VNJQ01005740.1,1,5720,3.40685e-05,154310454,0.919078
D.truncata,167897087,VNJQ01003428.1,1,5720,3.40685e-05,154316174,0.919112
D.truncata,167897087,VNJQ01001460.1,1,5720,3.40685e-05,154321894,0.919146
D.truncata,167897087,VNJQ01007234.1,1,5719,3.40625e-05,154327613,0.91918
D.truncata,167897087,VNJQ01001954.1,1,5719,3.40625e-05,154333332,0.919214
D.truncata,167897087,VNJQ01006873.1,1,5718,3.40566e-05,154339050,0.919248
D.truncata,167897087,VNJQ01006666.1,1,5714,3.40328e-05,154344764,0.919282
D.truncata,167897087,VNJQ01000262.1,1,5712,3.40208e-05,154350476,0.919316
D.truncata,167897087,VNJQ01001415.1,1,5711,3.40149e-05,154356187,0.91935
D.truncata,167897087,VNJQ01006811.1,1,5709,3.4003e-05,154361896,0.919384
D.truncata,167897087,VNJQ01001782.1,1,5709,3.4003e-05,154367605,0.919418
D.truncata,167897087,VNJQ01005496.1,1,5705,3.39791e-05,154373310,0.919452
D.truncata,167897087,VNJQ01006210.1,1,5704,3.39732e-05,154379014,0.919486
D.truncata,167897087,VNJQ01006237.1,1,5703,3.39672e-05,154384717,0.91952
D.truncata,167897087,VNJQ01004299.1,1,5697,3.39315e-05,154390414,0.919554
D.truncata,167897087,VNJQ01002151.1,1,5693,3.39077e-05,154396107,0.919588
D.truncata,167897087,VNJQ01007615.1,1,5690,3.38898e-05,154401797,0.919622
D.truncata,167897087,VNJQ01002958.1,1,5689,3.38839e-05,154407486,0.919656
D.truncata,167897087,VNJQ01000540.1,1,5687,3.38719e-05,154413173,0.919689
D.truncata,167897087,VNJQ01001617.1,1,5686,3.3866e-05,154418859,0.919723
D.truncata,167897087,VNJQ01000697.1,1,5685,3.386e-05,154424544,0.919757
D.truncata,167897087,VNJQ01000639.1,1,5684,3.38541e-05,154430228,0.919791
D.truncata,167897087,VNJQ01001833.1,1,5682,3.38422e-05,154435910,0.919825
D.truncata,167897087,VNJQ01007573.1,1,5677,3.38124e-05,154441587,0.919859
D.truncata,167897087,VNJQ01004486.1,1,5674,3.37945e-05,154447261,0.919892
D.truncata,167897087,VNJQ01000460.1,1,5671,3.37766e-05,154452932,0.919926
D.truncata,167897087,VNJQ01000968.1,1,5670,3.37707e-05,154458602,0.91996
D.truncata,167897087,VNJQ01001421.1,1,5669,3.37647e-05,154464271,0.919994
D.truncata,167897087,VNJQ01002871.1,1,5665,3.37409e-05,154469936,0.920027
D.truncata,167897087,VNJQ01001060.1,1,5661,3.37171e-05,154475597,0.920061
D.truncata,167897087,VNJQ01005848.1,1,5649,3.36456e-05,154481246,0.920095
D.truncata,167897087,VNJQ01000828.1,1,5649,3.36456e-05,154486895,0.920129
D.truncata,167897087,VNJQ01002287.1,1,5645,3.36218e-05,154492540,0.920162
D.truncata,167897087,VNJQ01006334.1,1,5644,3.36158e-05,154498184,0.920196
D.truncata,167897087,VNJQ01007313.1,1,5643,3.36099e-05,154503827,0.920229
D.truncata,167897087,VNJQ01002246.1,1,5643,3.36099e-05,154509470,0.920263
D.truncata,167897087,VNJQ01006033.1,1,5629,3.35265e-05,154515099,0.920296
D.truncata,167897087,VNJQ01000281.1,1,5629,3.35265e-05,154520728,0.92033
D.truncata,167897087,VNJQ01002029.1,1,5624,3.34967e-05,154526352,0.920364
D.truncata,167897087,VNJQ01001264.1,1,5618,3.3461e-05,154531970,0.920397
D.truncata,167897087,VNJQ01007221.1,1,5617,3.3455e-05,154537587,0.92043
D.truncata,167897087,VNJQ01000670.1,1,5617,3.3455e-05,154543204,0.920464
D.truncata,167897087,VNJQ01008143.1,1,5616,3.34491e-05,154548820,0.920497
D.truncata,167897087,VNJQ01003965.1,1,5614,3.34371e-05,154554434,0.920531
D.truncata,167897087,VNJQ01005149.1,1,5612,3.34252e-05,154560046,0.920564
D.truncata,167897087,VNJQ01004923.1,1,5612,3.34252e-05,154565658,0.920598
D.truncata,167897087,VNJQ01004801.1,1,5608,3.34014e-05,154571266,0.920631
D.truncata,167897087,VNJQ01006337.1,1,5607,3.33955e-05,154576873,0.920664
D.truncata,167897087,VNJQ01005456.1,1,5606,3.33895e-05,154582479,0.920698
D.truncata,167897087,VNJQ01001291.1,1,5602,3.33657e-05,154588081,0.920731
D.truncata,167897087,VNJQ01003804.1,1,5598,3.33419e-05,154593679,0.920765
D.truncata,167897087,VNJQ01005154.1,1,5596,3.33299e-05,154599275,0.920798
D.truncata,167897087,VNJQ01001734.1,1,5596,3.33299e-05,154604871,0.920831
D.truncata,167897087,VNJQ01002259.1,1,5593,3.33121e-05,154610464,0.920864
D.truncata,167897087,VNJQ01004667.1,1,5588,3.32823e-05,154616052,0.920898
D.truncata,167897087,VNJQ01005601.1,1,5587,3.32763e-05,154621639,0.920931
D.truncata,167897087,VNJQ01000042.1,1,5587,3.32763e-05,154627226,0.920964
D.truncata,167897087,VNJQ01003080.1,1,5586,3.32704e-05,154632812,0.920998
D.truncata,167897087,VNJQ01006803.1,1,5583,3.32525e-05,154638395,0.921031
D.truncata,167897087,VNJQ01000934.1,1,5583,3.32525e-05,154643978,0.921064
D.truncata,167897087,VNJQ01003637.1,1,5575,3.32049e-05,154649553,0.921097
D.truncata,167897087,VNJQ01002285.1,1,5574,3.31989e-05,154655127,0.92113
D.truncata,167897087,VNJQ01006149.1,1,5566,3.31513e-05,154660693,0.921164
D.truncata,167897087,VNJQ01001682.1,1,5566,3.31513e-05,154666259,0.921197
D.truncata,167897087,VNJQ01001053.1,1,5566,3.31513e-05,154671825,0.92123
D.truncata,167897087,VNJQ01006000.1,1,5565,3.31453e-05,154677390,0.921263
D.truncata,167897087,VNJQ01000062.1,1,5554,3.30798e-05,154682944,0.921296
D.truncata,167897087,VNJQ01006350.1,1,5542,3.30083e-05,154688486,0.921329
D.truncata,167897087,VNJQ01004085.1,1,5540,3.29964e-05,154694026,0.921362
D.truncata,167897087,VNJQ01003417.1,1,5540,3.29964e-05,154699566,0.921395
D.truncata,167897087,VNJQ01006024.1,1,5531,3.29428e-05,154705097,0.921428
D.truncata,167897087,VNJQ01000122.1,1,5531,3.29428e-05,154710628,0.921461
D.truncata,167897087,VNJQ01007697.1,1,5528,3.29249e-05,154716156,0.921494
D.truncata,167897087,VNJQ01003082.1,1,5526,3.2913e-05,154721682,0.921527
D.truncata,167897087,VNJQ01001160.1,1,5523,3.28952e-05,154727205,0.92156
D.truncata,167897087,VNJQ01002611.1,1,5521,3.28832e-05,154732726,0.921593
D.truncata,167897087,VNJQ01002338.1,1,5520,3.28773e-05,154738246,0.921626
D.truncata,167897087,VNJQ01004497.1,1,5517,3.28594e-05,154743763,0.921658
D.truncata,167897087,VNJQ01007814.1,1,5516,3.28535e-05,154749279,0.921691
D.truncata,167897087,VNJQ01002049.1,1,5516,3.28535e-05,154754795,0.921724
D.truncata,167897087,VNJQ01002432.1,1,5511,3.28237e-05,154760306,0.921757
D.truncata,167897087,VNJQ01002607.1,1,5510,3.28177e-05,154765816,0.92179
D.truncata,167897087,VNJQ01002495.1,1,5510,3.28177e-05,154771326,0.921823
D.truncata,167897087,VNJQ01000269.1,1,5502,3.27701e-05,154776828,0.921855
D.truncata,167897087,VNJQ01002009.1,1,5496,3.27343e-05,154782324,0.921888
D.truncata,167897087,VNJQ01004364.1,1,5494,3.27224e-05,154787818,0.921921
D.truncata,167897087,VNJQ01007039.1,1,5489,3.26926e-05,154793307,0.921954
D.truncata,167897087,VNJQ01003840.1,1,5489,3.26926e-05,154798796,0.921986
D.truncata,167897087,VNJQ01000482.1,1,5489,3.26926e-05,154804285,0.922019
D.truncata,167897087,VNJQ01005863.1,1,5488,3.26867e-05,154809773,0.922052
D.truncata,167897087,VNJQ01004184.1,1,5484,3.26629e-05,154815257,0.922084
D.truncata,167897087,VNJQ01006190.1,1,5483,3.26569e-05,154820740,0.922117
D.truncata,167897087,VNJQ01007183.1,1,5481,3.2645e-05,154826221,0.92215
D.truncata,167897087,VNJQ01006892.1,1,5473,3.25973e-05,154831694,0.922182
D.truncata,167897087,VNJQ01003169.1,1,5471,3.25854e-05,154837165,0.922215
D.truncata,167897087,VNJQ01001556.1,1,5471,3.25854e-05,154842636,0.922247
D.truncata,167897087,VNJQ01005261.1,1,5467,3.25616e-05,154848103,0.92228
D.truncata,167897087,VNJQ01007079.1,1,5465,3.25497e-05,154853568,0.922312
D.truncata,167897087,VNJQ01008020.1,1,5463,3.25378e-05,154859031,0.922345
D.truncata,167897087,VNJQ01005068.1,1,5461,3.25259e-05,154864492,0.922377
D.truncata,167897087,VNJQ01001852.1,1,5455,3.24901e-05,154869947,0.92241
D.truncata,167897087,VNJQ01002101.1,1,5453,3.24782e-05,154875400,0.922442
D.truncata,167897087,VNJQ01001707.1,1,5453,3.24782e-05,154880853,0.922475
D.truncata,167897087,VNJQ01005834.1,1,5451,3.24663e-05,154886304,0.922507
D.truncata,167897087,VNJQ01006867.1,1,5449,3.24544e-05,154891753,0.92254
D.truncata,167897087,VNJQ01002659.1,1,5446,3.24365e-05,154897199,0.922572
D.truncata,167897087,VNJQ01006884.1,1,5445,3.24306e-05,154902644,0.922605
D.truncata,167897087,VNJQ01004632.1,1,5437,3.23829e-05,154908081,0.922637
D.truncata,167897087,VNJQ01001419.1,1,5435,3.2371e-05,154913516,0.922669
D.truncata,167897087,VNJQ01000223.1,1,5435,3.2371e-05,154918951,0.922702
D.truncata,167897087,VNJQ01006197.1,1,5425,3.23115e-05,154924376,0.922734
D.truncata,167897087,VNJQ01002393.1,1,5422,3.22936e-05,154929798,0.922766
D.truncata,167897087,VNJQ01003371.1,1,5421,3.22876e-05,154935219,0.922799
D.truncata,167897087,VNJQ01000136.1,1,5420,3.22817e-05,154940639,0.922831
D.truncata,167897087,VNJQ01006014.1,1,5418,3.22698e-05,154946057,0.922863
D.truncata,167897087,VNJQ01008098.1,1,5414,3.22459e-05,154951471,0.922896
D.truncata,167897087,VNJQ01006078.1,1,5413,3.224e-05,154956884,0.922928
D.truncata,167897087,VNJQ01005212.1,1,5413,3.224e-05,154962297,0.92296
D.truncata,167897087,VNJQ01001043.1,1,5409,3.22162e-05,154967706,0.922992
D.truncata,167897087,VNJQ01007175.1,1,5407,3.22043e-05,154973113,0.923024
D.truncata,167897087,VNJQ01004228.1,1,5407,3.22043e-05,154978520,0.923057
D.truncata,167897087,VNJQ01001220.1,1,5403,3.21804e-05,154983923,0.923089
D.truncata,167897087,VNJQ01007768.1,1,5400,3.21626e-05,154989323,0.923121
D.truncata,167897087,VNJQ01000224.1,1,5399,3.21566e-05,154994722,0.923153
D.truncata,167897087,VNJQ01005287.1,1,5395,3.21328e-05,155000117,0.923185
D.truncata,167897087,VNJQ01005278.1,1,5394,3.21268e-05,155005511,0.923217
D.truncata,167897087,VNJQ01001305.1,1,5394,3.21268e-05,155010905,0.92325
D.truncata,167897087,VNJQ01007895.1,1,5393,3.21209e-05,155016298,0.923282
D.truncata,167897087,VNJQ01004300.1,1,5393,3.21209e-05,155021691,0.923314
D.truncata,167897087,VNJQ01003377.1,1,5393,3.21209e-05,155027084,0.923346
D.truncata,167897087,VNJQ01001242.1,1,5391,3.2109e-05,155032475,0.923378
D.truncata,167897087,VNJQ01000575.1,1,5391,3.2109e-05,155037866,0.92341
D.truncata,167897087,VNJQ01007686.1,1,5389,3.2097e-05,155043255,0.923442
D.truncata,167897087,VNJQ01001504.1,1,5386,3.20792e-05,155048641,0.923474
D.truncata,167897087,VNJQ01001575.1,1,5385,3.20732e-05,155054026,0.923506
D.truncata,167897087,VNJQ01004893.1,1,5381,3.20494e-05,155059407,0.923538
D.truncata,167897087,VNJQ01008068.1,1,5376,3.20196e-05,155064783,0.92357
D.truncata,167897087,VNJQ01007543.1,1,5376,3.20196e-05,155070159,0.923602
D.truncata,167897087,VNJQ01006848.1,1,5372,3.19958e-05,155075531,0.923634
D.truncata,167897087,VNJQ01006081.1,1,5370,3.19839e-05,155080901,0.923666
D.truncata,167897087,VNJQ01006175.1,1,5361,3.19303e-05,155086262,0.923698
D.truncata,167897087,VNJQ01006127.1,1,5357,3.19064e-05,155091619,0.92373
D.truncata,167897087,VNJQ01003829.1,1,5357,3.19064e-05,155096976,0.923762
D.truncata,167897087,VNJQ01006469.1,1,5348,3.18528e-05,155102324,0.923794
D.truncata,167897087,VNJQ01002625.1,1,5346,3.18409e-05,155107670,0.923826
D.truncata,167897087,VNJQ01006345.1,1,5345,3.1835e-05,155113015,0.923858
D.truncata,167897087,VNJQ01001437.1,1,5345,3.1835e-05,155118360,0.92389
D.truncata,167897087,VNJQ01004513.1,1,5344,3.1829e-05,155123704,0.923921
D.truncata,167897087,VNJQ01008134.1,1,5343,3.18231e-05,155129047,0.923953
D.truncata,167897087,VNJQ01001543.1,1,5343,3.18231e-05,155134390,0.923985
D.truncata,167897087,VNJQ01003810.1,1,5337,3.17873e-05,155139727,0.924017
D.truncata,167897087,VNJQ01000092.1,1,5335,3.17754e-05,155145062,0.924049
D.truncata,167897087,VNJQ01006119.1,1,5330,3.17456e-05,155150392,0.92408
D.truncata,167897087,VNJQ01000225.1,1,5330,3.17456e-05,155155722,0.924112
D.truncata,167897087,VNJQ01002525.1,1,5326,3.17218e-05,155161048,0.924144
D.truncata,167897087,VNJQ01002577.1,1,5324,3.17099e-05,155166372,0.924175
D.truncata,167897087,VNJQ01007301.1,1,5323,3.17039e-05,155171695,0.924207
D.truncata,167897087,VNJQ01004732.1,1,5323,3.17039e-05,155177018,0.924239
D.truncata,167897087,VNJQ01008094.1,1,5322,3.1698e-05,155182340,0.924271
D.truncata,167897087,VNJQ01002188.1,1,5322,3.1698e-05,155187662,0.924302
D.truncata,167897087,VNJQ01006454.1,1,5321,3.1692e-05,155192983,0.924334
D.truncata,167897087,VNJQ01002578.1,1,5321,3.1692e-05,155198304,0.924366
D.truncata,167897087,VNJQ01004924.1,1,5318,3.16742e-05,155203622,0.924397
D.truncata,167897087,VNJQ01004955.1,1,5315,3.16563e-05,155208937,0.924429
D.truncata,167897087,VNJQ01006165.1,1,5314,3.16503e-05,155214251,0.924461
D.truncata,167897087,VNJQ01001062.1,1,5314,3.16503e-05,155219565,0.924492
D.truncata,167897087,VNJQ01001944.1,1,5313,3.16444e-05,155224878,0.924524
D.truncata,167897087,VNJQ01000082.1,1,5313,3.16444e-05,155230191,0.924556
D.truncata,167897087,VNJQ01002788.1,1,5312,3.16384e-05,155235503,0.924587
D.truncata,167897087,VNJQ01006269.1,1,5308,3.16146e-05,155240811,0.924619
D.truncata,167897087,VNJQ01001183.1,1,5308,3.16146e-05,155246119,0.92465
D.truncata,167897087,VNJQ01008158.1,1,5307,3.16086e-05,155251426,0.924682
D.truncata,167897087,VNJQ01006934.1,1,5307,3.16086e-05,155256733,0.924714
D.truncata,167897087,VNJQ01000313.1,1,5300,3.1567e-05,155262033,0.924745
D.truncata,167897087,VNJQ01006875.1,1,5298,3.1555e-05,155267331,0.924777
D.truncata,167897087,VNJQ01007452.1,1,5295,3.15372e-05,155272626,0.924808
D.truncata,167897087,VNJQ01000167.1,1,5295,3.15372e-05,155277921,0.92484
D.truncata,167897087,VNJQ01003489.1,1,5294,3.15312e-05,155283215,0.924871
D.truncata,167897087,VNJQ01002113.1,1,5290,3.15074e-05,155288505,0.924903
D.truncata,167897087,VNJQ01001464.1,1,5289,3.15014e-05,155293794,0.924934
D.truncata,167897087,VNJQ01007917.1,1,5287,3.14895e-05,155299081,0.924966
D.truncata,167897087,VNJQ01000617.1,1,5287,3.14895e-05,155304368,0.924997
D.truncata,167897087,VNJQ01000564.1,1,5285,3.14776e-05,155309653,0.925029
D.truncata,167897087,VNJQ01002580.1,1,5284,3.14717e-05,155314937,0.92506
D.truncata,167897087,VNJQ01007560.1,1,5283,3.14657e-05,155320220,0.925092
D.truncata,167897087,VNJQ01005994.1,1,5282,3.14597e-05,155325502,0.925123
D.truncata,167897087,VNJQ01005627.1,1,5282,3.14597e-05,155330784,0.925155
D.truncata,167897087,VNJQ01006516.1,1,5280,3.14478e-05,155336064,0.925186
D.truncata,167897087,VNJQ01001983.1,1,5274,3.14121e-05,155341338,0.925218
D.truncata,167897087,VNJQ01002775.1,1,5272,3.14002e-05,155346610,0.925249
D.truncata,167897087,VNJQ01000691.1,1,5272,3.14002e-05,155351882,0.92528
D.truncata,167897087,VNJQ01002804.1,1,5269,3.13823e-05,155357151,0.925312
D.truncata,167897087,VNJQ01000977.1,1,5265,3.13585e-05,155362416,0.925343
D.truncata,167897087,VNJQ01005451.1,1,5261,3.13347e-05,155367677,0.925374
D.truncata,167897087,VNJQ01000726.1,1,5257,3.13108e-05,155372934,0.925406
D.truncata,167897087,VNJQ01001743.1,1,5256,3.13049e-05,155378190,0.925437
D.truncata,167897087,VNJQ01007559.1,1,5254,3.1293e-05,155383444,0.925468
D.truncata,167897087,VNJQ01004560.1,1,5250,3.12692e-05,155388694,0.9255
D.truncata,167897087,VNJQ01004798.1,1,5249,3.12632e-05,155393943,0.925531
D.truncata,167897087,VNJQ01007930.1,1,5248,3.12572e-05,155399191,0.925562
D.truncata,167897087,VNJQ01007496.1,1,5245,3.12394e-05,155404436,0.925593
D.truncata,167897087,VNJQ01001400.1,1,5243,3.12275e-05,155409679,0.925625
D.truncata,167897087,VNJQ01000920.1,1,5242,3.12215e-05,155414921,0.925656
D.truncata,167897087,VNJQ01004883.1,1,5241,3.12156e-05,155420162,0.925687
D.truncata,167897087,VNJQ01001910.1,1,5241,3.12156e-05,155425403,0.925718
D.truncata,167897087,VNJQ01001467.1,1,5241,3.12156e-05,155430644,0.925749
D.truncata,167897087,VNJQ01003239.1,1,5240,3.12096e-05,155435884,0.925781
D.truncata,167897087,VNJQ01008144.1,1,5239,3.12036e-05,155441123,0.925812
D.truncata,167897087,VNJQ01006015.1,1,5239,3.12036e-05,155446362,0.925843
D.truncata,167897087,VNJQ01003676.1,1,5238,3.11977e-05,155451600,0.925874
D.truncata,167897087,VNJQ01006971.1,1,5237,3.11917e-05,155456837,0.925906
D.truncata,167897087,VNJQ01005063.1,1,5235,3.11798e-05,155462072,0.925937
D.truncata,167897087,VNJQ01002528.1,1,5229,3.11441e-05,155467301,0.925968
D.truncata,167897087,VNJQ01001639.1,1,5229,3.11441e-05,155472530,0.925999
D.truncata,167897087,VNJQ01005996.1,1,5228,3.11381e-05,155477758,0.92603
D.truncata,167897087,VNJQ01003492.1,1,5228,3.11381e-05,155482986,0.926061
D.truncata,167897087,VNJQ01002557.1,1,5225,3.11203e-05,155488211,0.926092
D.truncata,167897087,VNJQ01000077.1,1,5225,3.11203e-05,155493436,0.926123
D.truncata,167897087,VNJQ01006463.1,1,5223,3.11083e-05,155498659,0.926155
D.truncata,167897087,VNJQ01003846.1,1,5223,3.11083e-05,155503882,0.926186
D.truncata,167897087,VNJQ01001799.1,1,5221,3.10964e-05,155509103,0.926217
D.truncata,167897087,VNJQ01007583.1,1,5218,3.10786e-05,155514321,0.926248
D.truncata,167897087,VNJQ01000735.1,1,5217,3.10726e-05,155519538,0.926279
D.truncata,167897087,VNJQ01003001.1,1,5213,3.10488e-05,155524751,0.92631
D.truncata,167897087,VNJQ01003475.1,1,5209,3.1025e-05,155529960,0.926341
D.truncata,167897087,VNJQ01003771.1,1,5205,3.10011e-05,155535165,0.926372
D.truncata,167897087,VNJQ01003230.1,1,5204,3.09952e-05,155540369,0.926403
D.truncata,167897087,VNJQ01004487.1,1,5202,3.09833e-05,155545571,0.926434
D.truncata,167897087,VNJQ01004886.1,1,5201,3.09773e-05,155550772,0.926465
D.truncata,167897087,VNJQ01001583.1,1,5201,3.09773e-05,155555973,0.926496
D.truncata,167897087,VNJQ01007861.1,1,5199,3.09654e-05,155561172,0.926527
D.truncata,167897087,VNJQ01006156.1,1,5195,3.09416e-05,155566367,0.926558
D.truncata,167897087,VNJQ01005166.1,1,5195,3.09416e-05,155571562,0.926589
D.truncata,167897087,VNJQ01006390.1,1,5194,3.09356e-05,155576756,0.92662
D.truncata,167897087,VNJQ01001541.1,1,5194,3.09356e-05,155581950,0.926651
D.truncata,167897087,VNJQ01001659.1,1,5191,3.09177e-05,155587141,0.926682
D.truncata,167897087,VNJQ01003566.1,1,5189,3.09058e-05,155592330,0.926713
D.truncata,167897087,VNJQ01005167.1,1,5186,3.0888e-05,155597516,0.926743
D.truncata,167897087,VNJQ01004879.1,1,5186,3.0888e-05,155602702,0.926774
D.truncata,167897087,VNJQ01006172.1,1,5185,3.0882e-05,155607887,0.926805
D.truncata,167897087,VNJQ01006208.1,1,5182,3.08641e-05,155613069,0.926836
D.truncata,167897087,VNJQ01004365.1,1,5179,3.08463e-05,155618248,0.926867
D.truncata,167897087,VNJQ01007172.1,1,5177,3.08344e-05,155623425,0.926898
D.truncata,167897087,VNJQ01007093.1,1,5176,3.08284e-05,155628601,0.926929
D.truncata,167897087,VNJQ01004714.1,1,5175,3.08225e-05,155633776,0.926959
D.truncata,167897087,VNJQ01005081.1,1,5172,3.08046e-05,155638948,0.92699
D.truncata,167897087,VNJQ01001701.1,1,5171,3.07986e-05,155644119,0.927021
D.truncata,167897087,VNJQ01002173.1,1,5170,3.07927e-05,155649289,0.927052
D.truncata,167897087,VNJQ01007200.1,1,5167,3.07748e-05,155654456,0.927083
D.truncata,167897087,VNJQ01007714.1,1,5166,3.07688e-05,155659622,0.927113
D.truncata,167897087,VNJQ01005721.1,1,5161,3.07391e-05,155664783,0.927144
D.truncata,167897087,VNJQ01001353.1,1,5153,3.06914e-05,155669936,0.927175
D.truncata,167897087,VNJQ01002990.1,1,5150,3.06736e-05,155675086,0.927205
D.truncata,167897087,VNJQ01006338.1,1,5149,3.06676e-05,155680235,0.927236
D.truncata,167897087,VNJQ01004577.1,1,5144,3.06378e-05,155685379,0.927267
D.truncata,167897087,VNJQ01003876.1,1,5143,3.06319e-05,155690522,0.927297
D.truncata,167897087,VNJQ01006899.1,1,5139,3.0608e-05,155695661,0.927328
D.truncata,167897087,VNJQ01003019.1,1,5138,3.06021e-05,155700799,0.927359
D.truncata,167897087,VNJQ01004752.1,1,5137,3.05961e-05,155705936,0.927389
D.truncata,167897087,VNJQ01003868.1,1,5137,3.05961e-05,155711073,0.92742
D.truncata,167897087,VNJQ01005868.1,1,5136,3.05902e-05,155716209,0.92745
D.truncata,167897087,VNJQ01005159.1,1,5135,3.05842e-05,155721344,0.927481
D.truncata,167897087,VNJQ01002378.1,1,5135,3.05842e-05,155726479,0.927511
D.truncata,167897087,VNJQ01001343.1,1,5135,3.05842e-05,155731614,0.927542
D.truncata,167897087,VNJQ01000830.1,1,5135,3.05842e-05,155736749,0.927573
D.truncata,167897087,VNJQ01006727.1,1,5129,3.05485e-05,155741878,0.927603
D.truncata,167897087,VNJQ01001979.1,1,5129,3.05485e-05,155747007,0.927634
D.truncata,167897087,VNJQ01005804.1,1,5128,3.05425e-05,155752135,0.927664
D.truncata,167897087,VNJQ01007955.1,1,5127,3.05366e-05,155757262,0.927695
D.truncata,167897087,VNJQ01001402.1,1,5127,3.05366e-05,155762389,0.927725
D.truncata,167897087,VNJQ01007689.1,1,5116,3.0471e-05,155767505,0.927756
D.truncata,167897087,VNJQ01001216.1,1,5116,3.0471e-05,155772621,0.927786
D.truncata,167897087,VNJQ01000114.1,1,5115,3.04651e-05,155777736,0.927817
D.truncata,167897087,VNJQ01006195.1,1,5113,3.04532e-05,155782849,0.927847
D.truncata,167897087,VNJQ01006613.1,1,5112,3.04472e-05,155787961,0.927878
D.truncata,167897087,VNJQ01001002.1,1,5111,3.04413e-05,155793072,0.927908
D.truncata,167897087,VNJQ01004803.1,1,5110,3.04353e-05,155798182,0.927939
D.truncata,167897087,VNJQ01003850.1,1,5110,3.04353e-05,155803292,0.927969
D.truncata,167897087,VNJQ01001922.1,1,5109,3.04294e-05,155808401,0.927999
D.truncata,167897087,VNJQ01002160.1,1,5104,3.03996e-05,155813505,0.92803
D.truncata,167897087,VNJQ01001411.1,1,5103,3.03936e-05,155818608,0.92806
D.truncata,167897087,VNJQ01006986.1,1,5101,3.03817e-05,155823709,0.928091
D.truncata,167897087,VNJQ01000390.1,1,5099,3.03698e-05,155828808,0.928121
D.truncata,167897087,VNJQ01002010.1,1,5079,3.02507e-05,155833887,0.928151
D.truncata,167897087,VNJQ01003920.1,1,5078,3.02447e-05,155838965,0.928181
D.truncata,167897087,VNJQ01000504.1,1,5077,3.02388e-05,155844042,0.928212
D.truncata,167897087,VNJQ01005284.1,1,5070,3.01971e-05,155849112,0.928242
D.truncata,167897087,VNJQ01005613.1,1,5068,3.01852e-05,155854180,0.928272
D.truncata,167897087,VNJQ01006668.1,1,5064,3.01613e-05,155859244,0.928302
D.truncata,167897087,VNJQ01002060.1,1,5063,3.01554e-05,155864307,0.928332
D.truncata,167897087,VNJQ01003882.1,1,5055,3.01077e-05,155869362,0.928363
D.truncata,167897087,VNJQ01004984.1,1,5051,3.00839e-05,155874413,0.928393
D.truncata,167897087,VNJQ01005587.1,1,5045,3.00482e-05,155879458,0.928423
D.truncata,167897087,VNJQ01003474.1,1,5045,3.00482e-05,155884503,0.928453
D.truncata,167897087,VNJQ01008163.1,1,5041,3.00243e-05,155889544,0.928483
D.truncata,167897087,VNJQ01004673.1,1,5036,2.99946e-05,155894580,0.928513
D.truncata,167897087,VNJQ01004586.1,1,5033,2.99767e-05,155899613,0.928543
D.truncata,167897087,VNJQ01002156.1,1,5029,2.99529e-05,155904642,0.928573
D.truncata,167897087,VNJQ01004481.1,1,5027,2.9941e-05,155909669,0.928603
D.truncata,167897087,VNJQ01003234.1,1,5025,2.9929e-05,155914694,0.928633
D.truncata,167897087,VNJQ01001554.1,1,5019,2.98933e-05,155919713,0.928662
D.truncata,167897087,VNJQ01000431.1,1,5017,2.98814e-05,155924730,0.928692
D.truncata,167897087,VNJQ01005738.1,1,5016,2.98754e-05,155929746,0.928722
D.truncata,167897087,VNJQ01003870.1,1,5010,2.98397e-05,155934756,0.928752
D.truncata,167897087,VNJQ01005431.1,1,5009,2.98338e-05,155939765,0.928782
D.truncata,167897087,VNJQ01006446.1,1,5002,2.97921e-05,155944767,0.928812
D.truncata,167897087,VNJQ01007820.1,1,5000,2.97801e-05,155949767,0.928841
D.truncata,167897087,VNJQ01001251.1,1,4998,2.97682e-05,155954765,0.928871
D.truncata,167897087,VNJQ01007765.1,1,4993,2.97385e-05,155959758,0.928901
D.truncata,167897087,VNJQ01000522.1,1,4993,2.97385e-05,155964751,0.928931
D.truncata,167897087,VNJQ01002664.1,1,4989,2.97146e-05,155969740,0.92896
D.truncata,167897087,VNJQ01001205.1,1,4988,2.97087e-05,155974728,0.92899
D.truncata,167897087,VNJQ01003085.1,1,4986,2.96968e-05,155979714,0.92902
D.truncata,167897087,VNJQ01003301.1,1,4985,2.96908e-05,155984699,0.929049
D.truncata,167897087,VNJQ01003339.1,1,4978,2.96491e-05,155989677,0.929079
D.truncata,167897087,VNJQ01004370.1,1,4976,2.96372e-05,155994653,0.929109
D.truncata,167897087,VNJQ01001626.1,1,4974,2.96253e-05,155999627,0.929138
D.truncata,167897087,VNJQ01003584.1,1,4969,2.95955e-05,156004596,0.929168
D.truncata,167897087,VNJQ01003819.1,1,4964,2.95657e-05,156009560,0.929198
D.truncata,167897087,VNJQ01003041.1,1,4963,2.95598e-05,156014523,0.929227
D.truncata,167897087,VNJQ01006670.1,1,4958,2.953e-05,156019481,0.929257
D.truncata,167897087,VNJQ01005348.1,1,4948,2.94704e-05,156024429,0.929286
D.truncata,167897087,VNJQ01005866.1,1,4947,2.94645e-05,156029376,0.929316
D.truncata,167897087,VNJQ01005852.1,1,4947,2.94645e-05,156034323,0.929345
D.truncata,167897087,VNJQ01002165.1,1,4944,2.94466e-05,156039267,0.929374
D.truncata,167897087,VNJQ01001483.1,1,4944,2.94466e-05,156044211,0.929404
D.truncata,167897087,VNJQ01003626.1,1,4943,2.94407e-05,156049154,0.929433
D.truncata,167897087,VNJQ01005413.1,1,4941,2.94287e-05,156054095,0.929463
D.truncata,167897087,VNJQ01005162.1,1,4940,2.94228e-05,156059035,0.929492
D.truncata,167897087,VNJQ01005157.1,1,4940,2.94228e-05,156063975,0.929522
D.truncata,167897087,VNJQ01003590.1,1,4940,2.94228e-05,156068915,0.929551
D.truncata,167897087,VNJQ01000938.1,1,4938,2.94109e-05,156073853,0.92958
D.truncata,167897087,VNJQ01006549.1,1,4937,2.94049e-05,156078790,0.92961
D.truncata,167897087,VNJQ01006719.1,1,4930,2.93632e-05,156083720,0.929639
D.truncata,167897087,VNJQ01000145.1,1,4930,2.93632e-05,156088650,0.929669
D.truncata,167897087,VNJQ01007713.1,1,4929,2.93573e-05,156093579,0.929698
D.truncata,167897087,VNJQ01001645.1,1,4928,2.93513e-05,156098507,0.929727
D.truncata,167897087,VNJQ01004524.1,1,4926,2.93394e-05,156103433,0.929757
D.truncata,167897087,VNJQ01006975.1,1,4919,2.92977e-05,156108352,0.929786
D.truncata,167897087,VNJQ01000768.1,1,4919,2.92977e-05,156113271,0.929815
D.truncata,167897087,VNJQ01007468.1,1,4917,2.92858e-05,156118188,0.929845
D.truncata,167897087,VNJQ01004870.1,1,4917,2.92858e-05,156123105,0.929874
D.truncata,167897087,VNJQ01004025.1,1,4917,2.92858e-05,156128022,0.929903
D.truncata,167897087,VNJQ01006305.1,1,4915,2.92739e-05,156132937,0.929932
D.truncata,167897087,VNJQ01006260.1,1,4915,2.92739e-05,156137852,0.929962
D.truncata,167897087,VNJQ01000792.1,1,4910,2.92441e-05,156142762,0.929991
D.truncata,167897087,VNJQ01002725.1,1,4909,2.92381e-05,156147671,0.93002
D.truncata,167897087,VNJQ01000332.1,1,4907,2.92262e-05,156152578,0.930049
D.truncata,167897087,VNJQ01004873.1,1,4906,2.92203e-05,156157484,0.930079
D.truncata,167897087,VNJQ01006734.1,1,4904,2.92084e-05,156162388,0.930108
D.truncata,167897087,VNJQ01006351.1,1,4904,2.92084e-05,156167292,0.930137
D.truncata,167897087,VNJQ01001559.1,1,4903,2.92024e-05,156172195,0.930166
D.truncata,167897087,VNJQ01007407.1,1,4902,2.91965e-05,156177097,0.930195
D.truncata,167897087,VNJQ01007267.1,1,4899,2.91786e-05,156181996,0.930225
D.truncata,167897087,VNJQ01006473.1,1,4899,2.91786e-05,156186895,0.930254
D.truncata,167897087,VNJQ01001157.1,1,4898,2.91726e-05,156191793,0.930283
D.truncata,167897087,VNJQ01002661.1,1,4897,2.91667e-05,156196690,0.930312
D.truncata,167897087,VNJQ01001820.1,1,4897,2.91667e-05,156201587,0.930341
D.truncata,167897087,VNJQ01003068.1,1,4894,2.91488e-05,156206481,0.93037
D.truncata,167897087,VNJQ01007460.1,1,4887,2.91071e-05,156211368,0.9304
D.truncata,167897087,VNJQ01004935.1,1,4887,2.91071e-05,156216255,0.930429
D.truncata,167897087,VNJQ01001330.1,1,4885,2.90952e-05,156221140,0.930458
D.truncata,167897087,VNJQ01006001.1,1,4883,2.90833e-05,156226023,0.930487
D.truncata,167897087,VNJQ01004012.1,1,4883,2.90833e-05,156230906,0.930516
D.truncata,167897087,VNJQ01004749.1,1,4882,2.90773e-05,156235788,0.930545
D.truncata,167897087,VNJQ01007885.1,1,4877,2.90476e-05,156240665,0.930574
D.truncata,167897087,VNJQ01004490.1,1,4876,2.90416e-05,156245541,0.930603
D.truncata,167897087,VNJQ01005663.1,1,4872,2.90178e-05,156250413,0.930632
D.truncata,167897087,VNJQ01004742.1,1,4869,2.89999e-05,156255282,0.930661
D.truncata,167897087,VNJQ01000254.1,1,4869,2.89999e-05,156260151,0.93069
D.truncata,167897087,VNJQ01002732.1,1,4868,2.8994e-05,156265019,0.930719
D.truncata,167897087,VNJQ01006926.1,1,4863,2.89642e-05,156269882,0.930748
D.truncata,167897087,VNJQ01005916.1,1,4863,2.89642e-05,156274745,0.930777
D.truncata,167897087,VNJQ01001700.1,1,4863,2.89642e-05,156279608,0.930806
D.truncata,167897087,VNJQ01007191.1,1,4862,2.89582e-05,156284470,0.930835
D.truncata,167897087,VNJQ01003314.1,1,4862,2.89582e-05,156289332,0.930864
D.truncata,167897087,VNJQ01000242.1,1,4862,2.89582e-05,156294194,0.930893
D.truncata,167897087,VNJQ01001501.1,1,4859,2.89403e-05,156299053,0.930922
D.truncata,167897087,VNJQ01000056.1,1,4858,2.89344e-05,156303911,0.930951
D.truncata,167897087,VNJQ01003690.1,1,4856,2.89225e-05,156308767,0.93098
D.truncata,167897087,VNJQ01003016.1,1,4856,2.89225e-05,156313623,0.931009
D.truncata,167897087,VNJQ01004086.1,1,4854,2.89106e-05,156318477,0.931037
D.truncata,167897087,VNJQ01004626.1,1,4840,2.88272e-05,156323317,0.931066
D.truncata,167897087,VNJQ01007214.1,1,4839,2.88212e-05,156328156,0.931095
D.truncata,167897087,VNJQ01002237.1,1,4835,2.87974e-05,156332991,0.931124
D.truncata,167897087,VNJQ01001045.1,1,4830,2.87676e-05,156337821,0.931153
D.truncata,167897087,VNJQ01001699.1,1,4826,2.87438e-05,156342647,0.931181
D.truncata,167897087,VNJQ01003678.1,1,4824,2.87319e-05,156347471,0.93121
D.truncata,167897087,VNJQ01002001.1,1,4824,2.87319e-05,156352295,0.931239
D.truncata,167897087,VNJQ01004167.1,1,4823,2.87259e-05,156357118,0.931268
D.truncata,167897087,VNJQ01003603.1,1,4823,2.87259e-05,156361941,0.931296
D.truncata,167897087,VNJQ01005502.1,1,4817,2.86902e-05,156366758,0.931325
D.truncata,167897087,VNJQ01006037.1,1,4815,2.86783e-05,156371573,0.931354
D.truncata,167897087,VNJQ01000359.1,1,4815,2.86783e-05,156376388,0.931382
D.truncata,167897087,VNJQ01006177.1,1,4814,2.86723e-05,156381202,0.931411
D.truncata,167897087,VNJQ01004041.1,1,4812,2.86604e-05,156386014,0.93144
D.truncata,167897087,VNJQ01003031.1,1,4810,2.86485e-05,156390824,0.931468
D.truncata,167897087,VNJQ01000425.1,1,4809,2.86425e-05,156395633,0.931497
D.truncata,167897087,VNJQ01004143.1,1,4808,2.86366e-05,156400441,0.931526
D.truncata,167897087,VNJQ01005571.1,1,4799,2.8583e-05,156405240,0.931554
D.truncata,167897087,VNJQ01002085.1,1,4798,2.8577e-05,156410038,0.931583
D.truncata,167897087,VNJQ01005191.1,1,4797,2.85711e-05,156414835,0.931611
D.truncata,167897087,VNJQ01002671.1,1,4795,2.85592e-05,156419630,0.93164
D.truncata,167897087,VNJQ01008060.1,1,4793,2.85472e-05,156424423,0.931668
D.truncata,167897087,VNJQ01004874.1,1,4790,2.85294e-05,156429213,0.931697
D.truncata,167897087,VNJQ01004914.1,1,4788,2.85175e-05,156434001,0.931726
D.truncata,167897087,VNJQ01002218.1,1,4783,2.84877e-05,156438784,0.931754
D.truncata,167897087,VNJQ01000244.1,1,4778,2.84579e-05,156443562,0.931782
D.truncata,167897087,VNJQ01003644.1,1,4770,2.84103e-05,156448332,0.931811
D.truncata,167897087,VNJQ01004499.1,1,4766,2.83864e-05,156453098,0.931839
D.truncata,167897087,VNJQ01006617.1,1,4765,2.83805e-05,156457863,0.931868
D.truncata,167897087,VNJQ01006992.1,1,4759,2.83447e-05,156462622,0.931896
D.truncata,167897087,VNJQ01008178.1,1,4756,2.83269e-05,156467378,0.931924
D.truncata,167897087,VNJQ01007033.1,1,4756,2.83269e-05,156472134,0.931953
D.truncata,167897087,VNJQ01000319.1,1,4755,2.83209e-05,156476889,0.931981
D.truncata,167897087,VNJQ01004140.1,1,4754,2.8315e-05,156481643,0.932009
D.truncata,167897087,VNJQ01007494.1,1,4750,2.82911e-05,156486393,0.932038
D.truncata,167897087,VNJQ01006064.1,1,4749,2.82852e-05,156491142,0.932066
D.truncata,167897087,VNJQ01002533.1,1,4747,2.82733e-05,156495889,0.932094
D.truncata,167897087,VNJQ01000635.1,1,4743,2.82494e-05,156500632,0.932122
D.truncata,167897087,VNJQ01005216.1,1,4740,2.82316e-05,156505372,0.932151
D.truncata,167897087,VNJQ01007314.1,1,4734,2.81958e-05,156510106,0.932179
D.truncata,167897087,VNJQ01007165.1,1,4733,2.81899e-05,156514839,0.932207
D.truncata,167897087,VNJQ01001392.1,1,4732,2.81839e-05,156519571,0.932235
D.truncata,167897087,VNJQ01005329.1,1,4729,2.81661e-05,156524300,0.932263
D.truncata,167897087,VNJQ01004627.1,1,4728,2.81601e-05,156529028,0.932292
D.truncata,167897087,VNJQ01005112.1,1,4725,2.81422e-05,156533753,0.93232
D.truncata,167897087,VNJQ01005865.1,1,4724,2.81363e-05,156538477,0.932348
D.truncata,167897087,VNJQ01004380.1,1,4723,2.81303e-05,156543200,0.932376
D.truncata,167897087,VNJQ01006974.1,1,4722,2.81244e-05,156547922,0.932404
D.truncata,167897087,VNJQ01001337.1,1,4721,2.81184e-05,156552643,0.932432
D.truncata,167897087,VNJQ01003927.1,1,4719,2.81065e-05,156557362,0.93246
D.truncata,167897087,VNJQ01000604.1,1,4719,2.81065e-05,156562081,0.932488
D.truncata,167897087,VNJQ01006927.1,1,4716,2.80886e-05,156566797,0.932516
D.truncata,167897087,VNJQ01005901.1,1,4716,2.80886e-05,156571513,0.932545
D.truncata,167897087,VNJQ01002738.1,1,4716,2.80886e-05,156576229,0.932573
D.truncata,167897087,VNJQ01005213.1,1,4715,2.80827e-05,156580944,0.932601
D.truncata,167897087,VNJQ01004433.1,1,4715,2.80827e-05,156585659,0.932629
D.truncata,167897087,VNJQ01007600.1,1,4709,2.80469e-05,156590368,0.932657
D.truncata,167897087,VNJQ01006089.1,1,4706,2.80291e-05,156595074,0.932685
D.truncata,167897087,VNJQ01001342.1,1,4706,2.80291e-05,156599780,0.932713
D.truncata,167897087,VNJQ01001193.1,1,4705,2.80231e-05,156604485,0.932741
D.truncata,167897087,VNJQ01004771.1,1,4704,2.80172e-05,156609189,0.932769
D.truncata,167897087,VNJQ01006932.1,1,4703,2.80112e-05,156613892,0.932797
D.truncata,167897087,VNJQ01004338.1,1,4702,2.80053e-05,156618594,0.932825
D.truncata,167897087,VNJQ01003312.1,1,4702,2.80053e-05,156623296,0.932853
D.truncata,167897087,VNJQ01001413.1,1,4701,2.79993e-05,156627997,0.932881
D.truncata,167897087,VNJQ01003789.1,1,4700,2.79933e-05,156632697,0.932909
D.truncata,167897087,VNJQ01001815.1,1,4698,2.79814e-05,156637395,0.932937
D.truncata,167897087,VNJQ01007847.1,1,4696,2.79695e-05,156642091,0.932965
D.truncata,167897087,VNJQ01007322.1,1,4696,2.79695e-05,156646787,0.932993
D.truncata,167897087,VNJQ01002521.1,1,4692,2.79457e-05,156651479,0.933021
D.truncata,167897087,VNJQ01001162.1,1,4692,2.79457e-05,156656171,0.933049
D.truncata,167897087,VNJQ01000591.1,1,4691,2.79397e-05,156660862,0.933077
D.truncata,167897087,VNJQ01003645.1,1,4690,2.79338e-05,156665552,0.933105
D.truncata,167897087,VNJQ01007469.1,1,4686,2.791e-05,156670238,0.933133
D.truncata,167897087,VNJQ01001641.1,1,4683,2.78921e-05,156674921,0.93316
D.truncata,167897087,VNJQ01007035.1,1,4681,2.78802e-05,156679602,0.933188
D.truncata,167897087,VNJQ01002634.1,1,4681,2.78802e-05,156684283,0.933216
D.truncata,167897087,VNJQ01000902.1,1,4680,2.78742e-05,156688963,0.933244
D.truncata,167897087,VNJQ01003163.1,1,4678,2.78623e-05,156693641,0.933272
D.truncata,167897087,VNJQ01002073.1,1,4678,2.78623e-05,156698319,0.9333
D.truncata,167897087,VNJQ01000636.1,1,4676,2.78504e-05,156702995,0.933328
D.truncata,167897087,VNJQ01004628.1,1,4674,2.78385e-05,156707669,0.933355
D.truncata,167897087,VNJQ01000267.1,1,4668,2.78027e-05,156712337,0.933383
D.truncata,167897087,VNJQ01002658.1,1,4666,2.77908e-05,156717003,0.933411
D.truncata,167897087,VNJQ01004414.1,1,4665,2.77849e-05,156721668,0.933439
D.truncata,167897087,VNJQ01007563.1,1,4659,2.77491e-05,156726327,0.933467
D.truncata,167897087,VNJQ01000467.1,1,4656,2.77313e-05,156730983,0.933494
D.truncata,167897087,VNJQ01003839.1,1,4653,2.77134e-05,156735636,0.933522
D.truncata,167897087,VNJQ01000597.1,1,4650,2.76955e-05,156740286,0.93355
D.truncata,167897087,VNJQ01007345.1,1,4649,2.76896e-05,156744935,0.933577
D.truncata,167897087,VNJQ01003925.1,1,4647,2.76777e-05,156749582,0.933605
D.truncata,167897087,VNJQ01008120.1,1,4646,2.76717e-05,156754228,0.933633
D.truncata,167897087,VNJQ01000886.1,1,4644,2.76598e-05,156758872,0.93366
D.truncata,167897087,VNJQ01000559.1,1,4642,2.76479e-05,156763514,0.933688
D.truncata,167897087,VNJQ01003164.1,1,4639,2.763e-05,156768153,0.933716
D.truncata,167897087,VNJQ01007862.1,1,4637,2.76181e-05,156772790,0.933743
D.truncata,167897087,VNJQ01004452.1,1,4637,2.76181e-05,156777427,0.933771
D.truncata,167897087,VNJQ01001229.1,1,4634,2.76002e-05,156782061,0.933799
D.truncata,167897087,VNJQ01006995.1,1,4632,2.75883e-05,156786693,0.933826
D.truncata,167897087,VNJQ01004536.1,1,4632,2.75883e-05,156791325,0.933854
D.truncata,167897087,VNJQ01004064.1,1,4632,2.75883e-05,156795957,0.933881
D.truncata,167897087,VNJQ01004821.1,1,4629,2.75705e-05,156800586,0.933909
D.truncata,167897087,VNJQ01003674.1,1,4629,2.75705e-05,156805215,0.933936
D.truncata,167897087,VNJQ01005662.1,1,4626,2.75526e-05,156809841,0.933964
D.truncata,167897087,VNJQ01006720.1,1,4623,2.75347e-05,156814464,0.933992
D.truncata,167897087,VNJQ01005977.1,1,4623,2.75347e-05,156819087,0.934019
D.truncata,167897087,VNJQ01002015.1,1,4623,2.75347e-05,156823710,0.934047
D.truncata,167897087,VNJQ01006405.1,1,4621,2.75228e-05,156828331,0.934074
D.truncata,167897087,VNJQ01003497.1,1,4615,2.74871e-05,156832946,0.934102
D.truncata,167897087,VNJQ01004592.1,1,4613,2.74752e-05,156837559,0.934129
D.truncata,167897087,VNJQ01000605.1,1,4613,2.74752e-05,156842172,0.934157
D.truncata,167897087,VNJQ01000529.1,1,4613,2.74752e-05,156846785,0.934184
D.truncata,167897087,VNJQ01001344.1,1,4612,2.74692e-05,156851397,0.934212
D.truncata,167897087,VNJQ01005184.1,1,4611,2.74633e-05,156856008,0.934239
D.truncata,167897087,VNJQ01005282.1,1,4608,2.74454e-05,156860616,0.934266
D.truncata,167897087,VNJQ01001037.1,1,4604,2.74216e-05,156865220,0.934294
D.truncata,167897087,VNJQ01003242.1,1,4603,2.74156e-05,156869823,0.934321
D.truncata,167897087,VNJQ01005294.1,1,4602,2.74096e-05,156874425,0.934349
D.truncata,167897087,VNJQ01001126.1,1,4602,2.74096e-05,156879027,0.934376
D.truncata,167897087,VNJQ01005654.1,1,4601,2.74037e-05,156883628,0.934404
D.truncata,167897087,VNJQ01001781.1,1,4601,2.74037e-05,156888229,0.934431
D.truncata,167897087,VNJQ01004426.1,1,4600,2.73977e-05,156892829,0.934458
D.truncata,167897087,VNJQ01005998.1,1,4590,2.73382e-05,156897419,0.934486
D.truncata,167897087,VNJQ01008003.1,1,4589,2.73322e-05,156902008,0.934513
D.truncata,167897087,VNJQ01007344.1,1,4589,2.73322e-05,156906597,0.93454
D.truncata,167897087,VNJQ01006999.1,1,4589,2.73322e-05,156911186,0.934568
D.truncata,167897087,VNJQ01004200.1,1,4584,2.73024e-05,156915770,0.934595
D.truncata,167897087,VNJQ01000869.1,1,4584,2.73024e-05,156920354,0.934622
D.truncata,167897087,VNJQ01005636.1,1,4583,2.72965e-05,156924937,0.93465
D.truncata,167897087,VNJQ01004201.1,1,4581,2.72846e-05,156929518,0.934677
D.truncata,167897087,VNJQ01002695.1,1,4581,2.72846e-05,156934099,0.934704
D.truncata,167897087,VNJQ01007915.1,1,4580,2.72786e-05,156938679,0.934731
D.truncata,167897087,VNJQ01001414.1,1,4580,2.72786e-05,156943259,0.934759
D.truncata,167897087,VNJQ01001052.1,1,4580,2.72786e-05,156947839,0.934786
D.truncata,167897087,VNJQ01001780.1,1,4579,2.72727e-05,156952418,0.934813
D.truncata,167897087,VNJQ01002251.1,1,4578,2.72667e-05,156956996,0.93484
D.truncata,167897087,VNJQ01007125.1,1,4577,2.72607e-05,156961573,0.934868
D.truncata,167897087,VNJQ01007306.1,1,4574,2.72429e-05,156966147,0.934895
D.truncata,167897087,VNJQ01003959.1,1,4572,2.7231e-05,156970719,0.934922
D.truncata,167897087,VNJQ01002821.1,1,4571,2.7225e-05,156975290,0.934949
D.truncata,167897087,VNJQ01003986.1,1,4569,2.72131e-05,156979859,0.934977
D.truncata,167897087,VNJQ01004031.1,1,4567,2.72012e-05,156984426,0.935004
D.truncata,167897087,VNJQ01001104.1,1,4567,2.72012e-05,156988993,0.935031
D.truncata,167897087,VNJQ01004845.1,1,4565,2.71893e-05,156993558,0.935058
D.truncata,167897087,VNJQ01004920.1,1,4562,2.71714e-05,156998120,0.935085
D.truncata,167897087,VNJQ01006160.1,1,4560,2.71595e-05,157002680,0.935113
D.truncata,167897087,VNJQ01002261.1,1,4560,2.71595e-05,157007240,0.93514
D.truncata,167897087,VNJQ01000041.1,1,4559,2.71535e-05,157011799,0.935167
D.truncata,167897087,VNJQ01007802.1,1,4557,2.71416e-05,157016356,0.935194
D.truncata,167897087,VNJQ01003166.1,1,4553,2.71178e-05,157020909,0.935221
D.truncata,167897087,VNJQ01007454.1,1,4551,2.71059e-05,157025460,0.935248
D.truncata,167897087,VNJQ01001624.1,1,4548,2.7088e-05,157030008,0.935275
D.truncata,167897087,VNJQ01001619.1,1,4548,2.7088e-05,157034556,0.935302
D.truncata,167897087,VNJQ01007387.1,1,4547,2.70821e-05,157039103,0.93533
D.truncata,167897087,VNJQ01007004.1,1,4546,2.70761e-05,157043649,0.935357
D.truncata,167897087,VNJQ01003184.1,1,4546,2.70761e-05,157048195,0.935384
D.truncata,167897087,VNJQ01000360.1,1,4546,2.70761e-05,157052741,0.935411
D.truncata,167897087,VNJQ01000214.1,1,4546,2.70761e-05,157057287,0.935438
D.truncata,167897087,VNJQ01006027.1,1,4544,2.70642e-05,157061831,0.935465
D.truncata,167897087,VNJQ01005486.1,1,4544,2.70642e-05,157066375,0.935492
D.truncata,167897087,VNJQ01002258.1,1,4544,2.70642e-05,157070919,0.935519
D.truncata,167897087,VNJQ01000375.1,1,4544,2.70642e-05,157075463,0.935546
D.truncata,167897087,VNJQ01007371.1,1,4542,2.70523e-05,157080005,0.935573
D.truncata,167897087,VNJQ01000759.1,1,4540,2.70404e-05,157084545,0.9356
D.truncata,167897087,VNJQ01002359.1,1,4538,2.70285e-05,157089083,0.935627
D.truncata,167897087,VNJQ01005058.1,1,4537,2.70225e-05,157093620,0.935654
D.truncata,167897087,VNJQ01006282.1,1,4535,2.70106e-05,157098155,0.935681
D.truncata,167897087,VNJQ01001033.1,1,4534,2.70046e-05,157102689,0.935708
D.truncata,167897087,VNJQ01007275.1,1,4528,2.69689e-05,157107217,0.935735
D.truncata,167897087,VNJQ01002329.1,1,4528,2.69689e-05,157111745,0.935762
D.truncata,167897087,VNJQ01001803.1,1,4528,2.69689e-05,157116273,0.935789
D.truncata,167897087,VNJQ01007793.1,1,4524,2.69451e-05,157120797,0.935816
D.truncata,167897087,VNJQ01007169.1,1,4524,2.69451e-05,157125321,0.935843
D.truncata,167897087,VNJQ01002081.1,1,4524,2.69451e-05,157129845,0.93587
D.truncata,167897087,VNJQ01000232.1,1,4521,2.69272e-05,157134366,0.935897
D.truncata,167897087,VNJQ01008033.1,1,4518,2.69093e-05,157138884,0.935924
D.truncata,167897087,VNJQ01007716.1,1,4516,2.68974e-05,157143400,0.935951
D.truncata,167897087,VNJQ01007188.1,1,4515,2.68915e-05,157147915,0.935978
D.truncata,167897087,VNJQ01001265.1,1,4515,2.68915e-05,157152430,0.936005
D.truncata,167897087,VNJQ01007463.1,1,4513,2.68796e-05,157156943,0.936031
D.truncata,167897087,VNJQ01007186.1,1,4507,2.68438e-05,157161450,0.936058
D.truncata,167897087,VNJQ01003571.1,1,4505,2.68319e-05,157165955,0.936085
D.truncata,167897087,VNJQ01000108.1,1,4505,2.68319e-05,157170460,0.936112
D.truncata,167897087,VNJQ01006103.1,1,4504,2.6826e-05,157174964,0.936139
D.truncata,167897087,VNJQ01005817.1,1,4503,2.682e-05,157179467,0.936166
D.truncata,167897087,VNJQ01004432.1,1,4500,2.68021e-05,157183967,0.936192
D.truncata,167897087,VNJQ01007061.1,1,4499,2.67962e-05,157188466,0.936219
D.truncata,167897087,VNJQ01005220.1,1,4499,2.67962e-05,157192965,0.936246
D.truncata,167897087,VNJQ01007934.1,1,4493,2.67604e-05,157197458,0.936273
D.truncata,167897087,VNJQ01002992.1,1,4493,2.67604e-05,157201951,0.936299
D.truncata,167897087,VNJQ01001720.1,1,4493,2.67604e-05,157206444,0.936326
D.truncata,167897087,VNJQ01002929.1,1,4492,2.67545e-05,157210936,0.936353
D.truncata,167897087,VNJQ01001804.1,1,4492,2.67545e-05,157215428,0.93638
D.truncata,167897087,VNJQ01007483.1,1,4491,2.67485e-05,157219919,0.936406
D.truncata,167897087,VNJQ01005979.1,1,4489,2.67366e-05,157224408,0.936433
D.truncata,167897087,VNJQ01004492.1,1,4487,2.67247e-05,157228895,0.93646
D.truncata,167897087,VNJQ01000115.1,1,4487,2.67247e-05,157233382,0.936487
D.truncata,167897087,VNJQ01000415.1,1,4486,2.67187e-05,157237868,0.936513
D.truncata,167897087,VNJQ01003437.1,1,4482,2.66949e-05,157242350,0.93654
D.truncata,167897087,VNJQ01000755.1,1,4482,2.66949e-05,157246832,0.936567
D.truncata,167897087,VNJQ01006387.1,1,4481,2.6689e-05,157251313,0.936593
D.truncata,167897087,VNJQ01000181.1,1,4481,2.6689e-05,157255794,0.93662
D.truncata,167897087,VNJQ01004474.1,1,4474,2.66473e-05,157260268,0.936647
D.truncata,167897087,VNJQ01001560.1,1,4472,2.66354e-05,157264740,0.936673
D.truncata,167897087,VNJQ01002649.1,1,4470,2.66235e-05,157269210,0.9367
D.truncata,167897087,VNJQ01004137.1,1,4468,2.66115e-05,157273678,0.936727
D.truncata,167897087,VNJQ01000643.1,1,4468,2.66115e-05,157278146,0.936753
D.truncata,167897087,VNJQ01007237.1,1,4466,2.65996e-05,157282612,0.93678
D.truncata,167897087,VNJQ01007095.1,1,4466,2.65996e-05,157287078,0.936806
D.truncata,167897087,VNJQ01004939.1,1,4465,2.65937e-05,157291543,0.936833
D.truncata,167897087,VNJQ01007492.1,1,4464,2.65877e-05,157296007,0.93686
D.truncata,167897087,VNJQ01007865.1,1,4461,2.65698e-05,157300468,0.936886
D.truncata,167897087,VNJQ01000124.1,1,4459,2.65579e-05,157304927,0.936913
D.truncata,167897087,VNJQ01007731.1,1,4457,2.6546e-05,157309384,0.936939
D.truncata,167897087,VNJQ01000192.1,1,4457,2.6546e-05,157313841,0.936966
D.truncata,167897087,VNJQ01006258.1,1,4456,2.65401e-05,157318297,0.936992
D.truncata,167897087,VNJQ01003078.1,1,4453,2.65222e-05,157322750,0.937019
D.truncata,167897087,VNJQ01004504.1,1,4452,2.65162e-05,157327202,0.937045
D.truncata,167897087,VNJQ01000420.1,1,4452,2.65162e-05,157331654,0.937072
D.truncata,167897087,VNJQ01001751.1,1,4451,2.65103e-05,157336105,0.937098
D.truncata,167897087,VNJQ01005490.1,1,4450,2.65043e-05,157340555,0.937125
D.truncata,167897087,VNJQ01005274.1,1,4450,2.65043e-05,157345005,0.937151
D.truncata,167897087,VNJQ01005590.1,1,4443,2.64626e-05,157349448,0.937178
D.truncata,167897087,VNJQ01000576.1,1,4441,2.64507e-05,157353889,0.937204
D.truncata,167897087,VNJQ01004650.1,1,4436,2.64209e-05,157358325,0.937231
D.truncata,167897087,VNJQ01002184.1,1,4436,2.64209e-05,157362761,0.937257
D.truncata,167897087,VNJQ01004352.1,1,4435,2.6415e-05,157367196,0.937284
D.truncata,167897087,VNJQ01003269.1,1,4435,2.6415e-05,157371631,0.93731
D.truncata,167897087,VNJQ01002621.1,1,4429,2.63793e-05,157376060,0.937336
D.truncata,167897087,VNJQ01002866.1,1,4427,2.63673e-05,157380487,0.937363
D.truncata,167897087,VNJQ01001985.1,1,4427,2.63673e-05,157384914,0.937389
D.truncata,167897087,VNJQ01003924.1,1,4426,2.63614e-05,157389340,0.937416
D.truncata,167897087,VNJQ01002716.1,1,4424,2.63495e-05,157393764,0.937442
D.truncata,167897087,VNJQ01005769.1,1,4422,2.63376e-05,157398186,0.937468
D.truncata,167897087,VNJQ01002353.1,1,4422,2.63376e-05,157402608,0.937495
D.truncata,167897087,VNJQ01004195.1,1,4421,2.63316e-05,157407029,0.937521
D.truncata,167897087,VNJQ01003235.1,1,4417,2.63078e-05,157411446,0.937547
D.truncata,167897087,VNJQ01005780.1,1,4416,2.63018e-05,157415862,0.937574
D.truncata,167897087,VNJQ01004280.1,1,4416,2.63018e-05,157420278,0.9376
D.truncata,167897087,VNJQ01006402.1,1,4415,2.62959e-05,157424693,0.937626
D.truncata,167897087,VNJQ01001748.1,1,4412,2.6278e-05,157429105,0.937652
D.truncata,167897087,VNJQ01002720.1,1,4409,2.62601e-05,157433514,0.937679
D.truncata,167897087,VNJQ01001394.1,1,4409,2.62601e-05,157437923,0.937705
D.truncata,167897087,VNJQ01007341.1,1,4408,2.62542e-05,157442331,0.937731
D.truncata,167897087,VNJQ01002275.1,1,4407,2.62482e-05,157446738,0.937757
D.truncata,167897087,VNJQ01006561.1,1,4405,2.62363e-05,157451143,0.937784
D.truncata,167897087,VNJQ01005269.1,1,4405,2.62363e-05,157455548,0.93781
D.truncata,167897087,VNJQ01002430.1,1,4405,2.62363e-05,157459953,0.937836
D.truncata,167897087,VNJQ01007772.1,1,4404,2.62304e-05,157464357,0.937862
D.truncata,167897087,VNJQ01004193.1,1,4403,2.62244e-05,157468760,0.937889
D.truncata,167897087,VNJQ01003999.1,1,4403,2.62244e-05,157473163,0.937915
D.truncata,167897087,VNJQ01004921.1,1,4402,2.62184e-05,157477565,0.937941
D.truncata,167897087,VNJQ01006196.1,1,4399,2.62006e-05,157481964,0.937967
D.truncata,167897087,VNJQ01006407.1,1,4398,2.61946e-05,157486362,0.937993
D.truncata,167897087,VNJQ01006097.1,1,4390,2.6147e-05,157490752,0.93802
D.truncata,167897087,VNJQ01004156.1,1,4390,2.6147e-05,157495142,0.938046
D.truncata,167897087,VNJQ01007317.1,1,4389,2.6141e-05,157499531,0.938072
D.truncata,167897087,VNJQ01000270.1,1,4389,2.6141e-05,157503920,0.938098
D.truncata,167897087,VNJQ01008213.1,1,4385,2.61172e-05,157508305,0.938124
D.truncata,167897087,VNJQ01007366.1,1,4385,2.61172e-05,157512690,0.93815
D.truncata,167897087,VNJQ01007320.1,1,4384,2.61112e-05,157517074,0.938176
D.truncata,167897087,VNJQ01002007.1,1,4380,2.60874e-05,157521454,0.938202
D.truncata,167897087,VNJQ01005638.1,1,4379,2.60815e-05,157525833,0.938229
D.truncata,167897087,VNJQ01001951.1,1,4376,2.60636e-05,157530209,0.938255
D.truncata,167897087,VNJQ01000441.1,1,4376,2.60636e-05,157534585,0.938281
D.truncata,167897087,VNJQ01002376.1,1,4374,2.60517e-05,157538959,0.938307
D.truncata,167897087,VNJQ01001928.1,1,4370,2.60278e-05,157543329,0.938333
D.truncata,167897087,VNJQ01007585.1,1,4369,2.60219e-05,157547698,0.938359
D.truncata,167897087,VNJQ01000855.1,1,4369,2.60219e-05,157552067,0.938385
D.truncata,167897087,VNJQ01000888.1,1,4368,2.60159e-05,157556435,0.938411
D.truncata,167897087,VNJQ01000612.1,1,4366,2.6004e-05,157560801,0.938437
D.truncata,167897087,VNJQ01000043.1,1,4364,2.59921e-05,157565165,0.938463
D.truncata,167897087,VNJQ01006201.1,1,4362,2.59802e-05,157569527,0.938489
D.truncata,167897087,VNJQ01001886.1,1,4361,2.59742e-05,157573888,0.938515
D.truncata,167897087,VNJQ01007899.1,1,4359,2.59623e-05,157578247,0.938541
D.truncata,167897087,VNJQ01005053.1,1,4356,2.59445e-05,157582603,0.938567
D.truncata,167897087,VNJQ01000566.1,1,4356,2.59445e-05,157586959,0.938593
D.truncata,167897087,VNJQ01007890.1,1,4355,2.59385e-05,157591314,0.938619
D.truncata,167897087,VNJQ01001313.1,1,4355,2.59385e-05,157595669,0.938644
D.truncata,167897087,VNJQ01000648.1,1,4355,2.59385e-05,157600024,0.93867
D.truncata,167897087,VNJQ01002892.1,1,4353,2.59266e-05,157604377,0.938696
D.truncata,167897087,VNJQ01006936.1,1,4352,2.59206e-05,157608729,0.938722
D.truncata,167897087,VNJQ01002715.1,1,4352,2.59206e-05,157613081,0.938748
D.truncata,167897087,VNJQ01003452.1,1,4350,2.59087e-05,157617431,0.938774
D.truncata,167897087,VNJQ01000999.1,1,4348,2.58968e-05,157621779,0.9388
D.truncata,167897087,VNJQ01002358.1,1,4346,2.58849e-05,157626125,0.938826
D.truncata,167897087,VNJQ01004477.1,1,4343,2.5867e-05,157630468,0.938852
D.truncata,167897087,VNJQ01007368.1,1,4340,2.58492e-05,157634808,0.938878
D.truncata,167897087,VNJQ01003282.1,1,4335,2.58194e-05,157639143,0.938903
D.truncata,167897087,VNJQ01002091.1,1,4335,2.58194e-05,157643478,0.938929
D.truncata,167897087,VNJQ01004807.1,1,4334,2.58134e-05,157647812,0.938955
D.truncata,167897087,VNJQ01004246.1,1,4334,2.58134e-05,157652146,0.938981
D.truncata,167897087,VNJQ01003612.1,1,4334,2.58134e-05,157656480,0.939007
D.truncata,167897087,VNJQ01001683.1,1,4332,2.58015e-05,157660812,0.939032
D.truncata,167897087,VNJQ01000346.1,1,4331,2.57956e-05,157665143,0.939058
D.truncata,167897087,VNJQ01006529.1,1,4330,2.57896e-05,157669473,0.939084
D.truncata,167897087,VNJQ01006638.1,1,4328,2.57777e-05,157673801,0.93911
D.truncata,167897087,VNJQ01006191.1,1,4327,2.57717e-05,157678128,0.939136
D.truncata,167897087,VNJQ01007158.1,1,4326,2.57658e-05,157682454,0.939161
D.truncata,167897087,VNJQ01002131.1,1,4326,2.57658e-05,157686780,0.939187
D.truncata,167897087,VNJQ01006261.1,1,4324,2.57539e-05,157691104,0.939213
D.truncata,167897087,VNJQ01001704.1,1,4324,2.57539e-05,157695428,0.939239
D.truncata,167897087,VNJQ01004054.1,1,4323,2.57479e-05,157699751,0.939264
D.truncata,167897087,VNJQ01003187.1,1,4323,2.57479e-05,157704074,0.93929
D.truncata,167897087,VNJQ01004018.1,1,4321,2.5736e-05,157708395,0.939316
D.truncata,167897087,VNJQ01002584.1,1,4321,2.5736e-05,157712716,0.939342
D.truncata,167897087,VNJQ01007792.1,1,4319,2.57241e-05,157717035,0.939367
D.truncata,167897087,VNJQ01005815.1,1,4319,2.57241e-05,157721354,0.939393
D.truncata,167897087,VNJQ01001137.1,1,4318,2.57181e-05,157725672,0.939419
D.truncata,167897087,VNJQ01006355.1,1,4314,2.56943e-05,157729986,0.939444
D.truncata,167897087,VNJQ01005354.1,1,4313,2.56884e-05,157734299,0.93947
D.truncata,167897087,VNJQ01003579.1,1,4306,2.56467e-05,157738605,0.939496
D.truncata,167897087,VNJQ01008016.1,1,4305,2.56407e-05,157742910,0.939521
D.truncata,167897087,VNJQ01005070.1,1,4301,2.56169e-05,157747211,0.939547
D.truncata,167897087,VNJQ01002422.1,1,4301,2.56169e-05,157751512,0.939573
D.truncata,167897087,VNJQ01004882.1,1,4300,2.56109e-05,157755812,0.939598
D.truncata,167897087,VNJQ01003608.1,1,4296,2.55871e-05,157760108,0.939624
D.truncata,167897087,VNJQ01000510.1,1,4296,2.55871e-05,157764404,0.939649
D.truncata,167897087,VNJQ01000096.1,1,4295,2.55811e-05,157768699,0.939675
D.truncata,167897087,VNJQ01008177.1,1,4294,2.55752e-05,157772993,0.939701
D.truncata,167897087,VNJQ01000923.1,1,4293,2.55692e-05,157777286,0.939726
D.truncata,167897087,VNJQ01003945.1,1,4288,2.55395e-05,157781574,0.939752
D.truncata,167897087,VNJQ01001189.1,1,4288,2.55395e-05,157785862,0.939777
D.truncata,167897087,VNJQ01006671.1,1,4285,2.55216e-05,157790147,0.939803
D.truncata,167897087,VNJQ01000647.1,1,4285,2.55216e-05,157794432,0.939828
D.truncata,167897087,VNJQ01005411.1,1,4283,2.55097e-05,157798715,0.939854
D.truncata,167897087,VNJQ01001300.1,1,4282,2.55037e-05,157802997,0.939879
D.truncata,167897087,VNJQ01000058.1,1,4282,2.55037e-05,157807279,0.939905
D.truncata,167897087,VNJQ01006455.1,1,4278,2.54799e-05,157811557,0.93993
D.truncata,167897087,VNJQ01003580.1,1,4274,2.54561e-05,157815831,0.939956
D.truncata,167897087,VNJQ01006450.1,1,4271,2.54382e-05,157820102,0.939981
D.truncata,167897087,VNJQ01004623.1,1,4270,2.54322e-05,157824372,0.940007
D.truncata,167897087,VNJQ01008017.1,1,4269,2.54263e-05,157828641,0.940032
D.truncata,167897087,VNJQ01004110.1,1,4269,2.54263e-05,157832910,0.940057
D.truncata,167897087,VNJQ01008161.1,1,4266,2.54084e-05,157837176,0.940083
D.truncata,167897087,VNJQ01005536.1,1,4266,2.54084e-05,157841442,0.940108
D.truncata,167897087,VNJQ01001729.1,1,4265,2.54025e-05,157845707,0.940134
D.truncata,167897087,VNJQ01001074.1,1,4263,2.53906e-05,157849970,0.940159
D.truncata,167897087,VNJQ01006059.1,1,4262,2.53846e-05,157854232,0.940184
D.truncata,167897087,VNJQ01006462.1,1,4260,2.53727e-05,157858492,0.94021
D.truncata,167897087,VNJQ01001017.1,1,4258,2.53608e-05,157862750,0.940235
D.truncata,167897087,VNJQ01002734.1,1,4257,2.53548e-05,157867007,0.940261
D.truncata,167897087,VNJQ01001395.1,1,4256,2.53489e-05,157871263,0.940286
D.truncata,167897087,VNJQ01003309.1,1,4255,2.53429e-05,157875518,0.940311
D.truncata,167897087,VNJQ01000537.1,1,4253,2.5331e-05,157879771,0.940337
D.truncata,167897087,VNJQ01000476.1,1,4250,2.53131e-05,157884021,0.940362
D.truncata,167897087,VNJQ01005902.1,1,4248,2.53012e-05,157888269,0.940387
D.truncata,167897087,VNJQ01002220.1,1,4248,2.53012e-05,157892517,0.940412
D.truncata,167897087,VNJQ01002123.1,1,4248,2.53012e-05,157896765,0.940438
D.truncata,167897087,VNJQ01000772.1,1,4248,2.53012e-05,157901013,0.940463
D.truncata,167897087,VNJQ01000289.1,1,4248,2.53012e-05,157905261,0.940488
D.truncata,167897087,VNJQ01003851.1,1,4245,2.52833e-05,157909506,0.940514
D.truncata,167897087,VNJQ01006248.1,1,4244,2.52774e-05,157913750,0.940539
D.truncata,167897087,VNJQ01006036.1,1,4244,2.52774e-05,157917994,0.940564
D.truncata,167897087,VNJQ01004158.1,1,4241,2.52595e-05,157922235,0.940589
D.truncata,167897087,VNJQ01007842.1,1,4238,2.52417e-05,157926473,0.940615
D.truncata,167897087,VNJQ01002520.1,1,4236,2.52297e-05,157930709,0.94064
D.truncata,167897087,VNJQ01004267.1,1,4232,2.52059e-05,157934941,0.940665
D.truncata,167897087,VNJQ01007790.1,1,4230,2.5194e-05,157939171,0.94069
D.truncata,167897087,VNJQ01007249.1,1,4229,2.5188e-05,157943400,0.940716
D.truncata,167897087,VNJQ01004287.1,1,4227,2.51761e-05,157947627,0.940741
D.truncata,167897087,VNJQ01002146.1,1,4223,2.51523e-05,157951850,0.940766
D.truncata,167897087,VNJQ01002267.1,1,4222,2.51464e-05,157956072,0.940791
D.truncata,167897087,VNJQ01008018.1,1,4219,2.51285e-05,157960291,0.940816
D.truncata,167897087,VNJQ01007489.1,1,4216,2.51106e-05,157964507,0.940841
D.truncata,167897087,VNJQ01002891.1,1,4212,2.50868e-05,157968719,0.940866
D.truncata,167897087,VNJQ01004105.1,1,4211,2.50808e-05,157972930,0.940891
D.truncata,167897087,VNJQ01001946.1,1,4211,2.50808e-05,157977141,0.940917
D.truncata,167897087,VNJQ01000897.1,1,4208,2.5063e-05,157981349,0.940942
D.truncata,167897087,VNJQ01001680.1,1,4207,2.5057e-05,157985556,0.940967
D.truncata,167897087,VNJQ01007046.1,1,4206,2.50511e-05,157989762,0.940992
D.truncata,167897087,VNJQ01002155.1,1,4205,2.50451e-05,157993967,0.941017
D.truncata,167897087,VNJQ01007892.1,1,4202,2.50272e-05,157998169,0.941042
D.truncata,167897087,VNJQ01004070.1,1,4200,2.50153e-05,158002369,0.941067
D.truncata,167897087,VNJQ01003905.1,1,4200,2.50153e-05,158006569,0.941092
D.truncata,167897087,VNJQ01002568.1,1,4200,2.50153e-05,158010769,0.941117
D.truncata,167897087,VNJQ01000230.1,1,4200,2.50153e-05,158014969,0.941142
D.truncata,167897087,VNJQ01002351.1,1,4199,2.50094e-05,158019168,0.941167
D.truncata,167897087,VNJQ01006174.1,1,4198,2.50034e-05,158023366,0.941192
D.truncata,167897087,VNJQ01003380.1,1,4197,2.49975e-05,158027563,0.941217
D.truncata,167897087,VNJQ01002109.1,1,4197,2.49975e-05,158031760,0.941242
D.truncata,167897087,VNJQ01007670.1,1,4195,2.49855e-05,158035955,0.941267
D.truncata,167897087,VNJQ01006317.1,1,4194,2.49796e-05,158040149,0.941292
D.truncata,167897087,VNJQ01006636.1,1,4193,2.49736e-05,158044342,0.941317
D.truncata,167897087,VNJQ01005414.1,1,4193,2.49736e-05,158048535,0.941342
D.truncata,167897087,VNJQ01002413.1,1,4192,2.49677e-05,158052727,0.941367
D.truncata,167897087,VNJQ01006465.1,1,4190,2.49558e-05,158056917,0.941392
D.truncata,167897087,VNJQ01002624.1,1,4189,2.49498e-05,158061106,0.941417
D.truncata,167897087,VNJQ01001286.1,1,4188,2.49439e-05,158065294,0.941442
D.truncata,167897087,VNJQ01005382.1,1,4182,2.49081e-05,158069476,0.941466
D.truncata,167897087,VNJQ01001457.1,1,4182,2.49081e-05,158073658,0.941491
D.truncata,167897087,VNJQ01006505.1,1,4181,2.49022e-05,158077839,0.941516
D.truncata,167897087,VNJQ01008150.1,1,4180,2.48962e-05,158082019,0.941541
D.truncata,167897087,VNJQ01002823.1,1,4179,2.48902e-05,158086198,0.941566
D.truncata,167897087,VNJQ01003718.1,1,4178,2.48843e-05,158090376,0.941591
D.truncata,167897087,VNJQ01007071.1,1,4177,2.48783e-05,158094553,0.941616
D.truncata,167897087,VNJQ01003280.1,1,4174,2.48605e-05,158098727,0.941641
D.truncata,167897087,VNJQ01008182.1,1,4173,2.48545e-05,158102900,0.941666
D.truncata,167897087,VNJQ01007833.1,1,4171,2.48426e-05,158107071,0.94169
D.truncata,167897087,VNJQ01004758.1,1,4170,2.48366e-05,158111241,0.941715
D.truncata,167897087,VNJQ01002099.1,1,4170,2.48366e-05,158115411,0.94174
D.truncata,167897087,VNJQ01000474.1,1,4170,2.48366e-05,158119581,0.941765
D.truncata,167897087,VNJQ01005281.1,1,4169,2.48307e-05,158123750,0.94179
D.truncata,167897087,VNJQ01001487.1,1,4165,2.48069e-05,158127915,0.941815
D.truncata,167897087,VNJQ01001334.1,1,4165,2.48069e-05,158132080,0.941839
D.truncata,167897087,VNJQ01001136.1,1,4165,2.48069e-05,158136245,0.941864
D.truncata,167897087,VNJQ01007732.1,1,4163,2.4795e-05,158140408,0.941889
D.truncata,167897087,VNJQ01006044.1,1,4163,2.4795e-05,158144571,0.941914
D.truncata,167897087,VNJQ01006802.1,1,4162,2.4789e-05,158148733,0.941939
D.truncata,167897087,VNJQ01006171.1,1,4162,2.4789e-05,158152895,0.941963
D.truncata,167897087,VNJQ01005454.1,1,4157,2.47592e-05,158157052,0.941988
D.truncata,167897087,VNJQ01005458.1,1,4155,2.47473e-05,158161207,0.942013
D.truncata,167897087,VNJQ01005173.1,1,4155,2.47473e-05,158165362,0.942038
D.truncata,167897087,VNJQ01002575.1,1,4153,2.47354e-05,158169515,0.942062
D.truncata,167897087,VNJQ01003866.1,1,4152,2.47294e-05,158173667,0.942087
D.truncata,167897087,VNJQ01001233.1,1,4152,2.47294e-05,158177819,0.942112
D.truncata,167897087,VNJQ01006521.1,1,4150,2.47175e-05,158181969,0.942136
D.truncata,167897087,VNJQ01002882.1,1,4143,2.46758e-05,158186112,0.942161
D.truncata,167897087,VNJQ01004422.1,1,4140,2.4658e-05,158190252,0.942186
D.truncata,167897087,VNJQ01002122.1,1,4139,2.4652e-05,158194391,0.94221
D.truncata,167897087,VNJQ01007962.1,1,4137,2.46401e-05,158198528,0.942235
D.truncata,167897087,VNJQ01001397.1,1,4136,2.46341e-05,158202664,0.94226
D.truncata,167897087,VNJQ01006775.1,1,4135,2.46282e-05,158206799,0.942284
D.truncata,167897087,VNJQ01000161.1,1,4135,2.46282e-05,158210934,0.942309
D.truncata,167897087,VNJQ01005816.1,1,4134,2.46222e-05,158215068,0.942334
D.truncata,167897087,VNJQ01005373.1,1,4131,2.46044e-05,158219199,0.942358
D.truncata,167897087,VNJQ01007693.1,1,4130,2.45984e-05,158223329,0.942383
D.truncata,167897087,VNJQ01007449.1,1,4130,2.45984e-05,158227459,0.942407
D.truncata,167897087,VNJQ01003764.1,1,4129,2.45924e-05,158231588,0.942432
D.truncata,167897087,VNJQ01007881.1,1,4128,2.45865e-05,158235716,0.942457
D.truncata,167897087,VNJQ01006584.1,1,4126,2.45746e-05,158239842,0.942481
D.truncata,167897087,VNJQ01001935.1,1,4124,2.45627e-05,158243966,0.942506
D.truncata,167897087,VNJQ01008057.1,1,4122,2.45508e-05,158248088,0.94253
D.truncata,167897087,VNJQ01006813.1,1,4117,2.4521e-05,158252205,0.942555
D.truncata,167897087,VNJQ01000011.1,1,4116,2.4515e-05,158256321,0.942579
D.truncata,167897087,VNJQ01002915.1,1,4111,2.44852e-05,158260432,0.942604
D.truncata,167897087,VNJQ01007590.1,1,4109,2.44733e-05,158264541,0.942628
D.truncata,167897087,VNJQ01003181.1,1,4108,2.44674e-05,158268649,0.942653
D.truncata,167897087,VNJQ01005795.1,1,4103,2.44376e-05,158272752,0.942677
D.truncata,167897087,VNJQ01005572.1,1,4103,2.44376e-05,158276855,0.942702
D.truncata,167897087,VNJQ01004720.1,1,4100,2.44197e-05,158280955,0.942726
D.truncata,167897087,VNJQ01007288.1,1,4099,2.44138e-05,158285054,0.94275
D.truncata,167897087,VNJQ01002183.1,1,4099,2.44138e-05,158289153,0.942775
D.truncata,167897087,VNJQ01000101.1,1,4097,2.44019e-05,158293250,0.942799
D.truncata,167897087,VNJQ01000558.1,1,4095,2.43899e-05,158297345,0.942824
D.truncata,167897087,VNJQ01007548.1,1,4091,2.43661e-05,158301436,0.942848
D.truncata,167897087,VNJQ01003487.1,1,4088,2.43482e-05,158305524,0.942872
D.truncata,167897087,VNJQ01006954.1,1,4087,2.43423e-05,158309611,0.942897
D.truncata,167897087,VNJQ01003005.1,1,4087,2.43423e-05,158313698,0.942921
D.truncata,167897087,VNJQ01002186.1,1,4087,2.43423e-05,158317785,0.942945
D.truncata,167897087,VNJQ01007457.1,1,4085,2.43304e-05,158321870,0.94297
D.truncata,167897087,VNJQ01002722.1,1,4085,2.43304e-05,158325955,0.942994
D.truncata,167897087,VNJQ01006236.1,1,4084,2.43244e-05,158330039,0.943018
D.truncata,167897087,VNJQ01006065.1,1,4084,2.43244e-05,158334123,0.943043
D.truncata,167897087,VNJQ01005383.1,1,4084,2.43244e-05,158338207,0.943067
D.truncata,167897087,VNJQ01004690.1,1,4083,2.43185e-05,158342290,0.943091
D.truncata,167897087,VNJQ01001138.1,1,4083,2.43185e-05,158346373,0.943116
D.truncata,167897087,VNJQ01002726.1,1,4082,2.43125e-05,158350455,0.94314
D.truncata,167897087,VNJQ01005520.1,1,4079,2.42946e-05,158354534,0.943164
D.truncata,167897087,VNJQ01003176.1,1,4078,2.42887e-05,158358612,0.943189
D.truncata,167897087,VNJQ01006244.1,1,4076,2.42768e-05,158362688,0.943213
D.truncata,167897087,VNJQ01001529.1,1,4073,2.42589e-05,158366761,0.943237
D.truncata,167897087,VNJQ01006742.1,1,4072,2.4253e-05,158370833,0.943261
D.truncata,167897087,VNJQ01002040.1,1,4072,2.4253e-05,158374905,0.943286
D.truncata,167897087,VNJQ01004842.1,1,4071,2.4247e-05,158378976,0.94331
D.truncata,167897087,VNJQ01003219.1,1,4071,2.4247e-05,158383047,0.943334
D.truncata,167897087,VNJQ01001746.1,1,4071,2.4247e-05,158387118,0.943358
D.truncata,167897087,VNJQ01007114.1,1,4070,2.4241e-05,158391188,0.943383
D.truncata,167897087,VNJQ01003174.1,1,4068,2.42291e-05,158395256,0.943407
D.truncata,167897087,VNJQ01000076.1,1,4066,2.42172e-05,158399322,0.943431
D.truncata,167897087,VNJQ01001816.1,1,4064,2.42053e-05,158403386,0.943455
D.truncata,167897087,VNJQ01003168.1,1,4063,2.41993e-05,158407449,0.943479
D.truncata,167897087,VNJQ01002803.1,1,4063,2.41993e-05,158411512,0.943504
D.truncata,167897087,VNJQ01001690.1,1,4062,2.41934e-05,158415574,0.943528
D.truncata,167897087,VNJQ01006735.1,1,4061,2.41874e-05,158419635,0.943552
D.truncata,167897087,VNJQ01005401.1,1,4060,2.41815e-05,158423695,0.943576
D.truncata,167897087,VNJQ01005484.1,1,4059,2.41755e-05,158427754,0.9436
D.truncata,167897087,VNJQ01008128.1,1,4058,2.41696e-05,158431812,0.943625
D.truncata,167897087,VNJQ01005745.1,1,4057,2.41636e-05,158435869,0.943649
D.truncata,167897087,VNJQ01004959.1,1,4055,2.41517e-05,158439924,0.943673
D.truncata,167897087,VNJQ01001697.1,1,4053,2.41398e-05,158443977,0.943697
D.truncata,167897087,VNJQ01007153.1,1,4048,2.411e-05,158448025,0.943721
D.truncata,167897087,VNJQ01007232.1,1,4047,2.41041e-05,158452072,0.943745
D.truncata,167897087,VNJQ01004439.1,1,4047,2.41041e-05,158456119,0.943769
D.truncata,167897087,VNJQ01002308.1,1,4046,2.40981e-05,158460165,0.943793
D.truncata,167897087,VNJQ01006537.1,1,4043,2.40802e-05,158464208,0.943817
D.truncata,167897087,VNJQ01002426.1,1,4043,2.40802e-05,158468251,0.943842
D.truncata,167897087,VNJQ01001404.1,1,4042,2.40743e-05,158472293,0.943866
D.truncata,167897087,VNJQ01005482.1,1,4039,2.40564e-05,158476332,0.94389
D.truncata,167897087,VNJQ01007020.1,1,4038,2.40504e-05,158480370,0.943914
D.truncata,167897087,VNJQ01004804.1,1,4037,2.40445e-05,158484407,0.943938
D.truncata,167897087,VNJQ01002688.1,1,4036,2.40385e-05,158488443,0.943962
D.truncata,167897087,VNJQ01004562.1,1,4034,2.40266e-05,158492477,0.943986
D.truncata,167897087,VNJQ01000721.1,1,4034,2.40266e-05,158496511,0.94401
D.truncata,167897087,VNJQ01004970.1,1,4033,2.40207e-05,158500544,0.944034
D.truncata,167897087,VNJQ01007751.1,1,4032,2.40147e-05,158504576,0.944058
D.truncata,167897087,VNJQ01005875.1,1,4032,2.40147e-05,158508608,0.944082
D.truncata,167897087,VNJQ01002698.1,1,4029,2.39968e-05,158512637,0.944106
D.truncata,167897087,VNJQ01004044.1,1,4028,2.39909e-05,158516665,0.94413
D.truncata,167897087,VNJQ01006851.1,1,4027,2.39849e-05,158520692,0.944154
D.truncata,167897087,VNJQ01003907.1,1,4025,2.3973e-05,158524717,0.944178
D.truncata,167897087,VNJQ01002638.1,1,4025,2.3973e-05,158528742,0.944202
D.truncata,167897087,VNJQ01007138.1,1,4024,2.39671e-05,158532766,0.944226
D.truncata,167897087,VNJQ01002792.1,1,4018,2.39313e-05,158536784,0.94425
D.truncata,167897087,VNJQ01007396.1,1,4017,2.39254e-05,158540801,0.944274
D.truncata,167897087,VNJQ01003035.1,1,4017,2.39254e-05,158544818,0.944298
D.truncata,167897087,VNJQ01003684.1,1,4016,2.39194e-05,158548834,0.944322
D.truncata,167897087,VNJQ01007568.1,1,4013,2.39015e-05,158552847,0.944345
D.truncata,167897087,VNJQ01005140.1,1,4012,2.38956e-05,158556859,0.944369
D.truncata,167897087,VNJQ01001497.1,1,4012,2.38956e-05,158560871,0.944393
D.truncata,167897087,VNJQ01004383.1,1,4011,2.38896e-05,158564882,0.944417
D.truncata,167897087,VNJQ01002662.1,1,4011,2.38896e-05,158568893,0.944441
D.truncata,167897087,VNJQ01008029.1,1,4007,2.38658e-05,158572900,0.944465
D.truncata,167897087,VNJQ01003379.1,1,4007,2.38658e-05,158576907,0.944489
D.truncata,167897087,VNJQ01002820.1,1,4004,2.38479e-05,158580911,0.944513
D.truncata,167897087,VNJQ01007678.1,1,4003,2.3842e-05,158584914,0.944536
D.truncata,167897087,VNJQ01005921.1,1,4003,2.3842e-05,158588917,0.94456
D.truncata,167897087,VNJQ01004459.1,1,4001,2.38301e-05,158592918,0.944584
D.truncata,167897087,VNJQ01003518.1,1,4001,2.38301e-05,158596919,0.944608
D.truncata,167897087,VNJQ01000784.1,1,4001,2.38301e-05,158600920,0.944632
D.truncata,167897087,VNJQ01004904.1,1,4000,2.38241e-05,158604920,0.944656
D.truncata,167897087,VNJQ01003369.1,1,3997,2.38062e-05,158608917,0.944679
D.truncata,167897087,VNJQ01007233.1,1,3995,2.37943e-05,158612912,0.944703
D.truncata,167897087,VNJQ01005195.1,1,3995,2.37943e-05,158616907,0.944727
D.truncata,167897087,VNJQ01002305.1,1,3994,2.37884e-05,158620901,0.944751
D.truncata,167897087,VNJQ01007703.1,1,3991,2.37705e-05,158624892,0.944775
D.truncata,167897087,VNJQ01005801.1,1,3990,2.37646e-05,158628882,0.944798
D.truncata,167897087,VNJQ01001430.1,1,3990,2.37646e-05,158632872,0.944822
D.truncata,167897087,VNJQ01004527.1,1,3988,2.37526e-05,158636860,0.944846
D.truncata,167897087,VNJQ01007791.1,1,3986,2.37407e-05,158640846,0.94487
D.truncata,167897087,VNJQ01005497.1,1,3986,2.37407e-05,158644832,0.944893
D.truncata,167897087,VNJQ01000737.1,1,3983,2.37229e-05,158648815,0.944917
D.truncata,167897087,VNJQ01000421.1,1,3979,2.3699e-05,158652794,0.944941
D.truncata,167897087,VNJQ01005391.1,1,3978,2.36931e-05,158656772,0.944964
D.truncata,167897087,VNJQ01002493.1,1,3978,2.36931e-05,158660750,0.944988
D.truncata,167897087,VNJQ01002167.1,1,3976,2.36812e-05,158664726,0.945012
D.truncata,167897087,VNJQ01004820.1,1,3973,2.36633e-05,158668699,0.945035
D.truncata,167897087,VNJQ01003154.1,1,3971,2.36514e-05,158672670,0.945059
D.truncata,167897087,VNJQ01004269.1,1,3970,2.36454e-05,158676640,0.945083
D.truncata,167897087,VNJQ01002917.1,1,3970,2.36454e-05,158680610,0.945106
D.truncata,167897087,VNJQ01006471.1,1,3969,2.36395e-05,158684579,0.94513
D.truncata,167897087,VNJQ01000680.1,1,3969,2.36395e-05,158688548,0.945154
D.truncata,167897087,VNJQ01007855.1,1,3966,2.36216e-05,158692514,0.945177
D.truncata,167897087,VNJQ01001862.1,1,3966,2.36216e-05,158696480,0.945201
D.truncata,167897087,VNJQ01006897.1,1,3963,2.36037e-05,158700443,0.945225
D.truncata,167897087,VNJQ01000044.1,1,3963,2.36037e-05,158704406,0.945248
D.truncata,167897087,VNJQ01003355.1,1,3960,2.35859e-05,158708366,0.945272
D.truncata,167897087,VNJQ01002605.1,1,3960,2.35859e-05,158712326,0.945295
D.truncata,167897087,VNJQ01005914.1,1,3957,2.3568e-05,158716283,0.945319
D.truncata,167897087,VNJQ01001745.1,1,3955,2.35561e-05,158720238,0.945342
D.truncata,167897087,VNJQ01001689.1,1,3951,2.35323e-05,158724189,0.945366
D.truncata,167897087,VNJQ01000822.1,1,3947,2.35084e-05,158728136,0.945389
D.truncata,167897087,VNJQ01006700.1,1,3943,2.34846e-05,158732079,0.945413
D.truncata,167897087,VNJQ01006565.1,1,3943,2.34846e-05,158736022,0.945436
D.truncata,167897087,VNJQ01003781.1,1,3942,2.34787e-05,158739964,0.94546
D.truncata,167897087,VNJQ01007291.1,1,3940,2.34668e-05,158743904,0.945483
D.truncata,167897087,VNJQ01004030.1,1,3940,2.34668e-05,158747844,0.945507
D.truncata,167897087,VNJQ01002323.1,1,3940,2.34668e-05,158751784,0.94553
D.truncata,167897087,VNJQ01007453.1,1,3937,2.34489e-05,158755721,0.945554
D.truncata,167897087,VNJQ01001636.1,1,3935,2.3437e-05,158759656,0.945577
D.truncata,167897087,VNJQ01000829.1,1,3933,2.34251e-05,158763589,0.945601
D.truncata,167897087,VNJQ01001287.1,1,3932,2.34191e-05,158767521,0.945624
D.truncata,167897087,VNJQ01001738.1,1,3931,2.34132e-05,158771452,0.945647
D.truncata,167897087,VNJQ01005842.1,1,3926,2.33834e-05,158775378,0.945671
D.truncata,167897087,VNJQ01004761.1,1,3926,2.33834e-05,158779304,0.945694
D.truncata,167897087,VNJQ01004451.1,1,3925,2.33774e-05,158783229,0.945718
D.truncata,167897087,VNJQ01005117.1,1,3923,2.33655e-05,158787152,0.945741
D.truncata,167897087,VNJQ01001753.1,1,3922,2.33595e-05,158791074,0.945764
D.truncata,167897087,VNJQ01000329.1,1,3922,2.33595e-05,158794996,0.945788
D.truncata,167897087,VNJQ01001429.1,1,3921,2.33536e-05,158798917,0.945811
D.truncata,167897087,VNJQ01004980.1,1,3918,2.33357e-05,158802835,0.945834
D.truncata,167897087,VNJQ01005199.1,1,3917,2.33298e-05,158806752,0.945858
D.truncata,167897087,VNJQ01003076.1,1,3916,2.33238e-05,158810668,0.945881
D.truncata,167897087,VNJQ01004139.1,1,3914,2.33119e-05,158814582,0.945904
D.truncata,167897087,VNJQ01000070.1,1,3914,2.33119e-05,158818496,0.945928
D.truncata,167897087,VNJQ01005802.1,1,3913,2.33059e-05,158822409,0.945951
D.truncata,167897087,VNJQ01002541.1,1,3912,2.33e-05,158826321,0.945974
D.truncata,167897087,VNJQ01000532.1,1,3912,2.33e-05,158830233,0.945998
D.truncata,167897087,VNJQ01005171.1,1,3911,2.3294e-05,158834144,0.946021
D.truncata,167897087,VNJQ01005511.1,1,3907,2.32702e-05,158838051,0.946044
D.truncata,167897087,VNJQ01003691.1,1,3907,2.32702e-05,158841958,0.946067
D.truncata,167897087,VNJQ01007164.1,1,3904,2.32523e-05,158845862,0.946091
D.truncata,167897087,VNJQ01004777.1,1,3903,2.32464e-05,158849765,0.946114
D.truncata,167897087,VNJQ01003072.1,1,3903,2.32464e-05,158853668,0.946137
D.truncata,167897087,VNJQ01000856.1,1,3903,2.32464e-05,158857571,0.94616
D.truncata,167897087,VNJQ01005193.1,1,3900,2.32285e-05,158861471,0.946184
D.truncata,167897087,VNJQ01001941.1,1,3899,2.32226e-05,158865370,0.946207
D.truncata,167897087,VNJQ01002748.1,1,3897,2.32106e-05,158869267,0.94623
D.truncata,167897087,VNJQ01000391.1,1,3897,2.32106e-05,158873164,0.946253
D.truncata,167897087,VNJQ01001698.1,1,3896,2.32047e-05,158877060,0.946276
D.truncata,167897087,VNJQ01005325.1,1,3894,2.31928e-05,158880954,0.9463
D.truncata,167897087,VNJQ01003889.1,1,3891,2.31749e-05,158884845,0.946323
D.truncata,167897087,VNJQ01005488.1,1,3889,2.3163e-05,158888734,0.946346
D.truncata,167897087,VNJQ01004363.1,1,3889,2.3163e-05,158892623,0.946369
D.truncata,167897087,VNJQ01003641.1,1,3889,2.3163e-05,158896512,0.946392
D.truncata,167897087,VNJQ01007498.1,1,3888,2.3157e-05,158900400,0.946415
D.truncata,167897087,VNJQ01006757.1,1,3887,2.31511e-05,158904287,0.946439
D.truncata,167897087,VNJQ01001418.1,1,3886,2.31451e-05,158908173,0.946462
D.truncata,167897087,VNJQ01004785.1,1,3885,2.31392e-05,158912058,0.946485
D.truncata,167897087,VNJQ01003623.1,1,3884,2.31332e-05,158915942,0.946508
D.truncata,167897087,VNJQ01000006.1,1,3884,2.31332e-05,158919826,0.946531
D.truncata,167897087,VNJQ01002364.1,1,3883,2.31273e-05,158923709,0.946554
D.truncata,167897087,VNJQ01006573.1,1,3882,2.31213e-05,158927591,0.946577
D.truncata,167897087,VNJQ01001358.1,1,3881,2.31154e-05,158931472,0.946601
D.truncata,167897087,VNJQ01008122.1,1,3879,2.31034e-05,158935351,0.946624
D.truncata,167897087,VNJQ01000917.1,1,3878,2.30975e-05,158939229,0.946647
D.truncata,167897087,VNJQ01005513.1,1,3873,2.30677e-05,158943102,0.94667
D.truncata,167897087,VNJQ01000216.1,1,3873,2.30677e-05,158946975,0.946693
D.truncata,167897087,VNJQ01007485.1,1,3872,2.30617e-05,158950847,0.946716
D.truncata,167897087,VNJQ01004564.1,1,3871,2.30558e-05,158954718,0.946739
D.truncata,167897087,VNJQ01006818.1,1,3869,2.30439e-05,158958587,0.946762
D.truncata,167897087,VNJQ01007622.1,1,3868,2.30379e-05,158962455,0.946785
D.truncata,167897087,VNJQ01003666.1,1,3866,2.3026e-05,158966321,0.946808
D.truncata,167897087,VNJQ01007553.1,1,3865,2.30201e-05,158970186,0.946831
D.truncata,167897087,VNJQ01003479.1,1,3865,2.30201e-05,158974051,0.946854
D.truncata,167897087,VNJQ01001872.1,1,3862,2.30022e-05,158977913,0.946877
D.truncata,167897087,VNJQ01006255.1,1,3861,2.29962e-05,158981774,0.9469
D.truncata,167897087,VNJQ01005172.1,1,3859,2.29843e-05,158985633,0.946923
D.truncata,167897087,VNJQ01002484.1,1,3858,2.29784e-05,158989491,0.946946
D.truncata,167897087,VNJQ01002075.1,1,3858,2.29784e-05,158993349,0.946969
D.truncata,167897087,VNJQ01008149.1,1,3857,2.29724e-05,158997206,0.946992
D.truncata,167897087,VNJQ01001083.1,1,3857,2.29724e-05,159001063,0.947015
D.truncata,167897087,VNJQ01003211.1,1,3855,2.29605e-05,159004918,0.947038
D.truncata,167897087,VNJQ01002946.1,1,3854,2.29545e-05,159008772,0.947061
D.truncata,167897087,VNJQ01003969.1,1,3853,2.29486e-05,159012625,0.947084
D.truncata,167897087,VNJQ01006883.1,1,3852,2.29426e-05,159016477,0.947107
D.truncata,167897087,VNJQ01004621.1,1,3851,2.29367e-05,159020328,0.94713
D.truncata,167897087,VNJQ01004911.1,1,3850,2.29307e-05,159024178,0.947153
D.truncata,167897087,VNJQ01004691.1,1,3847,2.29128e-05,159028025,0.947176
D.truncata,167897087,VNJQ01002854.1,1,3847,2.29128e-05,159031872,0.947199
D.truncata,167897087,VNJQ01000538.1,1,3847,2.29128e-05,159035719,0.947221
D.truncata,167897087,VNJQ01005222.1,1,3846,2.29069e-05,159039565,0.947244
D.truncata,167897087,VNJQ01005528.1,1,3845,2.29009e-05,159043410,0.947267
D.truncata,167897087,VNJQ01007663.1,1,3844,2.2895e-05,159047254,0.94729
D.truncata,167897087,VNJQ01006919.1,1,3844,2.2895e-05,159051098,0.947313
D.truncata,167897087,VNJQ01003412.1,1,3842,2.28831e-05,159054940,0.947336
D.truncata,167897087,VNJQ01005214.1,1,3841,2.28771e-05,159058781,0.947359
D.truncata,167897087,VNJQ01004135.1,1,3835,2.28414e-05,159062616,0.947382
D.truncata,167897087,VNJQ01007604.1,1,3834,2.28354e-05,159066450,0.947404
D.truncata,167897087,VNJQ01004310.1,1,3833,2.28295e-05,159070283,0.947427
D.truncata,167897087,VNJQ01003193.1,1,3832,2.28235e-05,159074115,0.94745
D.truncata,167897087,VNJQ01006570.1,1,3831,2.28175e-05,159077946,0.947473
D.truncata,167897087,VNJQ01000609.1,1,3830,2.28116e-05,159081776,0.947496
D.truncata,167897087,VNJQ01000093.1,1,3828,2.27997e-05,159085604,0.947519
D.truncata,167897087,VNJQ01006213.1,1,3827,2.27937e-05,159089431,0.947541
D.truncata,167897087,VNJQ01005026.1,1,3820,2.2752e-05,159093251,0.947564
D.truncata,167897087,VNJQ01004816.1,1,3820,2.2752e-05,159097071,0.947587
D.truncata,167897087,VNJQ01004613.1,1,3819,2.27461e-05,159100890,0.94761
D.truncata,167897087,VNJQ01003464.1,1,3817,2.27342e-05,159104707,0.947632
D.truncata,167897087,VNJQ01007635.1,1,3816,2.27282e-05,159108523,0.947655
D.truncata,167897087,VNJQ01000297.1,1,3816,2.27282e-05,159112339,0.947678
D.truncata,167897087,VNJQ01002797.1,1,3815,2.27223e-05,159116154,0.947701
D.truncata,167897087,VNJQ01005612.1,1,3812,2.27044e-05,159119966,0.947723
D.truncata,167897087,VNJQ01002299.1,1,3812,2.27044e-05,159123778,0.947746
D.truncata,167897087,VNJQ01007680.1,1,3811,2.26984e-05,159127589,0.947769
D.truncata,167897087,VNJQ01004032.1,1,3811,2.26984e-05,159131400,0.947791
D.truncata,167897087,VNJQ01000246.1,1,3811,2.26984e-05,159135211,0.947814
D.truncata,167897087,VNJQ01006555.1,1,3809,2.26865e-05,159139020,0.947837
D.truncata,167897087,VNJQ01000074.1,1,3809,2.26865e-05,159142829,0.947859
D.truncata,167897087,VNJQ01002901.1,1,3806,2.26686e-05,159146635,0.947882
D.truncata,167897087,VNJQ01001109.1,1,3806,2.26686e-05,159150441,0.947905
D.truncata,167897087,VNJQ01003470.1,1,3804,2.26567e-05,159154245,0.947927
D.truncata,167897087,VNJQ01000143.1,1,3804,2.26567e-05,159158049,0.94795
D.truncata,167897087,VNJQ01002253.1,1,3803,2.26508e-05,159161852,0.947973
D.truncata,167897087,VNJQ01003183.1,1,3801,2.26389e-05,159165653,0.947995
D.truncata,167897087,VNJQ01006043.1,1,3800,2.26329e-05,159169453,0.948018
D.truncata,167897087,VNJQ01005652.1,1,3800,2.26329e-05,159173253,0.948041
D.truncata,167897087,VNJQ01005357.1,1,3800,2.26329e-05,159177053,0.948063
D.truncata,167897087,VNJQ01008070.1,1,3799,2.2627e-05,159180852,0.948086
D.truncata,167897087,VNJQ01005759.1,1,3799,2.2627e-05,159184651,0.948108
D.truncata,167897087,VNJQ01003665.1,1,3799,2.2627e-05,159188450,0.948131
D.truncata,167897087,VNJQ01004910.1,1,3794,2.25972e-05,159192244,0.948154
D.truncata,167897087,VNJQ01003647.1,1,3790,2.25734e-05,159196034,0.948176
D.truncata,167897087,VNJQ01005385.1,1,3787,2.25555e-05,159199821,0.948199
D.truncata,167897087,VNJQ01001801.1,1,3787,2.25555e-05,159203608,0.948221
D.truncata,167897087,VNJQ01000337.1,1,3786,2.25495e-05,159207394,0.948244
D.truncata,167897087,VNJQ01005705.1,1,3784,2.25376e-05,159211178,0.948266
D.truncata,167897087,VNJQ01004802.1,1,3781,2.25197e-05,159214959,0.948289
D.truncata,167897087,VNJQ01008159.1,1,3780,2.25138e-05,159218739,0.948312
D.truncata,167897087,VNJQ01002144.1,1,3778,2.25019e-05,159222517,0.948334
D.truncata,167897087,VNJQ01007923.1,1,3774,2.24781e-05,159226291,0.948356
D.truncata,167897087,VNJQ01004853.1,1,3774,2.24781e-05,159230065,0.948379
D.truncata,167897087,VNJQ01004797.1,1,3773,2.24721e-05,159233838,0.948401
D.truncata,167897087,VNJQ01004232.1,1,3770,2.24542e-05,159237608,0.948424
D.truncata,167897087,VNJQ01006629.1,1,3769,2.24483e-05,159241377,0.948446
D.truncata,167897087,VNJQ01000173.1,1,3768,2.24423e-05,159245145,0.948469
D.truncata,167897087,VNJQ01001274.1,1,3766,2.24304e-05,159248911,0.948491
D.truncata,167897087,VNJQ01006290.1,1,3763,2.24125e-05,159252674,0.948514
D.truncata,167897087,VNJQ01001635.1,1,3762,2.24066e-05,159256436,0.948536
D.truncata,167897087,VNJQ01004405.1,1,3757,2.23768e-05,159260193,0.948558
D.truncata,167897087,VNJQ01007578.1,1,3756,2.23708e-05,159263949,0.948581
D.truncata,167897087,VNJQ01001147.1,1,3756,2.23708e-05,159267705,0.948603
D.truncata,167897087,VNJQ01000513.1,1,3754,2.23589e-05,159271459,0.948626
D.truncata,167897087,VNJQ01002273.1,1,3752,2.2347e-05,159275211,0.948648
D.truncata,167897087,VNJQ01001860.1,1,3752,2.2347e-05,159278963,0.94867
D.truncata,167897087,VNJQ01007999.1,1,3749,2.23292e-05,159282712,0.948693
D.truncata,167897087,VNJQ01007010.1,1,3749,2.23292e-05,159286461,0.948715
D.truncata,167897087,VNJQ01006243.1,1,3749,2.23292e-05,159290210,0.948737
D.truncata,167897087,VNJQ01004029.1,1,3748,2.23232e-05,159293958,0.94876
D.truncata,167897087,VNJQ01003770.1,1,3747,2.23172e-05,159297705,0.948782
D.truncata,167897087,VNJQ01004138.1,1,3741,2.22815e-05,159301446,0.948804
D.truncata,167897087,VNJQ01001471.1,1,3741,2.22815e-05,159305187,0.948826
D.truncata,167897087,VNJQ01005911.1,1,3739,2.22696e-05,159308926,0.948849
D.truncata,167897087,VNJQ01002164.1,1,3734,2.22398e-05,159312660,0.948871
D.truncata,167897087,VNJQ01007349.1,1,3732,2.22279e-05,159316392,0.948893
D.truncata,167897087,VNJQ01007149.1,1,3730,2.2216e-05,159320122,0.948915
D.truncata,167897087,VNJQ01002020.1,1,3730,2.2216e-05,159323852,0.948938
D.truncata,167897087,VNJQ01000998.1,1,3730,2.2216e-05,159327582,0.94896
D.truncata,167897087,VNJQ01000875.1,1,3730,2.2216e-05,159331312,0.948982
D.truncata,167897087,VNJQ01006879.1,1,3729,2.221e-05,159335041,0.949004
D.truncata,167897087,VNJQ01004555.1,1,3729,2.221e-05,159338770,0.949026
D.truncata,167897087,VNJQ01001182.1,1,3729,2.221e-05,159342499,0.949049
D.truncata,167897087,VNJQ01005744.1,1,3727,2.21981e-05,159346226,0.949071
D.truncata,167897087,VNJQ01007926.1,1,3726,2.21922e-05,159349952,0.949093
D.truncata,167897087,VNJQ01001567.1,1,3724,2.21803e-05,159353676,0.949115
D.truncata,167897087,VNJQ01002166.1,1,3723,2.21743e-05,159357399,0.949137
D.truncata,167897087,VNJQ01001523.1,1,3722,2.21683e-05,159361121,0.94916
D.truncata,167897087,VNJQ01000462.1,1,3721,2.21624e-05,159364842,0.949182
D.truncata,167897087,VNJQ01003565.1,1,3720,2.21564e-05,159368562,0.949204
D.truncata,167897087,VNJQ01005909.1,1,3712,2.21088e-05,159372274,0.949226
D.truncata,167897087,VNJQ01003267.1,1,3711,2.21028e-05,159375985,0.949248
D.truncata,167897087,VNJQ01002535.1,1,3710,2.20969e-05,159379695,0.94927
D.truncata,167897087,VNJQ01004582.1,1,3709,2.20909e-05,159383404,0.949292
D.truncata,167897087,VNJQ01003341.1,1,3709,2.20909e-05,159387113,0.949314
D.truncata,167897087,VNJQ01004295.1,1,3708,2.2085e-05,159390821,0.949336
D.truncata,167897087,VNJQ01000469.1,1,3708,2.2085e-05,159394529,0.949359
D.truncata,167897087,VNJQ01005534.1,1,3704,2.20611e-05,159398233,0.949381
D.truncata,167897087,VNJQ01001315.1,1,3703,2.20552e-05,159401936,0.949403
D.truncata,167897087,VNJQ01007954.1,1,3702,2.20492e-05,159405638,0.949425
D.truncata,167897087,VNJQ01005992.1,1,3701,2.20433e-05,159409339,0.949447
D.truncata,167897087,VNJQ01007021.1,1,3700,2.20373e-05,159413039,0.949469
D.truncata,167897087,VNJQ01007747.1,1,3698,2.20254e-05,159416737,0.949491
D.truncata,167897087,VNJQ01000288.1,1,3698,2.20254e-05,159420435,0.949513
D.truncata,167897087,VNJQ01001217.1,1,3696,2.20135e-05,159424131,0.949535
D.truncata,167897087,VNJQ01007681.1,1,3693,2.19956e-05,159427824,0.949557
D.truncata,167897087,VNJQ01006153.1,1,3685,2.1948e-05,159431509,0.949579
D.truncata,167897087,VNJQ01002778.1,1,3684,2.1942e-05,159435193,0.949601
D.truncata,167897087,VNJQ01001726.1,1,3684,2.1942e-05,159438877,0.949623
D.truncata,167897087,VNJQ01003093.1,1,3683,2.19361e-05,159442560,0.949645
D.truncata,167897087,VNJQ01002970.1,1,3683,2.19361e-05,159446243,0.949667
D.truncata,167897087,VNJQ01000071.1,1,3682,2.19301e-05,159449925,0.949688
D.truncata,167897087,VNJQ01000957.1,1,3681,2.19241e-05,159453606,0.94971
D.truncata,167897087,VNJQ01002622.1,1,3677,2.19003e-05,159457283,0.949732
D.truncata,167897087,VNJQ01003415.1,1,3676,2.18944e-05,159460959,0.949754
D.truncata,167897087,VNJQ01000954.1,1,3675,2.18884e-05,159464634,0.949776
D.truncata,167897087,VNJQ01007464.1,1,3674,2.18825e-05,159468308,0.949798
D.truncata,167897087,VNJQ01003675.1,1,3674,2.18825e-05,159471982,0.94982
D.truncata,167897087,VNJQ01002944.1,1,3673,2.18765e-05,159475655,0.949842
D.truncata,167897087,VNJQ01000654.1,1,3672,2.18705e-05,159479327,0.949864
D.truncata,167897087,VNJQ01005142.1,1,3670,2.18586e-05,159482997,0.949885
D.truncata,167897087,VNJQ01000561.1,1,3669,2.18527e-05,159486666,0.949907
D.truncata,167897087,VNJQ01002143.1,1,3668,2.18467e-05,159490334,0.949929
D.truncata,167897087,VNJQ01005539.1,1,3667,2.18408e-05,159494001,0.949951
D.truncata,167897087,VNJQ01005742.1,1,3666,2.18348e-05,159497667,0.949973
D.truncata,167897087,VNJQ01003155.1,1,3666,2.18348e-05,159501333,0.949995
D.truncata,167897087,VNJQ01001499.1,1,3663,2.18169e-05,159504996,0.950016
D.truncata,167897087,VNJQ01007858.1,1,3661,2.1805e-05,159508657,0.950038
D.truncata,167897087,VNJQ01001231.1,1,3661,2.1805e-05,159512318,0.95006
D.truncata,167897087,VNJQ01008090.1,1,3659,2.17931e-05,159515977,0.950082
D.truncata,167897087,VNJQ01006491.1,1,3659,2.17931e-05,159519636,0.950104
D.truncata,167897087,VNJQ01001957.1,1,3659,2.17931e-05,159523295,0.950125
D.truncata,167897087,VNJQ01001553.1,1,3657,2.17812e-05,159526952,0.950147
D.truncata,167897087,VNJQ01006624.1,1,3656,2.17752e-05,159530608,0.950169
D.truncata,167897087,VNJQ01003381.1,1,3655,2.17693e-05,159534263,0.950191
D.truncata,167897087,VNJQ01004488.1,1,3654,2.17633e-05,159537917,0.950213
D.truncata,167897087,VNJQ01001871.1,1,3654,2.17633e-05,159541571,0.950234
D.truncata,167897087,VNJQ01007933.1,1,3651,2.17455e-05,159545222,0.950256
D.truncata,167897087,VNJQ01000377.1,1,3651,2.17455e-05,159548873,0.950278
D.truncata,167897087,VNJQ01003300.1,1,3650,2.17395e-05,159552523,0.9503
D.truncata,167897087,VNJQ01006347.1,1,3647,2.17216e-05,159556170,0.950321
D.truncata,167897087,VNJQ01002050.1,1,3646,2.17157e-05,159559816,0.950343
D.truncata,167897087,VNJQ01003841.1,1,3644,2.17038e-05,159563460,0.950365
D.truncata,167897087,VNJQ01008062.1,1,3643,2.16978e-05,159567103,0.950386
D.truncata,167897087,VNJQ01001722.1,1,3643,2.16978e-05,159570746,0.950408
D.truncata,167897087,VNJQ01007601.1,1,3642,2.16919e-05,159574388,0.95043
D.truncata,167897087,VNJQ01001089.1,1,3642,2.16919e-05,159578030,0.950451
D.truncata,167897087,VNJQ01000840.1,1,3642,2.16919e-05,159581672,0.950473
D.truncata,167897087,VNJQ01006652.1,1,3638,2.1668e-05,159585310,0.950495
D.truncata,167897087,VNJQ01003761.1,1,3638,2.1668e-05,159588948,0.950516
D.truncata,167897087,VNJQ01006772.1,1,3637,2.16621e-05,159592585,0.950538
D.truncata,167897087,VNJQ01000751.1,1,3637,2.16621e-05,159596222,0.95056
D.truncata,167897087,VNJQ01002023.1,1,3636,2.16561e-05,159599858,0.950581
D.truncata,167897087,VNJQ01001451.1,1,3636,2.16561e-05,159603494,0.950603
D.truncata,167897087,VNJQ01001297.1,1,3636,2.16561e-05,159607130,0.950625
D.truncata,167897087,VNJQ01000439.1,1,3636,2.16561e-05,159610766,0.950646
D.truncata,167897087,VNJQ01006268.1,1,3633,2.16383e-05,159614399,0.950668
D.truncata,167897087,VNJQ01001152.1,1,3632,2.16323e-05,159618031,0.95069
D.truncata,167897087,VNJQ01002790.1,1,3631,2.16263e-05,159621662,0.950711
D.truncata,167897087,VNJQ01003642.1,1,3627,2.16025e-05,159625289,0.950733
D.truncata,167897087,VNJQ01001909.1,1,3627,2.16025e-05,159628916,0.950755
D.truncata,167897087,VNJQ01000120.1,1,3627,2.16025e-05,159632543,0.950776
D.truncata,167897087,VNJQ01005700.1,1,3626,2.15966e-05,159636169,0.950798
D.truncata,167897087,VNJQ01003848.1,1,3626,2.15966e-05,159639795,0.950819
D.truncata,167897087,VNJQ01001466.1,1,3626,2.15966e-05,159643421,0.950841
D.truncata,167897087,VNJQ01001832.1,1,3625,2.15906e-05,159647046,0.950863
D.truncata,167897087,VNJQ01001391.1,1,3624,2.15847e-05,159650670,0.950884
D.truncata,167897087,VNJQ01008050.1,1,3623,2.15787e-05,159654293,0.950906
D.truncata,167897087,VNJQ01004333.1,1,3622,2.15727e-05,159657915,0.950927
D.truncata,167897087,VNJQ01004378.1,1,3621,2.15668e-05,159661536,0.950949
D.truncata,167897087,VNJQ01003147.1,1,3621,2.15668e-05,159665157,0.95097
D.truncata,167897087,VNJQ01002027.1,1,3621,2.15668e-05,159668778,0.950992
D.truncata,167897087,VNJQ01004652.1,1,3618,2.15489e-05,159672396,0.951013
D.truncata,167897087,VNJQ01001724.1,1,3616,2.1537e-05,159676012,0.951035
D.truncata,167897087,VNJQ01000740.1,1,3616,2.1537e-05,159679628,0.951057
D.truncata,167897087,VNJQ01002187.1,1,3613,2.15191e-05,159683241,0.951078
D.truncata,167897087,VNJQ01001035.1,1,3612,2.15132e-05,159686853,0.9511
D.truncata,167897087,VNJQ01007036.1,1,3610,2.15013e-05,159690463,0.951121
D.truncata,167897087,VNJQ01005104.1,1,3608,2.14894e-05,159694071,0.951143
D.truncata,167897087,VNJQ01001433.1,1,3607,2.14834e-05,159697678,0.951164
D.truncata,167897087,VNJQ01007303.1,1,3606,2.14774e-05,159701284,0.951186
D.truncata,167897087,VNJQ01004096.1,1,3606,2.14774e-05,159704890,0.951207
D.truncata,167897087,VNJQ01006349.1,1,3605,2.14715e-05,159708495,0.951229
D.truncata,167897087,VNJQ01000851.1,1,3605,2.14715e-05,159712100,0.95125
D.truncata,167897087,VNJQ01003695.1,1,3604,2.14655e-05,159715704,0.951271
D.truncata,167897087,VNJQ01004722.1,1,3603,2.14596e-05,159719307,0.951293
D.truncata,167897087,VNJQ01002872.1,1,3602,2.14536e-05,159722909,0.951314
D.truncata,167897087,VNJQ01000234.1,1,3602,2.14536e-05,159726511,0.951336
D.truncata,167897087,VNJQ01003677.1,1,3600,2.14417e-05,159730111,0.951357
D.truncata,167897087,VNJQ01006844.1,1,3599,2.14358e-05,159733710,0.951379
D.truncata,167897087,VNJQ01008124.1,1,3598,2.14298e-05,159737308,0.9514
D.truncata,167897087,VNJQ01006823.1,1,3598,2.14298e-05,159740906,0.951422
D.truncata,167897087,VNJQ01005084.1,1,3596,2.14179e-05,159744502,0.951443
D.truncata,167897087,VNJQ01006132.1,1,3593,2.14e-05,159748095,0.951464
D.truncata,167897087,VNJQ01006399.1,1,3592,2.13941e-05,159751687,0.951486
D.truncata,167897087,VNJQ01006100.1,1,3589,2.13762e-05,159755276,0.951507
D.truncata,167897087,VNJQ01002487.1,1,3588,2.13702e-05,159758864,0.951529
D.truncata,167897087,VNJQ01001282.1,1,3586,2.13583e-05,159762450,0.95155
D.truncata,167897087,VNJQ01006557.1,1,3585,2.13524e-05,159766035,0.951571
D.truncata,167897087,VNJQ01004431.1,1,3585,2.13524e-05,159769620,0.951593
D.truncata,167897087,VNJQ01007355.1,1,3584,2.13464e-05,159773204,0.951614
D.truncata,167897087,VNJQ01005713.1,1,3584,2.13464e-05,159776788,0.951635
D.truncata,167897087,VNJQ01003173.1,1,3584,2.13464e-05,159780372,0.951657
D.truncata,167897087,VNJQ01002330.1,1,3584,2.13464e-05,159783956,0.951678
D.truncata,167897087,VNJQ01007675.1,1,3583,2.13405e-05,159787539,0.951699
D.truncata,167897087,VNJQ01006265.1,1,3583,2.13405e-05,159791122,0.951721
D.truncata,167897087,VNJQ01007761.1,1,3582,2.13345e-05,159794704,0.951742
D.truncata,167897087,VNJQ01005370.1,1,3581,2.13285e-05,159798285,0.951763
D.truncata,167897087,VNJQ01001278.1,1,3579,2.13166e-05,159801864,0.951785
D.truncata,167897087,VNJQ01003188.1,1,3578,2.13107e-05,159805442,0.951806
D.truncata,167897087,VNJQ01000445.1,1,3578,2.13107e-05,159809020,0.951827
D.truncata,167897087,VNJQ01005135.1,1,3577,2.13047e-05,159812597,0.951849
D.truncata,167897087,VNJQ01005316.1,1,3574,2.12868e-05,159816171,0.95187
D.truncata,167897087,VNJQ01004394.1,1,3573,2.12809e-05,159819744,0.951891
D.truncata,167897087,VNJQ01003373.1,1,3573,2.12809e-05,159823317,0.951912
D.truncata,167897087,VNJQ01003512.1,1,3572,2.12749e-05,159826889,0.951934
D.truncata,167897087,VNJQ01001211.1,1,3571,2.1269e-05,159830460,0.951955
D.truncata,167897087,VNJQ01000487.1,1,3571,2.1269e-05,159834031,0.951976
D.truncata,167897087,VNJQ01005935.1,1,3570,2.1263e-05,159837601,0.951997
D.truncata,167897087,VNJQ01005702.1,1,3570,2.1263e-05,159841171,0.952019
D.truncata,167897087,VNJQ01005288.1,1,3570,2.1263e-05,159844741,0.95204
D.truncata,167897087,VNJQ01006633.1,1,3569,2.12571e-05,159848310,0.952061
D.truncata,167897087,VNJQ01001550.1,1,3569,2.12571e-05,159851879,0.952083
D.truncata,167897087,VNJQ01007766.1,1,3568,2.12511e-05,159855447,0.952104
D.truncata,167897087,VNJQ01007775.1,1,3567,2.12452e-05,159859014,0.952125
D.truncata,167897087,VNJQ01000781.1,1,3563,2.12213e-05,159862577,0.952146
D.truncata,167897087,VNJQ01008089.1,1,3559,2.11975e-05,159866136,0.952167
D.truncata,167897087,VNJQ01000717.1,1,3558,2.11916e-05,159869694,0.952189
D.truncata,167897087,VNJQ01001914.1,1,3556,2.11796e-05,159873250,0.95221
D.truncata,167897087,VNJQ01001858.1,1,3556,2.11796e-05,159876806,0.952231
D.truncata,167897087,VNJQ01000296.1,1,3556,2.11796e-05,159880362,0.952252
D.truncata,167897087,VNJQ01000384.1,1,3555,2.11737e-05,159883917,0.952273
D.truncata,167897087,VNJQ01002163.1,1,3553,2.11618e-05,159887470,0.952294
D.truncata,167897087,VNJQ01000922.1,1,3553,2.11618e-05,159891023,0.952316
D.truncata,167897087,VNJQ01004677.1,1,3552,2.11558e-05,159894575,0.952337
D.truncata,167897087,VNJQ01003670.1,1,3550,2.11439e-05,159898125,0.952358
D.truncata,167897087,VNJQ01007437.1,1,3549,2.11379e-05,159901674,0.952379
D.truncata,167897087,VNJQ01006614.1,1,3547,2.1126e-05,159905221,0.9524
D.truncata,167897087,VNJQ01004142.1,1,3545,2.11141e-05,159908766,0.952421
D.truncata,167897087,VNJQ01004229.1,1,3542,2.10963e-05,159912308,0.952442
D.truncata,167897087,VNJQ01001049.1,1,3542,2.10963e-05,159915850,0.952464
D.truncata,167897087,VNJQ01004516.1,1,3541,2.10903e-05,159919391,0.952485
D.truncata,167897087,VNJQ01001073.1,1,3540,2.10843e-05,159922931,0.952506
D.truncata,167897087,VNJQ01000827.1,1,3540,2.10843e-05,159926471,0.952527
D.truncata,167897087,VNJQ01004003.1,1,3539,2.10784e-05,159930010,0.952548
D.truncata,167897087,VNJQ01005368.1,1,3538,2.10724e-05,159933548,0.952569
D.truncata,167897087,VNJQ01004226.1,1,3538,2.10724e-05,159937086,0.95259
D.truncata,167897087,VNJQ01000763.1,1,3538,2.10724e-05,159940624,0.952611
D.truncata,167897087,VNJQ01006296.1,1,3537,2.10665e-05,159944161,0.952632
D.truncata,167897087,VNJQ01003592.1,1,3537,2.10665e-05,159947698,0.952653
D.truncata,167897087,VNJQ01007888.1,1,3535,2.10546e-05,159951233,0.952674
D.truncata,167897087,VNJQ01004253.1,1,3535,2.10546e-05,159954768,0.952695
D.truncata,167897087,VNJQ01005358.1,1,3534,2.10486e-05,159958302,0.952716
D.truncata,167897087,VNJQ01006674.1,1,3532,2.10367e-05,159961834,0.952737
D.truncata,167897087,VNJQ01005981.1,1,3528,2.10129e-05,159965362,0.952758
D.truncata,167897087,VNJQ01001408.1,1,3526,2.1001e-05,159968888,0.952779
D.truncata,167897087,VNJQ01000890.1,1,3526,2.1001e-05,159972414,0.9528
D.truncata,167897087,VNJQ01004693.1,1,3525,2.0995e-05,159975939,0.952821
D.truncata,167897087,VNJQ01004162.1,1,3525,2.0995e-05,159979464,0.952842
D.truncata,167897087,VNJQ01003791.1,1,3525,2.0995e-05,159982989,0.952863
D.truncata,167897087,VNJQ01003271.1,1,3525,2.0995e-05,159986514,0.952884
D.truncata,167897087,VNJQ01000536.1,1,3525,2.0995e-05,159990039,0.952905
D.truncata,167897087,VNJQ01004585.1,1,3524,2.0989e-05,159993563,0.952926
D.truncata,167897087,VNJQ01002280.1,1,3524,2.0989e-05,159997087,0.952947
D.truncata,167897087,VNJQ01001730.1,1,3523,2.09831e-05,160000610,0.952968
D.truncata,167897087,VNJQ01008093.1,1,3520,2.09652e-05,160004130,0.952989
D.truncata,167897087,VNJQ01005470.1,1,3520,2.09652e-05,160007650,0.95301
D.truncata,167897087,VNJQ01005273.1,1,3519,2.09593e-05,160011169,0.953031
D.truncata,167897087,VNJQ01008106.1,1,3517,2.09474e-05,160014686,0.953052
D.truncata,167897087,VNJQ01003476.1,1,3517,2.09474e-05,160018203,0.953073
D.truncata,167897087,VNJQ01002071.1,1,3517,2.09474e-05,160021720,0.953094
D.truncata,167897087,VNJQ01001817.1,1,3516,2.09414e-05,160025236,0.953115
D.truncata,167897087,VNJQ01001091.1,1,3515,2.09354e-05,160028751,0.953136
D.truncata,167897087,VNJQ01001015.1,1,3512,2.09176e-05,160032263,0.953157
D.truncata,167897087,VNJQ01005972.1,1,3511,2.09116e-05,160035774,0.953178
D.truncata,167897087,VNJQ01006185.1,1,3509,2.08997e-05,160039283,0.953199
D.truncata,167897087,VNJQ01003322.1,1,3507,2.08878e-05,160042790,0.95322
D.truncata,167897087,VNJQ01003481.1,1,3506,2.08818e-05,160046296,0.95324
D.truncata,167897087,VNJQ01007931.1,1,3505,2.08759e-05,160049801,0.953261
D.truncata,167897087,VNJQ01000651.1,1,3503,2.0864e-05,160053304,0.953282
D.truncata,167897087,VNJQ01005241.1,1,3500,2.08461e-05,160056804,0.953303
D.truncata,167897087,VNJQ01006080.1,1,3498,2.08342e-05,160060302,0.953324
D.truncata,167897087,VNJQ01001289.1,1,3498,2.08342e-05,160063800,0.953345
D.truncata,167897087,VNJQ01002485.1,1,3497,2.08282e-05,160067297,0.953366
D.truncata,167897087,VNJQ01004545.1,1,3493,2.08044e-05,160070790,0.953386
D.truncata,167897087,VNJQ01004500.1,1,3493,2.08044e-05,160074283,0.953407
D.truncata,167897087,VNJQ01006810.1,1,3491,2.07925e-05,160077774,0.953428
D.truncata,167897087,VNJQ01007979.1,1,3488,2.07746e-05,160081262,0.953449
D.truncata,167897087,VNJQ01000481.1,1,3487,2.07687e-05,160084749,0.953469
D.truncata,167897087,VNJQ01007928.1,1,3483,2.07449e-05,160088232,0.95349
D.truncata,167897087,VNJQ01000483.1,1,3480,2.0727e-05,160091712,0.953511
D.truncata,167897087,VNJQ01007589.1,1,3479,2.0721e-05,160095191,0.953532
D.truncata,167897087,VNJQ01002210.1,1,3479,2.0721e-05,160098670,0.953552
D.truncata,167897087,VNJQ01000892.1,1,3477,2.07091e-05,160102147,0.953573
D.truncata,167897087,VNJQ01005743.1,1,3474,2.06912e-05,160105621,0.953594
D.truncata,167897087,VNJQ01008077.1,1,3472,2.06793e-05,160109093,0.953614
D.truncata,167897087,VNJQ01003281.1,1,3470,2.06674e-05,160112563,0.953635
D.truncata,167897087,VNJQ01004478.1,1,3469,2.06615e-05,160116032,0.953656
D.truncata,167897087,VNJQ01007495.1,1,3468,2.06555e-05,160119500,0.953676
D.truncata,167897087,VNJQ01002000.1,1,3468,2.06555e-05,160122968,0.953697
D.truncata,167897087,VNJQ01003949.1,1,3466,2.06436e-05,160126434,0.953718
D.truncata,167897087,VNJQ01002208.1,1,3466,2.06436e-05,160129900,0.953738
D.truncata,167897087,VNJQ01001453.1,1,3466,2.06436e-05,160133366,0.953759
D.truncata,167897087,VNJQ01005145.1,1,3465,2.06376e-05,160136831,0.95378
D.truncata,167897087,VNJQ01003798.1,1,3463,2.06257e-05,160140294,0.9538
D.truncata,167897087,VNJQ01004899.1,1,3460,2.06079e-05,160143754,0.953821
D.truncata,167897087,VNJQ01006363.1,1,3457,2.059e-05,160147211,0.953842
D.truncata,167897087,VNJQ01003766.1,1,3457,2.059e-05,160150668,0.953862
D.truncata,167897087,VNJQ01006009.1,1,3455,2.05781e-05,160154123,0.953883
D.truncata,167897087,VNJQ01004906.1,1,3455,2.05781e-05,160157578,0.953903
D.truncata,167897087,VNJQ01000400.1,1,3455,2.05781e-05,160161033,0.953924
D.truncata,167897087,VNJQ01003689.1,1,3454,2.05721e-05,160164487,0.953944
D.truncata,167897087,VNJQ01004666.1,1,3453,2.05662e-05,160167940,0.953965
D.truncata,167897087,VNJQ01006878.1,1,3450,2.05483e-05,160171390,0.953986
D.truncata,167897087,VNJQ01000472.1,1,3450,2.05483e-05,160174840,0.954006
D.truncata,167897087,VNJQ01001425.1,1,3448,2.05364e-05,160178288,0.954027
D.truncata,167897087,VNJQ01001061.1,1,3446,2.05245e-05,160181734,0.954047
D.truncata,167897087,VNJQ01000327.1,1,3446,2.05245e-05,160185180,0.954068
D.truncata,167897087,VNJQ01007131.1,1,3445,2.05185e-05,160188625,0.954088
D.truncata,167897087,VNJQ01001907.1,1,3445,2.05185e-05,160192070,0.954109
D.truncata,167897087,VNJQ01007810.1,1,3444,2.05126e-05,160195514,0.954129
D.truncata,167897087,VNJQ01007650.1,1,3443,2.05066e-05,160198957,0.95415
D.truncata,167897087,VNJQ01003768.1,1,3443,2.05066e-05,160202400,0.95417
D.truncata,167897087,VNJQ01007017.1,1,3442,2.05007e-05,160205842,0.954191
D.truncata,167897087,VNJQ01000457.1,1,3441,2.04947e-05,160209283,0.954211
D.truncata,167897087,VNJQ01003888.1,1,3440,2.04887e-05,160212723,0.954232
D.truncata,167897087,VNJQ01005706.1,1,3438,2.04768e-05,160216161,0.954252
D.truncata,167897087,VNJQ01005266.1,1,3438,2.04768e-05,160219599,0.954273
D.truncata,167897087,VNJQ01005412.1,1,3437,2.04709e-05,160223036,0.954293
D.truncata,167897087,VNJQ01003509.1,1,3435,2.0459e-05,160226471,0.954314
D.truncata,167897087,VNJQ01003332.1,1,3435,2.0459e-05,160229906,0.954334
D.truncata,167897087,VNJQ01007335.1,1,3434,2.0453e-05,160233340,0.954354
D.truncata,167897087,VNJQ01006148.1,1,3433,2.0447e-05,160236773,0.954375
D.truncata,167897087,VNJQ01005772.1,1,3433,2.0447e-05,160240206,0.954395
D.truncata,167897087,VNJQ01000743.1,1,3432,2.04411e-05,160243638,0.954416
D.truncata,167897087,VNJQ01004111.1,1,3431,2.04351e-05,160247069,0.954436
D.truncata,167897087,VNJQ01006779.1,1,3430,2.04292e-05,160250499,0.954457
D.truncata,167897087,VNJQ01002396.1,1,3430,2.04292e-05,160253929,0.954477
D.truncata,167897087,VNJQ01004141.1,1,3428,2.04173e-05,160257357,0.954498
D.truncata,167897087,VNJQ01006467.1,1,3427,2.04113e-05,160260784,0.954518
D.truncata,167897087,VNJQ01003307.1,1,3426,2.04054e-05,160264210,0.954538
D.truncata,167897087,VNJQ01001919.1,1,3423,2.03875e-05,160267633,0.954559
D.truncata,167897087,VNJQ01005050.1,1,3422,2.03815e-05,160271055,0.954579
D.truncata,167897087,VNJQ01006524.1,1,3420,2.03696e-05,160274475,0.954599
D.truncata,167897087,VNJQ01001625.1,1,3418,2.03577e-05,160277893,0.95462
D.truncata,167897087,VNJQ01005039.1,1,3417,2.03518e-05,160281310,0.95464
D.truncata,167897087,VNJQ01008123.1,1,3415,2.03398e-05,160284725,0.954661
D.truncata,167897087,VNJQ01007982.1,1,3415,2.03398e-05,160288140,0.954681
D.truncata,167897087,VNJQ01003871.1,1,3414,2.03339e-05,160291554,0.954701
D.truncata,167897087,VNJQ01005303.1,1,3413,2.03279e-05,160294967,0.954722
D.truncata,167897087,VNJQ01003175.1,1,3413,2.03279e-05,160298380,0.954742
D.truncata,167897087,VNJQ01000915.1,1,3412,2.0322e-05,160301792,0.954762
D.truncata,167897087,VNJQ01001622.1,1,3411,2.0316e-05,160305203,0.954783
D.truncata,167897087,VNJQ01003374.1,1,3409,2.03041e-05,160308612,0.954803
D.truncata,167897087,VNJQ01002752.1,1,3408,2.02981e-05,160312020,0.954823
D.truncata,167897087,VNJQ01005475.1,1,3407,2.02922e-05,160315427,0.954843
D.truncata,167897087,VNJQ01005709.1,1,3406,2.02862e-05,160318833,0.954864
D.truncata,167897087,VNJQ01008112.1,1,3405,2.02803e-05,160322238,0.954884
D.truncata,167897087,VNJQ01005209.1,1,3405,2.02803e-05,160325643,0.954904
D.truncata,167897087,VNJQ01007104.1,1,3404,2.02743e-05,160329047,0.954925
D.truncata,167897087,VNJQ01003046.1,1,3404,2.02743e-05,160332451,0.954945
D.truncata,167897087,VNJQ01000340.1,1,3404,2.02743e-05,160335855,0.954965
D.truncata,167897087,VNJQ01006311.1,1,3403,2.02684e-05,160339258,0.954985
D.truncata,167897087,VNJQ01005659.1,1,3403,2.02684e-05,160342661,0.955006
D.truncata,167897087,VNJQ01001709.1,1,3402,2.02624e-05,160346063,0.955026
D.truncata,167897087,VNJQ01000832.1,1,3402,2.02624e-05,160349465,0.955046
D.truncata,167897087,VNJQ01000478.1,1,3402,2.02624e-05,160352867,0.955066
D.truncata,167897087,VNJQ01003229.1,1,3399,2.02445e-05,160356266,0.955087
D.truncata,167897087,VNJQ01006005.1,1,3396,2.02267e-05,160359662,0.955107
D.truncata,167897087,VNJQ01005460.1,1,3393,2.02088e-05,160363055,0.955127
D.truncata,167897087,VNJQ01001218.1,1,3393,2.02088e-05,160366448,0.955147
D.truncata,167897087,VNJQ01006339.1,1,3392,2.02029e-05,160369840,0.955167
D.truncata,167897087,VNJQ01006359.1,1,3388,2.0179e-05,160373228,0.955188
D.truncata,167897087,VNJQ01005374.1,1,3387,2.01731e-05,160376615,0.955208
D.truncata,167897087,VNJQ01002898.1,1,3387,2.01731e-05,160380002,0.955228
D.truncata,167897087,VNJQ01001728.1,1,3386,2.01671e-05,160383388,0.955248
D.truncata,167897087,VNJQ01003881.1,1,3384,2.01552e-05,160386772,0.955268
D.truncata,167897087,VNJQ01003401.1,1,3384,2.01552e-05,160390156,0.955288
D.truncata,167897087,VNJQ01003508.1,1,3383,2.01492e-05,160393539,0.955309
D.truncata,167897087,VNJQ01007655.1,1,3382,2.01433e-05,160396921,0.955329
D.truncata,167897087,VNJQ01005969.1,1,3382,2.01433e-05,160400303,0.955349
D.truncata,167897087,VNJQ01003622.1,1,3379,2.01254e-05,160403682,0.955369
D.truncata,167897087,VNJQ01000850.1,1,3379,2.01254e-05,160407061,0.955389
D.truncata,167897087,VNJQ01005900.1,1,3377,2.01135e-05,160410438,0.955409
D.truncata,167897087,VNJQ01005975.1,1,3376,2.01076e-05,160413814,0.955429
D.truncata,167897087,VNJQ01006654.1,1,3375,2.01016e-05,160417189,0.95545
D.truncata,167897087,VNJQ01004423.1,1,3375,2.01016e-05,160420564,0.95547
D.truncata,167897087,VNJQ01004772.1,1,3373,2.00897e-05,160423937,0.95549
D.truncata,167897087,VNJQ01006458.1,1,3371,2.00778e-05,160427308,0.95551
D.truncata,167897087,VNJQ01006397.1,1,3371,2.00778e-05,160430679,0.95553
D.truncata,167897087,VNJQ01004844.1,1,3371,2.00778e-05,160434050,0.95555
D.truncata,167897087,VNJQ01005512.1,1,3369,2.00659e-05,160437419,0.95557
D.truncata,167897087,VNJQ01001093.1,1,3369,2.00659e-05,160440788,0.95559
D.truncata,167897087,VNJQ01007207.1,1,3368,2.00599e-05,160444156,0.95561
D.truncata,167897087,VNJQ01006332.1,1,3368,2.00599e-05,160447524,0.95563
D.truncata,167897087,VNJQ01001597.1,1,3367,2.0054e-05,160450891,0.95565
D.truncata,167897087,VNJQ01001561.1,1,3367,2.0054e-05,160454258,0.95567
D.truncata,167897087,VNJQ01000655.1,1,3367,2.0054e-05,160457625,0.95569
D.truncata,167897087,VNJQ01003662.1,1,3366,2.0048e-05,160460991,0.95571
D.truncata,167897087,VNJQ01000838.1,1,3365,2.0042e-05,160464356,0.95573
D.truncata,167897087,VNJQ01000694.1,1,3364,2.00361e-05,160467720,0.95575
D.truncata,167897087,VNJQ01003338.1,1,3363,2.00301e-05,160471083,0.955771
D.truncata,167897087,VNJQ01002226.1,1,3362,2.00242e-05,160474445,0.955791
D.truncata,167897087,VNJQ01007316.1,1,3359,2.00063e-05,160477804,0.955811
D.truncata,167897087,VNJQ01003904.1,1,3359,2.00063e-05,160481163,0.955831
D.truncata,167897087,VNJQ01005408.1,1,3358,2.00003e-05,160484521,0.955851
D.truncata,167897087,VNJQ01006530.1,1,3357,1.99944e-05,160487878,0.955871
D.truncata,167897087,VNJQ01002694.1,1,3357,1.99944e-05,160491235,0.955891
D.truncata,167897087,VNJQ01002392.1,1,3357,1.99944e-05,160494592,0.955911
D.truncata,167897087,VNJQ01001548.1,1,3357,1.99944e-05,160497949,0.955931
D.truncata,167897087,VNJQ01004466.1,1,3353,1.99706e-05,160501302,0.95595
D.truncata,167897087,VNJQ01006323.1,1,3352,1.99646e-05,160504654,0.95597
D.truncata,167897087,VNJQ01006354.1,1,3351,1.99587e-05,160508005,0.95599
D.truncata,167897087,VNJQ01004736.1,1,3351,1.99587e-05,160511356,0.95601
D.truncata,167897087,VNJQ01004112.1,1,3351,1.99587e-05,160514707,0.95603
D.truncata,167897087,VNJQ01006295.1,1,3350,1.99527e-05,160518057,0.95605
D.truncata,167897087,VNJQ01004108.1,1,3350,1.99527e-05,160521407,0.95607
D.truncata,167897087,VNJQ01008193.1,1,3349,1.99467e-05,160524756,0.95609
D.truncata,167897087,VNJQ01004010.1,1,3348,1.99408e-05,160528104,0.95611
D.truncata,167897087,VNJQ01007882.1,1,3347,1.99348e-05,160531451,0.95613
D.truncata,167897087,VNJQ01007190.1,1,3346,1.99289e-05,160534797,0.95615
D.truncata,167897087,VNJQ01006361.1,1,3346,1.99289e-05,160538143,0.95617
D.truncata,167897087,VNJQ01004529.1,1,3346,1.99289e-05,160541489,0.95619
D.truncata,167897087,VNJQ01001939.1,1,3344,1.9917e-05,160544833,0.95621
D.truncata,167897087,VNJQ01001181.1,1,3344,1.9917e-05,160548177,0.95623
D.truncata,167897087,VNJQ01003993.1,1,3343,1.9911e-05,160551520,0.95625
D.truncata,167897087,VNJQ01003354.1,1,3342,1.99051e-05,160554862,0.956269
D.truncata,167897087,VNJQ01001036.1,1,3338,1.98812e-05,160558200,0.956289
D.truncata,167897087,VNJQ01005794.1,1,3337,1.98753e-05,160561537,0.956309
D.truncata,167897087,VNJQ01007350.1,1,3336,1.98693e-05,160564873,0.956329
D.truncata,167897087,VNJQ01001735.1,1,3336,1.98693e-05,160568209,0.956349
D.truncata,167897087,VNJQ01005686.1,1,3334,1.98574e-05,160571543,0.956369
D.truncata,167897087,VNJQ01006933.1,1,3331,1.98395e-05,160574874,0.956389
D.truncata,167897087,VNJQ01006874.1,1,3330,1.98336e-05,160578204,0.956409
D.truncata,167897087,VNJQ01006294.1,1,3329,1.98276e-05,160581533,0.956428
D.truncata,167897087,VNJQ01001155.1,1,3329,1.98276e-05,160584862,0.956448
D.truncata,167897087,VNJQ01005760.1,1,3328,1.98217e-05,160588190,0.956468
D.truncata,167897087,VNJQ01005939.1,1,3327,1.98157e-05,160591517,0.956488
D.truncata,167897087,VNJQ01001359.1,1,3327,1.98157e-05,160594844,0.956508
D.truncata,167897087,VNJQ01005859.1,1,3326,1.98098e-05,160598170,0.956527
D.truncata,167897087,VNJQ01000368.1,1,3325,1.98038e-05,160601495,0.956547
D.truncata,167897087,VNJQ01004703.1,1,3324,1.97978e-05,160604819,0.956567
D.truncata,167897087,VNJQ01002479.1,1,3324,1.97978e-05,160608143,0.956587
D.truncata,167897087,VNJQ01003883.1,1,3322,1.97859e-05,160611465,0.956607
D.truncata,167897087,VNJQ01007762.1,1,3321,1.978e-05,160614786,0.956626
D.truncata,167897087,VNJQ01002532.1,1,3320,1.9774e-05,160618106,0.956646
D.truncata,167897087,VNJQ01000298.1,1,3320,1.9774e-05,160621426,0.956666
D.truncata,167897087,VNJQ01002867.1,1,3319,1.97681e-05,160624745,0.956686
D.truncata,167897087,VNJQ01000188.1,1,3319,1.97681e-05,160628064,0.956705
D.truncata,167897087,VNJQ01003111.1,1,3317,1.97561e-05,160631381,0.956725
D.truncata,167897087,VNJQ01002663.1,1,3315,1.97442e-05,160634696,0.956745
D.truncata,167897087,VNJQ01006464.1,1,3314,1.97383e-05,160638010,0.956765
D.truncata,167897087,VNJQ01003683.1,1,3314,1.97383e-05,160641324,0.956784
D.truncata,167897087,VNJQ01002693.1,1,3314,1.97383e-05,160644638,0.956804
D.truncata,167897087,VNJQ01000771.1,1,3314,1.97383e-05,160647952,0.956824
D.truncata,167897087,VNJQ01006558.1,1,3313,1.97323e-05,160651265,0.956844
D.truncata,167897087,VNJQ01003387.1,1,3313,1.97323e-05,160654578,0.956863
D.truncata,167897087,VNJQ01000741.1,1,3310,1.97145e-05,160657888,0.956883
D.truncata,167897087,VNJQ01005708.1,1,3308,1.97025e-05,160661196,0.956903
D.truncata,167897087,VNJQ01001422.1,1,3308,1.97025e-05,160664504,0.956923
D.truncata,167897087,VNJQ01002095.1,1,3305,1.96847e-05,160667809,0.956942
D.truncata,167897087,VNJQ01005168.1,1,3304,1.96787e-05,160671113,0.956962
D.truncata,167897087,VNJQ01004371.1,1,3302,1.96668e-05,160674415,0.956982
D.truncata,167897087,VNJQ01004784.1,1,3301,1.96609e-05,160677716,0.957001
D.truncata,167897087,VNJQ01008025.1,1,3300,1.96549e-05,160681016,0.957021
D.truncata,167897087,VNJQ01006904.1,1,3298,1.9643e-05,160684314,0.957041
D.truncata,167897087,VNJQ01006891.1,1,3297,1.9637e-05,160687611,0.95706
D.truncata,167897087,VNJQ01004702.1,1,3296,1.96311e-05,160690907,0.95708
D.truncata,167897087,VNJQ01003446.1,1,3295,1.96251e-05,160694202,0.957099
D.truncata,167897087,VNJQ01008074.1,1,3294,1.96192e-05,160697496,0.957119
D.truncata,167897087,VNJQ01000088.1,1,3294,1.96192e-05,160700790,0.957139
D.truncata,167897087,VNJQ01005990.1,1,3291,1.96013e-05,160704081,0.957158
D.truncata,167897087,VNJQ01004245.1,1,3290,1.95953e-05,160707371,0.957178
D.truncata,167897087,VNJQ01002822.1,1,3289,1.95894e-05,160710660,0.957197
D.truncata,167897087,VNJQ01008082.1,1,3287,1.95775e-05,160713947,0.957217
D.truncata,167897087,VNJQ01005196.1,1,3287,1.95775e-05,160717234,0.957237
D.truncata,167897087,VNJQ01004441.1,1,3285,1.95656e-05,160720519,0.957256
D.truncata,167897087,VNJQ01005461.1,1,3284,1.95596e-05,160723803,0.957276
D.truncata,167897087,VNJQ01002205.1,1,3284,1.95596e-05,160727087,0.957295
D.truncata,167897087,VNJQ01001063.1,1,3283,1.95536e-05,160730370,0.957315
D.truncata,167897087,VNJQ01003818.1,1,3282,1.95477e-05,160733652,0.957334
D.truncata,167897087,VNJQ01005845.1,1,3281,1.95417e-05,160736933,0.957354
D.truncata,167897087,VNJQ01004434.1,1,3281,1.95417e-05,160740214,0.957373
D.truncata,167897087,VNJQ01005771.1,1,3278,1.95239e-05,160743492,0.957393
D.truncata,167897087,VNJQ01001403.1,1,3278,1.95239e-05,160746770,0.957413
D.truncata,167897087,VNJQ01005387.1,1,3276,1.9512e-05,160750046,0.957432
D.truncata,167897087,VNJQ01007248.1,1,3275,1.9506e-05,160753321,0.957452
D.truncata,167897087,VNJQ01002594.1,1,3275,1.9506e-05,160756596,0.957471
D.truncata,167897087,VNJQ01002074.1,1,3275,1.9506e-05,160759871,0.957491
D.truncata,167897087,VNJQ01000601.1,1,3275,1.9506e-05,160763146,0.95751
D.truncata,167897087,VNJQ01002381.1,1,3273,1.94941e-05,160766419,0.95753
D.truncata,167897087,VNJQ01006900.1,1,3270,1.94762e-05,160769689,0.957549
D.truncata,167897087,VNJQ01006678.1,1,3268,1.94643e-05,160772957,0.957568
D.truncata,167897087,VNJQ01000142.1,1,3267,1.94583e-05,160776224,0.957588
D.truncata,167897087,VNJQ01004353.1,1,3266,1.94524e-05,160779490,0.957607
D.truncata,167897087,VNJQ01002617.1,1,3266,1.94524e-05,160782756,0.957627
D.truncata,167897087,VNJQ01005765.1,1,3265,1.94464e-05,160786021,0.957646
D.truncata,167897087,VNJQ01006628.1,1,3264,1.94405e-05,160789285,0.957666
D.truncata,167897087,VNJQ01000780.1,1,3264,1.94405e-05,160792549,0.957685
D.truncata,167897087,VNJQ01005177.1,1,3262,1.94286e-05,160795811,0.957705
D.truncata,167897087,VNJQ01004291.1,1,3262,1.94286e-05,160799073,0.957724
D.truncata,167897087,VNJQ01005899.1,1,3261,1.94226e-05,160802334,0.957743
D.truncata,167897087,VNJQ01002361.1,1,3261,1.94226e-05,160805595,0.957763
D.truncata,167897087,VNJQ01005704.1,1,3260,1.94167e-05,160808855,0.957782
D.truncata,167897087,VNJQ01002579.1,1,3260,1.94167e-05,160812115,0.957802
D.truncata,167897087,VNJQ01004252.1,1,3257,1.93988e-05,160815372,0.957821
D.truncata,167897087,VNJQ01004744.1,1,3255,1.93869e-05,160818627,0.95784
D.truncata,167897087,VNJQ01002256.1,1,3254,1.93809e-05,160821881,0.95786
D.truncata,167897087,VNJQ01000480.1,1,3254,1.93809e-05,160825135,0.957879
D.truncata,167897087,VNJQ01007499.1,1,3252,1.9369e-05,160828387,0.957899
D.truncata,167897087,VNJQ01001967.1,1,3252,1.9369e-05,160831639,0.957918
D.truncata,167897087,VNJQ01007078.1,1,3251,1.93631e-05,160834890,0.957937
D.truncata,167897087,VNJQ01005784.1,1,3250,1.93571e-05,160838140,0.957957
D.truncata,167897087,VNJQ01002780.1,1,3250,1.93571e-05,160841390,0.957976
D.truncata,167897087,VNJQ01000638.1,1,3249,1.93511e-05,160844639,0.957995
D.truncata,167897087,VNJQ01006709.1,1,3248,1.93452e-05,160847887,0.958015
D.truncata,167897087,VNJQ01000174.1,1,3248,1.93452e-05,160851135,0.958034
D.truncata,167897087,VNJQ01007727.1,1,3247,1.93392e-05,160854382,0.958053
D.truncata,167897087,VNJQ01002889.1,1,3246,1.93333e-05,160857628,0.958073
D.truncata,167897087,VNJQ01001714.1,1,3246,1.93333e-05,160860874,0.958092
D.truncata,167897087,VNJQ01006287.1,1,3245,1.93273e-05,160864119,0.958111
D.truncata,167897087,VNJQ01005194.1,1,3245,1.93273e-05,160867364,0.958131
D.truncata,167897087,VNJQ01001238.1,1,3242,1.93094e-05,160870606,0.95815
D.truncata,167897087,VNJQ01006218.1,1,3241,1.93035e-05,160873847,0.958169
D.truncata,167897087,VNJQ01005350.1,1,3240,1.92975e-05,160877087,0.958189
D.truncata,167897087,VNJQ01002498.1,1,3240,1.92975e-05,160880327,0.958208
D.truncata,167897087,VNJQ01005703.1,1,3238,1.92856e-05,160883565,0.958227
D.truncata,167897087,VNJQ01002397.1,1,3237,1.92797e-05,160886802,0.958247
D.truncata,167897087,VNJQ01006246.1,1,3235,1.92678e-05,160890037,0.958266
D.truncata,167897087,VNJQ01001612.1,1,3235,1.92678e-05,160893272,0.958285
D.truncata,167897087,VNJQ01005543.1,1,3234,1.92618e-05,160896506,0.958304
D.truncata,167897087,VNJQ01004217.1,1,3234,1.92618e-05,160899740,0.958324
D.truncata,167897087,VNJQ01003800.1,1,3234,1.92618e-05,160902974,0.958343
D.truncata,167897087,VNJQ01005843.1,1,3233,1.92558e-05,160906207,0.958362
D.truncata,167897087,VNJQ01006051.1,1,3232,1.92499e-05,160909439,0.958381
D.truncata,167897087,VNJQ01002641.1,1,3232,1.92499e-05,160912671,0.958401
D.truncata,167897087,VNJQ01002177.1,1,3232,1.92499e-05,160915903,0.95842
D.truncata,167897087,VNJQ01001999.1,1,3232,1.92499e-05,160919135,0.958439
D.truncata,167897087,VNJQ01006333.1,1,3231,1.92439e-05,160922366,0.958458
D.truncata,167897087,VNJQ01007305.1,1,3230,1.9238e-05,160925596,0.958478
D.truncata,167897087,VNJQ01006910.1,1,3230,1.9238e-05,160928826,0.958497
D.truncata,167897087,VNJQ01008030.1,1,3229,1.9232e-05,160932055,0.958516
D.truncata,167897087,VNJQ01006716.1,1,3229,1.9232e-05,160935284,0.958535
D.truncata,167897087,VNJQ01007311.1,1,3228,1.92261e-05,160938512,0.958555
D.truncata,167897087,VNJQ01006912.1,1,3228,1.92261e-05,160941740,0.958574
D.truncata,167897087,VNJQ01004180.1,1,3226,1.92142e-05,160944966,0.958593
D.truncata,167897087,VNJQ01000137.1,1,3225,1.92082e-05,160948191,0.958612
D.truncata,167897087,VNJQ01007436.1,1,3224,1.92022e-05,160951415,0.958631
D.truncata,167897087,VNJQ01005747.1,1,3223,1.91963e-05,160954638,0.958651
D.truncata,167897087,VNJQ01005922.1,1,3222,1.91903e-05,160957860,0.95867
D.truncata,167897087,VNJQ01002937.1,1,3221,1.91844e-05,160961081,0.958689
D.truncata,167897087,VNJQ01001677.1,1,3221,1.91844e-05,160964302,0.958708
D.truncata,167897087,VNJQ01005787.1,1,3220,1.91784e-05,160967522,0.958727
D.truncata,167897087,VNJQ01006756.1,1,3218,1.91665e-05,160970740,0.958746
D.truncata,167897087,VNJQ01001046.1,1,3218,1.91665e-05,160973958,0.958766
D.truncata,167897087,VNJQ01000209.1,1,3218,1.91665e-05,160977176,0.958785
D.truncata,167897087,VNJQ01002451.1,1,3217,1.91605e-05,160980393,0.958804
D.truncata,167897087,VNJQ01005029.1,1,3216,1.91546e-05,160983609,0.958823
D.truncata,167897087,VNJQ01002570.1,1,3216,1.91546e-05,160986825,0.958842
D.truncata,167897087,VNJQ01003213.1,1,3214,1.91427e-05,160990039,0.958861
D.truncata,167897087,VNJQ01007610.1,1,3212,1.91308e-05,160993251,0.958881
D.truncata,167897087,VNJQ01001486.1,1,3211,1.91248e-05,160996462,0.9589
D.truncata,167897087,VNJQ01006708.1,1,3210,1.91189e-05,160999672,0.958919
D.truncata,167897087,VNJQ01001097.1,1,3210,1.91189e-05,161002882,0.958938
D.truncata,167897087,VNJQ01004205.1,1,3209,1.91129e-05,161006091,0.958957
D.truncata,167897087,VNJQ01002583.1,1,3209,1.91129e-05,161009300,0.958976
D.truncata,167897087,VNJQ01002203.1,1,3208,1.91069e-05,161012508,0.958995
D.truncata,167897087,VNJQ01004013.1,1,3205,1.90891e-05,161015713,0.959014
D.truncata,167897087,VNJQ01002589.1,1,3205,1.90891e-05,161018918,0.959033
D.truncata,167897087,VNJQ01001047.1,1,3205,1.90891e-05,161022123,0.959053
D.truncata,167897087,VNJQ01004389.1,1,3204,1.90831e-05,161025327,0.959072
D.truncata,167897087,VNJQ01007586.1,1,3203,1.90772e-05,161028530,0.959091
D.truncata,167897087,VNJQ01000932.1,1,3203,1.90772e-05,161031733,0.95911
D.truncata,167897087,VNJQ01001831.1,1,3202,1.90712e-05,161034935,0.959129
D.truncata,167897087,VNJQ01007082.1,1,3201,1.90653e-05,161038136,0.959148
D.truncata,167897087,VNJQ01002149.1,1,3201,1.90653e-05,161041337,0.959167
D.truncata,167897087,VNJQ01007286.1,1,3200,1.90593e-05,161044537,0.959186
D.truncata,167897087,VNJQ01007795.1,1,3197,1.90414e-05,161047734,0.959205
D.truncata,167897087,VNJQ01007072.1,1,3197,1.90414e-05,161050931,0.959224
D.truncata,167897087,VNJQ01000905.1,1,3197,1.90414e-05,161054128,0.959243
D.truncata,167897087,VNJQ01006448.1,1,3193,1.90176e-05,161057321,0.959262
D.truncata,167897087,VNJQ01002344.1,1,3193,1.90176e-05,161060514,0.959281
D.truncata,167897087,VNJQ01000813.1,1,3193,1.90176e-05,161063707,0.9593
D.truncata,167897087,VNJQ01002168.1,1,3191,1.90057e-05,161066898,0.959319
D.truncata,167897087,VNJQ01005179.1,1,3185,1.897e-05,161070083,0.959338
D.truncata,167897087,VNJQ01003044.1,1,3183,1.8958e-05,161073266,0.959357
D.truncata,167897087,VNJQ01005230.1,1,3182,1.89521e-05,161076448,0.959376
D.truncata,167897087,VNJQ01004314.1,1,3182,1.89521e-05,161079630,0.959395
D.truncata,167897087,VNJQ01006254.1,1,3181,1.89461e-05,161082811,0.959414
D.truncata,167897087,VNJQ01002150.1,1,3181,1.89461e-05,161085992,0.959433
D.truncata,167897087,VNJQ01007433.1,1,3180,1.89402e-05,161089172,0.959452
D.truncata,167897087,VNJQ01003994.1,1,3180,1.89402e-05,161092352,0.959471
D.truncata,167897087,VNJQ01002632.1,1,3179,1.89342e-05,161095531,0.95949
D.truncata,167897087,VNJQ01004770.1,1,3178,1.89283e-05,161098709,0.959509
D.truncata,167897087,VNJQ01001834.1,1,3177,1.89223e-05,161101886,0.959528
D.truncata,167897087,VNJQ01002904.1,1,3173,1.88985e-05,161105059,0.959546
D.truncata,167897087,VNJQ01003574.1,1,3170,1.88806e-05,161108229,0.959565
D.truncata,167897087,VNJQ01006364.1,1,3168,1.88687e-05,161111397,0.959584
D.truncata,167897087,VNJQ01005495.1,1,3168,1.88687e-05,161114565,0.959603
D.truncata,167897087,VNJQ01003435.1,1,3168,1.88687e-05,161117733,0.959622
D.truncata,167897087,VNJQ01000144.1,1,3168,1.88687e-05,161120901,0.959641
D.truncata,167897087,VNJQ01006632.1,1,3167,1.88627e-05,161124068,0.95966
D.truncata,167897087,VNJQ01000607.1,1,3167,1.88627e-05,161127235,0.959679
D.truncata,167897087,VNJQ01000484.1,1,3167,1.88627e-05,161130402,0.959697
D.truncata,167897087,VNJQ01007856.1,1,3166,1.88568e-05,161133568,0.959716
D.truncata,167897087,VNJQ01003523.1,1,3165,1.88508e-05,161136733,0.959735
D.truncata,167897087,VNJQ01007889.1,1,3164,1.88449e-05,161139897,0.959754
D.truncata,167897087,VNJQ01002497.1,1,3164,1.88449e-05,161143061,0.959773
D.truncata,167897087,VNJQ01005340.1,1,3163,1.88389e-05,161146224,0.959792
D.truncata,167897087,VNJQ01006007.1,1,3161,1.8827e-05,161149385,0.95981
D.truncata,167897087,VNJQ01002620.1,1,3161,1.8827e-05,161152546,0.959829
D.truncata,167897087,VNJQ01001899.1,1,3161,1.8827e-05,161155707,0.959848
D.truncata,167897087,VNJQ01003448.1,1,3158,1.88091e-05,161158865,0.959867
D.truncata,167897087,VNJQ01002846.1,1,3158,1.88091e-05,161162023,0.959886
D.truncata,167897087,VNJQ01005741.1,1,3153,1.87794e-05,161165176,0.959905
D.truncata,167897087,VNJQ01004556.1,1,3153,1.87794e-05,161168329,0.959923
D.truncata,167897087,VNJQ01005832.1,1,3150,1.87615e-05,161171479,0.959942
D.truncata,167897087,VNJQ01001133.1,1,3148,1.87496e-05,161174627,0.959961
D.truncata,167897087,VNJQ01005733.1,1,3147,1.87436e-05,161177774,0.95998
D.truncata,167897087,VNJQ01000005.1,1,3147,1.87436e-05,161180921,0.959998
D.truncata,167897087,VNJQ01001621.1,1,3146,1.87377e-05,161184067,0.960017
D.truncata,167897087,VNJQ01007542.1,1,3145,1.87317e-05,161187212,0.960036
D.truncata,167897087,VNJQ01006105.1,1,3144,1.87258e-05,161190356,0.960055
D.truncata,167897087,VNJQ01002296.1,1,3144,1.87258e-05,161193500,0.960073
D.truncata,167897087,VNJQ01002104.1,1,3144,1.87258e-05,161196644,0.960092
D.truncata,167897087,VNJQ01004531.1,1,3143,1.87198e-05,161199787,0.960111
D.truncata,167897087,VNJQ01004302.1,1,3143,1.87198e-05,161202930,0.960129
D.truncata,167897087,VNJQ01001767.1,1,3143,1.87198e-05,161206073,0.960148
D.truncata,167897087,VNJQ01006292.1,1,3141,1.87079e-05,161209214,0.960167
D.truncata,167897087,VNJQ01005891.1,1,3141,1.87079e-05,161212355,0.960186
D.truncata,167897087,VNJQ01005653.1,1,3141,1.87079e-05,161215496,0.960204
D.truncata,167897087,VNJQ01001304.1,1,3141,1.87079e-05,161218637,0.960223
D.truncata,167897087,VNJQ01001512.1,1,3140,1.87019e-05,161221777,0.960242
D.truncata,167897087,VNJQ01004799.1,1,3139,1.8696e-05,161224916,0.96026
D.truncata,167897087,VNJQ01004038.1,1,3138,1.869e-05,161228054,0.960279
D.truncata,167897087,VNJQ01004848.1,1,3137,1.86841e-05,161231191,0.960298
D.truncata,167897087,VNJQ01003455.1,1,3137,1.86841e-05,161234328,0.960316
D.truncata,167897087,VNJQ01003244.1,1,3134,1.86662e-05,161237462,0.960335
D.truncata,167897087,VNJQ01006877.1,1,3133,1.86602e-05,161240595,0.960354
D.truncata,167897087,VNJQ01005075.1,1,3132,1.86543e-05,161243727,0.960372
D.truncata,167897087,VNJQ01003153.1,1,3132,1.86543e-05,161246859,0.960391
D.truncata,167897087,VNJQ01007913.1,1,3131,1.86483e-05,161249990,0.96041
D.truncata,167897087,VNJQ01005853.1,1,3131,1.86483e-05,161253121,0.960428
D.truncata,167897087,VNJQ01000824.1,1,3131,1.86483e-05,161256252,0.960447
D.truncata,167897087,VNJQ01001521.1,1,3130,1.86424e-05,161259382,0.960466
D.truncata,167897087,VNJQ01006777.1,1,3129,1.86364e-05,161262511,0.960484
D.truncata,167897087,VNJQ01003972.1,1,3129,1.86364e-05,161265640,0.960503
D.truncata,167897087,VNJQ01003178.1,1,3129,1.86364e-05,161268769,0.960522
D.truncata,167897087,VNJQ01001401.1,1,3129,1.86364e-05,161271898,0.96054
D.truncata,167897087,VNJQ01004390.1,1,3128,1.86305e-05,161275026,0.960559
D.truncata,167897087,VNJQ01001488.1,1,3127,1.86245e-05,161278153,0.960577
D.truncata,167897087,VNJQ01003150.1,1,3126,1.86185e-05,161281279,0.960596
D.truncata,167897087,VNJQ01000786.1,1,3126,1.86185e-05,161284405,0.960615
D.truncata,167897087,VNJQ01007667.1,1,3125,1.86126e-05,161287530,0.960633
D.truncata,167897087,VNJQ01005376.1,1,3125,1.86126e-05,161290655,0.960652
D.truncata,167897087,VNJQ01003962.1,1,3124,1.86066e-05,161293779,0.960671
D.truncata,167897087,VNJQ01002654.1,1,3124,1.86066e-05,161296903,0.960689
D.truncata,167897087,VNJQ01002140.1,1,3122,1.85947e-05,161300025,0.960708
D.truncata,167897087,VNJQ01000900.1,1,3122,1.85947e-05,161303147,0.960726
D.truncata,167897087,VNJQ01000535.1,1,3121,1.85888e-05,161306268,0.960745
D.truncata,167897087,VNJQ01001098.1,1,3119,1.85769e-05,161309387,0.960763
D.truncata,167897087,VNJQ01004812.1,1,3117,1.85649e-05,161312504,0.960782
D.truncata,167897087,VNJQ01002154.1,1,3117,1.85649e-05,161315621,0.960801
D.truncata,167897087,VNJQ01002012.1,1,3117,1.85649e-05,161318738,0.960819
D.truncata,167897087,VNJQ01002274.1,1,3115,1.8553e-05,161321853,0.960838
D.truncata,167897087,VNJQ01000969.1,1,3114,1.85471e-05,161324967,0.960856
D.truncata,167897087,VNJQ01000517.1,1,3114,1.85471e-05,161328081,0.960875
D.truncata,167897087,VNJQ01007959.1,1,3113,1.85411e-05,161331194,0.960893
D.truncata,167897087,VNJQ01000086.1,1,3109,1.85173e-05,161334303,0.960912
D.truncata,167897087,VNJQ01005724.1,1,3107,1.85054e-05,161337410,0.96093
D.truncata,167897087,VNJQ01000506.1,1,3105,1.84935e-05,161340515,0.960949
D.truncata,167897087,VNJQ01005279.1,1,3104,1.84875e-05,161343619,0.960967
D.truncata,167897087,VNJQ01000814.1,1,3104,1.84875e-05,161346723,0.960986
D.truncata,167897087,VNJQ01004972.1,1,3103,1.84816e-05,161349826,0.961004
D.truncata,167897087,VNJQ01004386.1,1,3103,1.84816e-05,161352929,0.961023
D.truncata,167897087,VNJQ01003142.1,1,3103,1.84816e-05,161356032,0.961041
D.truncata,167897087,VNJQ01002061.1,1,3103,1.84816e-05,161359135,0.96106
D.truncata,167897087,VNJQ01008145.1,1,3101,1.84696e-05,161362236,0.961078
D.truncata,167897087,VNJQ01002785.1,1,3101,1.84696e-05,161365337,0.961097
D.truncata,167897087,VNJQ01003318.1,1,3100,1.84637e-05,161368437,0.961115
D.truncata,167897087,VNJQ01003222.1,1,3100,1.84637e-05,161371537,0.961134
D.truncata,167897087,VNJQ01000834.1,1,3099,1.84577e-05,161374636,0.961152
D.truncata,167897087,VNJQ01004091.1,1,3098,1.84518e-05,161377734,0.961171
D.truncata,167897087,VNJQ01002974.1,1,3098,1.84518e-05,161380832,0.961189
D.truncata,167897087,VNJQ01006150.1,1,3096,1.84399e-05,161383928,0.961207
D.truncata,167897087,VNJQ01005926.1,1,3095,1.84339e-05,161387023,0.961226
D.truncata,167897087,VNJQ01002412.1,1,3094,1.8428e-05,161390117,0.961244
D.truncata,167897087,VNJQ01005592.1,1,3093,1.8422e-05,161393210,0.961263
D.truncata,167897087,VNJQ01001369.1,1,3092,1.8416e-05,161396302,0.961281
D.truncata,167897087,VNJQ01002604.1,1,3091,1.84101e-05,161399393,0.9613
D.truncata,167897087,VNJQ01006527.1,1,3090,1.84041e-05,161402483,0.961318
D.truncata,167897087,VNJQ01007259.1,1,3087,1.83863e-05,161405570,0.961336
D.truncata,167897087,VNJQ01006782.1,1,3087,1.83863e-05,161408657,0.961355
D.truncata,167897087,VNJQ01005146.1,1,3087,1.83863e-05,161411744,0.961373
D.truncata,167897087,VNJQ01002724.1,1,3086,1.83803e-05,161414830,0.961391
D.truncata,167897087,VNJQ01002336.1,1,3086,1.83803e-05,161417916,0.96141
D.truncata,167897087,VNJQ01007657.1,1,3084,1.83684e-05,161421000,0.961428
D.truncata,167897087,VNJQ01007077.1,1,3084,1.83684e-05,161424084,0.961447
D.truncata,167897087,VNJQ01005570.1,1,3084,1.83684e-05,161427168,0.961465
D.truncata,167897087,VNJQ01002193.1,1,3084,1.83684e-05,161430252,0.961483
D.truncata,167897087,VNJQ01004055.1,1,3081,1.83505e-05,161433333,0.961502
D.truncata,167897087,VNJQ01003990.1,1,3080,1.83446e-05,161436413,0.96152
D.truncata,167897087,VNJQ01006093.1,1,3079,1.83386e-05,161439492,0.961538
D.truncata,167897087,VNJQ01005714.1,1,3078,1.83327e-05,161442570,0.961557
D.truncata,167897087,VNJQ01007006.1,1,3077,1.83267e-05,161445647,0.961575
D.truncata,167897087,VNJQ01004366.1,1,3077,1.83267e-05,161448724,0.961593
D.truncata,167897087,VNJQ01002221.1,1,3076,1.83207e-05,161451800,0.961612
D.truncata,167897087,VNJQ01006987.1,1,3073,1.83029e-05,161454873,0.96163
D.truncata,167897087,VNJQ01006489.1,1,3073,1.83029e-05,161457946,0.961648
D.truncata,167897087,VNJQ01005444.1,1,3072,1.82969e-05,161461018,0.961667
D.truncata,167897087,VNJQ01007992.1,1,3071,1.8291e-05,161464089,0.961685
D.truncata,167897087,VNJQ01003803.1,1,3070,1.8285e-05,161467159,0.961703
D.truncata,167897087,VNJQ01003679.1,1,3065,1.82552e-05,161470224,0.961721
D.truncata,167897087,VNJQ01005919.1,1,3063,1.82433e-05,161473287,0.96174
D.truncata,167897087,VNJQ01001705.1,1,3063,1.82433e-05,161476350,0.961758
D.truncata,167897087,VNJQ01007170.1,1,3061,1.82314e-05,161479411,0.961776
D.truncata,167897087,VNJQ01006683.1,1,3060,1.82255e-05,161482471,0.961794
D.truncata,167897087,VNJQ01007676.1,1,3059,1.82195e-05,161485530,0.961813
D.truncata,167897087,VNJQ01006422.1,1,3057,1.82076e-05,161488587,0.961831
D.truncata,167897087,VNJQ01000002.1,1,3057,1.82076e-05,161491644,0.961849
D.truncata,167897087,VNJQ01005155.1,1,3056,1.82016e-05,161494700,0.961867
D.truncata,167897087,VNJQ01003671.1,1,3055,1.81957e-05,161497755,0.961885
D.truncata,167897087,VNJQ01007450.1,1,3054,1.81897e-05,161500809,0.961904
D.truncata,167897087,VNJQ01007547.1,1,3052,1.81778e-05,161503861,0.961922
D.truncata,167897087,VNJQ01007029.1,1,3050,1.81659e-05,161506911,0.96194
D.truncata,167897087,VNJQ01006611.1,1,3050,1.81659e-05,161509961,0.961958
D.truncata,167897087,VNJQ01000992.1,1,3050,1.81659e-05,161513011,0.961976
D.truncata,167897087,VNJQ01003543.1,1,3049,1.81599e-05,161516060,0.961994
D.truncata,167897087,VNJQ01003079.1,1,3046,1.81421e-05,161519106,0.962013
D.truncata,167897087,VNJQ01007763.1,1,3044,1.81302e-05,161522150,0.962031
D.truncata,167897087,VNJQ01001202.1,1,3043,1.81242e-05,161525193,0.962049
D.truncata,167897087,VNJQ01007019.1,1,3042,1.81182e-05,161528235,0.962067
D.truncata,167897087,VNJQ01005841.1,1,3042,1.81182e-05,161531277,0.962085
D.truncata,167897087,VNJQ01005389.1,1,3042,1.81182e-05,161534319,0.962103
D.truncata,167897087,VNJQ01004473.1,1,3042,1.81182e-05,161537361,0.962121
D.truncata,167897087,VNJQ01002380.1,1,3042,1.81182e-05,161540403,0.962139
D.truncata,167897087,VNJQ01004186.1,1,3041,1.81123e-05,161543444,0.962158
D.truncata,167897087,VNJQ01002776.1,1,3041,1.81123e-05,161546485,0.962176
D.truncata,167897087,VNJQ01002910.1,1,3038,1.80944e-05,161549523,0.962194
D.truncata,167897087,VNJQ01001716.1,1,3038,1.80944e-05,161552561,0.962212
D.truncata,167897087,VNJQ01006230.1,1,3037,1.80885e-05,161555598,0.96223
D.truncata,167897087,VNJQ01001308.1,1,3035,1.80765e-05,161558633,0.962248
D.truncata,167897087,VNJQ01001185.1,1,3034,1.80706e-05,161561667,0.962266
D.truncata,167897087,VNJQ01003600.1,1,3033,1.80646e-05,161564700,0.962284
D.truncata,167897087,VNJQ01002835.1,1,3033,1.80646e-05,161567733,0.962302
D.truncata,167897087,VNJQ01003837.1,1,3032,1.80587e-05,161570765,0.96232
D.truncata,167897087,VNJQ01002783.1,1,3032,1.80587e-05,161573797,0.962338
D.truncata,167897087,VNJQ01002170.1,1,3031,1.80527e-05,161576828,0.962356
D.truncata,167897087,VNJQ01008207.1,1,3028,1.80349e-05,161579856,0.962374
D.truncata,167897087,VNJQ01007459.1,1,3027,1.80289e-05,161582883,0.962392
D.truncata,167897087,VNJQ01005363.1,1,3027,1.80289e-05,161585910,0.96241
D.truncata,167897087,VNJQ01002360.1,1,3025,1.8017e-05,161588935,0.962428
D.truncata,167897087,VNJQ01002207.1,1,3024,1.8011e-05,161591959,0.962446
D.truncata,167897087,VNJQ01004250.1,1,3023,1.80051e-05,161594982,0.962464
D.truncata,167897087,VNJQ01003981.1,1,3020,1.79872e-05,161598002,0.962482
D.truncata,167897087,VNJQ01003653.1,1,3019,1.79813e-05,161601021,0.9625
D.truncata,167897087,VNJQ01001299.1,1,3017,1.79693e-05,161604038,0.962518
D.truncata,167897087,VNJQ01000683.1,1,3017,1.79693e-05,161607055,0.962536
D.truncata,167897087,VNJQ01000133.1,1,3017,1.79693e-05,161610072,0.962554
D.truncata,167897087,VNJQ01003615.1,1,3015,1.79574e-05,161613087,0.962572
D.truncata,167897087,VNJQ01001190.1,1,3015,1.79574e-05,161616102,0.96259
D.truncata,167897087,VNJQ01005478.1,1,3014,1.79515e-05,161619116,0.962608
D.truncata,167897087,VNJQ01003466.1,1,3013,1.79455e-05,161622129,0.962626
D.truncata,167897087,VNJQ01002750.1,1,3013,1.79455e-05,161625142,0.962644
D.truncata,167897087,VNJQ01002747.1,1,3012,1.79396e-05,161628154,0.962662
D.truncata,167897087,VNJQ01001987.1,1,3010,1.79276e-05,161631164,0.96268
D.truncata,167897087,VNJQ01000519.1,1,3010,1.79276e-05,161634174,0.962698
D.truncata,167897087,VNJQ01000342.1,1,3010,1.79276e-05,161637184,0.962716
D.truncata,167897087,VNJQ01006710.1,1,3008,1.79157e-05,161640192,0.962734
D.truncata,167897087,VNJQ01002390.1,1,3005,1.78979e-05,161643197,0.962752
D.truncata,167897087,VNJQ01002316.1,1,3004,1.78919e-05,161646201,0.96277
D.truncata,167897087,VNJQ01001602.1,1,3004,1.78919e-05,161649205,0.962787
D.truncata,167897087,VNJQ01004991.1,1,3002,1.788e-05,161652207,0.962805
D.truncata,167897087,VNJQ01003533.1,1,3001,1.7874e-05,161655208,0.962823
D.truncata,167897087,VNJQ01000266.1,1,3000,1.78681e-05,161658208,0.962841
D.truncata,167897087,VNJQ01002986.1,1,2999,1.78621e-05,161661207,0.962859
D.truncata,167897087,VNJQ01007669.1,1,2996,1.78443e-05,161664203,0.962877
D.truncata,167897087,VNJQ01001912.1,1,2995,1.78383e-05,161667198,0.962895
D.truncata,167897087,VNJQ01006894.1,1,2993,1.78264e-05,161670191,0.962912
D.truncata,167897087,VNJQ01001623.1,1,2993,1.78264e-05,161673184,0.96293
D.truncata,167897087,VNJQ01006444.1,1,2992,1.78204e-05,161676176,0.962948
D.truncata,167897087,VNJQ01000852.1,1,2992,1.78204e-05,161679168,0.962966
D.truncata,167897087,VNJQ01005594.1,1,2991,1.78145e-05,161682159,0.962984
D.truncata,167897087,VNJQ01001564.1,1,2991,1.78145e-05,161685150,0.963002
D.truncata,167897087,VNJQ01000909.1,1,2990,1.78085e-05,161688140,0.963019
D.truncata,167897087,VNJQ01008180.1,1,2989,1.78026e-05,161691129,0.963037
D.truncata,167897087,VNJQ01006616.1,1,2989,1.78026e-05,161694118,0.963055
D.truncata,167897087,VNJQ01003614.1,1,2989,1.78026e-05,161697107,0.963073
D.truncata,167897087,VNJQ01001279.1,1,2989,1.78026e-05,161700096,0.963091
D.truncata,167897087,VNJQ01000833.1,1,2989,1.78026e-05,161703085,0.963108
D.truncata,167897087,VNJQ01004360.1,1,2987,1.77907e-05,161706072,0.963126
D.truncata,167897087,VNJQ01008065.1,1,2986,1.77847e-05,161709058,0.963144
D.truncata,167897087,VNJQ01003075.1,1,2986,1.77847e-05,161712044,0.963162
D.truncata,167897087,VNJQ01008152.1,1,2985,1.77787e-05,161715029,0.963179
D.truncata,167897087,VNJQ01000971.1,1,2985,1.77787e-05,161718014,0.963197
D.truncata,167897087,VNJQ01004318.1,1,2984,1.77728e-05,161720998,0.963215
D.truncata,167897087,VNJQ01004161.1,1,2984,1.77728e-05,161723982,0.963233
D.truncata,167897087,VNJQ01002460.1,1,2983,1.77668e-05,161726965,0.963251
D.truncata,167897087,VNJQ01002868.1,1,2981,1.77549e-05,161729946,0.963268
D.truncata,167897087,VNJQ01001515.1,1,2981,1.77549e-05,161732927,0.963286
D.truncata,167897087,VNJQ01000520.1,1,2980,1.7749e-05,161735907,0.963304
D.truncata,167897087,VNJQ01006470.1,1,2979,1.7743e-05,161738886,0.963322
D.truncata,167897087,VNJQ01006107.1,1,2979,1.7743e-05,161741865,0.963339
D.truncata,167897087,VNJQ01000410.1,1,2979,1.7743e-05,161744844,0.963357
D.truncata,167897087,VNJQ01006084.1,1,2978,1.77371e-05,161747822,0.963375
D.truncata,167897087,VNJQ01002782.1,1,2976,1.77251e-05,161750798,0.963393
D.truncata,167897087,VNJQ01002386.1,1,2975,1.77192e-05,161753773,0.96341
D.truncata,167897087,VNJQ01000237.1,1,2975,1.77192e-05,161756748,0.963428
D.truncata,167897087,VNJQ01001607.1,1,2974,1.77132e-05,161759722,0.963446
D.truncata,167897087,VNJQ01006074.1,1,2973,1.77073e-05,161762695,0.963463
D.truncata,167897087,VNJQ01000947.1,1,2973,1.77073e-05,161765668,0.963481
D.truncata,167897087,VNJQ01006959.1,1,2972,1.77013e-05,161768640,0.963499
D.truncata,167897087,VNJQ01001055.1,1,2972,1.77013e-05,161771612,0.963516
D.truncata,167897087,VNJQ01001034.1,1,2972,1.77013e-05,161774584,0.963534
D.truncata,167897087,VNJQ01007070.1,1,2971,1.76954e-05,161777555,0.963552
D.truncata,167897087,VNJQ01004699.1,1,2971,1.76954e-05,161780526,0.96357
D.truncata,167897087,VNJQ01002293.1,1,2969,1.76835e-05,161783495,0.963587
D.truncata,167897087,VNJQ01001513.1,1,2965,1.76596e-05,161786460,0.963605
D.truncata,167897087,VNJQ01000503.1,1,2965,1.76596e-05,161789425,0.963623
D.truncata,167897087,VNJQ01002158.1,1,2962,1.76418e-05,161792387,0.96364
D.truncata,167897087,VNJQ01003388.1,1,2961,1.76358e-05,161795348,0.963658
D.truncata,167897087,VNJQ01000138.1,1,2960,1.76298e-05,161798308,0.963675
D.truncata,167897087,VNJQ01006911.1,1,2959,1.76239e-05,161801267,0.963693
D.truncata,167897087,VNJQ01006585.1,1,2959,1.76239e-05,161804226,0.963711
D.truncata,167897087,VNJQ01000744.1,1,2959,1.76239e-05,161807185,0.963728
D.truncata,167897087,VNJQ01002909.1,1,2957,1.7612e-05,161810142,0.963746
D.truncata,167897087,VNJQ01000595.1,1,2955,1.76001e-05,161813097,0.963764
D.truncata,167897087,VNJQ01005762.1,1,2954,1.75941e-05,161816051,0.963781
D.truncata,167897087,VNJQ01006794.1,1,2953,1.75882e-05,161819004,0.963799
D.truncata,167897087,VNJQ01005089.1,1,2953,1.75882e-05,161821957,0.963816
D.truncata,167897087,VNJQ01003733.1,1,2953,1.75882e-05,161824910,0.963834
D.truncata,167897087,VNJQ01000903.1,1,2953,1.75882e-05,161827863,0.963852
D.truncata,167897087,VNJQ01000326.1,1,2953,1.75882e-05,161830816,0.963869
D.truncata,167897087,VNJQ01001969.1,1,2952,1.75822e-05,161833768,0.963887
D.truncata,167897087,VNJQ01006866.1,1,2949,1.75643e-05,161836717,0.963904
D.truncata,167897087,VNJQ01007909.1,1,2948,1.75584e-05,161839665,0.963922
D.truncata,167897087,VNJQ01002282.1,1,2948,1.75584e-05,161842613,0.963939
D.truncata,167897087,VNJQ01002335.1,1,2947,1.75524e-05,161845560,0.963957
D.truncata,167897087,VNJQ01003638.1,1,2946,1.75465e-05,161848506,0.963974
D.truncata,167897087,VNJQ01006075.1,1,2943,1.75286e-05,161851449,0.963992
D.truncata,167897087,VNJQ01003849.1,1,2943,1.75286e-05,161854392,0.96401
D.truncata,167897087,VNJQ01007195.1,1,2941,1.75167e-05,161857333,0.964027
D.truncata,167897087,VNJQ01007864.1,1,2940,1.75107e-05,161860273,0.964045
D.truncata,167897087,VNJQ01001681.1,1,2940,1.75107e-05,161863213,0.964062
D.truncata,167897087,VNJQ01001132.1,1,2939,1.75048e-05,161866152,0.96408
D.truncata,167897087,VNJQ01006506.1,1,2938,1.74988e-05,161869090,0.964097
D.truncata,167897087,VNJQ01006930.1,1,2936,1.74869e-05,161872026,0.964115
D.truncata,167897087,VNJQ01006250.1,1,2936,1.74869e-05,161874962,0.964132
D.truncata,167897087,VNJQ01005736.1,1,2936,1.74869e-05,161877898,0.96415
D.truncata,167897087,VNJQ01002331.1,1,2936,1.74869e-05,161880834,0.964167
D.truncata,167897087,VNJQ01001463.1,1,2935,1.74809e-05,161883769,0.964185
D.truncata,167897087,VNJQ01006095.1,1,2933,1.7469e-05,161886702,0.964202
D.truncata,167897087,VNJQ01004783.1,1,2933,1.7469e-05,161889635,0.964219
D.truncata,167897087,VNJQ01000434.1,1,2933,1.7469e-05,161892568,0.964237
D.truncata,167897087,VNJQ01007905.1,1,2929,1.74452e-05,161895497,0.964254
D.truncata,167897087,VNJQ01004099.1,1,2929,1.74452e-05,161898426,0.964272
D.truncata,167897087,VNJQ01000046.1,1,2928,1.74393e-05,161901354,0.964289
D.truncata,167897087,VNJQ01006684.1,1,2927,1.74333e-05,161904281,0.964307
D.truncata,167897087,VNJQ01005656.1,1,2927,1.74333e-05,161907208,0.964324
D.truncata,167897087,VNJQ01004865.1,1,2927,1.74333e-05,161910135,0.964342
D.truncata,167897087,VNJQ01002764.1,1,2927,1.74333e-05,161913062,0.964359
D.truncata,167897087,VNJQ01000424.1,1,2927,1.74333e-05,161915989,0.964376
D.truncata,167897087,VNJQ01005754.1,1,2926,1.74273e-05,161918915,0.964394
D.truncata,167897087,VNJQ01006423.1,1,2925,1.74214e-05,161921840,0.964411
D.truncata,167897087,VNJQ01003486.1,1,2924,1.74154e-05,161924764,0.964429
D.truncata,167897087,VNJQ01003123.1,1,2924,1.74154e-05,161927688,0.964446
D.truncata,167897087,VNJQ01007831.1,1,2923,1.74095e-05,161930611,0.964463
D.truncata,167897087,VNJQ01008141.1,1,2922,1.74035e-05,161933533,0.964481
D.truncata,167897087,VNJQ01004907.1,1,2921,1.73976e-05,161936454,0.964498
D.truncata,167897087,VNJQ01002283.1,1,2919,1.73857e-05,161939373,0.964516
D.truncata,167897087,VNJQ01001991.1,1,2919,1.73857e-05,161942292,0.964533
D.truncata,167897087,VNJQ01005369.1,1,2917,1.73737e-05,161945209,0.96455
D.truncata,167897087,VNJQ01007503.1,1,2916,1.73678e-05,161948125,0.964568
D.truncata,167897087,VNJQ01006205.1,1,2916,1.73678e-05,161951041,0.964585
D.truncata,167897087,VNJQ01001048.1,1,2916,1.73678e-05,161953957,0.964603
D.truncata,167897087,VNJQ01008186.1,1,2915,1.73618e-05,161956872,0.96462
D.truncata,167897087,VNJQ01007054.1,1,2915,1.73618e-05,161959787,0.964637
D.truncata,167897087,VNJQ01005437.1,1,2913,1.73499e-05,161962700,0.964655
D.truncata,167897087,VNJQ01003171.1,1,2913,1.73499e-05,161965613,0.964672
D.truncata,167897087,VNJQ01007908.1,1,2912,1.7344e-05,161968525,0.964689
D.truncata,167897087,VNJQ01006619.1,1,2912,1.7344e-05,161971437,0.964707
D.truncata,167897087,VNJQ01001423.1,1,2911,1.7338e-05,161974348,0.964724
D.truncata,167897087,VNJQ01001476.1,1,2909,1.73261e-05,161977257,0.964741
D.truncata,167897087,VNJQ01005092.1,1,2908,1.73201e-05,161980165,0.964759
D.truncata,167897087,VNJQ01001915.1,1,2908,1.73201e-05,161983073,0.964776
D.truncata,167897087,VNJQ01004304.1,1,2907,1.73142e-05,161985980,0.964793
D.truncata,167897087,VNJQ01003500.1,1,2905,1.73023e-05,161988885,0.964811
D.truncata,167897087,VNJQ01000435.1,1,2905,1.73023e-05,161991790,0.964828
D.truncata,167897087,VNJQ01004941.1,1,2904,1.72963e-05,161994694,0.964845
D.truncata,167897087,VNJQ01000318.1,1,2904,1.72963e-05,161997598,0.964862
D.truncata,167897087,VNJQ01001293.1,1,2901,1.72784e-05,162000499,0.96488
D.truncata,167897087,VNJQ01002940.1,1,2900,1.72725e-05,162003399,0.964897
D.truncata,167897087,VNJQ01000924.1,1,2900,1.72725e-05,162006299,0.964914
D.truncata,167897087,VNJQ01004738.1,1,2899,1.72665e-05,162009198,0.964932
D.truncata,167897087,VNJQ01002206.1,1,2899,1.72665e-05,162012097,0.964949
D.truncata,167897087,VNJQ01007742.1,1,2897,1.72546e-05,162014994,0.964966
D.truncata,167897087,VNJQ01000817.1,1,2896,1.72487e-05,162017890,0.964983
D.truncata,167897087,VNJQ01005540.1,1,2895,1.72427e-05,162020785,0.965001
D.truncata,167897087,VNJQ01007618.1,1,2893,1.72308e-05,162023678,0.965018
D.truncata,167897087,VNJQ01004871.1,1,2893,1.72308e-05,162026571,0.965035
D.truncata,167897087,VNJQ01007173.1,1,2892,1.72248e-05,162029463,0.965052
D.truncata,167897087,VNJQ01006620.1,1,2889,1.7207e-05,162032352,0.965069
D.truncata,167897087,VNJQ01005255.1,1,2889,1.7207e-05,162035241,0.965087
D.truncata,167897087,VNJQ01003723.1,1,2889,1.7207e-05,162038130,0.965104
D.truncata,167897087,VNJQ01000524.1,1,2889,1.7207e-05,162041019,0.965121
D.truncata,167897087,VNJQ01006776.1,1,2888,1.7201e-05,162043907,0.965138
D.truncata,167897087,VNJQ01004202.1,1,2888,1.7201e-05,162046795,0.965155
D.truncata,167897087,VNJQ01003059.1,1,2888,1.7201e-05,162049683,0.965173
D.truncata,167897087,VNJQ01001527.1,1,2888,1.7201e-05,162052571,0.96519
D.truncata,167897087,VNJQ01005649.1,1,2884,1.71772e-05,162055455,0.965207
D.truncata,167897087,VNJQ01006722.1,1,2883,1.71712e-05,162058338,0.965224
D.truncata,167897087,VNJQ01005591.1,1,2882,1.71653e-05,162061220,0.965241
D.truncata,167897087,VNJQ01002321.1,1,2882,1.71653e-05,162064102,0.965259
D.truncata,167897087,VNJQ01000916.1,1,2882,1.71653e-05,162066984,0.965276
D.truncata,167897087,VNJQ01007951.1,1,2881,1.71593e-05,162069865,0.965293
D.truncata,167897087,VNJQ01007297.1,1,2880,1.71534e-05,162072745,0.96531
D.truncata,167897087,VNJQ01006445.1,1,2877,1.71355e-05,162075622,0.965327
D.truncata,167897087,VNJQ01000800.1,1,2877,1.71355e-05,162078499,0.965344
D.truncata,167897087,VNJQ01000162.1,1,2877,1.71355e-05,162081376,0.965361
D.truncata,167897087,VNJQ01005093.1,1,2876,1.71295e-05,162084252,0.965379
D.truncata,167897087,VNJQ01001361.1,1,2876,1.71295e-05,162087128,0.965396
D.truncata,167897087,VNJQ01001090.1,1,2876,1.71295e-05,162090004,0.965413
D.truncata,167897087,VNJQ01000027.1,1,2875,1.71236e-05,162092879,0.96543
D.truncata,167897087,VNJQ01006925.1,1,2874,1.71176e-05,162095753,0.965447
D.truncata,167897087,VNJQ01006293.1,1,2873,1.71117e-05,162098626,0.965464
D.truncata,167897087,VNJQ01002450.1,1,2873,1.71117e-05,162101499,0.965481
D.truncata,167897087,VNJQ01006972.1,1,2872,1.71057e-05,162104371,0.965498
D.truncata,167897087,VNJQ01007137.1,1,2871,1.70998e-05,162107242,0.965516
D.truncata,167897087,VNJQ01006680.1,1,2871,1.70998e-05,162110113,0.965533
D.truncata,167897087,VNJQ01007738.1,1,2868,1.70819e-05,162112981,0.96555
D.truncata,167897087,VNJQ01003342.1,1,2866,1.707e-05,162115847,0.965567
D.truncata,167897087,VNJQ01004116.1,1,2865,1.7064e-05,162118712,0.965584
D.truncata,167897087,VNJQ01003610.1,1,2865,1.7064e-05,162121577,0.965601
D.truncata,167897087,VNJQ01003209.1,1,2864,1.70581e-05,162124441,0.965618
D.truncata,167897087,VNJQ01002954.1,1,2864,1.70581e-05,162127305,0.965635
D.truncata,167897087,VNJQ01003578.1,1,2863,1.70521e-05,162130168,0.965652
D.truncata,167897087,VNJQ01003739.1,1,2862,1.70462e-05,162133030,0.965669
D.truncata,167897087,VNJQ01003114.1,1,2862,1.70462e-05,162135892,0.965686
D.truncata,167897087,VNJQ01006682.1,1,2861,1.70402e-05,162138753,0.965703
D.truncata,167897087,VNJQ01007211.1,1,2860,1.70342e-05,162141613,0.96572
D.truncata,167897087,VNJQ01004908.1,1,2860,1.70342e-05,162144473,0.965737
D.truncata,167897087,VNJQ01000606.1,1,2859,1.70283e-05,162147332,0.965754
D.truncata,167897087,VNJQ01006805.1,1,2858,1.70223e-05,162150190,0.965771
D.truncata,167897087,VNJQ01004157.1,1,2857,1.70164e-05,162153047,0.965788
D.truncata,167897087,VNJQ01002357.1,1,2857,1.70164e-05,162155904,0.965805
D.truncata,167897087,VNJQ01005418.1,1,2855,1.70045e-05,162158759,0.965822
D.truncata,167897087,VNJQ01001542.1,1,2855,1.70045e-05,162161614,0.965839
D.truncata,167897087,VNJQ01002647.1,1,2853,1.69926e-05,162164467,0.965856
D.truncata,167897087,VNJQ01004169.1,1,2852,1.69866e-05,162167319,0.965873
D.truncata,167897087,VNJQ01003873.1,1,2850,1.69747e-05,162170169,0.96589
D.truncata,167897087,VNJQ01000151.1,1,2850,1.69747e-05,162173019,0.965907
D.truncata,167897087,VNJQ01006939.1,1,2849,1.69687e-05,162175868,0.965924
D.truncata,167897087,VNJQ01003081.1,1,2849,1.69687e-05,162178717,0.965941
D.truncata,167897087,VNJQ01007684.1,1,2848,1.69628e-05,162181565,0.965958
D.truncata,167897087,VNJQ01007594.1,1,2848,1.69628e-05,162184413,0.965975
D.truncata,167897087,VNJQ01004584.1,1,2848,1.69628e-05,162187261,0.965992
D.truncata,167897087,VNJQ01000278.1,1,2848,1.69628e-05,162190109,0.966009
D.truncata,167897087,VNJQ01005669.1,1,2847,1.69568e-05,162192956,0.966026
D.truncata,167897087,VNJQ01005462.1,1,2847,1.69568e-05,162195803,0.966043
D.truncata,167897087,VNJQ01004270.1,1,2847,1.69568e-05,162198650,0.96606
D.truncata,167897087,VNJQ01002500.1,1,2847,1.69568e-05,162201497,0.966077
D.truncata,167897087,VNJQ01007901.1,1,2845,1.69449e-05,162204342,0.966094
D.truncata,167897087,VNJQ01006596.1,1,2845,1.69449e-05,162207187,0.966111
D.truncata,167897087,VNJQ01005087.1,1,2845,1.69449e-05,162210032,0.966128
D.truncata,167897087,VNJQ01007342.1,1,2843,1.6933e-05,162212875,0.966145
D.truncata,167897087,VNJQ01007507.1,1,2840,1.69151e-05,162215715,0.966162
D.truncata,167897087,VNJQ01001956.1,1,2839,1.69092e-05,162218554,0.966178
D.truncata,167897087,VNJQ01003885.1,1,2837,1.68973e-05,162221391,0.966195
D.truncata,167897087,VNJQ01000355.1,1,2836,1.68913e-05,162224227,0.966212
D.truncata,167897087,VNJQ01004483.1,1,2835,1.68853e-05,162227062,0.966229
D.truncata,167897087,VNJQ01003279.1,1,2834,1.68794e-05,162229896,0.966246
D.truncata,167897087,VNJQ01005169.1,1,2832,1.68675e-05,162232728,0.966263
D.truncata,167897087,VNJQ01002767.1,1,2831,1.68615e-05,162235559,0.96628
D.truncata,167897087,VNJQ01000930.1,1,2830,1.68556e-05,162238389,0.966297
D.truncata,167897087,VNJQ01006962.1,1,2827,1.68377e-05,162241216,0.966313
D.truncata,167897087,VNJQ01003496.1,1,2827,1.68377e-05,162244043,0.96633
D.truncata,167897087,VNJQ01002088.1,1,2827,1.68377e-05,162246870,0.966347
D.truncata,167897087,VNJQ01007829.1,1,2825,1.68258e-05,162249695,0.966364
D.truncata,167897087,VNJQ01004786.1,1,2825,1.68258e-05,162252520,0.966381
D.truncata,167897087,VNJQ01003091.1,1,2824,1.68198e-05,162255344,0.966398
D.truncata,167897087,VNJQ01000049.1,1,2824,1.68198e-05,162258168,0.966414
D.truncata,167897087,VNJQ01008130.1,1,2823,1.68139e-05,162260991,0.966431
D.truncata,167897087,VNJQ01001840.1,1,2822,1.68079e-05,162263813,0.966448
D.truncata,167897087,VNJQ01000348.1,1,2822,1.68079e-05,162266635,0.966465
D.truncata,167897087,VNJQ01001725.1,1,2821,1.6802e-05,162269456,0.966482
D.truncata,167897087,VNJQ01005828.1,1,2819,1.679e-05,162272275,0.966498
D.truncata,167897087,VNJQ01005013.1,1,2819,1.679e-05,162275094,0.966515
D.truncata,167897087,VNJQ01003911.1,1,2819,1.679e-05,162277913,0.966532
D.truncata,167897087,VNJQ01000931.1,1,2819,1.679e-05,162280732,0.966549
D.truncata,167897087,VNJQ01007834.1,1,2818,1.67841e-05,162283550,0.966566
D.truncata,167897087,VNJQ01005790.1,1,2817,1.67781e-05,162286367,0.966582
D.truncata,167897087,VNJQ01004983.1,1,2817,1.67781e-05,162289184,0.966599
D.truncata,167897087,VNJQ01006578.1,1,2816,1.67722e-05,162292000,0.966616
D.truncata,167897087,VNJQ01004075.1,1,2815,1.67662e-05,162294815,0.966633
D.truncata,167897087,VNJQ01003874.1,1,2815,1.67662e-05,162297630,0.966649
D.truncata,167897087,VNJQ01003493.1,1,2814,1.67603e-05,162300444,0.966666
D.truncata,167897087,VNJQ01007736.1,1,2813,1.67543e-05,162303257,0.966683
D.truncata,167897087,VNJQ01006223.1,1,2813,1.67543e-05,162306070,0.9667
D.truncata,167897087,VNJQ01001718.1,1,2813,1.67543e-05,162308883,0.966716
D.truncata,167897087,VNJQ01006106.1,1,2812,1.67484e-05,162311695,0.966733
D.truncata,167897087,VNJQ01006108.1,1,2811,1.67424e-05,162314506,0.96675
D.truncata,167897087,VNJQ01004930.1,1,2810,1.67364e-05,162317316,0.966767
D.truncata,167897087,VNJQ01001995.1,1,2809,1.67305e-05,162320125,0.966783
D.truncata,167897087,VNJQ01003236.1,1,2808,1.67245e-05,162322933,0.9668
D.truncata,167897087,VNJQ01001399.1,1,2808,1.67245e-05,162325741,0.966817
D.truncata,167897087,VNJQ01007853.1,1,2807,1.67186e-05,162328548,0.966834
D.truncata,167897087,VNJQ01007808.1,1,2807,1.67186e-05,162331355,0.96685
D.truncata,167897087,VNJQ01007534.1,1,2806,1.67126e-05,162334161,0.966867
D.truncata,167897087,VNJQ01006178.1,1,2806,1.67126e-05,162336967,0.966884
D.truncata,167897087,VNJQ01001272.1,1,2806,1.67126e-05,162339773,0.9669
D.truncata,167897087,VNJQ01002204.1,1,2804,1.67007e-05,162342577,0.966917
D.truncata,167897087,VNJQ01005756.1,1,2803,1.66948e-05,162345380,0.966934
D.truncata,167897087,VNJQ01002182.1,1,2803,1.66948e-05,162348183,0.966951
D.truncata,167897087,VNJQ01001836.1,1,2802,1.66888e-05,162350985,0.966967
D.truncata,167897087,VNJQ01000508.1,1,2802,1.66888e-05,162353787,0.966984
D.truncata,167897087,VNJQ01003950.1,1,2801,1.66828e-05,162356588,0.967001
D.truncata,167897087,VNJQ01003867.1,1,2801,1.66828e-05,162359389,0.967017
D.truncata,167897087,VNJQ01001808.1,1,2800,1.66769e-05,162362189,0.967034
D.truncata,167897087,VNJQ01000100.1,1,2800,1.66769e-05,162364989,0.967051
D.truncata,167897087,VNJQ01004658.1,1,2799,1.66709e-05,162367788,0.967067
D.truncata,167897087,VNJQ01007015.1,1,2798,1.6665e-05,162370586,0.967084
D.truncata,167897087,VNJQ01002736.1,1,2798,1.6665e-05,162373384,0.967101
D.truncata,167897087,VNJQ01004681.1,1,2797,1.6659e-05,162376181,0.967117
D.truncata,167897087,VNJQ01003625.1,1,2796,1.66531e-05,162378977,0.967134
D.truncata,167897087,VNJQ01003272.1,1,2796,1.66531e-05,162381773,0.967151
D.truncata,167897087,VNJQ01001159.1,1,2794,1.66411e-05,162384567,0.967167
D.truncata,167897087,VNJQ01007952.1,1,2792,1.66292e-05,162387359,0.967184
D.truncata,167897087,VNJQ01002745.1,1,2791,1.66233e-05,162390150,0.967201
D.truncata,167897087,VNJQ01002252.1,1,2791,1.66233e-05,162392941,0.967217
D.truncata,167897087,VNJQ01007813.1,1,2790,1.66173e-05,162395731,0.967234
D.truncata,167897087,VNJQ01007687.1,1,2790,1.66173e-05,162398521,0.96725
D.truncata,167897087,VNJQ01004256.1,1,2787,1.65995e-05,162401308,0.967267
D.truncata,167897087,VNJQ01000253.1,1,2787,1.65995e-05,162404095,0.967284
D.truncata,167897087,VNJQ01007260.1,1,2786,1.65935e-05,162406881,0.9673
D.truncata,167897087,VNJQ01005632.1,1,2786,1.65935e-05,162409667,0.967317
D.truncata,167897087,VNJQ01006251.1,1,2784,1.65816e-05,162412451,0.967333
D.truncata,167897087,VNJQ01005761.1,1,2783,1.65756e-05,162415234,0.96735
D.truncata,167897087,VNJQ01007166.1,1,2780,1.65578e-05,162418014,0.967366
D.truncata,167897087,VNJQ01002554.1,1,2780,1.65578e-05,162420794,0.967383
D.truncata,167897087,VNJQ01000674.1,1,2780,1.65578e-05,162423574,0.9674
D.truncata,167897087,VNJQ01006750.1,1,2779,1.65518e-05,162426353,0.967416
D.truncata,167897087,VNJQ01003585.1,1,2779,1.65518e-05,162429132,0.967433
D.truncata,167897087,VNJQ01007392.1,1,2778,1.65458e-05,162431910,0.967449
D.truncata,167897087,VNJQ01005860.1,1,2777,1.65399e-05,162434687,0.967466
D.truncata,167897087,VNJQ01004083.1,1,2777,1.65399e-05,162437464,0.967482
D.truncata,167897087,VNJQ01001779.1,1,2776,1.65339e-05,162440240,0.967499
D.truncata,167897087,VNJQ01001333.1,1,2776,1.65339e-05,162443016,0.967515
D.truncata,167897087,VNJQ01004869.1,1,2775,1.6528e-05,162445791,0.967532
D.truncata,167897087,VNJQ01000227.1,1,2775,1.6528e-05,162448566,0.967548
D.truncata,167897087,VNJQ01002897.1,1,2774,1.6522e-05,162451340,0.967565
D.truncata,167897087,VNJQ01004986.1,1,2773,1.65161e-05,162454113,0.967581
D.truncata,167897087,VNJQ01001964.1,1,2773,1.65161e-05,162456886,0.967598
D.truncata,167897087,VNJQ01001038.1,1,2773,1.65161e-05,162459659,0.967615
D.truncata,167897087,VNJQ01004973.1,1,2772,1.65101e-05,162462431,0.967631
D.truncata,167897087,VNJQ01001518.1,1,2770,1.64982e-05,162465201,0.967648
D.truncata,167897087,VNJQ01001082.1,1,2770,1.64982e-05,162467971,0.967664
D.truncata,167897087,VNJQ01000419.1,1,2768,1.64863e-05,162470739,0.967681
D.truncata,167897087,VNJQ01003977.1,1,2767,1.64803e-05,162473506,0.967697
D.truncata,167897087,VNJQ01006151.1,1,2765,1.64684e-05,162476271,0.967713
D.truncata,167897087,VNJQ01004876.1,1,2765,1.64684e-05,162479036,0.96773
D.truncata,167897087,VNJQ01008172.1,1,2764,1.64625e-05,162481800,0.967746
D.truncata,167897087,VNJQ01007323.1,1,2764,1.64625e-05,162484564,0.967763
D.truncata,167897087,VNJQ01004354.1,1,2764,1.64625e-05,162487328,0.967779
D.truncata,167897087,VNJQ01005956.1,1,2763,1.64565e-05,162490091,0.967796
D.truncata,167897087,VNJQ01001711.1,1,2763,1.64565e-05,162492854,0.967812
D.truncata,167897087,VNJQ01007413.1,1,2761,1.64446e-05,162495615,0.967829
D.truncata,167897087,VNJQ01005903.1,1,2761,1.64446e-05,162498376,0.967845
D.truncata,167897087,VNJQ01003788.1,1,2761,1.64446e-05,162501137,0.967862
D.truncata,167897087,VNJQ01000438.1,1,2761,1.64446e-05,162503898,0.967878
D.truncata,167897087,VNJQ01006890.1,1,2760,1.64386e-05,162506658,0.967894
D.truncata,167897087,VNJQ01007037.1,1,2759,1.64327e-05,162509417,0.967911
D.truncata,167897087,VNJQ01006129.1,1,2759,1.64327e-05,162512176,0.967927
D.truncata,167897087,VNJQ01004014.1,1,2759,1.64327e-05,162514935,0.967944
D.truncata,167897087,VNJQ01004581.1,1,2757,1.64208e-05,162517692,0.96796
D.truncata,167897087,VNJQ01004392.1,1,2755,1.64089e-05,162520447,0.967977
D.truncata,167897087,VNJQ01003793.1,1,2755,1.64089e-05,162523202,0.967993
D.truncata,167897087,VNJQ01006382.1,1,2754,1.64029e-05,162525956,0.968009
D.truncata,167897087,VNJQ01001095.1,1,2752,1.6391e-05,162528708,0.968026
D.truncata,167897087,VNJQ01004981.1,1,2751,1.6385e-05,162531459,0.968042
D.truncata,167897087,VNJQ01000581.1,1,2751,1.6385e-05,162534210,0.968059
D.truncata,167897087,VNJQ01003940.1,1,2750,1.63791e-05,162536960,0.968075
D.truncata,167897087,VNJQ01003424.1,1,2750,1.63791e-05,162539710,0.968091
D.truncata,167897087,VNJQ01001496.1,1,2749,1.63731e-05,162542459,0.968108
D.truncata,167897087,VNJQ01007470.1,1,2746,1.63553e-05,162545205,0.968124
D.truncata,167897087,VNJQ01007208.1,1,2746,1.63553e-05,162547951,0.96814
D.truncata,167897087,VNJQ01006060.1,1,2746,1.63553e-05,162550697,0.968157
D.truncata,167897087,VNJQ01004374.1,1,2746,1.63553e-05,162553443,0.968173
D.truncata,167897087,VNJQ01008192.1,1,2744,1.63433e-05,162556187,0.968189
D.truncata,167897087,VNJQ01007089.1,1,2743,1.63374e-05,162558930,0.968206
D.truncata,167897087,VNJQ01004233.1,1,2743,1.63374e-05,162561673,0.968222
D.truncata,167897087,VNJQ01004578.1,1,2742,1.63314e-05,162564415,0.968238
D.truncata,167897087,VNJQ01002825.1,1,2741,1.63255e-05,162567156,0.968255
D.truncata,167897087,VNJQ01001379.1,1,2740,1.63195e-05,162569896,0.968271
D.truncata,167897087,VNJQ01003628.1,1,2739,1.63136e-05,162572635,0.968287
D.truncata,167897087,VNJQ01002772.1,1,2739,1.63136e-05,162575374,0.968304
D.truncata,167897087,VNJQ01007794.1,1,2738,1.63076e-05,162578112,0.96832
D.truncata,167897087,VNJQ01004489.1,1,2737,1.63017e-05,162580849,0.968336
D.truncata,167897087,VNJQ01002560.1,1,2737,1.63017e-05,162583586,0.968353
D.truncata,167897087,VNJQ01005494.1,1,2734,1.62838e-05,162586320,0.968369
D.truncata,167897087,VNJQ01002019.1,1,2734,1.62838e-05,162589054,0.968385
D.truncata,167897087,VNJQ01001715.1,1,2733,1.62778e-05,162591787,0.968401
D.truncata,167897087,VNJQ01003602.1,1,2732,1.62719e-05,162594519,0.968418
D.truncata,167897087,VNJQ01001757.1,1,2732,1.62719e-05,162597251,0.968434
D.truncata,167897087,VNJQ01004307.1,1,2731,1.62659e-05,162599982,0.96845
D.truncata,167897087,VNJQ01001081.1,1,2730,1.626e-05,162602712,0.968467
D.truncata,167897087,VNJQ01005925.1,1,2729,1.6254e-05,162605441,0.968483
D.truncata,167897087,VNJQ01005459.1,1,2727,1.62421e-05,162608168,0.968499
D.truncata,167897087,VNJQ01004286.1,1,2727,1.62421e-05,162610895,0.968515
D.truncata,167897087,VNJQ01002313.1,1,2727,1.62421e-05,162613622,0.968532
D.truncata,167897087,VNJQ01002096.1,1,2727,1.62421e-05,162616349,0.968548
D.truncata,167897087,VNJQ01003088.1,1,2725,1.62302e-05,162619074,0.968564
D.truncata,167897087,VNJQ01004653.1,1,2724,1.62242e-05,162621798,0.96858
D.truncata,167897087,VNJQ01000940.1,1,2723,1.62183e-05,162624521,0.968596
D.truncata,167897087,VNJQ01002352.1,1,2721,1.62064e-05,162627242,0.968613
D.truncata,167897087,VNJQ01005527.1,1,2720,1.62004e-05,162629962,0.968629
D.truncata,167897087,VNJQ01003937.1,1,2720,1.62004e-05,162632682,0.968645
D.truncata,167897087,VNJQ01002290.1,1,2718,1.61885e-05,162635400,0.968661
D.truncata,167897087,VNJQ01003386.1,1,2717,1.61825e-05,162638117,0.968677
D.truncata,167897087,VNJQ01002596.1,1,2717,1.61825e-05,162640834,0.968694
D.truncata,167897087,VNJQ01005439.1,1,2716,1.61766e-05,162643550,0.96871
D.truncata,167897087,VNJQ01005396.1,1,2715,1.61706e-05,162646265,0.968726
D.truncata,167897087,VNJQ01006495.1,1,2712,1.61528e-05,162648977,0.968742
D.truncata,167897087,VNJQ01007011.1,1,2711,1.61468e-05,162651688,0.968758
D.truncata,167897087,VNJQ01003510.1,1,2711,1.61468e-05,162654399,0.968774
D.truncata,167897087,VNJQ01001856.1,1,2711,1.61468e-05,162657110,0.968791
D.truncata,167897087,VNJQ01001838.1,1,2710,1.61408e-05,162659820,0.968807
D.truncata,167897087,VNJQ01000409.1,1,2710,1.61408e-05,162662530,0.968823
D.truncata,167897087,VNJQ01000210.1,1,2707,1.6123e-05,162665237,0.968839
D.truncata,167897087,VNJQ01007997.1,1,2706,1.6117e-05,162667943,0.968855
D.truncata,167897087,VNJQ01001522.1,1,2706,1.6117e-05,162670649,0.968871
D.truncata,167897087,VNJQ01007671.1,1,2702,1.60932e-05,162673351,0.968887
D.truncata,167897087,VNJQ01007554.1,1,2702,1.60932e-05,162676053,0.968903
D.truncata,167897087,VNJQ01007444.1,1,2702,1.60932e-05,162678755,0.968919
D.truncata,167897087,VNJQ01006783.1,1,2700,1.60813e-05,162681455,0.968936
D.truncata,167897087,VNJQ01004819.1,1,2699,1.60753e-05,162684154,0.968952
D.truncata,167897087,VNJQ01006468.1,1,2698,1.60694e-05,162686852,0.968968
D.truncata,167897087,VNJQ01004237.1,1,2698,1.60694e-05,162689550,0.968984
D.truncata,167897087,VNJQ01005465.1,1,2694,1.60455e-05,162692244,0.969
D.truncata,167897087,VNJQ01007963.1,1,2693,1.60396e-05,162694937,0.969016
D.truncata,167897087,VNJQ01007832.1,1,2693,1.60396e-05,162697630,0.969032
D.truncata,167897087,VNJQ01003943.1,1,2693,1.60396e-05,162700323,0.969048
D.truncata,167897087,VNJQ01001176.1,1,2693,1.60396e-05,162703016,0.969064
D.truncata,167897087,VNJQ01007699.1,1,2692,1.60336e-05,162705708,0.96908
D.truncata,167897087,VNJQ01005095.1,1,2692,1.60336e-05,162708400,0.969096
D.truncata,167897087,VNJQ01001830.1,1,2691,1.60277e-05,162711091,0.969112
D.truncata,167897087,VNJQ01005163.1,1,2689,1.60158e-05,162713780,0.969128
D.truncata,167897087,VNJQ01002404.1,1,2688,1.60098e-05,162716468,0.969144
D.truncata,167897087,VNJQ01000839.1,1,2688,1.60098e-05,162719156,0.96916
D.truncata,167897087,VNJQ01000490.1,1,2688,1.60098e-05,162721844,0.969176
D.truncata,167897087,VNJQ01006222.1,1,2687,1.60039e-05,162724531,0.969192
D.truncata,167897087,VNJQ01004841.1,1,2686,1.59979e-05,162727217,0.969208
D.truncata,167897087,VNJQ01003299.1,1,2685,1.59919e-05,162729902,0.969224
D.truncata,167897087,VNJQ01005974.1,1,2680,1.59622e-05,162732582,0.96924
D.truncata,167897087,VNJQ01002417.1,1,2679,1.59562e-05,162735261,0.969256
D.truncata,167897087,VNJQ01006433.1,1,2678,1.59502e-05,162737939,0.969272
D.truncata,167897087,VNJQ01005417.1,1,2678,1.59502e-05,162740617,0.969288
D.truncata,167897087,VNJQ01001164.1,1,2678,1.59502e-05,162743295,0.969304
D.truncata,167897087,VNJQ01000470.1,1,2678,1.59502e-05,162745973,0.96932
D.truncata,167897087,VNJQ01000206.1,1,2677,1.59443e-05,162748650,0.969336
D.truncata,167897087,VNJQ01004573.1,1,2676,1.59383e-05,162751326,0.969352
D.truncata,167897087,VNJQ01000422.1,1,2676,1.59383e-05,162754002,0.969368
D.truncata,167897087,VNJQ01007075.1,1,2675,1.59324e-05,162756677,0.969384
D.truncata,167897087,VNJQ01004313.1,1,2675,1.59324e-05,162759352,0.969399
D.truncata,167897087,VNJQ01002157.1,1,2675,1.59324e-05,162762027,0.969415
D.truncata,167897087,VNJQ01000785.1,1,2675,1.59324e-05,162764702,0.969431
D.truncata,167897087,VNJQ01007797.1,1,2672,1.59145e-05,162767374,0.969447
D.truncata,167897087,VNJQ01006853.1,1,2672,1.59145e-05,162770046,0.969463
D.truncata,167897087,VNJQ01004073.1,1,2672,1.59145e-05,162772718,0.969479
D.truncata,167897087,VNJQ01007804.1,1,2670,1.59026e-05,162775388,0.969495
D.truncata,167897087,VNJQ01002159.1,1,2670,1.59026e-05,162778058,0.969511
D.truncata,167897087,VNJQ01007843.1,1,2669,1.58966e-05,162780727,0.969527
D.truncata,167897087,VNJQ01000012.1,1,2669,1.58966e-05,162783396,0.969543
D.truncata,167897087,VNJQ01002127.1,1,2668,1.58907e-05,162786064,0.969559
D.truncata,167897087,VNJQ01005980.1,1,2666,1.58788e-05,162788730,0.969574
D.truncata,167897087,VNJQ01004794.1,1,2666,1.58788e-05,162791396,0.96959
D.truncata,167897087,VNJQ01006146.1,1,2665,1.58728e-05,162794061,0.969606
D.truncata,167897087,VNJQ01006188.1,1,2664,1.58669e-05,162796725,0.969622
D.truncata,167897087,VNJQ01004176.1,1,2664,1.58669e-05,162799389,0.969638
D.truncata,167897087,VNJQ01000569.1,1,2664,1.58669e-05,162802053,0.969654
D.truncata,167897087,VNJQ01000589.1,1,2663,1.58609e-05,162804716,0.96967
D.truncata,167897087,VNJQ01007432.1,1,2662,1.5855e-05,162807378,0.969686
D.truncata,167897087,VNJQ01003729.1,1,2662,1.5855e-05,162810040,0.969701
D.truncata,167897087,VNJQ01003938.1,1,2660,1.5843e-05,162812700,0.969717
D.truncata,167897087,VNJQ01005507.1,1,2659,1.58371e-05,162815359,0.969733
D.truncata,167897087,VNJQ01007343.1,1,2657,1.58252e-05,162818016,0.969749
D.truncata,167897087,VNJQ01006949.1,1,2656,1.58192e-05,162820672,0.969765
D.truncata,167897087,VNJQ01006224.1,1,2656,1.58192e-05,162823328,0.969781
D.truncata,167897087,VNJQ01007592.1,1,2654,1.58073e-05,162825982,0.969796
D.truncata,167897087,VNJQ01007383.1,1,2654,1.58073e-05,162828636,0.969812
D.truncata,167897087,VNJQ01003145.1,1,2654,1.58073e-05,162831290,0.969828
D.truncata,167897087,VNJQ01004485.1,1,2653,1.58013e-05,162833943,0.969844
D.truncata,167897087,VNJQ01007517.1,1,2649,1.57775e-05,162836592,0.96986
D.truncata,167897087,VNJQ01006404.1,1,2648,1.57716e-05,162839240,0.969875
D.truncata,167897087,VNJQ01005907.1,1,2648,1.57716e-05,162841888,0.969891
D.truncata,167897087,VNJQ01004840.1,1,2648,1.57716e-05,162844536,0.969907
D.truncata,167897087,VNJQ01001678.1,1,2647,1.57656e-05,162847183,0.969923
D.truncata,167897087,VNJQ01000896.1,1,2647,1.57656e-05,162849830,0.969938
D.truncata,167897087,VNJQ01006373.1,1,2646,1.57597e-05,162852476,0.969954
D.truncata,167897087,VNJQ01006637.1,1,2645,1.57537e-05,162855121,0.96997
D.truncata,167897087,VNJQ01001888.1,1,2645,1.57537e-05,162857766,0.969986
D.truncata,167897087,VNJQ01005165.1,1,2643,1.57418e-05,162860409,0.970001
D.truncata,167897087,VNJQ01002652.1,1,2641,1.57299e-05,162863050,0.970017
D.truncata,167897087,VNJQ01008160.1,1,2640,1.57239e-05,162865690,0.970033
D.truncata,167897087,VNJQ01003921.1,1,2640,1.57239e-05,162868330,0.970049
D.truncata,167897087,VNJQ01002933.1,1,2640,1.57239e-05,162870970,0.970064
D.truncata,167897087,VNJQ01008027.1,1,2639,1.5718e-05,162873609,0.97008
D.truncata,167897087,VNJQ01002433.1,1,2639,1.5718e-05,162876248,0.970096
D.truncata,167897087,VNJQ01005318.1,1,2638,1.5712e-05,162878886,0.970111
D.truncata,167897087,VNJQ01003340.1,1,2637,1.5706e-05,162881523,0.970127
D.truncata,167897087,VNJQ01002094.1,1,2637,1.5706e-05,162884160,0.970143
D.truncata,167897087,VNJQ01002492.1,1,2636,1.57001e-05,162886796,0.970159
D.truncata,167897087,VNJQ01000782.1,1,2636,1.57001e-05,162889432,0.970174
D.truncata,167897087,VNJQ01007427.1,1,2635,1.56941e-05,162892067,0.97019
D.truncata,167897087,VNJQ01005471.1,1,2635,1.56941e-05,162894702,0.970206
D.truncata,167897087,VNJQ01004315.1,1,2635,1.56941e-05,162897337,0.970221
D.truncata,167897087,VNJQ01004461.1,1,2634,1.56882e-05,162899971,0.970237
D.truncata,167897087,VNJQ01004106.1,1,2632,1.56763e-05,162902603,0.970253
D.truncata,167897087,VNJQ01001605.1,1,2632,1.56763e-05,162905235,0.970268
D.truncata,167897087,VNJQ01000098.1,1,2629,1.56584e-05,162907864,0.970284
D.truncata,167897087,VNJQ01006378.1,1,2628,1.56524e-05,162910492,0.9703
D.truncata,167897087,VNJQ01004818.1,1,2627,1.56465e-05,162913119,0.970315
D.truncata,167897087,VNJQ01003772.1,1,2626,1.56405e-05,162915745,0.970331
D.truncata,167897087,VNJQ01008181.1,1,2625,1.56346e-05,162918370,0.970347
D.truncata,167897087,VNJQ01007226.1,1,2624,1.56286e-05,162920994,0.970362
D.truncata,167897087,VNJQ01003974.1,1,2624,1.56286e-05,162923618,0.970378
D.truncata,167897087,VNJQ01001646.1,1,2624,1.56286e-05,162926242,0.970394
D.truncata,167897087,VNJQ01008095.1,1,2623,1.56227e-05,162928865,0.970409
D.truncata,167897087,VNJQ01001462.1,1,2623,1.56227e-05,162931488,0.970425
D.truncata,167897087,VNJQ01004274.1,1,2622,1.56167e-05,162934110,0.97044
D.truncata,167897087,VNJQ01002072.1,1,2622,1.56167e-05,162936732,0.970456
D.truncata,167897087,VNJQ01005573.1,1,2621,1.56108e-05,162939353,0.970472
D.truncata,167897087,VNJQ01008155.1,1,2620,1.56048e-05,162941973,0.970487
D.truncata,167897087,VNJQ01008127.1,1,2620,1.56048e-05,162944593,0.970503
D.truncata,167897087,VNJQ01008118.1,1,2620,1.56048e-05,162947213,0.970518
D.truncata,167897087,VNJQ01005904.1,1,2620,1.56048e-05,162949833,0.970534
D.truncata,167897087,VNJQ01004656.1,1,2619,1.55988e-05,162952452,0.97055
D.truncata,167897087,VNJQ01003431.1,1,2619,1.55988e-05,162955071,0.970565
D.truncata,167897087,VNJQ01001335.1,1,2619,1.55988e-05,162957690,0.970581
D.truncata,167897087,VNJQ01006656.1,1,2618,1.55929e-05,162960308,0.970596
D.truncata,167897087,VNJQ01006587.1,1,2617,1.55869e-05,162962925,0.970612
D.truncata,167897087,VNJQ01004309.1,1,2617,1.55869e-05,162965542,0.970628
D.truncata,167897087,VNJQ01001837.1,1,2617,1.55869e-05,162968159,0.970643
D.truncata,167897087,VNJQ01006601.1,1,2616,1.5581e-05,162970775,0.970659
D.truncata,167897087,VNJQ01002467.1,1,2615,1.5575e-05,162973390,0.970674
D.truncata,167897087,VNJQ01008138.1,1,2612,1.55571e-05,162976002,0.97069
D.truncata,167897087,VNJQ01001961.1,1,2612,1.55571e-05,162978614,0.970705
D.truncata,167897087,VNJQ01004231.1,1,2610,1.55452e-05,162981224,0.970721
D.truncata,167897087,VNJQ01003065.1,1,2610,1.55452e-05,162983834,0.970737
D.truncata,167897087,VNJQ01001161.1,1,2609,1.55393e-05,162986443,0.970752
D.truncata,167897087,VNJQ01002480.1,1,2608,1.55333e-05,162989051,0.970768
D.truncata,167897087,VNJQ01001721.1,1,2608,1.55333e-05,162991659,0.970783
D.truncata,167897087,VNJQ01000382.1,1,2607,1.55274e-05,162994266,0.970799
D.truncata,167897087,VNJQ01003051.1,1,2606,1.55214e-05,162996872,0.970814
D.truncata,167897087,VNJQ01002687.1,1,2606,1.55214e-05,162999478,0.97083
D.truncata,167897087,VNJQ01005737.1,1,2603,1.55035e-05,163002081,0.970845
D.truncata,167897087,VNJQ01004019.1,1,2601,1.54916e-05,163004682,0.970861
D.truncata,167897087,VNJQ01002670.1,1,2601,1.54916e-05,163007283,0.970876
D.truncata,167897087,VNJQ01001434.1,1,2601,1.54916e-05,163009884,0.970892
D.truncata,167897087,VNJQ01004588.1,1,2600,1.54857e-05,163012484,0.970907
D.truncata,167897087,VNJQ01007103.1,1,2599,1.54797e-05,163015083,0.970923
D.truncata,167897087,VNJQ01001078.1,1,2599,1.54797e-05,163017682,0.970938
D.truncata,167897087,VNJQ01007575.1,1,2598,1.54738e-05,163020280,0.970954
D.truncata,167897087,VNJQ01006882.1,1,2597,1.54678e-05,163022877,0.970969
D.truncata,167897087,VNJQ01005345.1,1,2597,1.54678e-05,163025474,0.970985
D.truncata,167897087,VNJQ01001819.1,1,2596,1.54619e-05,163028070,0.971
D.truncata,167897087,VNJQ01001940.1,1,2595,1.54559e-05,163030665,0.971015
D.truncata,167897087,VNJQ01007606.1,1,2594,1.54499e-05,163033259,0.971031
D.truncata,167897087,VNJQ01006942.1,1,2594,1.54499e-05,163035853,0.971046
D.truncata,167897087,VNJQ01004774.1,1,2594,1.54499e-05,163038447,0.971062
D.truncata,167897087,VNJQ01004080.1,1,2592,1.5438e-05,163041039,0.971077
D.truncata,167897087,VNJQ01008067.1,1,2590,1.54261e-05,163043629,0.971093
D.truncata,167897087,VNJQ01005096.1,1,2590,1.54261e-05,163046219,0.971108
D.truncata,167897087,VNJQ01004766.1,1,2590,1.54261e-05,163048809,0.971124
D.truncata,167897087,VNJQ01006743.1,1,2589,1.54202e-05,163051398,0.971139
D.truncata,167897087,VNJQ01001773.1,1,2589,1.54202e-05,163053987,0.971154
D.truncata,167897087,VNJQ01003015.1,1,2588,1.54142e-05,163056575,0.97117
D.truncata,167897087,VNJQ01006477.1,1,2587,1.54082e-05,163059162,0.971185
D.truncata,167897087,VNJQ01006194.1,1,2587,1.54082e-05,163061749,0.971201
D.truncata,167897087,VNJQ01005691.1,1,2586,1.54023e-05,163064335,0.971216
D.truncata,167897087,VNJQ01007980.1,1,2585,1.53963e-05,163066920,0.971231
D.truncata,167897087,VNJQ01005906.1,1,2585,1.53963e-05,163069505,0.971247
D.truncata,167897087,VNJQ01004825.1,1,2584,1.53904e-05,163072089,0.971262
D.truncata,167897087,VNJQ01003495.1,1,2584,1.53904e-05,163074673,0.971278
D.truncata,167897087,VNJQ01006966.1,1,2583,1.53844e-05,163077256,0.971293
D.truncata,167897087,VNJQ01002730.1,1,2583,1.53844e-05,163079839,0.971308
D.truncata,167897087,VNJQ01008151.1,1,2582,1.53785e-05,163082421,0.971324
D.truncata,167897087,VNJQ01006310.1,1,2582,1.53785e-05,163085003,0.971339
D.truncata,167897087,VNJQ01003159.1,1,2581,1.53725e-05,163087584,0.971354
D.truncata,167897087,VNJQ01001215.1,1,2581,1.53725e-05,163090165,0.97137
D.truncata,167897087,VNJQ01007894.1,1,2580,1.53666e-05,163092745,0.971385
D.truncata,167897087,VNJQ01005245.1,1,2580,1.53666e-05,163095325,0.971401
D.truncata,167897087,VNJQ01006157.1,1,2579,1.53606e-05,163097904,0.971416
D.truncata,167897087,VNJQ01005814.1,1,2578,1.53546e-05,163100482,0.971431
D.truncata,167897087,VNJQ01003217.1,1,2577,1.53487e-05,163103059,0.971447
D.truncata,167897087,VNJQ01003066.1,1,2577,1.53487e-05,163105636,0.971462
D.truncata,167897087,VNJQ01001848.1,1,2577,1.53487e-05,163108213,0.971477
D.truncata,167897087,VNJQ01002107.1,1,2575,1.53368e-05,163110788,0.971493
D.truncata,167897087,VNJQ01001756.1,1,2575,1.53368e-05,163113363,0.971508
D.truncata,167897087,VNJQ01002791.1,1,2573,1.53249e-05,163115936,0.971523
D.truncata,167897087,VNJQ01004393.1,1,2571,1.5313e-05,163118507,0.971539
D.truncata,167897087,VNJQ01005080.1,1,2570,1.5307e-05,163121077,0.971554
D.truncata,167897087,VNJQ01004583.1,1,2570,1.5307e-05,163123647,0.971569
D.truncata,167897087,VNJQ01003606.1,1,2568,1.52951e-05,163126215,0.971585
D.truncata,167897087,VNJQ01002515.1,1,2567,1.52891e-05,163128782,0.9716
D.truncata,167897087,VNJQ01003429.1,1,2565,1.52772e-05,163131347,0.971615
D.truncata,167897087,VNJQ01000572.1,1,2563,1.52653e-05,163133910,0.97163
D.truncata,167897087,VNJQ01002643.1,1,2562,1.52593e-05,163136472,0.971646
D.truncata,167897087,VNJQ01007845.1,1,2561,1.52534e-05,163139033,0.971661
D.truncata,167897087,VNJQ01006658.1,1,2561,1.52534e-05,163141594,0.971676
D.truncata,167897087,VNJQ01000515.1,1,2561,1.52534e-05,163144155,0.971691
D.truncata,167897087,VNJQ01005894.1,1,2560,1.52474e-05,163146715,0.971707
D.truncata,167897087,VNJQ01007972.1,1,2558,1.52355e-05,163149273,0.971722
D.truncata,167897087,VNJQ01006008.1,1,2558,1.52355e-05,163151831,0.971737
D.truncata,167897087,VNJQ01007664.1,1,2555,1.52177e-05,163154386,0.971752
D.truncata,167897087,VNJQ01005390.1,1,2555,1.52177e-05,163156941,0.971768
D.truncata,167897087,VNJQ01003020.1,1,2555,1.52177e-05,163159496,0.971783
D.truncata,167897087,VNJQ01005634.1,1,2554,1.52117e-05,163162050,0.971798
D.truncata,167897087,VNJQ01002865.1,1,2554,1.52117e-05,163164604,0.971813
D.truncata,167897087,VNJQ01001071.1,1,2554,1.52117e-05,163167158,0.971828
D.truncata,167897087,VNJQ01005682.1,1,2553,1.52057e-05,163169711,0.971844
D.truncata,167897087,VNJQ01002483.1,1,2553,1.52057e-05,163172264,0.971859
D.truncata,167897087,VNJQ01001087.1,1,2553,1.52057e-05,163174817,0.971874
D.truncata,167897087,VNJQ01006176.1,1,2549,1.51819e-05,163177366,0.971889
D.truncata,167897087,VNJQ01002884.1,1,2548,1.5176e-05,163179914,0.971904
D.truncata,167897087,VNJQ01000276.1,1,2548,1.5176e-05,163182462,0.97192
D.truncata,167897087,VNJQ01008109.1,1,2547,1.517e-05,163185009,0.971935
D.truncata,167897087,VNJQ01006726.1,1,2547,1.517e-05,163187556,0.97195
D.truncata,167897087,VNJQ01001630.1,1,2547,1.517e-05,163190103,0.971965
D.truncata,167897087,VNJQ01005958.1,1,2543,1.51462e-05,163192646,0.97198
D.truncata,167897087,VNJQ01000343.1,1,2543,1.51462e-05,163195189,0.971995
D.truncata,167897087,VNJQ01001184.1,1,2542,1.51402e-05,163197731,0.97201
D.truncata,167897087,VNJQ01000170.1,1,2541,1.51343e-05,163200272,0.972026
D.truncata,167897087,VNJQ01006536.1,1,2538,1.51164e-05,163202810,0.972041
D.truncata,167897087,VNJQ01002200.1,1,2538,1.51164e-05,163205348,0.972056
D.truncata,167897087,VNJQ01000045.1,1,2538,1.51164e-05,163207886,0.972071
D.truncata,167897087,VNJQ01004255.1,1,2537,1.51104e-05,163210423,0.972086
D.truncata,167897087,VNJQ01002799.1,1,2537,1.51104e-05,163212960,0.972101
D.truncata,167897087,VNJQ01007408.1,1,2536,1.51045e-05,163215496,0.972116
D.truncata,167897087,VNJQ01001929.1,1,2536,1.51045e-05,163218032,0.972131
D.truncata,167897087,VNJQ01005568.1,1,2534,1.50926e-05,163220566,0.972147
D.truncata,167897087,VNJQ01002810.1,1,2534,1.50926e-05,163223100,0.972162
D.truncata,167897087,VNJQ01000507.1,1,2534,1.50926e-05,163225634,0.972177
D.truncata,167897087,VNJQ01004398.1,1,2533,1.50866e-05,163228167,0.972192
D.truncata,167897087,VNJQ01002757.1,1,2533,1.50866e-05,163230700,0.972207
D.truncata,167897087,VNJQ01006784.1,1,2531,1.50747e-05,163233231,0.972222
D.truncata,167897087,VNJQ01008039.1,1,2530,1.50688e-05,163235761,0.972237
D.truncata,167897087,VNJQ01003865.1,1,2530,1.50688e-05,163238291,0.972252
D.truncata,167897087,VNJQ01000987.1,1,2530,1.50688e-05,163240821,0.972267
D.truncata,167897087,VNJQ01006819.1,1,2528,1.50568e-05,163243349,0.972282
D.truncata,167897087,VNJQ01005052.1,1,2527,1.50509e-05,163245876,0.972297
D.truncata,167897087,VNJQ01003335.1,1,2526,1.50449e-05,163248402,0.972312
D.truncata,167897087,VNJQ01005588.1,1,2523,1.50271e-05,163250925,0.972327
D.truncata,167897087,VNJQ01007769.1,1,2522,1.50211e-05,163253447,0.972342
D.truncata,167897087,VNJQ01000652.1,1,2522,1.50211e-05,163255969,0.972357
D.truncata,167897087,VNJQ01007431.1,1,2521,1.50152e-05,163258490,0.972372
D.truncata,167897087,VNJQ01004059.1,1,2521,1.50152e-05,163261011,0.972387
D.truncata,167897087,VNJQ01000248.1,1,2521,1.50152e-05,163263532,0.972402
D.truncata,167897087,VNJQ01003872.1,1,2519,1.50032e-05,163266051,0.972417
D.truncata,167897087,VNJQ01002920.1,1,2519,1.50032e-05,163268570,0.972432
D.truncata,167897087,VNJQ01001178.1,1,2519,1.50032e-05,163271089,0.972447
D.truncata,167897087,VNJQ01000819.1,1,2519,1.50032e-05,163273608,0.972462
D.truncata,167897087,VNJQ01002903.1,1,2518,1.49973e-05,163276126,0.972477
D.truncata,167897087,VNJQ01001405.1,1,2518,1.49973e-05,163278644,0.972492
D.truncata,167897087,VNJQ01002691.1,1,2517,1.49913e-05,163281161,0.972507
D.truncata,167897087,VNJQ01005041.1,1,2516,1.49854e-05,163283677,0.972522
D.truncata,167897087,VNJQ01004710.1,1,2516,1.49854e-05,163286193,0.972537
D.truncata,167897087,VNJQ01007199.1,1,2514,1.49735e-05,163288707,0.972552
D.truncata,167897087,VNJQ01003948.1,1,2513,1.49675e-05,163291220,0.972567
D.truncata,167897087,VNJQ01001266.1,1,2512,1.49615e-05,163293732,0.972582
D.truncata,167897087,VNJQ01000205.1,1,2512,1.49615e-05,163296244,0.972597
D.truncata,167897087,VNJQ01007960.1,1,2510,1.49496e-05,163298754,0.972612
D.truncata,167897087,VNJQ01003951.1,1,2510,1.49496e-05,163301264,0.972627
D.truncata,167897087,VNJQ01003003.1,1,2510,1.49496e-05,163303774,0.972642
D.truncata,167897087,VNJQ01004868.1,1,2507,1.49318e-05,163306281,0.972657
D.truncata,167897087,VNJQ01005931.1,1,2505,1.49199e-05,163308786,0.972672
D.truncata,167897087,VNJQ01000804.1,1,2504,1.49139e-05,163311290,0.972687
D.truncata,167897087,VNJQ01004369.1,1,2502,1.4902e-05,163313792,0.972702
D.truncata,167897087,VNJQ01007434.1,1,2501,1.4896e-05,163316293,0.972717
D.truncata,167897087,VNJQ01006083.1,1,2501,1.4896e-05,163318794,0.972732
D.truncata,167897087,VNJQ01005803.1,1,2501,1.4896e-05,163321295,0.972746
D.truncata,167897087,VNJQ01005372.1,1,2501,1.4896e-05,163323796,0.972761
D.truncata,167897087,VNJQ01004622.1,1,2500,1.48901e-05,163326296,0.972776
D.truncata,167897087,VNJQ01003273.1,1,2500,1.48901e-05,163328796,0.972791
D.truncata,167897087,VNJQ01008175.1,1,2499,1.48841e-05,163331295,0.972806
D.truncata,167897087,VNJQ01000675.1,1,2498,1.48782e-05,163333793,0.972821
D.truncata,167897087,VNJQ01007848.1,1,2497,1.48722e-05,163336290,0.972836
D.truncata,167897087,VNJQ01002488.1,1,2497,1.48722e-05,163338787,0.972851
D.truncata,167897087,VNJQ01001317.1,1,2497,1.48722e-05,163341284,0.972866
D.truncata,167897087,VNJQ01004574.1,1,2496,1.48662e-05,163343780,0.97288
D.truncata,167897087,VNJQ01003773.1,1,2495,1.48603e-05,163346275,0.972895
D.truncata,167897087,VNJQ01006128.1,1,2494,1.48543e-05,163348769,0.97291
D.truncata,167897087,VNJQ01005999.1,1,2494,1.48543e-05,163351263,0.972925
D.truncata,167897087,VNJQ01004634.1,1,2493,1.48484e-05,163353756,0.97294
D.truncata,167897087,VNJQ01002629.1,1,2491,1.48365e-05,163356247,0.972955
D.truncata,167897087,VNJQ01007388.1,1,2490,1.48305e-05,163358737,0.972969
D.truncata,167897087,VNJQ01000734.1,1,2490,1.48305e-05,163361227,0.972984
D.truncata,167897087,VNJQ01000228.1,1,2490,1.48305e-05,163363717,0.972999
D.truncata,167897087,VNJQ01001116.1,1,2489,1.48246e-05,163366206,0.973014
D.truncata,167897087,VNJQ01003270.1,1,2488,1.48186e-05,163368694,0.973029
D.truncata,167897087,VNJQ01000970.1,1,2487,1.48126e-05,163371181,0.973044
D.truncata,167897087,VNJQ01007391.1,1,2486,1.48067e-05,163373667,0.973058
D.truncata,167897087,VNJQ01006863.1,1,2486,1.48067e-05,163376153,0.973073
D.truncata,167897087,VNJQ01008035.1,1,2485,1.48007e-05,163378638,0.973088
D.truncata,167897087,VNJQ01007031.1,1,2484,1.47948e-05,163381122,0.973103
D.truncata,167897087,VNJQ01008000.1,1,2483,1.47888e-05,163383605,0.973118
D.truncata,167897087,VNJQ01005930.1,1,2483,1.47888e-05,163386088,0.973132
D.truncata,167897087,VNJQ01005781.1,1,2483,1.47888e-05,163388571,0.973147
D.truncata,167897087,VNJQ01002881.1,1,2483,1.47888e-05,163391054,0.973162
D.truncata,167897087,VNJQ01000983.1,1,2483,1.47888e-05,163393537,0.973177
D.truncata,167897087,VNJQ01007257.1,1,2482,1.47829e-05,163396019,0.973192
D.truncata,167897087,VNJQ01006590.1,1,2482,1.47829e-05,163398501,0.973206
D.truncata,167897087,VNJQ01004589.1,1,2480,1.4771e-05,163400981,0.973221
D.truncata,167897087,VNJQ01001798.1,1,2480,1.4771e-05,163403461,0.973236
D.truncata,167897087,VNJQ01005583.1,1,2479,1.4765e-05,163405940,0.973251
D.truncata,167897087,VNJQ01002542.1,1,2477,1.47531e-05,163408417,0.973265
D.truncata,167897087,VNJQ01007661.1,1,2476,1.47471e-05,163410893,0.97328
D.truncata,167897087,VNJQ01006475.1,1,2474,1.47352e-05,163413367,0.973295
D.truncata,167897087,VNJQ01003586.1,1,2474,1.47352e-05,163415841,0.97331
D.truncata,167897087,VNJQ01001018.1,1,2473,1.47293e-05,163418314,0.973324
D.truncata,167897087,VNJQ01007092.1,1,2472,1.47233e-05,163420786,0.973339
D.truncata,167897087,VNJQ01005259.1,1,2472,1.47233e-05,163423258,0.973354
D.truncata,167897087,VNJQ01000284.1,1,2472,1.47233e-05,163425730,0.973368
D.truncata,167897087,VNJQ01005718.1,1,2471,1.47173e-05,163428201,0.973383
D.truncata,167897087,VNJQ01002873.1,1,2469,1.47054e-05,163430670,0.973398
D.truncata,167897087,VNJQ01008196.1,1,2468,1.46995e-05,163433138,0.973413
D.truncata,167897087,VNJQ01000745.1,1,2468,1.46995e-05,163435606,0.973427
D.truncata,167897087,VNJQ01006781.1,1,2467,1.46935e-05,163438073,0.973442
D.truncata,167897087,VNJQ01006400.1,1,2467,1.46935e-05,163440540,0.973457
D.truncata,167897087,VNJQ01004182.1,1,2467,1.46935e-05,163443007,0.973471
D.truncata,167897087,VNJQ01002469.1,1,2467,1.46935e-05,163445474,0.973486
D.truncata,167897087,VNJQ01005125.1,1,2466,1.46876e-05,163447940,0.973501
D.truncata,167897087,VNJQ01002723.1,1,2466,1.46876e-05,163450406,0.973515
D.truncata,167897087,VNJQ01004379.1,1,2465,1.46816e-05,163452871,0.97353
D.truncata,167897087,VNJQ01002489.1,1,2465,1.46816e-05,163455336,0.973545
D.truncata,167897087,VNJQ01006817.1,1,2461,1.46578e-05,163457797,0.973559
D.truncata,167897087,VNJQ01006256.1,1,2461,1.46578e-05,163460258,0.973574
D.truncata,167897087,VNJQ01006002.1,1,2461,1.46578e-05,163462719,0.973589
D.truncata,167897087,VNJQ01006247.1,1,2460,1.46518e-05,163465179,0.973603
D.truncata,167897087,VNJQ01002585.1,1,2460,1.46518e-05,163467639,0.973618
D.truncata,167897087,VNJQ01002943.1,1,2459,1.46459e-05,163470098,0.973633
D.truncata,167897087,VNJQ01000020.1,1,2459,1.46459e-05,163472557,0.973647
D.truncata,167897087,VNJQ01007197.1,1,2458,1.46399e-05,163475015,0.973662
D.truncata,167897087,VNJQ01004015.1,1,2458,1.46399e-05,163477473,0.973677
D.truncata,167897087,VNJQ01002668.1,1,2458,1.46399e-05,163479931,0.973691
D.truncata,167897087,VNJQ01006517.1,1,2457,1.4634e-05,163482388,0.973706
D.truncata,167897087,VNJQ01004570.1,1,2456,1.4628e-05,163484844,0.973721
D.truncata,167897087,VNJQ01006365.1,1,2454,1.46161e-05,163487298,0.973735
D.truncata,167897087,VNJQ01004109.1,1,2453,1.46101e-05,163489751,0.97375
D.truncata,167897087,VNJQ01000547.1,1,2453,1.46101e-05,163492204,0.973764
D.truncata,167897087,VNJQ01006114.1,1,2452,1.46042e-05,163494656,0.973779
D.truncata,167897087,VNJQ01006238.1,1,2451,1.45982e-05,163497107,0.973794
D.truncata,167897087,VNJQ01003967.1,1,2450,1.45923e-05,163499557,0.973808
D.truncata,167897087,VNJQ01005726.1,1,2449,1.45863e-05,163502006,0.973823
D.truncata,167897087,VNJQ01006071.1,1,2448,1.45804e-05,163504454,0.973837
D.truncata,167897087,VNJQ01003410.1,1,2448,1.45804e-05,163506902,0.973852
D.truncata,167897087,VNJQ01005982.1,1,2447,1.45744e-05,163509349,0.973867
D.truncata,167897087,VNJQ01002623.1,1,2447,1.45744e-05,163511796,0.973881
D.truncata,167897087,VNJQ01004850.1,1,2446,1.45684e-05,163514242,0.973896
D.truncata,167897087,VNJQ01000287.1,1,2446,1.45684e-05,163516688,0.97391
D.truncata,167897087,VNJQ01001096.1,1,2445,1.45625e-05,163519133,0.973925
D.truncata,167897087,VNJQ01000722.1,1,2445,1.45625e-05,163521578,0.973939
D.truncata,167897087,VNJQ01004265.1,1,2444,1.45565e-05,163524022,0.973954
D.truncata,167897087,VNJQ01006731.1,1,2442,1.45446e-05,163526464,0.973968
D.truncata,167897087,VNJQ01003681.1,1,2442,1.45446e-05,163528906,0.973983
D.truncata,167897087,VNJQ01003421.1,1,2442,1.45446e-05,163531348,0.973998
D.truncata,167897087,VNJQ01000446.1,1,2442,1.45446e-05,163533790,0.974012
D.truncata,167897087,VNJQ01000067.1,1,2441,1.45387e-05,163536231,0.974027
D.truncata,167897087,VNJQ01008197.1,1,2440,1.45327e-05,163538671,0.974041
D.truncata,167897087,VNJQ01000799.1,1,2440,1.45327e-05,163541111,0.974056
D.truncata,167897087,VNJQ01006392.1,1,2439,1.45268e-05,163543550,0.97407
D.truncata,167897087,VNJQ01006308.1,1,2439,1.45268e-05,163545989,0.974085
D.truncata,167897087,VNJQ01007939.1,1,2438,1.45208e-05,163548427,0.974099
D.truncata,167897087,VNJQ01007850.1,1,2438,1.45208e-05,163550865,0.974114
D.truncata,167897087,VNJQ01001665.1,1,2438,1.45208e-05,163553303,0.974128
D.truncata,167897087,VNJQ01004567.1,1,2436,1.45089e-05,163555739,0.974143
D.truncata,167897087,VNJQ01007996.1,1,2434,1.4497e-05,163558173,0.974157
D.truncata,167897087,VNJQ01001000.1,1,2432,1.44851e-05,163560605,0.974172
D.truncata,167897087,VNJQ01002714.1,1,2431,1.44791e-05,163563036,0.974186
D.truncata,167897087,VNJQ01002728.1,1,2430,1.44732e-05,163565466,0.974201
D.truncata,167897087,VNJQ01004951.1,1,2429,1.44672e-05,163567895,0.974215
D.truncata,167897087,VNJQ01004072.1,1,2429,1.44672e-05,163570324,0.97423
D.truncata,167897087,VNJQ01001971.1,1,2429,1.44672e-05,163572753,0.974244
D.truncata,167897087,VNJQ01006219.1,1,2428,1.44612e-05,163575181,0.974259
D.truncata,167897087,VNJQ01003060.1,1,2428,1.44612e-05,163577609,0.974273
D.truncata,167897087,VNJQ01001878.1,1,2428,1.44612e-05,163580037,0.974288
D.truncata,167897087,VNJQ01003983.1,1,2427,1.44553e-05,163582464,0.974302
D.truncata,167897087,VNJQ01003559.1,1,2427,1.44553e-05,163584891,0.974316
D.truncata,167897087,VNJQ01004053.1,1,2426,1.44493e-05,163587317,0.974331
D.truncata,167897087,VNJQ01007645.1,1,2425,1.44434e-05,163589742,0.974345
D.truncata,167897087,VNJQ01005673.1,1,2425,1.44434e-05,163592167,0.97436
D.truncata,167897087,VNJQ01004978.1,1,2425,1.44434e-05,163594592,0.974374
D.truncata,167897087,VNJQ01000611.1,1,2425,1.44434e-05,163597017,0.974389
D.truncata,167897087,VNJQ01004292.1,1,2424,1.44374e-05,163599441,0.974403
D.truncata,167897087,VNJQ01007672.1,1,2423,1.44315e-05,163601864,0.974418
D.truncata,167897087,VNJQ01005535.1,1,2422,1.44255e-05,163604286,0.974432
D.truncata,167897087,VNJQ01004539.1,1,2421,1.44195e-05,163606707,0.974446
D.truncata,167897087,VNJQ01001903.1,1,2421,1.44195e-05,163609128,0.974461
D.truncata,167897087,VNJQ01007632.1,1,2420,1.44136e-05,163611548,0.974475
D.truncata,167897087,VNJQ01008031.1,1,2418,1.44017e-05,163613966,0.97449
D.truncata,167897087,VNJQ01006806.1,1,2418,1.44017e-05,163616384,0.974504
D.truncata,167897087,VNJQ01007544.1,1,2417,1.43957e-05,163618801,0.974518
D.truncata,167897087,VNJQ01002092.1,1,2417,1.43957e-05,163621218,0.974533
D.truncata,167897087,VNJQ01001870.1,1,2416,1.43898e-05,163623634,0.974547
D.truncata,167897087,VNJQ01007574.1,1,2415,1.43838e-05,163626049,0.974562
D.truncata,167897087,VNJQ01006088.1,1,2415,1.43838e-05,163628464,0.974576
D.truncata,167897087,VNJQ01001367.1,1,2414,1.43779e-05,163630878,0.97459
D.truncata,167897087,VNJQ01006996.1,1,2413,1.43719e-05,163633291,0.974605
D.truncata,167897087,VNJQ01003817.1,1,2413,1.43719e-05,163635704,0.974619
D.truncata,167897087,VNJQ01003762.1,1,2413,1.43719e-05,163638117,0.974633
D.truncata,167897087,VNJQ01001143.1,1,2413,1.43719e-05,163640530,0.974648
D.truncata,167897087,VNJQ01004509.1,1,2411,1.436e-05,163642941,0.974662
D.truncata,167897087,VNJQ01000428.1,1,2411,1.436e-05,163645352,0.974677
D.truncata,167897087,VNJQ01005608.1,1,2409,1.43481e-05,163647761,0.974691
D.truncata,167897087,VNJQ01001578.1,1,2408,1.43421e-05,163650169,0.974705
D.truncata,167897087,VNJQ01008198.1,1,2407,1.43362e-05,163652576,0.97472
D.truncata,167897087,VNJQ01007587.1,1,2407,1.43362e-05,163654983,0.974734
D.truncata,167897087,VNJQ01005960.1,1,2407,1.43362e-05,163657390,0.974748
D.truncata,167897087,VNJQ01004057.1,1,2407,1.43362e-05,163659797,0.974763
D.truncata,167897087,VNJQ01003599.1,1,2407,1.43362e-05,163662204,0.974777
D.truncata,167897087,VNJQ01000889.1,1,2407,1.43362e-05,163664611,0.974791
D.truncata,167897087,VNJQ01006688.1,1,2406,1.43302e-05,163667017,0.974806
D.truncata,167897087,VNJQ01000233.1,1,2406,1.43302e-05,163669423,0.97482
D.truncata,167897087,VNJQ01007032.1,1,2405,1.43243e-05,163671828,0.974834
D.truncata,167897087,VNJQ01003144.1,1,2405,1.43243e-05,163674233,0.974849
D.truncata,167897087,VNJQ01000842.1,1,2405,1.43243e-05,163676638,0.974863
D.truncata,167897087,VNJQ01000207.1,1,2404,1.43183e-05,163679042,0.974877
D.truncata,167897087,VNJQ01002005.1,1,2403,1.43123e-05,163681445,0.974892
D.truncata,167897087,VNJQ01005690.1,1,2402,1.43064e-05,163683847,0.974906
D.truncata,167897087,VNJQ01005480.1,1,2402,1.43064e-05,163686249,0.97492
D.truncata,167897087,VNJQ01004811.1,1,2402,1.43064e-05,163688651,0.974934
D.truncata,167897087,VNJQ01005746.1,1,2401,1.43004e-05,163691052,0.974949
D.truncata,167897087,VNJQ01005277.1,1,2400,1.42945e-05,163693452,0.974963
D.truncata,167897087,VNJQ01000104.1,1,2400,1.42945e-05,163695852,0.974977
D.truncata,167897087,VNJQ01006969.1,1,2399,1.42885e-05,163698251,0.974992
D.truncata,167897087,VNJQ01005985.1,1,2399,1.42885e-05,163700650,0.975006
D.truncata,167897087,VNJQ01002295.1,1,2398,1.42826e-05,163703048,0.97502
D.truncata,167897087,VNJQ01007638.1,1,2394,1.42587e-05,163705442,0.975034
D.truncata,167897087,VNJQ01005611.1,1,2394,1.42587e-05,163707836,0.975049
D.truncata,167897087,VNJQ01005331.1,1,2393,1.42528e-05,163710229,0.975063
D.truncata,167897087,VNJQ01000812.1,1,2393,1.42528e-05,163712622,0.975077
D.truncata,167897087,VNJQ01008048.1,1,2392,1.42468e-05,163715014,0.975091
D.truncata,167897087,VNJQ01004716.1,1,2392,1.42468e-05,163717406,0.975106
D.truncata,167897087,VNJQ01000836.1,1,2392,1.42468e-05,163719798,0.97512
D.truncata,167897087,VNJQ01007334.1,1,2391,1.42409e-05,163722189,0.975134
D.truncata,167897087,VNJQ01001019.1,1,2391,1.42409e-05,163724580,0.975148
D.truncata,167897087,VNJQ01002301.1,1,2390,1.42349e-05,163726970,0.975163
D.truncata,167897087,VNJQ01001835.1,1,2388,1.4223e-05,163729358,0.975177
D.truncata,167897087,VNJQ01007359.1,1,2387,1.4217e-05,163731745,0.975191
D.truncata,167897087,VNJQ01005198.1,1,2387,1.4217e-05,163734132,0.975205
D.truncata,167897087,VNJQ01008183.1,1,2386,1.42111e-05,163736518,0.97522
D.truncata,167897087,VNJQ01007053.1,1,2386,1.42111e-05,163738904,0.975234
D.truncata,167897087,VNJQ01002948.1,1,2385,1.42051e-05,163741289,0.975248
D.truncata,167897087,VNJQ01002552.1,1,2384,1.41992e-05,163743673,0.975262
D.truncata,167897087,VNJQ01002110.1,1,2383,1.41932e-05,163746056,0.975276
D.truncata,167897087,VNJQ01004259.1,1,2381,1.41813e-05,163748437,0.975291
D.truncata,167897087,VNJQ01007293.1,1,2380,1.41754e-05,163750817,0.975305
D.truncata,167897087,VNJQ01004415.1,1,2380,1.41754e-05,163753197,0.975319
D.truncata,167897087,VNJQ01004067.1,1,2380,1.41754e-05,163755577,0.975333
D.truncata,167897087,VNJQ01002590.1,1,2380,1.41754e-05,163757957,0.975347
D.truncata,167897087,VNJQ01002468.1,1,2380,1.41754e-05,163760337,0.975361
D.truncata,167897087,VNJQ01002832.1,1,2379,1.41694e-05,163762716,0.975376
D.truncata,167897087,VNJQ01006478.1,1,2378,1.41634e-05,163765094,0.97539
D.truncata,167897087,VNJQ01005491.1,1,2377,1.41575e-05,163767471,0.975404
D.truncata,167897087,VNJQ01001163.1,1,2377,1.41575e-05,163769848,0.975418
D.truncata,167897087,VNJQ01002466.1,1,2376,1.41515e-05,163772224,0.975432
D.truncata,167897087,VNJQ01000010.1,1,2376,1.41515e-05,163774600,0.975446
D.truncata,167897087,VNJQ01006011.1,1,2374,1.41396e-05,163776974,0.97546
D.truncata,167897087,VNJQ01001204.1,1,2373,1.41337e-05,163779347,0.975475
D.truncata,167897087,VNJQ01007310.1,1,2371,1.41217e-05,163781718,0.975489
D.truncata,167897087,VNJQ01006357.1,1,2371,1.41217e-05,163784089,0.975503
D.truncata,167897087,VNJQ01005898.1,1,2371,1.41217e-05,163786460,0.975517
D.truncata,167897087,VNJQ01003404.1,1,2371,1.41217e-05,163788831,0.975531
D.truncata,167897087,VNJQ01001942.1,1,2369,1.41098e-05,163791200,0.975545
D.truncata,167897087,VNJQ01002828.1,1,2368,1.41039e-05,163793568,0.975559
D.truncata,167897087,VNJQ01001960.1,1,2368,1.41039e-05,163795936,0.975573
D.truncata,167897087,VNJQ01007539.1,1,2367,1.40979e-05,163798303,0.975588
D.truncata,167897087,VNJQ01002345.1,1,2367,1.40979e-05,163800670,0.975602
D.truncata,167897087,VNJQ01000701.1,1,2367,1.40979e-05,163803037,0.975616
D.truncata,167897087,VNJQ01007319.1,1,2366,1.4092e-05,163805403,0.97563
D.truncata,167897087,VNJQ01004711.1,1,2366,1.4092e-05,163807769,0.975644
D.truncata,167897087,VNJQ01001679.1,1,2366,1.4092e-05,163810135,0.975658
D.truncata,167897087,VNJQ01007390.1,1,2365,1.4086e-05,163812500,0.975672
D.truncata,167897087,VNJQ01003247.1,1,2365,1.4086e-05,163814865,0.975686
D.truncata,167897087,VNJQ01006082.1,1,2364,1.40801e-05,163817229,0.9757
D.truncata,167897087,VNJQ01002419.1,1,2364,1.40801e-05,163819593,0.975714
D.truncata,167897087,VNJQ01007957.1,1,2361,1.40622e-05,163821954,0.975728
D.truncata,167897087,VNJQ01004199.1,1,2359,1.40503e-05,163824313,0.975742
D.truncata,167897087,VNJQ01007654.1,1,2358,1.40443e-05,163826671,0.975756
D.truncata,167897087,VNJQ01002121.1,1,2356,1.40324e-05,163829027,0.975771
D.truncata,167897087,VNJQ01005415.1,1,2353,1.40145e-05,163831380,0.975785
D.truncata,167897087,VNJQ01006608.1,1,2352,1.40086e-05,163833732,0.975799
D.truncata,167897087,VNJQ01001387.1,1,2351,1.40026e-05,163836083,0.975813
D.truncata,167897087,VNJQ01005347.1,1,2350,1.39967e-05,163838433,0.975827
D.truncata,167897087,VNJQ01001309.1,1,2350,1.39967e-05,163840783,0.975841
D.truncata,167897087,VNJQ01007572.1,1,2348,1.39848e-05,163843131,0.975855
D.truncata,167897087,VNJQ01003243.1,1,2348,1.39848e-05,163845479,0.975869
D.truncata,167897087,VNJQ01002755.1,1,2348,1.39848e-05,163847827,0.975882
D.truncata,167897087,VNJQ01001663.1,1,2348,1.39848e-05,163850175,0.975896
D.truncata,167897087,VNJQ01005110.1,1,2343,1.3955e-05,163852518,0.97591
D.truncata,167897087,VNJQ01005469.1,1,2342,1.3949e-05,163854860,0.975924
D.truncata,167897087,VNJQ01007146.1,1,2341,1.39431e-05,163857201,0.975938
D.truncata,167897087,VNJQ01005337.1,1,2341,1.39431e-05,163859542,0.975952
D.truncata,167897087,VNJQ01004831.1,1,2341,1.39431e-05,163861883,0.975966
D.truncata,167897087,VNJQ01002003.1,1,2341,1.39431e-05,163864224,0.97598
D.truncata,167897087,VNJQ01001752.1,1,2341,1.39431e-05,163866565,0.975994
D.truncata,167897087,VNJQ01006385.1,1,2340,1.39371e-05,163868905,0.976008
D.truncata,167897087,VNJQ01006221.1,1,2340,1.39371e-05,163871245,0.976022
D.truncata,167897087,VNJQ01007616.1,1,2339,1.39312e-05,163873584,0.976036
D.truncata,167897087,VNJQ01000081.1,1,2339,1.39312e-05,163875923,0.97605
D.truncata,167897087,VNJQ01008015.1,1,2338,1.39252e-05,163878261,0.976064
D.truncata,167897087,VNJQ01007903.1,1,2337,1.39192e-05,163880598,0.976078
D.truncata,167897087,VNJQ01002355.1,1,2337,1.39192e-05,163882935,0.976092
D.truncata,167897087,VNJQ01001802.1,1,2337,1.39192e-05,163885272,0.976106
D.truncata,167897087,VNJQ01004875.1,1,2336,1.39133e-05,163887608,0.976119
D.truncata,167897087,VNJQ01003942.1,1,2336,1.39133e-05,163889944,0.976133
D.truncata,167897087,VNJQ01000264.1,1,2336,1.39133e-05,163892280,0.976147
D.truncata,167897087,VNJQ01006905.1,1,2334,1.39014e-05,163894614,0.976161
D.truncata,167897087,VNJQ01004576.1,1,2334,1.39014e-05,163896948,0.976175
D.truncata,167897087,VNJQ01000147.1,1,2334,1.39014e-05,163899282,0.976189
D.truncata,167897087,VNJQ01007582.1,1,2333,1.38954e-05,163901615,0.976203
D.truncata,167897087,VNJQ01007277.1,1,2333,1.38954e-05,163903948,0.976217
D.truncata,167897087,VNJQ01007041.1,1,2333,1.38954e-05,163906281,0.976231
D.truncata,167897087,VNJQ01001114.1,1,2333,1.38954e-05,163908614,0.976245
D.truncata,167897087,VNJQ01001072.1,1,2333,1.38954e-05,163910947,0.976258
D.truncata,167897087,VNJQ01003737.1,1,2332,1.38895e-05,163913279,0.976272
D.truncata,167897087,VNJQ01004796.1,1,2331,1.38835e-05,163915610,0.976286
D.truncata,167897087,VNJQ01001224.1,1,2331,1.38835e-05,163917941,0.9763
D.truncata,167897087,VNJQ01005544.1,1,2329,1.38716e-05,163920270,0.976314
D.truncata,167897087,VNJQ01001861.1,1,2329,1.38716e-05,163922599,0.976328
D.truncata,167897087,VNJQ01008080.1,1,2328,1.38656e-05,163924927,0.976342
D.truncata,167897087,VNJQ01004552.1,1,2328,1.38656e-05,163927255,0.976356
D.truncata,167897087,VNJQ01002717.1,1,2328,1.38656e-05,163929583,0.976369
D.truncata,167897087,VNJQ01001604.1,1,2327,1.38597e-05,163931910,0.976383
D.truncata,167897087,VNJQ01005380.1,1,2326,1.38537e-05,163934236,0.976397
D.truncata,167897087,VNJQ01007767.1,1,2325,1.38478e-05,163936561,0.976411
D.truncata,167897087,VNJQ01003698.1,1,2325,1.38478e-05,163938886,0.976425
D.truncata,167897087,VNJQ01005599.1,1,2324,1.38418e-05,163941210,0.976439
D.truncata,167897087,VNJQ01003587.1,1,2324,1.38418e-05,163943534,0.976453
D.truncata,167897087,VNJQ01001754.1,1,2324,1.38418e-05,163945858,0.976466
D.truncata,167897087,VNJQ01001670.1,1,2324,1.38418e-05,163948182,0.97648
D.truncata,167897087,VNJQ01003008.1,1,2322,1.38299e-05,163950504,0.976494
D.truncata,167897087,VNJQ01004743.1,1,2321,1.38239e-05,163952825,0.976508
D.truncata,167897087,VNJQ01008096.1,1,2320,1.3818e-05,163955145,0.976522
D.truncata,167897087,VNJQ01005624.1,1,2320,1.3818e-05,163957465,0.976535
D.truncata,167897087,VNJQ01005059.1,1,2320,1.3818e-05,163959785,0.976549
D.truncata,167897087,VNJQ01001666.1,1,2320,1.3818e-05,163962105,0.976563
D.truncata,167897087,VNJQ01005973.1,1,2319,1.3812e-05,163964424,0.976577
D.truncata,167897087,VNJQ01004063.1,1,2319,1.3812e-05,163966743,0.976591
D.truncata,167897087,VNJQ01000272.1,1,2319,1.3812e-05,163969062,0.976605
D.truncata,167897087,VNJQ01007202.1,1,2318,1.38061e-05,163971380,0.976618
D.truncata,167897087,VNJQ01006603.1,1,2318,1.38061e-05,163973698,0.976632
D.truncata,167897087,VNJQ01007217.1,1,2317,1.38001e-05,163976015,0.976646
D.truncata,167897087,VNJQ01006744.1,1,2316,1.37942e-05,163978331,0.97666
D.truncata,167897087,VNJQ01001153.1,1,2316,1.37942e-05,163980647,0.976674
D.truncata,167897087,VNJQ01006135.1,1,2315,1.37882e-05,163982962,0.976687
D.truncata,167897087,VNJQ01006130.1,1,2315,1.37882e-05,163985277,0.976701
D.truncata,167897087,VNJQ01005518.1,1,2315,1.37882e-05,163987592,0.976715
D.truncata,167897087,VNJQ01001179.1,1,2315,1.37882e-05,163989907,0.976729
D.truncata,167897087,VNJQ01001275.1,1,2314,1.37823e-05,163992221,0.976743
D.truncata,167897087,VNJQ01000630.1,1,2314,1.37823e-05,163994535,0.976756
D.truncata,167897087,VNJQ01001884.1,1,2313,1.37763e-05,163996848,0.97677
D.truncata,167897087,VNJQ01001565.1,1,2313,1.37763e-05,163999161,0.976784
D.truncata,167897087,VNJQ01006281.1,1,2311,1.37644e-05,164001472,0.976798
D.truncata,167897087,VNJQ01001865.1,1,2311,1.37644e-05,164003783,0.976811
D.truncata,167897087,VNJQ01005225.1,1,2310,1.37584e-05,164006093,0.976825
D.truncata,167897087,VNJQ01002796.1,1,2308,1.37465e-05,164008401,0.976839
D.truncata,167897087,VNJQ01000767.1,1,2307,1.37406e-05,164010708,0.976853
D.truncata,167897087,VNJQ01006630.1,1,2306,1.37346e-05,164013014,0.976866
D.truncata,167897087,VNJQ01003941.1,1,2306,1.37346e-05,164015320,0.97688
D.truncata,167897087,VNJQ01000908.1,1,2306,1.37346e-05,164017626,0.976894
D.truncata,167897087,VNJQ01008081.1,1,2305,1.37286e-05,164019931,0.976908
D.truncata,167897087,VNJQ01007484.1,1,2305,1.37286e-05,164022236,0.976921
D.truncata,167897087,VNJQ01007626.1,1,2304,1.37227e-05,164024540,0.976935
D.truncata,167897087,VNJQ01006580.1,1,2304,1.37227e-05,164026844,0.976949
D.truncata,167897087,VNJQ01002595.1,1,2304,1.37227e-05,164029148,0.976962
D.truncata,167897087,VNJQ01002427.1,1,2304,1.37227e-05,164031452,0.976976
D.truncata,167897087,VNJQ01002317.1,1,2304,1.37227e-05,164033756,0.97699
D.truncata,167897087,VNJQ01001974.1,1,2304,1.37227e-05,164036060,0.977004
D.truncata,167897087,VNJQ01004011.1,1,2303,1.37167e-05,164038363,0.977017
D.truncata,167897087,VNJQ01003321.1,1,2303,1.37167e-05,164040666,0.977031
D.truncata,167897087,VNJQ01001733.1,1,2303,1.37167e-05,164042969,0.977045
D.truncata,167897087,VNJQ01003912.1,1,2302,1.37108e-05,164045271,0.977058
D.truncata,167897087,VNJQ01007050.1,1,2301,1.37048e-05,164047572,0.977072
D.truncata,167897087,VNJQ01006909.1,1,2301,1.37048e-05,164049873,0.977086
D.truncata,167897087,VNJQ01003971.1,1,2300,1.36989e-05,164052173,0.9771
D.truncata,167897087,VNJQ01002885.1,1,2300,1.36989e-05,164054473,0.977113
D.truncata,167897087,VNJQ01004359.1,1,2299,1.36929e-05,164056772,0.977127
D.truncata,167897087,VNJQ01003319.1,1,2299,1.36929e-05,164059071,0.977141
D.truncata,167897087,VNJQ01001135.1,1,2298,1.3687e-05,164061369,0.977154
D.truncata,167897087,VNJQ01004188.1,1,2296,1.3675e-05,164063665,0.977168
D.truncata,167897087,VNJQ01002619.1,1,2296,1.3675e-05,164065961,0.977182
D.truncata,167897087,VNJQ01001084.1,1,2295,1.36691e-05,164068256,0.977195
D.truncata,167897087,VNJQ01005463.1,1,2294,1.36631e-05,164070550,0.977209
D.truncata,167897087,VNJQ01002657.1,1,2294,1.36631e-05,164072844,0.977223
D.truncata,167897087,VNJQ01007136.1,1,2293,1.36572e-05,164075137,0.977236
D.truncata,167897087,VNJQ01005957.1,1,2293,1.36572e-05,164077430,0.97725
D.truncata,167897087,VNJQ01003809.1,1,2293,1.36572e-05,164079723,0.977264
D.truncata,167897087,VNJQ01002987.1,1,2293,1.36572e-05,164082016,0.977277
D.truncata,167897087,VNJQ01002877.1,1,2293,1.36572e-05,164084309,0.977291
D.truncata,167897087,VNJQ01006650.1,1,2291,1.36453e-05,164086600,0.977305
D.truncata,167897087,VNJQ01005660.1,1,2289,1.36334e-05,164088889,0.977318
D.truncata,167897087,VNJQ01000626.1,1,2289,1.36334e-05,164091178,0.977332
D.truncata,167897087,VNJQ01003334.1,1,2287,1.36214e-05,164093465,0.977346
D.truncata,167897087,VNJQ01007049.1,1,2286,1.36155e-05,164095751,0.977359
D.truncata,167897087,VNJQ01001150.1,1,2286,1.36155e-05,164098037,0.977373
D.truncata,167897087,VNJQ01007721.1,1,2284,1.36036e-05,164100321,0.977386
D.truncata,167897087,VNJQ01001127.1,1,2284,1.36036e-05,164102605,0.9774
D.truncata,167897087,VNJQ01006164.1,1,2283,1.35976e-05,164104888,0.977414
D.truncata,167897087,VNJQ01002653.1,1,2283,1.35976e-05,164107171,0.977427
D.truncata,167897087,VNJQ01003568.1,1,2282,1.35917e-05,164109453,0.977441
D.truncata,167897087,VNJQ01002847.1,1,2280,1.35797e-05,164111733,0.977454
D.truncata,167897087,VNJQ01005161.1,1,2278,1.35678e-05,164114011,0.977468
D.truncata,167897087,VNJQ01007254.1,1,2277,1.35619e-05,164116288,0.977481
D.truncata,167897087,VNJQ01003778.1,1,2276,1.35559e-05,164118564,0.977495
D.truncata,167897087,VNJQ01000891.1,1,2276,1.35559e-05,164120840,0.977509
D.truncata,167897087,VNJQ01003526.1,1,2275,1.355e-05,164123115,0.977522
D.truncata,167897087,VNJQ01001145.1,1,2275,1.355e-05,164125390,0.977536
D.truncata,167897087,VNJQ01000191.1,1,2275,1.355e-05,164127665,0.977549
D.truncata,167897087,VNJQ01000629.1,1,2274,1.3544e-05,164129939,0.977563
D.truncata,167897087,VNJQ01007906.1,1,2270,1.35202e-05,164132209,0.977576
D.truncata,167897087,VNJQ01007653.1,1,2268,1.35083e-05,164134477,0.97759
D.truncata,167897087,VNJQ01004305.1,1,2268,1.35083e-05,164136745,0.977603
D.truncata,167897087,VNJQ01003577.1,1,2268,1.35083e-05,164139013,0.977617
D.truncata,167897087,VNJQ01003109.1,1,2267,1.35023e-05,164141280,0.97763
D.truncata,167897087,VNJQ01006748.1,1,2266,1.34964e-05,164143546,0.977644
D.truncata,167897087,VNJQ01004725.1,1,2266,1.34964e-05,164145812,0.977657
D.truncata,167897087,VNJQ01001244.1,1,2266,1.34964e-05,164148078,0.977671
D.truncata,167897087,VNJQ01007022.1,1,2264,1.34845e-05,164150342,0.977684
D.truncata,167897087,VNJQ01002815.1,1,2264,1.34845e-05,164152606,0.977698
D.truncata,167897087,VNJQ01005079.1,1,2263,1.34785e-05,164154869,0.977711
D.truncata,167897087,VNJQ01002894.1,1,2263,1.34785e-05,164157132,0.977725
D.truncata,167897087,VNJQ01002434.1,1,2263,1.34785e-05,164159395,0.977738
D.truncata,167897087,VNJQ01002410.1,1,2263,1.34785e-05,164161658,0.977752
D.truncata,167897087,VNJQ01001958.1,1,2261,1.34666e-05,164163919,0.977765
D.truncata,167897087,VNJQ01004052.1,1,2260,1.34606e-05,164166179,0.977779
D.truncata,167897087,VNJQ01000695.1,1,2260,1.34606e-05,164168439,0.977792
D.truncata,167897087,VNJQ01003939.1,1,2259,1.34547e-05,164170698,0.977806
D.truncata,167897087,VNJQ01006858.1,1,2258,1.34487e-05,164172956,0.977819
D.truncata,167897087,VNJQ01005680.1,1,2258,1.34487e-05,164175214,0.977832
D.truncata,167897087,VNJQ01003382.1,1,2258,1.34487e-05,164177472,0.977846
D.truncata,167897087,VNJQ01001376.1,1,2258,1.34487e-05,164179730,0.977859
D.truncata,167897087,VNJQ01003432.1,1,2257,1.34428e-05,164181987,0.977873
D.truncata,167897087,VNJQ01001115.1,1,2257,1.34428e-05,164184244,0.977886
D.truncata,167897087,VNJQ01006034.1,1,2256,1.34368e-05,164186500,0.9779
D.truncata,167897087,VNJQ01007835.1,1,2255,1.34308e-05,164188755,0.977913
D.truncata,167897087,VNJQ01004400.1,1,2255,1.34308e-05,164191010,0.977926
D.truncata,167897087,VNJQ01007660.1,1,2254,1.34249e-05,164193264,0.97794
D.truncata,167897087,VNJQ01005589.1,1,2254,1.34249e-05,164195518,0.977953
D.truncata,167897087,VNJQ01001031.1,1,2254,1.34249e-05,164197772,0.977967
D.truncata,167897087,VNJQ01000806.1,1,2254,1.34249e-05,164200026,0.97798
D.truncata,167897087,VNJQ01007332.1,1,2253,1.34189e-05,164202279,0.977994
D.truncata,167897087,VNJQ01007218.1,1,2253,1.34189e-05,164204532,0.978007
D.truncata,167897087,VNJQ01007717.1,1,2251,1.3407e-05,164206783,0.97802
D.truncata,167897087,VNJQ01007302.1,1,2250,1.34011e-05,164209033,0.978034
D.truncata,167897087,VNJQ01007479.1,1,2248,1.33892e-05,164211281,0.978047
D.truncata,167897087,VNJQ01008154.1,1,2247,1.33832e-05,164213528,0.978061
D.truncata,167897087,VNJQ01004679.1,1,2247,1.33832e-05,164215775,0.978074
D.truncata,167897087,VNJQ01008202.1,1,2245,1.33713e-05,164218020,0.978087
D.truncata,167897087,VNJQ01006504.1,1,2245,1.33713e-05,164220265,0.978101
D.truncata,167897087,VNJQ01005424.1,1,2245,1.33713e-05,164222510,0.978114
D.truncata,167897087,VNJQ01003376.1,1,2245,1.33713e-05,164224755,0.978127
D.truncata,167897087,VNJQ01002038.1,1,2245,1.33713e-05,164227000,0.978141
D.truncata,167897087,VNJQ01001240.1,1,2245,1.33713e-05,164229245,0.978154
D.truncata,167897087,VNJQ01008187.1,1,2242,1.33534e-05,164231487,0.978168
D.truncata,167897087,VNJQ01006383.1,1,2242,1.33534e-05,164233729,0.978181
D.truncata,167897087,VNJQ01005850.1,1,2242,1.33534e-05,164235971,0.978194
D.truncata,167897087,VNJQ01004136.1,1,2242,1.33534e-05,164238213,0.978208
D.truncata,167897087,VNJQ01002409.1,1,2242,1.33534e-05,164240455,0.978221
D.truncata,167897087,VNJQ01002263.1,1,2242,1.33534e-05,164242697,0.978234
D.truncata,167897087,VNJQ01005090.1,1,2241,1.33475e-05,164244938,0.978248
D.truncata,167897087,VNJQ01002669.1,1,2241,1.33475e-05,164247179,0.978261
D.truncata,167897087,VNJQ01001973.1,1,2241,1.33475e-05,164249420,0.978274
D.truncata,167897087,VNJQ01005405.1,1,2240,1.33415e-05,164251660,0.978288
D.truncata,167897087,VNJQ01002120.1,1,2240,1.33415e-05,164253900,0.978301
D.truncata,167897087,VNJQ01002105.1,1,2240,1.33415e-05,164256140,0.978314
D.truncata,167897087,VNJQ01007069.1,1,2238,1.33296e-05,164258378,0.978328
D.truncata,167897087,VNJQ01004249.1,1,2238,1.33296e-05,164260616,0.978341
D.truncata,167897087,VNJQ01003220.1,1,2238,1.33296e-05,164262854,0.978354
D.truncata,167897087,VNJQ01001368.1,1,2238,1.33296e-05,164265092,0.978368
D.truncata,167897087,VNJQ01006507.1,1,2237,1.33236e-05,164267329,0.978381
D.truncata,167897087,VNJQ01007967.1,1,2236,1.33177e-05,164269565,0.978394
D.truncata,167897087,VNJQ01002746.1,1,2236,1.33177e-05,164271801,0.978408
D.truncata,167897087,VNJQ01007198.1,1,2235,1.33117e-05,164274036,0.978421
D.truncata,167897087,VNJQ01004296.1,1,2233,1.32998e-05,164276269,0.978434
D.truncata,167897087,VNJQ01002876.1,1,2232,1.32939e-05,164278501,0.978448
D.truncata,167897087,VNJQ01000339.1,1,2232,1.32939e-05,164280733,0.978461
D.truncata,167897087,VNJQ01008058.1,1,2230,1.32819e-05,164282963,0.978474
D.truncata,167897087,VNJQ01005631.1,1,2229,1.3276e-05,164285192,0.978487
D.truncata,167897087,VNJQ01006380.1,1,2227,1.32641e-05,164287419,0.978501
D.truncata,167897087,VNJQ01004100.1,1,2225,1.32522e-05,164289644,0.978514
D.truncata,167897087,VNJQ01007942.1,1,2224,1.32462e-05,164291868,0.978527
D.truncata,167897087,VNJQ01004171.1,1,2224,1.32462e-05,164294092,0.97854
D.truncata,167897087,VNJQ01003794.1,1,2224,1.32462e-05,164296316,0.978554
D.truncata,167897087,VNJQ01003699.1,1,2224,1.32462e-05,164298540,0.978567
D.truncata,167897087,VNJQ01003532.1,1,2224,1.32462e-05,164300764,0.97858
D.truncata,167897087,VNJQ01001495.1,1,2224,1.32462e-05,164302988,0.978593
D.truncata,167897087,VNJQ01001141.1,1,2224,1.32462e-05,164305212,0.978607
D.truncata,167897087,VNJQ01000644.1,1,2224,1.32462e-05,164307436,0.97862
D.truncata,167897087,VNJQ01006753.1,1,2223,1.32403e-05,164309659,0.978633
D.truncata,167897087,VNJQ01006019.1,1,2223,1.32403e-05,164311882,0.978646
D.truncata,167897087,VNJQ01004729.1,1,2223,1.32403e-05,164314105,0.97866
D.truncata,167897087,VNJQ01005628.1,1,2222,1.32343e-05,164316327,0.978673
D.truncata,167897087,VNJQ01003563.1,1,2222,1.32343e-05,164318549,0.978686
D.truncata,167897087,VNJQ01005581.1,1,2220,1.32224e-05,164320769,0.978699
D.truncata,167897087,VNJQ01003477.1,1,2220,1.32224e-05,164322989,0.978713
D.truncata,167897087,VNJQ01007068.1,1,2219,1.32164e-05,164325208,0.978726
D.truncata,167897087,VNJQ01000095.1,1,2217,1.32045e-05,164327425,0.978739
D.truncata,167897087,VNJQ01003465.1,1,2216,1.31986e-05,164329641,0.978752
D.truncata,167897087,VNJQ01006669.1,1,2215,1.31926e-05,164331856,0.978765
D.truncata,167897087,VNJQ01008190.1,1,2214,1.31866e-05,164334070,0.978779
D.truncata,167897087,VNJQ01006780.1,1,2214,1.31866e-05,164336284,0.978792
D.truncata,167897087,VNJQ01003385.1,1,2214,1.31866e-05,164338498,0.978805
D.truncata,167897087,VNJQ01006550.1,1,2213,1.31807e-05,164340711,0.978818
D.truncata,167897087,VNJQ01004572.1,1,2213,1.31807e-05,164342924,0.978831
D.truncata,167897087,VNJQ01002874.1,1,2213,1.31807e-05,164345137,0.978844
D.truncata,167897087,VNJQ01001775.1,1,2213,1.31807e-05,164347350,0.978858
D.truncata,167897087,VNJQ01007801.1,1,2212,1.31747e-05,164349562,0.978871
D.truncata,167897087,VNJQ01003100.1,1,2212,1.31747e-05,164351774,0.978884
D.truncata,167897087,VNJQ01002959.1,1,2211,1.31688e-05,164353985,0.978897
D.truncata,167897087,VNJQ01001080.1,1,2211,1.31688e-05,164356196,0.97891
D.truncata,167897087,VNJQ01004795.1,1,2210,1.31628e-05,164358406,0.978924
D.truncata,167897087,VNJQ01004375.1,1,2210,1.31628e-05,164360616,0.978937
D.truncata,167897087,VNJQ01003961.1,1,2210,1.31628e-05,164362826,0.97895
D.truncata,167897087,VNJQ01001829.1,1,2209,1.31569e-05,164365035,0.978963
D.truncata,167897087,VNJQ01007849.1,1,2207,1.3145e-05,164367242,0.978976
D.truncata,167897087,VNJQ01006513.1,1,2207,1.3145e-05,164369449,0.978989
D.truncata,167897087,VNJQ01004264.1,1,2207,1.3145e-05,164371656,0.979002
D.truncata,167897087,VNJQ01007285.1,1,2206,1.3139e-05,164373862,0.979016
D.truncata,167897087,VNJQ01006048.1,1,2205,1.3133e-05,164376067,0.979029
D.truncata,167897087,VNJQ01004947.1,1,2205,1.3133e-05,164378272,0.979042
D.truncata,167897087,VNJQ01006173.1,1,2204,1.31271e-05,164380476,0.979055
D.truncata,167897087,VNJQ01006109.1,1,2204,1.31271e-05,164382680,0.979068
D.truncata,167897087,VNJQ01003703.1,1,2204,1.31271e-05,164384884,0.979081
D.truncata,167897087,VNJQ01004482.1,1,2203,1.31211e-05,164387087,0.979094
D.truncata,167897087,VNJQ01002018.1,1,2203,1.31211e-05,164389290,0.979107
D.truncata,167897087,VNJQ01006342.1,1,2202,1.31152e-05,164391492,0.979121
D.truncata,167897087,VNJQ01005359.1,1,2202,1.31152e-05,164393694,0.979134
D.truncata,167897087,VNJQ01002812.1,1,2202,1.31152e-05,164395896,0.979147
D.truncata,167897087,VNJQ01002545.1,1,2201,1.31092e-05,164398097,0.97916
D.truncata,167897087,VNJQ01004257.1,1,2200,1.31033e-05,164400297,0.979173
D.truncata,167897087,VNJQ01002106.1,1,2200,1.31033e-05,164402497,0.979186
D.truncata,167897087,VNJQ01001008.1,1,2199,1.30973e-05,164404696,0.979199
D.truncata,167897087,VNJQ01007677.1,1,2198,1.30914e-05,164406894,0.979212
D.truncata,167897087,VNJQ01005918.1,1,2198,1.30914e-05,164409092,0.979225
D.truncata,167897087,VNJQ01007458.1,1,2195,1.30735e-05,164411287,0.979238
D.truncata,167897087,VNJQ01002571.1,1,2195,1.30735e-05,164413482,0.979252
D.truncata,167897087,VNJQ01004218.1,1,2194,1.30675e-05,164415676,0.979265
D.truncata,167897087,VNJQ01001393.1,1,2193,1.30616e-05,164417869,0.979278
D.truncata,167897087,VNJQ01001075.1,1,2193,1.30616e-05,164420062,0.979291
D.truncata,167897087,VNJQ01007141.1,1,2192,1.30556e-05,164422254,0.979304
D.truncata,167897087,VNJQ01006651.1,1,2192,1.30556e-05,164424446,0.979317
D.truncata,167897087,VNJQ01004107.1,1,2192,1.30556e-05,164426638,0.97933
D.truncata,167897087,VNJQ01004938.1,1,2191,1.30497e-05,164428829,0.979343
D.truncata,167897087,VNJQ01000901.1,1,2191,1.30497e-05,164431020,0.979356
D.truncata,167897087,VNJQ01003333.1,1,2189,1.30377e-05,164433209,0.979369
D.truncata,167897087,VNJQ01001924.1,1,2189,1.30377e-05,164435398,0.979382
D.truncata,167897087,VNJQ01007047.1,1,2188,1.30318e-05,164437586,0.979395
D.truncata,167897087,VNJQ01001119.1,1,2188,1.30318e-05,164439774,0.979408
D.truncata,167897087,VNJQ01007194.1,1,2187,1.30258e-05,164441961,0.979421
D.truncata,167897087,VNJQ01007142.1,1,2187,1.30258e-05,164444148,0.979434
D.truncata,167897087,VNJQ01006099.1,1,2187,1.30258e-05,164446335,0.979447
D.truncata,167897087,VNJQ01005082.1,1,2187,1.30258e-05,164448522,0.97946
D.truncata,167897087,VNJQ01000412.1,1,2187,1.30258e-05,164450709,0.979473
D.truncata,167897087,VNJQ01007752.1,1,2186,1.30199e-05,164452895,0.979486
D.truncata,167897087,VNJQ01004458.1,1,2186,1.30199e-05,164455081,0.979499
D.truncata,167897087,VNJQ01003814.1,1,2186,1.30199e-05,164457267,0.979512
D.truncata,167897087,VNJQ01003256.1,1,2186,1.30199e-05,164459453,0.979525
D.truncata,167897087,VNJQ01007348.1,1,2185,1.30139e-05,164461638,0.979538
D.truncata,167897087,VNJQ01007124.1,1,2185,1.30139e-05,164463823,0.979551
D.truncata,167897087,VNJQ01004179.1,1,2185,1.30139e-05,164466008,0.979564
D.truncata,167897087,VNJQ01005620.1,1,2184,1.3008e-05,164468192,0.979577
D.truncata,167897087,VNJQ01007649.1,1,2182,1.29961e-05,164470374,0.97959
D.truncata,167897087,VNJQ01006090.1,1,2182,1.29961e-05,164472556,0.979603
D.truncata,167897087,VNJQ01003352.1,1,2182,1.29961e-05,164474738,0.979616
D.truncata,167897087,VNJQ01002928.1,1,2182,1.29961e-05,164476920,0.979629
D.truncata,167897087,VNJQ01002673.1,1,2182,1.29961e-05,164479102,0.979642
D.truncata,167897087,VNJQ01006860.1,1,2181,1.29901e-05,164481283,0.979655
D.truncata,167897087,VNJQ01001346.1,1,2181,1.29901e-05,164483464,0.979668
D.truncata,167897087,VNJQ01004763.1,1,2180,1.29841e-05,164485644,0.979681
D.truncata,167897087,VNJQ01004263.1,1,2180,1.29841e-05,164487824,0.979694
D.truncata,167897087,VNJQ01001142.1,1,2180,1.29841e-05,164490004,0.979707
D.truncata,167897087,VNJQ01000926.1,1,2180,1.29841e-05,164492184,0.97972
D.truncata,167897087,VNJQ01003118.1,1,2179,1.29782e-05,164494363,0.979733
D.truncata,167897087,VNJQ01000899.1,1,2179,1.29782e-05,164496542,0.979746
D.truncata,167897087,VNJQ01007045.1,1,2178,1.29722e-05,164498720,0.979759
D.truncata,167897087,VNJQ01006864.1,1,2178,1.29722e-05,164500898,0.979772
D.truncata,167897087,VNJQ01004591.1,1,2178,1.29722e-05,164503076,0.979785
D.truncata,167897087,VNJQ01001962.1,1,2178,1.29722e-05,164505254,0.979798
D.truncata,167897087,VNJQ01006901.1,1,2177,1.29663e-05,164507431,0.979811
D.truncata,167897087,VNJQ01000013.1,1,2177,1.29663e-05,164509608,0.979824
D.truncata,167897087,VNJQ01003633.1,1,2175,1.29544e-05,164511783,0.979837
D.truncata,167897087,VNJQ01001191.1,1,2174,1.29484e-05,164513957,0.97985
D.truncata,167897087,VNJQ01004153.1,1,2172,1.29365e-05,164516129,0.979863
D.truncata,167897087,VNJQ01005057.1,1,2170,1.29246e-05,164518299,0.979876
D.truncata,167897087,VNJQ01005492.1,1,2168,1.29127e-05,164520467,0.979889
D.truncata,167897087,VNJQ01006289.1,1,2167,1.29067e-05,164522634,0.979902
D.truncata,167897087,VNJQ01006510.1,1,2166,1.29008e-05,164524800,0.979915
D.truncata,167897087,VNJQ01003137.1,1,2166,1.29008e-05,164526966,0.979927
D.truncata,167897087,VNJQ01002763.1,1,2166,1.29008e-05,164529132,0.97994
D.truncata,167897087,VNJQ01001146.1,1,2166,1.29008e-05,164531298,0.979953
D.truncata,167897087,VNJQ01004966.1,1,2165,1.28948e-05,164533463,0.979966
D.truncata,167897087,VNJQ01007701.1,1,2164,1.28888e-05,164535627,0.979979
D.truncata,167897087,VNJQ01004411.1,1,2163,1.28829e-05,164537790,0.979992
D.truncata,167897087,VNJQ01004007.1,1,2162,1.28769e-05,164539952,0.980005
D.truncata,167897087,VNJQ01004698.1,1,2161,1.2871e-05,164542113,0.980018
D.truncata,167897087,VNJQ01002601.1,1,2161,1.2871e-05,164544274,0.980031
D.truncata,167897087,VNJQ01007627.1,1,2160,1.2865e-05,164546434,0.980043
D.truncata,167897087,VNJQ01007219.1,1,2160,1.2865e-05,164548594,0.980056
D.truncata,167897087,VNJQ01005051.1,1,2160,1.2865e-05,164550754,0.980069
D.truncata,167897087,VNJQ01007919.1,1,2158,1.28531e-05,164552912,0.980082
D.truncata,167897087,VNJQ01005633.1,1,2158,1.28531e-05,164555070,0.980095
D.truncata,167897087,VNJQ01001355.1,1,2157,1.28472e-05,164557227,0.980108
D.truncata,167897087,VNJQ01008148.1,1,2156,1.28412e-05,164559383,0.980121
D.truncata,167897087,VNJQ01001986.1,1,2156,1.28412e-05,164561539,0.980133
D.truncata,167897087,VNJQ01007225.1,1,2155,1.28352e-05,164563694,0.980146
D.truncata,167897087,VNJQ01004587.1,1,2155,1.28352e-05,164565849,0.980159
D.truncata,167897087,VNJQ01002496.1,1,2155,1.28352e-05,164568004,0.980172
D.truncata,167897087,VNJQ01007659.1,1,2154,1.28293e-05,164570158,0.980185
D.truncata,167897087,VNJQ01000268.1,1,2153,1.28233e-05,164572311,0.980198
D.truncata,167897087,VNJQ01006239.1,1,2152,1.28174e-05,164574463,0.98021
D.truncata,167897087,VNJQ01005674.1,1,2151,1.28114e-05,164576614,0.980223
D.truncata,167897087,VNJQ01000183.1,1,2149,1.27995e-05,164578763,0.980236
D.truncata,167897087,VNJQ01007673.1,1,2148,1.27936e-05,164580911,0.980249
D.truncata,167897087,VNJQ01003936.1,1,2148,1.27936e-05,164583059,0.980262
D.truncata,167897087,VNJQ01008216.1,1,2147,1.27876e-05,164585206,0.980274
D.truncata,167897087,VNJQ01002112.1,1,2147,1.27876e-05,164587353,0.980287
D.truncata,167897087,VNJQ01001736.1,1,2147,1.27876e-05,164589500,0.9803
D.truncata,167897087,VNJQ01001563.1,1,2146,1.27816e-05,164591646,0.980313
D.truncata,167897087,VNJQ01000184.1,1,2146,1.27816e-05,164593792,0.980325
D.truncata,167897087,VNJQ01003120.1,1,2145,1.27757e-05,164595937,0.980338
D.truncata,167897087,VNJQ01007698.1,1,2144,1.27697e-05,164598081,0.980351
D.truncata,167897087,VNJQ01006202.1,1,2144,1.27697e-05,164600225,0.980364
D.truncata,167897087,VNJQ01004696.1,1,2144,1.27697e-05,164602369,0.980377
D.truncata,167897087,VNJQ01008164.1,1,2143,1.27638e-05,164604512,0.980389
D.truncata,167897087,VNJQ01001144.1,1,2143,1.27638e-05,164606655,0.980402
D.truncata,167897087,VNJQ01000489.1,1,2143,1.27638e-05,164608798,0.980415
D.truncata,167897087,VNJQ01004852.1,1,2142,1.27578e-05,164610940,0.980428
D.truncata,167897087,VNJQ01007347.1,1,2141,1.27519e-05,164613081,0.98044
D.truncata,167897087,VNJQ01007094.1,1,2141,1.27519e-05,164615222,0.980453
D.truncata,167897087,VNJQ01005356.1,1,2141,1.27519e-05,164617363,0.980466
D.truncata,167897087,VNJQ01000493.1,1,2141,1.27519e-05,164619504,0.980479
D.truncata,167897087,VNJQ01006466.1,1,2140,1.27459e-05,164621644,0.980491
D.truncata,167897087,VNJQ01002391.1,1,2140,1.27459e-05,164623784,0.980504
D.truncata,167897087,VNJQ01001620.1,1,2140,1.27459e-05,164625924,0.980517
D.truncata,167897087,VNJQ01002269.1,1,2139,1.27399e-05,164628063,0.98053
D.truncata,167897087,VNJQ01007536.1,1,2138,1.2734e-05,164630201,0.980542
D.truncata,167897087,VNJQ01005130.1,1,2138,1.2734e-05,164632339,0.980555
D.truncata,167897087,VNJQ01003450.1,1,2138,1.2734e-05,164634477,0.980568
D.truncata,167897087,VNJQ01000927.1,1,2138,1.2734e-05,164636615,0.980581
D.truncata,167897087,VNJQ01000500.1,1,2138,1.2734e-05,164638753,0.980593
D.truncata,167897087,VNJQ01003303.1,1,2137,1.2728e-05,164640890,0.980606
D.truncata,167897087,VNJQ01007907.1,1,2136,1.27221e-05,164643026,0.980619
D.truncata,167897087,VNJQ01006306.1,1,2136,1.27221e-05,164645162,0.980631
D.truncata,167897087,VNJQ01005371.1,1,2136,1.27221e-05,164647298,0.980644
D.truncata,167897087,VNJQ01000718.1,1,2136,1.27221e-05,164649434,0.980657
D.truncata,167897087,VNJQ01003995.1,1,2134,1.27102e-05,164651568,0.98067
D.truncata,167897087,VNJQ01004175.1,1,2133,1.27042e-05,164653701,0.980682
D.truncata,167897087,VNJQ01003451.1,1,2133,1.27042e-05,164655834,0.980695
D.truncata,167897087,VNJQ01002598.1,1,2132,1.26983e-05,164657966,0.980708
D.truncata,167897087,VNJQ01002416.1,1,2131,1.26923e-05,164660097,0.98072
D.truncata,167897087,VNJQ01000458.1,1,2131,1.26923e-05,164662228,0.980733
D.truncata,167897087,VNJQ01008021.1,1,2130,1.26863e-05,164664358,0.980746
D.truncata,167897087,VNJQ01000440.1,1,2130,1.26863e-05,164666488,0.980758
D.truncata,167897087,VNJQ01008022.1,1,2129,1.26804e-05,164668617,0.980771
D.truncata,167897087,VNJQ01007048.1,1,2129,1.26804e-05,164670746,0.980784
D.truncata,167897087,VNJQ01001573.1,1,2128,1.26744e-05,164672874,0.980796
D.truncata,167897087,VNJQ01006631.1,1,2125,1.26566e-05,164674999,0.980809
D.truncata,167897087,VNJQ01003659.1,1,2124,1.26506e-05,164677123,0.980822
D.truncata,167897087,VNJQ01005129.1,1,2123,1.26447e-05,164679246,0.980834
D.truncata,167897087,VNJQ01007358.1,1,2122,1.26387e-05,164681368,0.980847
D.truncata,167897087,VNJQ01000567.1,1,2118,1.26149e-05,164683486,0.98086
D.truncata,167897087,VNJQ01001980.1,1,2117,1.26089e-05,164685603,0.980872
D.truncata,167897087,VNJQ01003738.1,1,2116,1.2603e-05,164687719,0.980885
D.truncata,167897087,VNJQ01000868.1,1,2116,1.2603e-05,164689835,0.980898
D.truncata,167897087,VNJQ01007441.1,1,2115,1.2597e-05,164691950,0.98091
D.truncata,167897087,VNJQ01006314.1,1,2115,1.2597e-05,164694065,0.980923
D.truncata,167897087,VNJQ01005778.1,1,2115,1.2597e-05,164696180,0.980935
D.truncata,167897087,VNJQ01005735.1,1,2114,1.2591e-05,164698294,0.980948
D.truncata,167897087,VNJQ01005614.1,1,2114,1.2591e-05,164700408,0.98096
D.truncata,167897087,VNJQ01005800.1,1,2112,1.25791e-05,164702520,0.980973
D.truncata,167897087,VNJQ01005074.1,1,2112,1.25791e-05,164704632,0.980986
D.truncata,167897087,VNJQ01002264.1,1,2112,1.25791e-05,164706744,0.980998
D.truncata,167897087,VNJQ01003089.1,1,2110,1.25672e-05,164708854,0.981011
D.truncata,167897087,VNJQ01002842.1,1,2110,1.25672e-05,164710964,0.981023
D.truncata,167897087,VNJQ01001223.1,1,2110,1.25672e-05,164713074,0.981036
D.truncata,167897087,VNJQ01001673.1,1,2109,1.25613e-05,164715183,0.981048
D.truncata,167897087,VNJQ01005810.1,1,2108,1.25553e-05,164717291,0.981061
D.truncata,167897087,VNJQ01005579.1,1,2107,1.25494e-05,164719398,0.981074
D.truncata,167897087,VNJQ01001440.1,1,2107,1.25494e-05,164721505,0.981086
D.truncata,167897087,VNJQ01000148.1,1,2105,1.25374e-05,164723610,0.981099
D.truncata,167897087,VNJQ01004593.1,1,2104,1.25315e-05,164725714,0.981111
D.truncata,167897087,VNJQ01004000.1,1,2102,1.25196e-05,164727816,0.981124
D.truncata,167897087,VNJQ01008014.1,1,2100,1.25077e-05,164729916,0.981136
D.truncata,167897087,VNJQ01004214.1,1,2100,1.25077e-05,164732016,0.981149
D.truncata,167897087,VNJQ01000413.1,1,2100,1.25077e-05,164734116,0.981161
D.truncata,167897087,VNJQ01007456.1,1,2099,1.25017e-05,164736215,0.981174
D.truncata,167897087,VNJQ01004598.1,1,2099,1.25017e-05,164738314,0.981186
D.truncata,167897087,VNJQ01001822.1,1,2099,1.25017e-05,164740413,0.981199
D.truncata,167897087,VNJQ01001406.1,1,2098,1.24957e-05,164742511,0.981211
D.truncata,167897087,VNJQ01007425.1,1,2097,1.24898e-05,164744608,0.981224
D.truncata,167897087,VNJQ01007384.1,1,2097,1.24898e-05,164746705,0.981236
D.truncata,167897087,VNJQ01005668.1,1,2097,1.24898e-05,164748802,0.981249
D.truncata,167897087,VNJQ01003725.1,1,2096,1.24838e-05,164750898,0.981261
D.truncata,167897087,VNJQ01007394.1,1,2095,1.24779e-05,164752993,0.981274
D.truncata,167897087,VNJQ01004074.1,1,2095,1.24779e-05,164755088,0.981286
D.truncata,167897087,VNJQ01003732.1,1,2095,1.24779e-05,164757183,0.981299
D.truncata,167897087,VNJQ01003468.1,1,2095,1.24779e-05,164759278,0.981311
D.truncata,167897087,VNJQ01007281.1,1,2094,1.24719e-05,164761372,0.981324
D.truncata,167897087,VNJQ01006968.1,1,2092,1.246e-05,164763464,0.981336
D.truncata,167897087,VNJQ01007060.1,1,2088,1.24362e-05,164765552,0.981348
D.truncata,167897087,VNJQ01006602.1,1,2088,1.24362e-05,164767640,0.981361
D.truncata,167897087,VNJQ01006508.1,1,2086,1.24243e-05,164769726,0.981373
D.truncata,167897087,VNJQ01005190.1,1,2086,1.24243e-05,164771812,0.981386
D.truncata,167897087,VNJQ01002053.1,1,2086,1.24243e-05,164773898,0.981398
D.truncata,167897087,VNJQ01000123.1,1,2086,1.24243e-05,164775984,0.981411
D.truncata,167897087,VNJQ01004403.1,1,2084,1.24124e-05,164778068,0.981423
D.truncata,167897087,VNJQ01003459.1,1,2084,1.24124e-05,164780152,0.981435
D.truncata,167897087,VNJQ01008153.1,1,2083,1.24064e-05,164782235,0.981448
D.truncata,167897087,VNJQ01003640.1,1,2082,1.24005e-05,164784317,0.98146
D.truncata,167897087,VNJQ01002636.1,1,2082,1.24005e-05,164786399,0.981473
D.truncata,167897087,VNJQ01003414.1,1,2081,1.23945e-05,164788480,0.981485
D.truncata,167897087,VNJQ01003251.1,1,2081,1.23945e-05,164790561,0.981497
D.truncata,167897087,VNJQ01000534.1,1,2081,1.23945e-05,164792642,0.98151
D.truncata,167897087,VNJQ01008191.1,1,2080,1.23885e-05,164794722,0.981522
D.truncata,167897087,VNJQ01007304.1,1,2080,1.23885e-05,164796802,0.981535
D.truncata,167897087,VNJQ01003462.1,1,2080,1.23885e-05,164798882,0.981547
D.truncata,167897087,VNJQ01003106.1,1,2080,1.23885e-05,164800962,0.981559
D.truncata,167897087,VNJQ01001902.1,1,2078,1.23766e-05,164803040,0.981572
D.truncata,167897087,VNJQ01002839.1,1,2077,1.23707e-05,164805117,0.981584
D.truncata,167897087,VNJQ01008105.1,1,2076,1.23647e-05,164807193,0.981597
D.truncata,167897087,VNJQ01005038.1,1,2076,1.23647e-05,164809269,0.981609
D.truncata,167897087,VNJQ01004561.1,1,2076,1.23647e-05,164811345,0.981621
D.truncata,167897087,VNJQ01003774.1,1,2076,1.23647e-05,164813421,0.981634
D.truncata,167897087,VNJQ01005910.1,1,2075,1.23588e-05,164815496,0.981646
D.truncata,167897087,VNJQ01001744.1,1,2075,1.23588e-05,164817571,0.981658
D.truncata,167897087,VNJQ01006594.1,1,2074,1.23528e-05,164819645,0.981671
D.truncata,167897087,VNJQ01008045.1,1,2073,1.23468e-05,164821718,0.981683
D.truncata,167897087,VNJQ01002302.1,1,2073,1.23468e-05,164823791,0.981695
D.truncata,167897087,VNJQ01007185.1,1,2072,1.23409e-05,164825863,0.981708
D.truncata,167897087,VNJQ01004436.1,1,2072,1.23409e-05,164827935,0.98172
D.truncata,167897087,VNJQ01003444.1,1,2072,1.23409e-05,164830007,0.981732
D.truncata,167897087,VNJQ01008044.1,1,2071,1.23349e-05,164832078,0.981745
D.truncata,167897087,VNJQ01007101.1,1,2070,1.2329e-05,164834148,0.981757
D.truncata,167897087,VNJQ01004418.1,1,2069,1.2323e-05,164836217,0.981769
D.truncata,167897087,VNJQ01002836.1,1,2069,1.2323e-05,164838286,0.981782
D.truncata,167897087,VNJQ01002042.1,1,2069,1.2323e-05,164840355,0.981794
D.truncata,167897087,VNJQ01007935.1,1,2068,1.23171e-05,164842423,0.981806
D.truncata,167897087,VNJQ01007886.1,1,2068,1.23171e-05,164844491,0.981819
D.truncata,167897087,VNJQ01004977.1,1,2068,1.23171e-05,164846559,0.981831
D.truncata,167897087,VNJQ01008135.1,1,2067,1.23111e-05,164848626,0.981843
D.truncata,167897087,VNJQ01000371.1,1,2067,1.23111e-05,164850693,0.981856
D.truncata,167897087,VNJQ01000084.1,1,2066,1.23052e-05,164852759,0.981868
D.truncata,167897087,VNJQ01001356.1,1,2065,1.22992e-05,164854824,0.98188
D.truncata,167897087,VNJQ01005856.1,1,2064,1.22932e-05,164856888,0.981892
D.truncata,167897087,VNJQ01004823.1,1,2064,1.22932e-05,164858952,0.981905
D.truncata,167897087,VNJQ01007613.1,1,2061,1.22754e-05,164861013,0.981917
D.truncata,167897087,VNJQ01000204.1,1,2060,1.22694e-05,164863073,0.981929
D.truncata,167897087,VNJQ01005959.1,1,2059,1.22635e-05,164865132,0.981942
D.truncata,167897087,VNJQ01003098.1,1,2059,1.22635e-05,164867191,0.981954
D.truncata,167897087,VNJQ01000350.1,1,2059,1.22635e-05,164869250,0.981966
D.truncata,167897087,VNJQ01001900.1,1,2058,1.22575e-05,164871308,0.981978
D.truncata,167897087,VNJQ01003673.1,1,2057,1.22516e-05,164873365,0.981991
D.truncata,167897087,VNJQ01002324.1,1,2057,1.22516e-05,164875422,0.982003
D.truncata,167897087,VNJQ01001557.1,1,2057,1.22516e-05,164877479,0.982015
D.truncata,167897087,VNJQ01008115.1,1,2056,1.22456e-05,164879535,0.982027
D.truncata,167897087,VNJQ01002245.1,1,2056,1.22456e-05,164881591,0.98204
D.truncata,167897087,VNJQ01003442.1,1,2055,1.22396e-05,164883646,0.982052
D.truncata,167897087,VNJQ01000980.1,1,2055,1.22396e-05,164885701,0.982064
D.truncata,167897087,VNJQ01000823.1,1,2055,1.22396e-05,164887756,0.982076
D.truncata,167897087,VNJQ01007541.1,1,2054,1.22337e-05,164889810,0.982089
D.truncata,167897087,VNJQ01008038.1,1,2053,1.22277e-05,164891863,0.982101
D.truncata,167897087,VNJQ01005670.1,1,2053,1.22277e-05,164893916,0.982113
D.truncata,167897087,VNJQ01004367.1,1,2053,1.22277e-05,164895969,0.982125
D.truncata,167897087,VNJQ01001828.1,1,2053,1.22277e-05,164898022,0.982137
D.truncata,167897087,VNJQ01004077.1,1,2052,1.22218e-05,164900074,0.98215
D.truncata,167897087,VNJQ01004247.1,1,2051,1.22158e-05,164902125,0.982162
D.truncata,167897087,VNJQ01007940.1,1,2050,1.22099e-05,164904175,0.982174
D.truncata,167897087,VNJQ01007728.1,1,2050,1.22099e-05,164906225,0.982186
D.truncata,167897087,VNJQ01006623.1,1,2050,1.22099e-05,164908275,0.982199
D.truncata,167897087,VNJQ01006029.1,1,2050,1.22099e-05,164910325,0.982211
D.truncata,167897087,VNJQ01005585.1,1,2050,1.22099e-05,164912375,0.982223
D.truncata,167897087,VNJQ01003716.1,1,2050,1.22099e-05,164914425,0.982235
D.truncata,167897087,VNJQ01007516.1,1,2049,1.22039e-05,164916474,0.982247
D.truncata,167897087,VNJQ01004822.1,1,2049,1.22039e-05,164918523,0.98226
D.truncata,167897087,VNJQ01004779.1,1,2048,1.21979e-05,164920571,0.982272
D.truncata,167897087,VNJQ01002963.1,1,2048,1.21979e-05,164922619,0.982284
D.truncata,167897087,VNJQ01001996.1,1,2047,1.2192e-05,164924666,0.982296
D.truncata,167897087,VNJQ01006004.1,1,2046,1.2186e-05,164926712,0.982308
D.truncata,167897087,VNJQ01005091.1,1,2046,1.2186e-05,164928758,0.982321
D.truncata,167897087,VNJQ01000211.1,1,2045,1.21801e-05,164930803,0.982333
D.truncata,167897087,VNJQ01001959.1,1,2043,1.21682e-05,164932846,0.982345
D.truncata,167897087,VNJQ01007181.1,1,2042,1.21622e-05,164934888,0.982357
D.truncata,167897087,VNJQ01006830.1,1,2042,1.21622e-05,164936930,0.982369
D.truncata,167897087,VNJQ01006121.1,1,2041,1.21563e-05,164938971,0.982381
D.truncata,167897087,VNJQ01007683.1,1,2040,1.21503e-05,164941011,0.982394
D.truncata,167897087,VNJQ01003572.1,1,2040,1.21503e-05,164943051,0.982406
D.truncata,167897087,VNJQ01000945.1,1,2040,1.21503e-05,164945091,0.982418
D.truncata,167897087,VNJQ01005516.1,1,2038,1.21384e-05,164947129,0.98243
D.truncata,167897087,VNJQ01004708.1,1,2038,1.21384e-05,164949167,0.982442
D.truncata,167897087,VNJQ01000280.1,1,2038,1.21384e-05,164951205,0.982454
D.truncata,167897087,VNJQ01006838.1,1,2037,1.21324e-05,164953242,0.982466
D.truncata,167897087,VNJQ01006480.1,1,2037,1.21324e-05,164955279,0.982479
D.truncata,167897087,VNJQ01003447.1,1,2037,1.21324e-05,164957316,0.982491
D.truncata,167897087,VNJQ01002558.1,1,2037,1.21324e-05,164959353,0.982503
D.truncata,167897087,VNJQ01001611.1,1,2037,1.21324e-05,164961390,0.982515
D.truncata,167897087,VNJQ01001475.1,1,2037,1.21324e-05,164963427,0.982527
D.truncata,167897087,VNJQ01003210.1,1,2036,1.21265e-05,164965463,0.982539
D.truncata,167897087,VNJQ01001386.1,1,2036,1.21265e-05,164967499,0.982551
D.truncata,167897087,VNJQ01005897.1,1,2034,1.21146e-05,164969533,0.982563
D.truncata,167897087,VNJQ01003105.1,1,2034,1.21146e-05,164971567,0.982576
D.truncata,167897087,VNJQ01006503.1,1,2033,1.21086e-05,164973600,0.982588
D.truncata,167897087,VNJQ01005679.1,1,2032,1.21027e-05,164975632,0.9826
D.truncata,167897087,VNJQ01002004.1,1,2032,1.21027e-05,164977664,0.982612
D.truncata,167897087,VNJQ01000937.1,1,2032,1.21027e-05,164979696,0.982624
D.truncata,167897087,VNJQ01003815.1,1,2031,1.20967e-05,164981727,0.982636
D.truncata,167897087,VNJQ01005107.1,1,2029,1.20848e-05,164983756,0.982648
D.truncata,167897087,VNJQ01004413.1,1,2029,1.20848e-05,164985785,0.98266
D.truncata,167897087,VNJQ01001599.1,1,2029,1.20848e-05,164987814,0.982672
D.truncata,167897087,VNJQ01006548.1,1,2026,1.20669e-05,164989840,0.982684
D.truncata,167897087,VNJQ01002262.1,1,2024,1.2055e-05,164991864,0.982696
D.truncata,167897087,VNJQ01005675.1,1,2023,1.2049e-05,164993887,0.982708
D.truncata,167897087,VNJQ01000080.1,1,2023,1.2049e-05,164995910,0.982721
D.truncata,167897087,VNJQ01006738.1,1,2022,1.20431e-05,164997932,0.982733
D.truncata,167897087,VNJQ01004773.1,1,2022,1.20431e-05,164999954,0.982745
D.truncata,167897087,VNJQ01000682.1,1,2022,1.20431e-05,165001976,0.982757
D.truncata,167897087,VNJQ01007602.1,1,2021,1.20371e-05,165003997,0.982769
D.truncata,167897087,VNJQ01003629.1,1,2021,1.20371e-05,165006018,0.982781
D.truncata,167897087,VNJQ01008046.1,1,2020,1.20312e-05,165008038,0.982793
D.truncata,167897087,VNJQ01007118.1,1,2020,1.20312e-05,165010058,0.982805
D.truncata,167897087,VNJQ01005574.1,1,2020,1.20312e-05,165012078,0.982817
D.truncata,167897087,VNJQ01007839.1,1,2019,1.20252e-05,165014097,0.982829
D.truncata,167897087,VNJQ01007213.1,1,2018,1.20193e-05,165016115,0.982841
D.truncata,167897087,VNJQ01002912.1,1,2018,1.20193e-05,165018133,0.982853
D.truncata,167897087,VNJQ01001350.1,1,2018,1.20193e-05,165020151,0.982865
D.truncata,167897087,VNJQ01000406.1,1,2018,1.20193e-05,165022169,0.982877
D.truncata,167897087,VNJQ01007115.1,1,2017,1.20133e-05,165024186,0.982889
D.truncata,167897087,VNJQ01003413.1,1,2017,1.20133e-05,165026203,0.982901
D.truncata,167897087,VNJQ01000978.1,1,2017,1.20133e-05,165028220,0.982913
D.truncata,167897087,VNJQ01008104.1,1,2016,1.20074e-05,165030236,0.982925
D.truncata,167897087,VNJQ01007438.1,1,2016,1.20074e-05,165032252,0.982937
D.truncata,167897087,VNJQ01005622.1,1,2016,1.20074e-05,165034268,0.982949
D.truncata,167897087,VNJQ01004219.1,1,2016,1.20074e-05,165036284,0.982961
D.truncata,167897087,VNJQ01005143.1,1,2014,1.19954e-05,165038298,0.982973
D.truncata,167897087,VNJQ01001438.1,1,2012,1.19835e-05,165040310,0.982985
D.truncata,167897087,VNJQ01006560.1,1,2011,1.19776e-05,165042321,0.982997
D.truncata,167897087,VNJQ01006520.1,1,2011,1.19776e-05,165044332,0.983009
D.truncata,167897087,VNJQ01000456.1,1,2011,1.19776e-05,165046343,0.983021
D.truncata,167897087,VNJQ01000236.1,1,2010,1.19716e-05,165048353,0.983033
D.truncata,167897087,VNJQ01006839.1,1,2009,1.19657e-05,165050362,0.983045
D.truncata,167897087,VNJQ01002592.1,1,2009,1.19657e-05,165052371,0.983057
D.truncata,167897087,VNJQ01001478.1,1,2009,1.19657e-05,165054380,0.983069
D.truncata,167897087,VNJQ01007308.1,1,2008,1.19597e-05,165056388,0.983081
D.truncata,167897087,VNJQ01008010.1,1,2007,1.19538e-05,165058395,0.983093
D.truncata,167897087,VNJQ01003672.1,1,2006,1.19478e-05,165060401,0.983105
D.truncata,167897087,VNJQ01001360.1,1,2006,1.19478e-05,165062407,0.983117
D.truncata,167897087,VNJQ01007279.1,1,2005,1.19418e-05,165064412,0.983129
D.truncata,167897087,VNJQ01007044.1,1,2005,1.19418e-05,165066417,0.98314
D.truncata,167897087,VNJQ01003393.1,1,2005,1.19418e-05,165068422,0.983152
D.truncata,167897087,VNJQ01007085.1,1,2004,1.19359e-05,165070426,0.983164
D.truncata,167897087,VNJQ01006112.1,1,2004,1.19359e-05,165072430,0.983176
D.truncata,167897087,VNJQ01003985.1,1,2004,1.19359e-05,165074434,0.983188
D.truncata,167897087,VNJQ01001351.1,1,2004,1.19359e-05,165076438,0.9832
D.truncata,167897087,VNJQ01001245.1,1,2004,1.19359e-05,165078442,0.983212
D.truncata,167897087,VNJQ01004244.1,1,2003,1.19299e-05,165080445,0.983224
D.truncata,167897087,VNJQ01000150.1,1,2003,1.19299e-05,165082448,0.983236
D.truncata,167897087,VNJQ01005293.1,1,2002,1.1924e-05,165084450,0.983248
D.truncata,167897087,VNJQ01003832.1,1,2002,1.1924e-05,165086452,0.98326
D.truncata,167897087,VNJQ01004303.1,1,2001,1.1918e-05,165088453,0.983272
D.truncata,167897087,VNJQ01001966.1,1,2001,1.1918e-05,165090454,0.983284
D.truncata,167897087,VNJQ01000724.1,1,2001,1.1918e-05,165092455,0.983296
D.truncata,167897087,VNJQ01005822.1,1,2000,1.19121e-05,165094455,0.983307
D.truncata,167897087,VNJQ01001372.1,1,1999,1.19061e-05,165096454,0.983319
D.truncata,167897087,VNJQ01003396.1,1,1998,1.19001e-05,165098452,0.983331
D.truncata,167897087,VNJQ01005101.1,1,1995,1.18823e-05,165100447,0.983343
D.truncata,167897087,VNJQ01000286.1,1,1995,1.18823e-05,165102442,0.983355
D.truncata,167897087,VNJQ01007838.1,1,1994,1.18763e-05,165104436,0.983367
D.truncata,167897087,VNJQ01003395.1,1,1994,1.18763e-05,165106430,0.983379
D.truncata,167897087,VNJQ01003655.1,1,1993,1.18704e-05,165108423,0.983391
D.truncata,167897087,VNJQ01006896.1,1,1992,1.18644e-05,165110415,0.983402
D.truncata,167897087,VNJQ01004327.1,1,1992,1.18644e-05,165112407,0.983414
D.truncata,167897087,VNJQ01003884.1,1,1992,1.18644e-05,165114399,0.983426
D.truncata,167897087,VNJQ01000526.1,1,1992,1.18644e-05,165116391,0.983438
D.truncata,167897087,VNJQ01000372.1,1,1991,1.18585e-05,165118382,0.98345
D.truncata,167897087,VNJQ01005128.1,1,1990,1.18525e-05,165120372,0.983462
D.truncata,167897087,VNJQ01000361.1,1,1989,1.18465e-05,165122361,0.983474
D.truncata,167897087,VNJQ01007230.1,1,1988,1.18406e-05,165124349,0.983485
D.truncata,167897087,VNJQ01005757.1,1,1988,1.18406e-05,165126337,0.983497
D.truncata,167897087,VNJQ01006076.1,1,1987,1.18346e-05,165128324,0.983509
D.truncata,167897087,VNJQ01000573.1,1,1986,1.18287e-05,165130310,0.983521
D.truncata,167897087,VNJQ01007401.1,1,1985,1.18227e-05,165132295,0.983533
D.truncata,167897087,VNJQ01001691.1,1,1985,1.18227e-05,165134280,0.983545
D.truncata,167897087,VNJQ01005499.1,1,1984,1.18168e-05,165136264,0.983556
D.truncata,167897087,VNJQ01003389.1,1,1984,1.18168e-05,165138248,0.983568
D.truncata,167897087,VNJQ01000370.1,1,1984,1.18168e-05,165140232,0.98358
D.truncata,167897087,VNJQ01001498.1,1,1982,1.18049e-05,165142214,0.983592
D.truncata,167897087,VNJQ01000405.1,1,1982,1.18049e-05,165144196,0.983604
D.truncata,167897087,VNJQ01000620.1,1,1981,1.17989e-05,165146177,0.983615
D.truncata,167897087,VNJQ01004510.1,1,1980,1.17929e-05,165148157,0.983627
D.truncata,167897087,VNJQ01001653.1,1,1980,1.17929e-05,165150137,0.983639
D.truncata,167897087,VNJQ01001455.1,1,1980,1.17929e-05,165152117,0.983651
D.truncata,167897087,VNJQ01001310.1,1,1980,1.17929e-05,165154097,0.983663
D.truncata,167897087,VNJQ01004717.1,1,1979,1.1787e-05,165156076,0.983674
D.truncata,167897087,VNJQ01003391.1,1,1979,1.1787e-05,165158055,0.983686
D.truncata,167897087,VNJQ01007887.1,1,1978,1.1781e-05,165160033,0.983698
D.truncata,167897087,VNJQ01004326.1,1,1978,1.1781e-05,165162011,0.98371
D.truncata,167897087,VNJQ01003398.1,1,1978,1.1781e-05,165163989,0.983722
D.truncata,167897087,VNJQ01003063.1,1,1978,1.1781e-05,165165967,0.983733
D.truncata,167897087,VNJQ01002840.1,1,1978,1.1781e-05,165167945,0.983745
D.truncata,167897087,VNJQ01007528.1,1,1977,1.17751e-05,165169922,0.983757
D.truncata,167897087,VNJQ01000466.1,1,1977,1.17751e-05,165171899,0.983769
D.truncata,167897087,VNJQ01005711.1,1,1976,1.17691e-05,165173875,0.98378
D.truncata,167897087,VNJQ01002490.1,1,1975,1.17632e-05,165175850,0.983792
D.truncata,167897087,VNJQ01000764.1,1,1975,1.17632e-05,165177825,0.983804
D.truncata,167897087,VNJQ01006341.1,1,1974,1.17572e-05,165179799,0.983816
D.truncata,167897087,VNJQ01001140.1,1,1973,1.17512e-05,165181772,0.983828
D.truncata,167897087,VNJQ01005014.1,1,1972,1.17453e-05,165183744,0.983839
D.truncata,167897087,VNJQ01000533.1,1,1971,1.17393e-05,165185715,0.983851
D.truncata,167897087,VNJQ01007465.1,1,1969,1.17274e-05,165187684,0.983863
D.truncata,167897087,VNJQ01007084.1,1,1969,1.17274e-05,165189653,0.983874
D.truncata,167897087,VNJQ01007398.1,1,1968,1.17215e-05,165191621,0.983886
D.truncata,167897087,VNJQ01003852.1,1,1968,1.17215e-05,165193589,0.983898
D.truncata,167897087,VNJQ01003378.1,1,1968,1.17215e-05,165195557,0.98391
D.truncata,167897087,VNJQ01007399.1,1,1967,1.17155e-05,165197524,0.983921
D.truncata,167897087,VNJQ01003077.1,1,1967,1.17155e-05,165199491,0.983933
D.truncata,167897087,VNJQ01006012.1,1,1966,1.17096e-05,165201457,0.983945
D.truncata,167897087,VNJQ01005530.1,1,1966,1.17096e-05,165203423,0.983956
D.truncata,167897087,VNJQ01004724.1,1,1966,1.17096e-05,165205389,0.983968
D.truncata,167897087,VNJQ01000944.1,1,1966,1.17096e-05,165207355,0.98398
D.truncata,167897087,VNJQ01002985.1,1,1965,1.17036e-05,165209320,0.983992
D.truncata,167897087,VNJQ01003419.1,1,1964,1.16976e-05,165211284,0.984003
D.truncata,167897087,VNJQ01007402.1,1,1963,1.16917e-05,165213247,0.984015
D.truncata,167897087,VNJQ01002540.1,1,1963,1.16917e-05,165215210,0.984027
D.truncata,167897087,VNJQ01002132.1,1,1962,1.16857e-05,165217172,0.984038
D.truncata,167897087,VNJQ01006762.1,1,1960,1.16738e-05,165219132,0.98405
D.truncata,167897087,VNJQ01002340.1,1,1959,1.16679e-05,165221091,0.984062
D.truncata,167897087,VNJQ01005811.1,1,1958,1.16619e-05,165223049,0.984073
D.truncata,167897087,VNJQ01003101.1,1,1958,1.16619e-05,165225007,0.984085
D.truncata,167897087,VNJQ01002566.1,1,1957,1.16559e-05,165226964,0.984097
D.truncata,167897087,VNJQ01002334.1,1,1956,1.165e-05,165228920,0.984108
D.truncata,167897087,VNJQ01007859.1,1,1955,1.1644e-05,165230875,0.98412
D.truncata,167897087,VNJQ01001785.1,1,1955,1.1644e-05,165232830,0.984132
D.truncata,167897087,VNJQ01001574.1,1,1953,1.16321e-05,165234783,0.984143
D.truncata,167897087,VNJQ01000358.1,1,1953,1.16321e-05,165236736,0.984155
D.truncata,167897087,VNJQ01000659.1,1,1951,1.16202e-05,165238687,0.984166
D.truncata,167897087,VNJQ01005825.1,1,1949,1.16083e-05,165240636,0.984178
D.truncata,167897087,VNJQ01002587.1,1,1949,1.16083e-05,165242585,0.98419
D.truncata,167897087,VNJQ01001906.1,1,1949,1.16083e-05,165244534,0.984201
D.truncata,167897087,VNJQ01005047.1,1,1948,1.16023e-05,165246482,0.984213
D.truncata,167897087,VNJQ01007215.1,1,1947,1.15964e-05,165248429,0.984225
D.truncata,167897087,VNJQ01003286.1,1,1947,1.15964e-05,165250376,0.984236
D.truncata,167897087,VNJQ01002922.1,1,1947,1.15964e-05,165252323,0.984248
D.truncata,167897087,VNJQ01000252.1,1,1946,1.15904e-05,165254269,0.984259
D.truncata,167897087,VNJQ01003346.1,1,1944,1.15785e-05,165256213,0.984271
D.truncata,167897087,VNJQ01002257.1,1,1944,1.15785e-05,165258157,0.984282
D.truncata,167897087,VNJQ01000593.1,1,1944,1.15785e-05,165260101,0.984294
D.truncata,167897087,VNJQ01000585.1,1,1943,1.15726e-05,165262044,0.984306
D.truncata,167897087,VNJQ01007400.1,1,1942,1.15666e-05,165263986,0.984317
D.truncata,167897087,VNJQ01006563.1,1,1942,1.15666e-05,165265928,0.984329
D.truncata,167897087,VNJQ01002991.1,1,1942,1.15666e-05,165267870,0.98434
D.truncata,167897087,VNJQ01002326.1,1,1942,1.15666e-05,165269812,0.984352
D.truncata,167897087,VNJQ01001054.1,1,1941,1.15607e-05,165271753,0.984363
D.truncata,167897087,VNJQ01004170.1,1,1940,1.15547e-05,165273693,0.984375
D.truncata,167897087,VNJQ01001949.1,1,1940,1.15547e-05,165275633,0.984387
D.truncata,167897087,VNJQ01006929.1,1,1939,1.15487e-05,165277572,0.984398
D.truncata,167897087,VNJQ01005453.1,1,1938,1.15428e-05,165279510,0.98441
D.truncata,167897087,VNJQ01004325.1,1,1938,1.15428e-05,165281448,0.984421
D.truncata,167897087,VNJQ01001776.1,1,1938,1.15428e-05,165283386,0.984433
D.truncata,167897087,VNJQ01005630.1,1,1937,1.15368e-05,165285323,0.984444
D.truncata,167897087,VNJQ01007405.1,1,1936,1.15309e-05,165287259,0.984456
D.truncata,167897087,VNJQ01003397.1,1,1936,1.15309e-05,165289195,0.984467
D.truncata,167897087,VNJQ01005615.1,1,1935,1.15249e-05,165291130,0.984479
D.truncata,167897087,VNJQ01004147.1,1,1935,1.15249e-05,165293065,0.98449
D.truncata,167897087,VNJQ01000990.1,1,1934,1.1519e-05,165294999,0.984502
D.truncata,167897087,VNJQ01000732.1,1,1934,1.1519e-05,165296933,0.984513
D.truncata,167897087,VNJQ01003721.1,1,1933,1.1513e-05,165298866,0.984525
D.truncata,167897087,VNJQ01003422.1,1,1933,1.1513e-05,165300799,0.984536
D.truncata,167897087,VNJQ01000367.1,1,1933,1.1513e-05,165302732,0.984548
D.truncata,167897087,VNJQ01000330.1,1,1933,1.1513e-05,165304665,0.984559
D.truncata,167897087,VNJQ01008024.1,1,1932,1.1507e-05,165306597,0.984571
D.truncata,167897087,VNJQ01008131.1,1,1931,1.15011e-05,165308528,0.984582
D.truncata,167897087,VNJQ01006730.1,1,1931,1.15011e-05,165310459,0.984594
D.truncata,167897087,VNJQ01006047.1,1,1931,1.15011e-05,165312390,0.984605
D.truncata,167897087,VNJQ01005986.1,1,1930,1.14951e-05,165314320,0.984617
D.truncata,167897087,VNJQ01007406.1,1,1928,1.14832e-05,165316248,0.984628
D.truncata,167897087,VNJQ01006713.1,1,1927,1.14773e-05,165318175,0.98464
D.truncata,167897087,VNJQ01006181.1,1,1927,1.14773e-05,165320102,0.984651
D.truncata,167897087,VNJQ01005920.1,1,1927,1.14773e-05,165322029,0.984663
D.truncata,167897087,VNJQ01005487.1,1,1927,1.14773e-05,165323956,0.984674
D.truncata,167897087,VNJQ01006525.1,1,1926,1.14713e-05,165325882,0.984686
D.truncata,167897087,VNJQ01000437.1,1,1926,1.14713e-05,165327808,0.984697
D.truncata,167897087,VNJQ01005616.1,1,1925,1.14654e-05,165329733,0.984709
D.truncata,167897087,VNJQ01005094.1,1,1925,1.14654e-05,165331658,0.98472
D.truncata,167897087,VNJQ01004211.1,1,1925,1.14654e-05,165333583,0.984732
D.truncata,167897087,VNJQ01003928.1,1,1925,1.14654e-05,165335508,0.984743
D.truncata,167897087,VNJQ01006626.1,1,1924,1.14594e-05,165337432,0.984755
D.truncata,167897087,VNJQ01002844.1,1,1924,1.14594e-05,165339356,0.984766
D.truncata,167897087,VNJQ01006110.1,1,1922,1.14475e-05,165341278,0.984778
D.truncata,167897087,VNJQ01005732.1,1,1922,1.14475e-05,165343200,0.984789
D.truncata,167897087,VNJQ01004104.1,1,1922,1.14475e-05,165345122,0.9848
D.truncata,167897087,VNJQ01002633.1,1,1922,1.14475e-05,165347044,0.984812
D.truncata,167897087,VNJQ01003515.1,1,1921,1.14415e-05,165348965,0.984823
D.truncata,167897087,VNJQ01002507.1,1,1921,1.14415e-05,165350886,0.984835
D.truncata,167897087,VNJQ01001805.1,1,1921,1.14415e-05,165352807,0.984846
D.truncata,167897087,VNJQ01004234.1,1,1920,1.14356e-05,165354727,0.984858
D.truncata,167897087,VNJQ01008121.1,1,1919,1.14296e-05,165356646,0.984869
D.truncata,167897087,VNJQ01007067.1,1,1919,1.14296e-05,165358565,0.98488
D.truncata,167897087,VNJQ01002447.1,1,1919,1.14296e-05,165360484,0.984892
D.truncata,167897087,VNJQ01007958.1,1,1918,1.14237e-05,165362402,0.984903
D.truncata,167897087,VNJQ01006057.1,1,1918,1.14237e-05,165364320,0.984915
D.truncata,167897087,VNJQ01007966.1,1,1917,1.14177e-05,165366237,0.984926
D.truncata,167897087,VNJQ01004704.1,1,1917,1.14177e-05,165368154,0.984938
D.truncata,167897087,VNJQ01002464.1,1,1917,1.14177e-05,165370071,0.984949
D.truncata,167897087,VNJQ01002125.1,1,1917,1.14177e-05,165371988,0.98496
D.truncata,167897087,VNJQ01007720.1,1,1916,1.14118e-05,165373904,0.984972
D.truncata,167897087,VNJQ01002506.1,1,1916,1.14118e-05,165375820,0.984983
D.truncata,167897087,VNJQ01007182.1,1,1915,1.14058e-05,165377735,0.984995
D.truncata,167897087,VNJQ01004618.1,1,1915,1.14058e-05,165379650,0.985006
D.truncata,167897087,VNJQ01002505.1,1,1915,1.14058e-05,165381565,0.985017
D.truncata,167897087,VNJQ01005813.1,1,1914,1.13998e-05,165383479,0.985029
D.truncata,167897087,VNJQ01004590.1,1,1914,1.13998e-05,165385393,0.98504
D.truncata,167897087,VNJQ01002514.1,1,1914,1.13998e-05,165387307,0.985052
D.truncata,167897087,VNJQ01000353.1,1,1914,1.13998e-05,165389221,0.985063
D.truncata,167897087,VNJQ01002509.1,1,1912,1.13879e-05,165391133,0.985074
D.truncata,167897087,VNJQ01006540.1,1,1911,1.1382e-05,165393044,0.985086
D.truncata,167897087,VNJQ01007811.1,1,1908,1.13641e-05,165394952,0.985097
D.truncata,167897087,VNJQ01005397.1,1,1908,1.13641e-05,165396860,0.985109
D.truncata,167897087,VNJQ01003506.1,1,1908,1.13641e-05,165398768,0.98512
D.truncata,167897087,VNJQ01002002.1,1,1906,1.13522e-05,165400674,0.985131
D.truncata,167897087,VNJQ01007710.1,1,1905,1.13462e-05,165402579,0.985143
D.truncata,167897087,VNJQ01006922.1,1,1905,1.13462e-05,165404484,0.985154
D.truncata,167897087,VNJQ01005846.1,1,1905,1.13462e-05,165406389,0.985165
D.truncata,167897087,VNJQ01002513.1,1,1904,1.13403e-05,165408293,0.985177
D.truncata,167897087,VNJQ01002138.1,1,1904,1.13403e-05,165410197,0.985188
D.truncata,167897087,VNJQ01005646.1,1,1900,1.13165e-05,165412097,0.985199
D.truncata,167897087,VNJQ01005388.1,1,1899,1.13105e-05,165413996,0.985211
D.truncata,167897087,VNJQ01004197.1,1,1899,1.13105e-05,165415895,0.985222
D.truncata,167897087,VNJQ01001766.1,1,1899,1.13105e-05,165417794,0.985233
D.truncata,167897087,VNJQ01000720.1,1,1899,1.13105e-05,165419693,0.985245
D.truncata,167897087,VNJQ01000672.1,1,1899,1.13105e-05,165421592,0.985256
D.truncata,167897087,VNJQ01006494.1,1,1898,1.13045e-05,165423490,0.985267
D.truncata,167897087,VNJQ01005932.1,1,1898,1.13045e-05,165425388,0.985278
D.truncata,167897087,VNJQ01005598.1,1,1898,1.13045e-05,165427286,0.98529
D.truncata,167897087,VNJQ01004084.1,1,1898,1.13045e-05,165429184,0.985301
D.truncata,167897087,VNJQ01003980.1,1,1898,1.13045e-05,165431082,0.985312
D.truncata,167897087,VNJQ01003402.1,1,1898,1.13045e-05,165432980,0.985324
D.truncata,167897087,VNJQ01006778.1,1,1897,1.12986e-05,165434877,0.985335
D.truncata,167897087,VNJQ01005888.1,1,1897,1.12986e-05,165436774,0.985346
D.truncata,167897087,VNJQ01005477.1,1,1897,1.12986e-05,165438671,0.985358
D.truncata,167897087,VNJQ01007897.1,1,1896,1.12926e-05,165440567,0.985369
D.truncata,167897087,VNJQ01004566.1,1,1896,1.12926e-05,165442463,0.98538
D.truncata,167897087,VNJQ01003323.1,1,1896,1.12926e-05,165444359,0.985391
D.truncata,167897087,VNJQ01001094.1,1,1896,1.12926e-05,165446255,0.985403
D.truncata,167897087,VNJQ01004045.1,1,1893,1.12748e-05,165448148,0.985414
D.truncata,167897087,VNJQ01002864.1,1,1893,1.12748e-05,165450041,0.985425
D.truncata,167897087,VNJQ01004289.1,1,1892,1.12688e-05,165451933,0.985437
D.truncata,167897087,VNJQ01003991.1,1,1891,1.12629e-05,165453824,0.985448
D.truncata,167897087,VNJQ01002508.1,1,1891,1.12629e-05,165455715,0.985459
D.truncata,167897087,VNJQ01001398.1,1,1891,1.12629e-05,165457606,0.98547
D.truncata,167897087,VNJQ01001452.1,1,1890,1.12569e-05,165459496,0.985482
D.truncata,167897087,VNJQ01002606.1,1,1889,1.12509e-05,165461385,0.985493
D.truncata,167897087,VNJQ01004210.1,1,1888,1.1245e-05,165463273,0.985504
D.truncata,167897087,VNJQ01006192.1,1,1887,1.1239e-05,165465160,0.985515
D.truncata,167897087,VNJQ01000426.1,1,1887,1.1239e-05,165467047,0.985527
D.truncata,167897087,VNJQ01003430.1,1,1886,1.12331e-05,165468933,0.985538
D.truncata,167897087,VNJQ01001800.1,1,1885,1.12271e-05,165470818,0.985549
D.truncata,167897087,VNJQ01001598.1,1,1885,1.12271e-05,165472703,0.98556
D.truncata,167897087,VNJQ01006829.1,1,1884,1.12212e-05,165474587,0.985572
D.truncata,167897087,VNJQ01006539.1,1,1884,1.12212e-05,165476471,0.985583
D.truncata,167897087,VNJQ01002562.1,1,1884,1.12212e-05,165478355,0.985594
D.truncata,167897087,VNJQ01007179.1,1,1883,1.12152e-05,165480238,0.985605
D.truncata,167897087,VNJQ01003816.1,1,1883,1.12152e-05,165482121,0.985616
D.truncata,167897087,VNJQ01006189.1,1,1882,1.12092e-05,165484003,0.985628
D.truncata,167897087,VNJQ01004750.1,1,1882,1.12092e-05,165485885,0.985639
D.truncata,167897087,VNJQ01004262.1,1,1882,1.12092e-05,165487767,0.98565
D.truncata,167897087,VNJQ01006094.1,1,1881,1.12033e-05,165489648,0.985661
D.truncata,167897087,VNJQ01004312.1,1,1880,1.11973e-05,165491528,0.985672
D.truncata,167897087,VNJQ01003719.1,1,1880,1.11973e-05,165493408,0.985684
D.truncata,167897087,VNJQ01002761.1,1,1880,1.11973e-05,165495288,0.985695
D.truncata,167897087,VNJQ01002504.1,1,1880,1.11973e-05,165497168,0.985706
D.truncata,167897087,VNJQ01003989.1,1,1879,1.11914e-05,165499047,0.985717
D.truncata,167897087,VNJQ01003191.1,1,1879,1.11914e-05,165500926,0.985728
D.truncata,167897087,VNJQ01002449.1,1,1879,1.11914e-05,165502805,0.98574
D.truncata,167897087,VNJQ01006166.1,1,1878,1.11854e-05,165504683,0.985751
D.truncata,167897087,VNJQ01007120.1,1,1877,1.11795e-05,165506560,0.985762
D.truncata,167897087,VNJQ01000497.1,1,1877,1.11795e-05,165508437,0.985773
D.truncata,167897087,VNJQ01000351.1,1,1877,1.11795e-05,165510314,0.985784
D.truncata,167897087,VNJQ01007846.1,1,1876,1.11735e-05,165512190,0.985795
D.truncata,167897087,VNJQ01006496.1,1,1876,1.11735e-05,165514066,0.985807
D.truncata,167897087,VNJQ01004238.1,1,1875,1.11676e-05,165515941,0.985818
D.truncata,167897087,VNJQ01000979.1,1,1875,1.11676e-05,165517816,0.985829
D.truncata,167897087,VNJQ01002440.1,1,1874,1.11616e-05,165519690,0.98584
D.truncata,167897087,VNJQ01007178.1,1,1872,1.11497e-05,165521562,0.985851
D.truncata,167897087,VNJQ01003135.1,1,1871,1.11437e-05,165523433,0.985862
D.truncata,167897087,VNJQ01001603.1,1,1870,1.11378e-05,165525303,0.985874
D.truncata,167897087,VNJQ01005610.1,1,1869,1.11318e-05,165527172,0.985885
D.truncata,167897087,VNJQ01002339.1,1,1869,1.11318e-05,165529041,0.985896
D.truncata,167897087,VNJQ01000102.1,1,1869,1.11318e-05,165530910,0.985907
D.truncata,167897087,VNJQ01005950.1,1,1867,1.11199e-05,165532777,0.985918
D.truncata,167897087,VNJQ01004976.1,1,1865,1.1108e-05,165534642,0.985929
D.truncata,167897087,VNJQ01004297.1,1,1865,1.1108e-05,165536507,0.98594
D.truncata,167897087,VNJQ01006699.1,1,1864,1.1102e-05,165538371,0.985951
D.truncata,167897087,VNJQ01006592.1,1,1864,1.1102e-05,165540235,0.985963
D.truncata,167897087,VNJQ01005966.1,1,1864,1.1102e-05,165542099,0.985974
D.truncata,167897087,VNJQ01005949.1,1,1864,1.1102e-05,165543963,0.985985
D.truncata,167897087,VNJQ01005639.1,1,1864,1.1102e-05,165545827,0.985996
D.truncata,167897087,VNJQ01004636.1,1,1864,1.1102e-05,165547691,0.986007
D.truncata,167897087,VNJQ01000521.1,1,1864,1.1102e-05,165549555,0.986018
D.truncata,167897087,VNJQ01006497.1,1,1863,1.10961e-05,165551418,0.986029
D.truncata,167897087,VNJQ01004688.1,1,1863,1.10961e-05,165553281,0.98604
D.truncata,167897087,VNJQ01007113.1,1,1862,1.10901e-05,165555143,0.986051
D.truncata,167897087,VNJQ01004638.1,1,1862,1.10901e-05,165557005,0.986062
D.truncata,167897087,VNJQ01003524.1,1,1862,1.10901e-05,165558867,0.986073
D.truncata,167897087,VNJQ01003433.1,1,1862,1.10901e-05,165560729,0.986085
D.truncata,167897087,VNJQ01004087.1,1,1861,1.10842e-05,165562590,0.986096
D.truncata,167897087,VNJQ01004617.1,1,1859,1.10723e-05,165564449,0.986107
D.truncata,167897087,VNJQ01006931.1,1,1858,1.10663e-05,165566307,0.986118
D.truncata,167897087,VNJQ01002421.1,1,1858,1.10663e-05,165568165,0.986129
D.truncata,167897087,VNJQ01004215.1,1,1857,1.10603e-05,165570022,0.98614
D.truncata,167897087,VNJQ01001003.1,1,1857,1.10603e-05,165571879,0.986151
D.truncata,167897087,VNJQ01000075.1,1,1856,1.10544e-05,165573735,0.986162
D.truncata,167897087,VNJQ01006655.1,1,1855,1.10484e-05,165575590,0.986173
D.truncata,167897087,VNJQ01004212.1,1,1855,1.10484e-05,165577445,0.986184
D.truncata,167897087,VNJQ01006425.1,1,1854,1.10425e-05,165579299,0.986195
D.truncata,167897087,VNJQ01008040.1,1,1853,1.10365e-05,165581152,0.986206
D.truncata,167897087,VNJQ01007056.1,1,1852,1.10306e-05,165583004,0.986217
D.truncata,167897087,VNJQ01004051.1,1,1851,1.10246e-05,165584855,0.986228
D.truncata,167897087,VNJQ01006126.1,1,1850,1.10187e-05,165586705,0.986239
D.truncata,167897087,VNJQ01004700.1,1,1850,1.10187e-05,165588555,0.98625
D.truncata,167897087,VNJQ01004081.1,1,1850,1.10187e-05,165590405,0.986261
D.truncata,167897087,VNJQ01008061.1,1,1849,1.10127e-05,165592254,0.986272
D.truncata,167897087,VNJQ01007682.1,1,1847,1.10008e-05,165594101,0.986283
D.truncata,167897087,VNJQ01004324.1,1,1847,1.10008e-05,165595948,0.986294
D.truncata,167897087,VNJQ01003581.1,1,1847,1.10008e-05,165597795,0.986305
D.truncata,167897087,VNJQ01000769.1,1,1847,1.10008e-05,165599642,0.986316
D.truncata,167897087,VNJQ01005406.1,1,1846,1.09948e-05,165601488,0.986327
D.truncata,167897087,VNJQ01005936.1,1,1845,1.09889e-05,165603333,0.986338
D.truncata,167897087,VNJQ01000742.1,1,1845,1.09889e-05,165605178,0.986349
D.truncata,167897087,VNJQ01006315.1,1,1844,1.09829e-05,165607022,0.98636
D.truncata,167897087,VNJQ01005717.1,1,1844,1.09829e-05,165608866,0.986371
D.truncata,167897087,VNJQ01004409.1,1,1844,1.09829e-05,165610710,0.986382
D.truncata,167897087,VNJQ01000543.1,1,1844,1.09829e-05,165612554,0.986393
D.truncata,167897087,VNJQ01003023.1,1,1843,1.0977e-05,165614397,0.986404
D.truncata,167897087,VNJQ01002702.1,1,1843,1.0977e-05,165616240,0.986415
D.truncata,167897087,VNJQ01007244.1,1,1842,1.0971e-05,165618082,0.986426
D.truncata,167897087,VNJQ01001516.1,1,1842,1.0971e-05,165619924,0.986437
D.truncata,167897087,VNJQ01007059.1,1,1841,1.09651e-05,165621765,0.986448
D.truncata,167897087,VNJQ01005915.1,1,1841,1.09651e-05,165623606,0.986459
D.truncata,167897087,VNJQ01004755.1,1,1841,1.09651e-05,165625447,0.98647
D.truncata,167897087,VNJQ01007487.1,1,1840,1.09591e-05,165627287,0.986481
D.truncata,167897087,VNJQ01006950.1,1,1840,1.09591e-05,165629127,0.986492
D.truncata,167897087,VNJQ01003400.1,1,1840,1.09591e-05,165630967,0.986503
D.truncata,167897087,VNJQ01006353.1,1,1838,1.09472e-05,165632805,0.986514
D.truncata,167897087,VNJQ01003546.1,1,1838,1.09472e-05,165634643,0.986525
D.truncata,167897087,VNJQ01007577.1,1,1837,1.09412e-05,165636480,0.986536
D.truncata,167897087,VNJQ01003706.1,1,1837,1.09412e-05,165638317,0.986547
D.truncata,167897087,VNJQ01007447.1,1,1836,1.09353e-05,165640153,0.986558
D.truncata,167897087,VNJQ01003922.1,1,1836,1.09353e-05,165641989,0.986569
D.truncata,167897087,VNJQ01007595.1,1,1835,1.09293e-05,165643824,0.986579
D.truncata,167897087,VNJQ01000774.1,1,1835,1.09293e-05,165645659,0.98659
D.truncata,167897087,VNJQ01005923.1,1,1834,1.09234e-05,165647493,0.986601
D.truncata,167897087,VNJQ01000527.1,1,1834,1.09234e-05,165649327,0.986612
D.truncata,167897087,VNJQ01005730.1,1,1833,1.09174e-05,165651160,0.986623
D.truncata,167897087,VNJQ01001937.1,1,1833,1.09174e-05,165652993,0.986634
D.truncata,167897087,VNJQ01001968.1,1,1831,1.09055e-05,165654824,0.986645
D.truncata,167897087,VNJQ01004323.1,1,1830,1.08995e-05,165656654,0.986656
D.truncata,167897087,VNJQ01006170.1,1,1829,1.08936e-05,165658483,0.986667
D.truncata,167897087,VNJQ01001374.1,1,1829,1.08936e-05,165660312,0.986678
D.truncata,167897087,VNJQ01000052.1,1,1829,1.08936e-05,165662141,0.986689
D.truncata,167897087,VNJQ01006704.1,1,1828,1.08876e-05,165663969,0.986699
D.truncata,167897087,VNJQ01005937.1,1,1828,1.08876e-05,165665797,0.98671
D.truncata,167897087,VNJQ01001769.1,1,1828,1.08876e-05,165667625,0.986721
D.truncata,167897087,VNJQ01006209.1,1,1827,1.08817e-05,165669452,0.986732
D.truncata,167897087,VNJQ01002713.1,1,1827,1.08817e-05,165671279,0.986743
D.truncata,167897087,VNJQ01006500.1,1,1826,1.08757e-05,165673105,0.986754
D.truncata,167897087,VNJQ01000501.1,1,1826,1.08757e-05,165674931,0.986765
D.truncata,167897087,VNJQ01000403.1,1,1826,1.08757e-05,165676757,0.986776
D.truncata,167897087,VNJQ01005132.1,1,1825,1.08698e-05,165678582,0.986787
D.truncata,167897087,VNJQ01004726.1,1,1825,1.08698e-05,165680407,0.986797
D.truncata,167897087,VNJQ01000110.1,1,1825,1.08698e-05,165682232,0.986808
D.truncata,167897087,VNJQ01005965.1,1,1824,1.08638e-05,165684056,0.986819
D.truncata,167897087,VNJQ01002212.1,1,1824,1.08638e-05,165685880,0.98683
D.truncata,167897087,VNJQ01001214.1,1,1824,1.08638e-05,165687704,0.986841
D.truncata,167897087,VNJQ01003656.1,1,1823,1.08578e-05,165689527,0.986852
D.truncata,167897087,VNJQ01000443.1,1,1823,1.08578e-05,165691350,0.986863
D.truncata,167897087,VNJQ01005929.1,1,1822,1.08519e-05,165693172,0.986873
D.truncata,167897087,VNJQ01003775.1,1,1822,1.08519e-05,165694994,0.986884
D.truncata,167897087,VNJQ01003598.1,1,1822,1.08519e-05,165696816,0.986895
D.truncata,167897087,VNJQ01000939.1,1,1822,1.08519e-05,165698638,0.986906
D.truncata,167897087,VNJQ01000627.1,1,1822,1.08519e-05,165700460,0.986917
D.truncata,167897087,VNJQ01005421.1,1,1821,1.08459e-05,165702281,0.986928
D.truncata,167897087,VNJQ01003639.1,1,1820,1.084e-05,165704101,0.986939
D.truncata,167897087,VNJQ01002354.1,1,1820,1.084e-05,165705921,0.986949
D.truncata,167897087,VNJQ01002142.1,1,1819,1.0834e-05,165707740,0.98696
D.truncata,167897087,VNJQ01000991.1,1,1819,1.0834e-05,165709559,0.986971
D.truncata,167897087,VNJQ01004308.1,1,1818,1.08281e-05,165711377,0.986982
D.truncata,167897087,VNJQ01003350.1,1,1818,1.08281e-05,165713195,0.986993
D.truncata,167897087,VNJQ01007289.1,1,1817,1.08221e-05,165715012,0.987003
D.truncata,167897087,VNJQ01000179.1,1,1816,1.08161e-05,165716828,0.987014
D.truncata,167897087,VNJQ01007628.1,1,1815,1.08102e-05,165718643,0.987025
D.truncata,167897087,VNJQ01005455.1,1,1815,1.08102e-05,165720458,0.987036
D.truncata,167897087,VNJQ01003701.1,1,1815,1.08102e-05,165722273,0.987047
D.truncata,167897087,VNJQ01000911.1,1,1815,1.08102e-05,165724088,0.987058
D.truncata,167897087,VNJQ01007382.1,1,1813,1.07983e-05,165725901,0.987068
D.truncata,167897087,VNJQ01006502.1,1,1813,1.07983e-05,165727714,0.987079
D.truncata,167897087,VNJQ01004322.1,1,1813,1.07983e-05,165729527,0.98709
D.truncata,167897087,VNJQ01003225.1,1,1813,1.07983e-05,165731340,0.987101
D.truncata,167897087,VNJQ01005678.1,1,1812,1.07923e-05,165733152,0.987112
D.truncata,167897087,VNJQ01001113.1,1,1812,1.07923e-05,165734964,0.987122
D.truncata,167897087,VNJQ01007439.1,1,1811,1.07864e-05,165736775,0.987133
D.truncata,167897087,VNJQ01004159.1,1,1811,1.07864e-05,165738586,0.987144
D.truncata,167897087,VNJQ01003591.1,1,1811,1.07864e-05,165740397,0.987155
D.truncata,167897087,VNJQ01005695.1,1,1810,1.07804e-05,165742207,0.987165
D.truncata,167897087,VNJQ01002793.1,1,1809,1.07745e-05,165744016,0.987176
D.truncata,167897087,VNJQ01005710.1,1,1807,1.07625e-05,165745823,0.987187
D.truncata,167897087,VNJQ01002857.1,1,1807,1.07625e-05,165747630,0.987198
D.truncata,167897087,VNJQ01002452.1,1,1807,1.07625e-05,165749437,0.987209
D.truncata,167897087,VNJQ01001674.1,1,1807,1.07625e-05,165751244,0.987219
D.truncata,167897087,VNJQ01003366.1,1,1806,1.07566e-05,165753050,0.98723
D.truncata,167897087,VNJQ01003143.1,1,1806,1.07566e-05,165754856,0.987241
D.truncata,167897087,VNJQ01006989.1,1,1805,1.07506e-05,165756661,0.987252
D.truncata,167897087,VNJQ01000953.1,1,1805,1.07506e-05,165758466,0.987262
D.truncata,167897087,VNJQ01006621.1,1,1804,1.07447e-05,165760270,0.987273
D.truncata,167897087,VNJQ01004321.1,1,1804,1.07447e-05,165762074,0.987284
D.truncata,167897087,VNJQ01003427.1,1,1804,1.07447e-05,165763878,0.987295
D.truncata,167897087,VNJQ01002209.1,1,1804,1.07447e-05,165765682,0.987305
D.truncata,167897087,VNJQ01007247.1,1,1803,1.07387e-05,165767485,0.987316
D.truncata,167897087,VNJQ01006501.1,1,1802,1.07328e-05,165769287,0.987327
D.truncata,167897087,VNJQ01000736.1,1,1802,1.07328e-05,165771089,0.987337
D.truncata,167897087,VNJQ01002902.1,1,1801,1.07268e-05,165772890,0.987348
D.truncata,167897087,VNJQ01002856.1,1,1801,1.07268e-05,165774691,0.987359
D.truncata,167897087,VNJQ01007911.1,1,1800,1.07209e-05,165776491,0.98737
D.truncata,167897087,VNJQ01006902.1,1,1800,1.07209e-05,165778291,0.98738
D.truncata,167897087,VNJQ01004033.1,1,1800,1.07209e-05,165780091,0.987391
D.truncata,167897087,VNJQ01002268.1,1,1800,1.07209e-05,165781891,0.987402
D.truncata,167897087,VNJQ01002043.1,1,1800,1.07209e-05,165783691,0.987413
D.truncata,167897087,VNJQ01000986.1,1,1800,1.07209e-05,165785491,0.987423
D.truncata,167897087,VNJQ01003131.1,1,1799,1.07149e-05,165787290,0.987434
D.truncata,167897087,VNJQ01002441.1,1,1799,1.07149e-05,165789089,0.987445
D.truncata,167897087,VNJQ01001936.1,1,1798,1.07089e-05,165790887,0.987455
D.truncata,167897087,VNJQ01008166.1,1,1795,1.06911e-05,165792682,0.987466
D.truncata,167897087,VNJQ01004535.1,1,1795,1.06911e-05,165794477,0.987477
D.truncata,167897087,VNJQ01004329.1,1,1795,1.06911e-05,165796272,0.987487
D.truncata,167897087,VNJQ01002322.1,1,1795,1.06911e-05,165798067,0.987498
D.truncata,167897087,VNJQ01007733.1,1,1794,1.06851e-05,165799861,0.987509
D.truncata,167897087,VNJQ01004835.1,1,1794,1.06851e-05,165801655,0.98752
D.truncata,167897087,VNJQ01006812.1,1,1793,1.06792e-05,165803448,0.98753
D.truncata,167897087,VNJQ01006049.1,1,1793,1.06792e-05,165805241,0.987541
D.truncata,167897087,VNJQ01004017.1,1,1793,1.06792e-05,165807034,0.987552
D.truncata,167897087,VNJQ01004123.1,1,1789,1.06553e-05,165808823,0.987562
D.truncata,167897087,VNJQ01002916.1,1,1789,1.06553e-05,165810612,0.987573
D.truncata,167897087,VNJQ01002529.1,1,1789,1.06553e-05,165812401,0.987584
D.truncata,167897087,VNJQ01000018.1,1,1789,1.06553e-05,165814190,0.987594
D.truncata,167897087,VNJQ01003583.1,1,1787,1.06434e-05,165815977,0.987605
D.truncata,167897087,VNJQ01006511.1,1,1786,1.06375e-05,165817763,0.987615
D.truncata,167897087,VNJQ01004543.1,1,1786,1.06375e-05,165819549,0.987626
D.truncata,167897087,VNJQ01007192.1,1,1785,1.06315e-05,165821334,0.987637
D.truncata,167897087,VNJQ01004737.1,1,1785,1.06315e-05,165823119,0.987647
D.truncata,167897087,VNJQ01003014.1,1,1785,1.06315e-05,165824904,0.987658
D.truncata,167897087,VNJQ01007970.1,1,1783,1.06196e-05,165826687,0.987669
D.truncata,167897087,VNJQ01000773.1,1,1783,1.06196e-05,165828470,0.987679
D.truncata,167897087,VNJQ01005629.1,1,1782,1.06136e-05,165830252,0.98769
D.truncata,167897087,VNJQ01000325.1,1,1782,1.06136e-05,165832034,0.9877
D.truncata,167897087,VNJQ01000282.1,1,1782,1.06136e-05,165833816,0.987711
D.truncata,167897087,VNJQ01008007.1,1,1781,1.06077e-05,165835597,0.987722
D.truncata,167897087,VNJQ01007857.1,1,1781,1.06077e-05,165837378,0.987732
D.truncata,167897087,VNJQ01005254.1,1,1781,1.06077e-05,165839159,0.987743
D.truncata,167897087,VNJQ01003627.1,1,1781,1.06077e-05,165840940,0.987754
D.truncata,167897087,VNJQ01004768.1,1,1780,1.06017e-05,165842720,0.987764
D.truncata,167897087,VNJQ01002385.1,1,1778,1.05898e-05,165844498,0.987775
D.truncata,167897087,VNJQ01000750.1,1,1778,1.05898e-05,165846276,0.987785
D.truncata,167897087,VNJQ01007711.1,1,1777,1.05839e-05,165848053,0.987796
D.truncata,167897087,VNJQ01000660.1,1,1777,1.05839e-05,165849830,0.987806
D.truncata,167897087,VNJQ01000416.1,1,1777,1.05839e-05,165851607,0.987817
D.truncata,167897087,VNJQ01003107.1,1,1775,1.0572e-05,165853382,0.987828
D.truncata,167897087,VNJQ01000935.1,1,1775,1.0572e-05,165855157,0.987838
D.truncata,167897087,VNJQ01000808.1,1,1775,1.0572e-05,165856932,0.987849
D.truncata,167897087,VNJQ01005604.1,1,1774,1.0566e-05,165858706,0.987859
D.truncata,167897087,VNJQ01000379.1,1,1774,1.0566e-05,165860480,0.98787
D.truncata,167897087,VNJQ01003071.1,1,1773,1.056e-05,165862253,0.98788
D.truncata,167897087,VNJQ01002599.1,1,1773,1.056e-05,165864026,0.987891
D.truncata,167897087,VNJQ01002547.1,1,1773,1.056e-05,165865799,0.987902
D.truncata,167897087,VNJQ01002254.1,1,1773,1.056e-05,165867572,0.987912
D.truncata,167897087,VNJQ01000996.1,1,1773,1.056e-05,165869345,0.987923
D.truncata,167897087,VNJQ01007227.1,1,1772,1.05541e-05,165871117,0.987933
D.truncata,167897087,VNJQ01002602.1,1,1772,1.05541e-05,165872889,0.987944
D.truncata,167897087,VNJQ01007629.1,1,1771,1.05481e-05,165874660,0.987954
D.truncata,167897087,VNJQ01006597.1,1,1770,1.05422e-05,165876430,0.987965
D.truncata,167897087,VNJQ01003394.1,1,1770,1.05422e-05,165878200,0.987975
D.truncata,167897087,VNJQ01002931.1,1,1770,1.05422e-05,165879970,0.987986
D.truncata,167897087,VNJQ01007666.1,1,1769,1.05362e-05,165881739,0.987997
D.truncata,167897087,VNJQ01007235.1,1,1769,1.05362e-05,165883508,0.988007
D.truncata,167897087,VNJQ01005433.1,1,1769,1.05362e-05,165885277,0.988018
D.truncata,167897087,VNJQ01005109.1,1,1769,1.05362e-05,165887046,0.988028
D.truncata,167897087,VNJQ01002198.1,1,1769,1.05362e-05,165888815,0.988039
D.truncata,167897087,VNJQ01000835.1,1,1769,1.05362e-05,165890584,0.988049
D.truncata,167897087,VNJQ01006147.1,1,1767,1.05243e-05,165892351,0.98806
D.truncata,167897087,VNJQ01003705.1,1,1767,1.05243e-05,165894118,0.98807
D.truncata,167897087,VNJQ01003288.1,1,1767,1.05243e-05,165895885,0.988081
D.truncata,167897087,VNJQ01008170.1,1,1765,1.05124e-05,165897650,0.988091
D.truncata,167897087,VNJQ01007777.1,1,1763,1.05005e-05,165899413,0.988102
D.truncata,167897087,VNJQ01004260.1,1,1763,1.05005e-05,165901176,0.988112
D.truncata,167897087,VNJQ01001500.1,1,1763,1.05005e-05,165902939,0.988123
D.truncata,167897087,VNJQ01001302.1,1,1762,1.04945e-05,165904701,0.988133
D.truncata,167897087,VNJQ01007001.1,1,1761,1.04886e-05,165906462,0.988144
D.truncata,167897087,VNJQ01004408.1,1,1761,1.04886e-05,165908223,0.988154
D.truncata,167897087,VNJQ01002742.1,1,1761,1.04886e-05,165909984,0.988165
D.truncata,167897087,VNJQ01004328.1,1,1760,1.04826e-05,165911744,0.988175
D.truncata,167897087,VNJQ01000618.1,1,1760,1.04826e-05,165913504,0.988186
D.truncata,167897087,VNJQ01007719.1,1,1759,1.04767e-05,165915263,0.988196
D.truncata,167897087,VNJQ01007633.1,1,1758,1.04707e-05,165917021,0.988207
D.truncata,167897087,VNJQ01005963.1,1,1758,1.04707e-05,165918779,0.988217
D.truncata,167897087,VNJQ01004979.1,1,1757,1.04647e-05,165920536,0.988228
D.truncata,167897087,VNJQ01004129.1,1,1757,1.04647e-05,165922293,0.988238
D.truncata,167897087,VNJQ01000019.1,1,1757,1.04647e-05,165924050,0.988249
D.truncata,167897087,VNJQ01006634.1,1,1756,1.04588e-05,165925806,0.988259
D.truncata,167897087,VNJQ01007365.1,1,1755,1.04528e-05,165927561,0.988269
D.truncata,167897087,VNJQ01004950.1,1,1754,1.04469e-05,165929315,0.98828
D.truncata,167897087,VNJQ01000259.1,1,1754,1.04469e-05,165931069,0.98829
D.truncata,167897087,VNJQ01006343.1,1,1753,1.04409e-05,165932822,0.988301
D.truncata,167897087,VNJQ01005102.1,1,1753,1.04409e-05,165934575,0.988311
D.truncata,167897087,VNJQ01004689.1,1,1753,1.04409e-05,165936328,0.988322
D.truncata,167897087,VNJQ01006556.1,1,1751,1.0429e-05,165938079,0.988332
D.truncata,167897087,VNJQ01005808.1,1,1751,1.0429e-05,165939830,0.988343
D.truncata,167897087,VNJQ01002223.1,1,1750,1.04231e-05,165941580,0.988353
D.truncata,167897087,VNJQ01002134.1,1,1749,1.04171e-05,165943329,0.988363
D.truncata,167897087,VNJQ01003351.1,1,1748,1.04111e-05,165945077,0.988374
D.truncata,167897087,VNJQ01003779.1,1,1747,1.04052e-05,165946824,0.988384
D.truncata,167897087,VNJQ01002648.1,1,1747,1.04052e-05,165948571,0.988395
D.truncata,167897087,VNJQ01000816.1,1,1747,1.04052e-05,165950318,0.988405
D.truncata,167897087,VNJQ01006551.1,1,1746,1.03992e-05,165952064,0.988415
D.truncata,167897087,VNJQ01005447.1,1,1745,1.03933e-05,165953809,0.988426
D.truncata,167897087,VNJQ01004198.1,1,1745,1.03933e-05,165955554,0.988436
D.truncata,167897087,VNJQ01002523.1,1,1745,1.03933e-05,165957299,0.988447
D.truncata,167897087,VNJQ01003970.1,1,1744,1.03873e-05,165959043,0.988457
D.truncata,167897087,VNJQ01006577.1,1,1743,1.03814e-05,165960786,0.988467
D.truncata,167897087,VNJQ01005664.1,1,1743,1.03814e-05,165962529,0.988478
D.truncata,167897087,VNJQ01000766.1,1,1743,1.03814e-05,165964272,0.988488
D.truncata,167897087,VNJQ01004674.1,1,1742,1.03754e-05,165966014,0.988498
D.truncata,167897087,VNJQ01004320.1,1,1742,1.03754e-05,165967756,0.988509
D.truncata,167897087,VNJQ01001642.1,1,1742,1.03754e-05,165969498,0.988519
D.truncata,167897087,VNJQ01007063.1,1,1741,1.03694e-05,165971239,0.98853
D.truncata,167897087,VNJQ01003218.1,1,1741,1.03694e-05,165972980,0.98854
D.truncata,167897087,VNJQ01000055.1,1,1741,1.03694e-05,165974721,0.98855
D.truncata,167897087,VNJQ01005607.1,1,1740,1.03635e-05,165976461,0.988561
D.truncata,167897087,VNJQ01003084.1,1,1740,1.03635e-05,165978201,0.988571
D.truncata,167897087,VNJQ01001664.1,1,1740,1.03635e-05,165979941,0.988581
D.truncata,167897087,VNJQ01001638.1,1,1740,1.03635e-05,165981681,0.988592
D.truncata,167897087,VNJQ01000455.1,1,1740,1.03635e-05,165983421,0.988602
D.truncata,167897087,VNJQ01000119.1,1,1740,1.03635e-05,165985161,0.988613
D.truncata,167897087,VNJQ01003663.1,1,1739,1.03575e-05,165986900,0.988623
D.truncata,167897087,VNJQ01003601.1,1,1739,1.03575e-05,165988639,0.988633
D.truncata,167897087,VNJQ01001128.1,1,1738,1.03516e-05,165990377,0.988644
D.truncata,167897087,VNJQ01003930.1,1,1737,1.03456e-05,165992114,0.988654
D.truncata,167897087,VNJQ01001378.1,1,1737,1.03456e-05,165993851,0.988664
D.truncata,167897087,VNJQ01003769.1,1,1736,1.03397e-05,165995587,0.988675
D.truncata,167897087,VNJQ01003021.1,1,1736,1.03397e-05,165997323,0.988685
D.truncata,167897087,VNJQ01004399.1,1,1735,1.03337e-05,165999058,0.988695
D.truncata,167897087,VNJQ01003544.1,1,1735,1.03337e-05,166000793,0.988706
D.truncata,167897087,VNJQ01006091.1,1,1734,1.03278e-05,166002527,0.988716
D.truncata,167897087,VNJQ01001253.1,1,1734,1.03278e-05,166004261,0.988726
D.truncata,167897087,VNJQ01005854.1,1,1732,1.03158e-05,166005993,0.988737
D.truncata,167897087,VNJQ01004206.1,1,1732,1.03158e-05,166007725,0.988747
D.truncata,167897087,VNJQ01003390.1,1,1732,1.03158e-05,166009457,0.988757
D.truncata,167897087,VNJQ01002428.1,1,1732,1.03158e-05,166011189,0.988768
D.truncata,167897087,VNJQ01000845.1,1,1732,1.03158e-05,166012921,0.988778
D.truncata,167897087,VNJQ01000802.1,1,1732,1.03158e-05,166014653,0.988788
D.truncata,167897087,VNJQ01005076.1,1,1731,1.03099e-05,166016384,0.988798
D.truncata,167897087,VNJQ01001616.1,1,1731,1.03099e-05,166018115,0.988809
D.truncata,167897087,VNJQ01001416.1,1,1731,1.03099e-05,166019846,0.988819
D.truncata,167897087,VNJQ01001124.1,1,1729,1.0298e-05,166021575,0.988829
D.truncata,167897087,VNJQ01007685.1,1,1728,1.0292e-05,166023303,0.98884
D.truncata,167897087,VNJQ01003833.1,1,1728,1.0292e-05,166025031,0.98885
D.truncata,167897087,VNJQ01000667.1,1,1728,1.0292e-05,166026759,0.98886
D.truncata,167897087,VNJQ01000238.1,1,1728,1.0292e-05,166028487,0.988871
D.truncata,167897087,VNJQ01000054.1,1,1728,1.0292e-05,166030215,0.988881
D.truncata,167897087,VNJQ01007381.1,1,1726,1.02801e-05,166031941,0.988891
D.truncata,167897087,VNJQ01007097.1,1,1726,1.02801e-05,166033667,0.988901
D.truncata,167897087,VNJQ01003420.1,1,1726,1.02801e-05,166035393,0.988912
D.truncata,167897087,VNJQ01002861.1,1,1726,1.02801e-05,166037119,0.988922
D.truncata,167897087,VNJQ01000451.1,1,1726,1.02801e-05,166038845,0.988932
D.truncata,167897087,VNJQ01006401.1,1,1725,1.02742e-05,166040570,0.988943
D.truncata,167897087,VNJQ01005153.1,1,1724,1.02682e-05,166042294,0.988953
D.truncata,167897087,VNJQ01000376.1,1,1724,1.02682e-05,166044018,0.988963
D.truncata,167897087,VNJQ01004261.1,1,1723,1.02622e-05,166045741,0.988973
D.truncata,167897087,VNJQ01000511.1,1,1722,1.02563e-05,166047463,0.988984
D.truncata,167897087,VNJQ01006136.1,1,1721,1.02503e-05,166049184,0.988994
D.truncata,167897087,VNJQ01004484.1,1,1721,1.02503e-05,166050905,0.989004
D.truncata,167897087,VNJQ01003765.1,1,1721,1.02503e-05,166052626,0.989014
D.truncata,167897087,VNJQ01003345.1,1,1721,1.02503e-05,166054347,0.989025
D.truncata,167897087,VNJQ01002646.1,1,1721,1.02503e-05,166056068,0.989035
D.truncata,167897087,VNJQ01000257.1,1,1721,1.02503e-05,166057789,0.989045
D.truncata,167897087,VNJQ01000619.1,1,1720,1.02444e-05,166059509,0.989055
D.truncata,167897087,VNJQ01006115.1,1,1719,1.02384e-05,166061228,0.989066
D.truncata,167897087,VNJQ01004982.1,1,1718,1.02325e-05,166062946,0.989076
D.truncata,167897087,VNJQ01003540.1,1,1718,1.02325e-05,166064664,0.989086
D.truncata,167897087,VNJQ01001123.1,1,1717,1.02265e-05,166066381,0.989096
D.truncata,167897087,VNJQ01004088.1,1,1716,1.02205e-05,166068097,0.989106
D.truncata,167897087,VNJQ01000715.1,1,1716,1.02205e-05,166069813,0.989117
D.truncata,167897087,VNJQ01007625.1,1,1715,1.02146e-05,166071528,0.989127
D.truncata,167897087,VNJQ01006825.1,1,1715,1.02146e-05,166073243,0.989137
D.truncata,167897087,VNJQ01006591.1,1,1715,1.02146e-05,166074958,0.989147
D.truncata,167897087,VNJQ01005203.1,1,1713,1.02027e-05,166076671,0.989158
D.truncata,167897087,VNJQ01004917.1,1,1713,1.02027e-05,166078384,0.989168
D.truncata,167897087,VNJQ01004837.1,1,1713,1.02027e-05,166080097,0.989178
D.truncata,167897087,VNJQ01004595.1,1,1713,1.02027e-05,166081810,0.989188
D.truncata,167897087,VNJQ01002600.1,1,1713,1.02027e-05,166083523,0.989198
D.truncata,167897087,VNJQ01000910.1,1,1713,1.02027e-05,166085236,0.989209
D.truncata,167897087,VNJQ01007796.1,1,1712,1.01967e-05,166086948,0.989219
D.truncata,167897087,VNJQ01005576.1,1,1712,1.01967e-05,166088660,0.989229
D.truncata,167897087,VNJQ01004361.1,1,1712,1.01967e-05,166090372,0.989239
D.truncata,167897087,VNJQ01000525.1,1,1712,1.01967e-05,166092084,0.989249
D.truncata,167897087,VNJQ01007038.1,1,1711,1.01908e-05,166093795,0.98926
D.truncata,167897087,VNJQ01005097.1,1,1711,1.01908e-05,166095506,0.98927
D.truncata,167897087,VNJQ01004208.1,1,1711,1.01908e-05,166097217,0.98928
D.truncata,167897087,VNJQ01000475.1,1,1711,1.01908e-05,166098928,0.98929
D.truncata,167897087,VNJQ01002860.1,1,1710,1.01848e-05,166100638,0.9893
D.truncata,167897087,VNJQ01001997.1,1,1710,1.01848e-05,166102348,0.98931
D.truncata,167897087,VNJQ01000015.1,1,1710,1.01848e-05,166104058,0.989321
D.truncata,167897087,VNJQ01000014.1,1,1710,1.01848e-05,166105768,0.989331
D.truncata,167897087,VNJQ01006583.1,1,1709,1.01789e-05,166107477,0.989341
D.truncata,167897087,VNJQ01005940.1,1,1709,1.01789e-05,166109186,0.989351
D.truncata,167897087,VNJQ01006242.1,1,1708,1.01729e-05,166110894,0.989361
D.truncata,167897087,VNJQ01000016.1,1,1708,1.01729e-05,166112602,0.989372
D.truncata,167897087,VNJQ01005821.1,1,1707,1.01669e-05,166114309,0.989382
D.truncata,167897087,VNJQ01001763.1,1,1707,1.01669e-05,166116016,0.989392
D.truncata,167897087,VNJQ01007409.1,1,1706,1.0161e-05,166117722,0.989402
D.truncata,167897087,VNJQ01006836.1,1,1706,1.0161e-05,166119428,0.989412
D.truncata,167897087,VNJQ01006724.1,1,1706,1.0161e-05,166121134,0.989422
D.truncata,167897087,VNJQ01002079.1,1,1706,1.0161e-05,166122840,0.989433
D.truncata,167897087,VNJQ01000837.1,1,1706,1.0161e-05,166124546,0.989443
D.truncata,167897087,VNJQ01003652.1,1,1705,1.0155e-05,166126251,0.989453
D.truncata,167897087,VNJQ01003302.1,1,1704,1.01491e-05,166127955,0.989463
D.truncata,167897087,VNJQ01001810.1,1,1704,1.01491e-05,166129659,0.989473
D.truncata,167897087,VNJQ01005071.1,1,1703,1.01431e-05,166131362,0.989483
D.truncata,167897087,VNJQ01002952.1,1,1703,1.01431e-05,166133065,0.989493
D.truncata,167897087,VNJQ01002055.1,1,1703,1.01431e-05,166134768,0.989504
D.truncata,167897087,VNJQ01006808.1,1,1702,1.01372e-05,166136470,0.989514
D.truncata,167897087,VNJQ01007403.1,1,1701,1.01312e-05,166138171,0.989524
D.truncata,167897087,VNJQ01002448.1,1,1701,1.01312e-05,166139872,0.989534
D.truncata,167897087,VNJQ01004396.1,1,1700,1.01253e-05,166141572,0.989544
D.truncata,167897087,VNJQ01001661.1,1,1700,1.01253e-05,166143272,0.989554
D.truncata,167897087,VNJQ01003325.1,1,1698,1.01133e-05,166144970,0.989564
D.truncata,167897087,VNJQ01003253.1,1,1698,1.01133e-05,166146668,0.989574
D.truncata,167897087,VNJQ01002047.1,1,1698,1.01133e-05,166148366,0.989585
D.truncata,167897087,VNJQ01001654.1,1,1698,1.01133e-05,166150064,0.989595
D.truncata,167897087,VNJQ01003285.1,1,1697,1.01074e-05,166151761,0.989605
D.truncata,167897087,VNJQ01001650.1,1,1697,1.01074e-05,166153458,0.989615
D.truncata,167897087,VNJQ01007784.1,1,1696,1.01014e-05,166155154,0.989625
D.truncata,167897087,VNJQ01000017.1,1,1696,1.01014e-05,166156850,0.989635
D.truncata,167897087,VNJQ01008169.1,1,1695,1.00955e-05,166158545,0.989645
D.truncata,167897087,VNJQ01007662.1,1,1695,1.00955e-05,166160240,0.989655
D.truncata,167897087,VNJQ01004969.1,1,1695,1.00955e-05,166161935,0.989665
D.truncata,167897087,VNJQ01004337.1,1,1695,1.00955e-05,166163630,0.989675
D.truncata,167897087,VNJQ01000690.1,1,1695,1.00955e-05,166165325,0.989686
D.truncata,167897087,VNJQ01005479.1,1,1694,1.00895e-05,166167019,0.989696
D.truncata,167897087,VNJQ01007278.1,1,1693,1.00836e-05,166168712,0.989706
D.truncata,167897087,VNJQ01006319.1,1,1693,1.00836e-05,166170405,0.989716
D.truncata,167897087,VNJQ01000754.1,1,1693,1.00836e-05,166172098,0.989726
D.truncata,167897087,VNJQ01007162.1,1,1692,1.00776e-05,166173790,0.989736
D.truncata,167897087,VNJQ01002853.1,1,1692,1.00776e-05,166175482,0.989746
D.truncata,167897087,VNJQ01007228.1,1,1691,1.00716e-05,166177173,0.989756
D.truncata,167897087,VNJQ01006579.1,1,1691,1.00716e-05,166178864,0.989766
D.truncata,167897087,VNJQ01003505.1,1,1691,1.00716e-05,166180555,0.989776
D.truncata,167897087,VNJQ01006421.1,1,1690,1.00657e-05,166182245,0.989786
D.truncata,167897087,VNJQ01000274.1,1,1690,1.00657e-05,166183935,0.989796
D.truncata,167897087,VNJQ01003275.1,1,1689,1.00597e-05,166185624,0.989806
D.truncata,167897087,VNJQ01005739.1,1,1688,1.00538e-05,166187312,0.989817
D.truncata,167897087,VNJQ01004808.1,1,1688,1.00538e-05,166189000,0.989827
D.truncata,167897087,VNJQ01001058.1,1,1688,1.00538e-05,166190688,0.989837
D.truncata,167897087,VNJQ01000887.1,1,1688,1.00538e-05,166192376,0.989847
D.truncata,167897087,VNJQ01005862.1,1,1687,1.00478e-05,166194063,0.989857
D.truncata,167897087,VNJQ01005098.1,1,1687,1.00478e-05,166195750,0.989867
D.truncata,167897087,VNJQ01005394.1,1,1686,1.00419e-05,166197436,0.989877
D.truncata,167897087,VNJQ01002739.1,1,1686,1.00419e-05,166199122,0.989887
D.truncata,167897087,VNJQ01000621.1,1,1686,1.00419e-05,166200808,0.989897
D.truncata,167897087,VNJQ01006964.1,1,1685,1.00359e-05,166202493,0.989907
D.truncata,167897087,VNJQ01002807.1,1,1685,1.00359e-05,166204178,0.989917
D.truncata,167897087,VNJQ01005764.1,1,1684,1.003e-05,166205862,0.989927
D.truncata,167897087,VNJQ01001493.1,1,1684,1.003e-05,166207546,0.989937
D.truncata,167897087,VNJQ01001129.1,1,1684,1.003e-05,166209230,0.989947
D.truncata,167897087,VNJQ01000677.1,1,1684,1.003e-05,166210914,0.989957
D.truncata,167897087,VNJQ01007490.1,1,1683,1.0024e-05,166212597,0.989967
D.truncata,167897087,VNJQ01006914.1,1,1683,1.0024e-05,166214280,0.989977
D.truncata,167897087,VNJQ01005716.1,1,1683,1.0024e-05,166215963,0.989987
D.truncata,167897087,VNJQ01003249.1,1,1683,1.0024e-05,166217646,0.989997
D.truncata,167897087,VNJQ01002271.1,1,1683,1.0024e-05,166219329,0.990007
D.truncata,167897087,VNJQ01000373.1,1,1683,1.0024e-05,166221012,0.990017
D.truncata,167897087,VNJQ01005829.1,1,1682,1.0018e-05,166222694,0.990027
D.truncata,167897087,VNJQ01003722.1,1,1682,1.0018e-05,166224376,0.990037
D.truncata,167897087,VNJQ01003167.1,1,1682,1.0018e-05,166226058,0.990047
D.truncata,167897087,VNJQ01007780.1,1,1681,1.00121e-05,166227739,0.990057
D.truncata,167897087,VNJQ01007538.1,1,1681,1.00121e-05,166229420,0.990067
D.truncata,167897087,VNJQ01007884.1,1,1680,1.00061e-05,166231100,0.990077
D.truncata,167897087,VNJQ01002292.1,1,1680,1.00061e-05,166232780,0.990087
D.truncata,167897087,VNJQ01000430.1,1,1679,1.00002e-05,166234459,0.990097
D.truncata,167897087,VNJQ01007956.1,1,1678,9.99422e-06,166236137,0.990107
D.truncata,167897087,VNJQ01003136.1,1,1678,9.99422e-06,166237815,0.990117
D.truncata,167897087,VNJQ01002795.1,1,1678,9.99422e-06,166239493,0.990127
D.truncata,167897087,VNJQ01006835.1,1,1676,9.98231e-06,166241169,0.990137
D.truncata,167897087,VNJQ01005701.1,1,1676,9.98231e-06,166242845,0.990147
D.truncata,167897087,VNJQ01005623.1,1,1676,9.98231e-06,166244521,0.990157
D.truncata,167897087,VNJQ01002399.1,1,1676,9.98231e-06,166246197,0.990167
D.truncata,167897087,VNJQ01007000.1,1,1675,9.97635e-06,166247872,0.990177
D.truncata,167897087,VNJQ01000753.1,1,1675,9.97635e-06,166249547,0.990187
D.truncata,167897087,VNJQ01000099.1,1,1674,9.97039e-06,166251221,0.990197
D.truncata,167897087,VNJQ01004209.1,1,1673,9.96444e-06,166252894,0.990207
D.truncata,167897087,VNJQ01002325.1,1,1673,9.96444e-06,166254567,0.990217
D.truncata,167897087,VNJQ01000089.1,1,1673,9.96444e-06,166256240,0.990227
D.truncata,167897087,VNJQ01005643.1,1,1672,9.95848e-06,166257912,0.990237
D.truncata,167897087,VNJQ01002855.1,1,1672,9.95848e-06,166259584,0.990247
D.truncata,167897087,VNJQ01002743.1,1,1672,9.95848e-06,166261256,0.990257
D.truncata,167897087,VNJQ01006426.1,1,1671,9.95253e-06,166262927,0.990267
D.truncata,167897087,VNJQ01004594.1,1,1671,9.95253e-06,166264598,0.990277
D.truncata,167897087,VNJQ01002953.1,1,1671,9.95253e-06,166266269,0.990287
D.truncata,167897087,VNJQ01001600.1,1,1671,9.95253e-06,166267940,0.990297
D.truncata,167897087,VNJQ01001130.1,1,1671,9.95253e-06,166269611,0.990307
D.truncata,167897087,VNJQ01005773.1,1,1670,9.94657e-06,166271281,0.990317
D.truncata,167897087,VNJQ01003564.1,1,1668,9.93466e-06,166272949,0.990327
D.truncata,167897087,VNJQ01005928.1,1,1667,9.9287e-06,166274616,0.990337
D.truncata,167897087,VNJQ01005321.1,1,1666,9.92275e-06,166276282,0.990346
D.truncata,167897087,VNJQ01003786.1,1,1666,9.92275e-06,166277948,0.990356
D.truncata,167897087,VNJQ01001174.1,1,1666,9.92275e-06,166279614,0.990366
D.truncata,167897087,VNJQ01007448.1,1,1664,9.91083e-06,166281278,0.990376
D.truncata,167897087,VNJQ01005085.1,1,1664,9.91083e-06,166282942,0.990386
D.truncata,167897087,VNJQ01005621.1,1,1663,9.90488e-06,166284605,0.990396
D.truncata,167897087,VNJQ01004665.1,1,1663,9.90488e-06,166286268,0.990406
D.truncata,167897087,VNJQ01004020.1,1,1663,9.90488e-06,166287931,0.990416
D.truncata,167897087,VNJQ01001649.1,1,1663,9.90488e-06,166289594,0.990426
D.truncata,167897087,VNJQ01006593.1,1,1662,9.89892e-06,166291256,0.990436
D.truncata,167897087,VNJQ01006443.1,1,1661,9.89296e-06,166292917,0.990446
D.truncata,167897087,VNJQ01008037.1,1,1660,9.88701e-06,166294577,0.990455
D.truncata,167897087,VNJQ01004709.1,1,1660,9.88701e-06,166296237,0.990465
D.truncata,167897087,VNJQ01004669.1,1,1659,9.88105e-06,166297896,0.990475
D.truncata,167897087,VNJQ01002914.1,1,1659,9.88105e-06,166299555,0.990485
D.truncata,167897087,VNJQ01001898.1,1,1658,9.8751e-06,166301213,0.990495
D.truncata,167897087,VNJQ01001172.1,1,1658,9.8751e-06,166302871,0.990505
D.truncata,167897087,VNJQ01007782.1,1,1657,9.86914e-06,166304528,0.990515
D.truncata,167897087,VNJQ01007057.1,1,1657,9.86914e-06,166306185,0.990525
D.truncata,167897087,VNJQ01006826.1,1,1657,9.86914e-06,166307842,0.990534
D.truncata,167897087,VNJQ01004864.1,1,1656,9.86318e-06,166309498,0.990544
D.truncata,167897087,VNJQ01004069.1,1,1656,9.86318e-06,166311154,0.990554
D.truncata,167897087,VNJQ01001032.1,1,1656,9.86318e-06,166312810,0.990564
D.truncata,167897087,VNJQ01002319.1,1,1655,9.85723e-06,166314465,0.990574
D.truncata,167897087,VNJQ01001644.1,1,1655,9.85723e-06,166316120,0.990584
D.truncata,167897087,VNJQ01006821.1,1,1654,9.85127e-06,166317774,0.990594
D.truncata,167897087,VNJQ01005812.1,1,1654,9.85127e-06,166319428,0.990603
D.truncata,167897087,VNJQ01001390.1,1,1654,9.85127e-06,166321082,0.990613
D.truncata,167897087,VNJQ01006833.1,1,1653,9.84532e-06,166322735,0.990623
D.truncata,167897087,VNJQ01006046.1,1,1652,9.83936e-06,166324387,0.990633
D.truncata,167897087,VNJQ01001905.1,1,1652,9.83936e-06,166326039,0.990643
D.truncata,167897087,VNJQ01007779.1,1,1651,9.8334e-06,166327690,0.990653
D.truncata,167897087,VNJQ01007330.1,1,1651,9.8334e-06,166329341,0.990662
D.truncata,167897087,VNJQ01001742.1,1,1651,9.8334e-06,166330992,0.990672
D.truncata,167897087,VNJQ01000776.1,1,1651,9.8334e-06,166332643,0.990682
D.truncata,167897087,VNJQ01000028.1,1,1651,9.8334e-06,166334294,0.990692
D.truncata,167897087,VNJQ01001092.1,1,1650,9.82745e-06,166335944,0.990702
D.truncata,167897087,VNJQ01001079.1,1,1649,9.82149e-06,166337593,0.990712
D.truncata,167897087,VNJQ01006963.1,1,1648,9.81554e-06,166339241,0.990721
D.truncata,167897087,VNJQ01004762.1,1,1648,9.81554e-06,166340889,0.990731
D.truncata,167897087,VNJQ01003172.1,1,1648,9.81554e-06,166342537,0.990741
D.truncata,167897087,VNJQ01001173.1,1,1647,9.80958e-06,166344184,0.990751
D.truncata,167897087,VNJQ01002637.1,1,1646,9.80362e-06,166345830,0.990761
D.truncata,167897087,VNJQ01004511.1,1,1645,9.79767e-06,166347475,0.99077
D.truncata,167897087,VNJQ01000427.1,1,1645,9.79767e-06,166349120,0.99078
D.truncata,167897087,VNJQ01006834.1,1,1644,9.79171e-06,166350764,0.99079
D.truncata,167897087,VNJQ01007098.1,1,1643,9.78576e-06,166352407,0.9908
D.truncata,167897087,VNJQ01004676.1,1,1643,9.78576e-06,166354050,0.99081
D.truncata,167897087,VNJQ01006832.1,1,1642,9.7798e-06,166355692,0.990819
D.truncata,167897087,VNJQ01004971.1,1,1642,9.7798e-06,166357334,0.990829
D.truncata,167897087,VNJQ01002546.1,1,1642,9.7798e-06,166358976,0.990839
D.truncata,167897087,VNJQ01001170.1,1,1642,9.7798e-06,166360618,0.990849
D.truncata,167897087,VNJQ01007537.1,1,1641,9.77384e-06,166362259,0.990859
D.truncata,167897087,VNJQ01000570.1,1,1641,9.77384e-06,166363900,0.990868
D.truncata,167897087,VNJQ01006417.1,1,1639,9.76193e-06,166365539,0.990878
D.truncata,167897087,VNJQ01004895.1,1,1639,9.76193e-06,166367178,0.990888
D.truncata,167897087,VNJQ01000770.1,1,1639,9.76193e-06,166368817,0.990898
D.truncata,167897087,VNJQ01007579.1,1,1638,9.75598e-06,166370455,0.990907
D.truncata,167897087,VNJQ01006052.1,1,1637,9.75002e-06,166372092,0.990917
D.truncata,167897087,VNJQ01003545.1,1,1637,9.75002e-06,166373729,0.990927
D.truncata,167897087,VNJQ01002270.1,1,1637,9.75002e-06,166375366,0.990937
D.truncata,167897087,VNJQ01001070.1,1,1637,9.75002e-06,166377003,0.990946
D.truncata,167897087,VNJQ01000758.1,1,1637,9.75002e-06,166378640,0.990956
D.truncata,167897087,VNJQ01007336.1,1,1636,9.74406e-06,166380276,0.990966
D.truncata,167897087,VNJQ01007231.1,1,1636,9.74406e-06,166381912,0.990976
D.truncata,167897087,VNJQ01006327.1,1,1636,9.74406e-06,166383548,0.990985
D.truncata,167897087,VNJQ01001647.1,1,1636,9.74406e-06,166385184,0.990995
D.truncata,167897087,VNJQ01000811.1,1,1636,9.74406e-06,166386820,0.991005
D.truncata,167897087,VNJQ01000201.1,1,1635,9.73811e-06,166388455,0.991015
D.truncata,167897087,VNJQ01004597.1,1,1634,9.73215e-06,166390089,0.991024
D.truncata,167897087,VNJQ01000185.1,1,1634,9.73215e-06,166391723,0.991034
D.truncata,167897087,VNJQ01004672.1,1,1633,9.7262e-06,166393356,0.991044
D.truncata,167897087,VNJQ01002597.1,1,1633,9.7262e-06,166394989,0.991053
D.truncata,167897087,VNJQ01001978.1,1,1633,9.7262e-06,166396622,0.991063
D.truncata,167897087,VNJQ01001648.1,1,1631,9.71428e-06,166398253,0.991073
D.truncata,167897087,VNJQ01003010.1,1,1630,9.70833e-06,166399883,0.991083
D.truncata,167897087,VNJQ01006419.1,1,1629,9.70237e-06,166401512,0.991092
D.truncata,167897087,VNJQ01007255.1,1,1628,9.69642e-06,166403140,0.991102
D.truncata,167897087,VNJQ01006509.1,1,1626,9.6845e-06,166404766,0.991112
D.truncata,167897087,VNJQ01000293.1,1,1626,9.6845e-06,166406392,0.991121
D.truncata,167897087,VNJQ01001851.1,1,1625,9.67855e-06,166408017,0.991131
D.truncata,167897087,VNJQ01005820.1,1,1624,9.67259e-06,166409641,0.991141
D.truncata,167897087,VNJQ01002470.1,1,1624,9.67259e-06,166411265,0.99115
D.truncata,167897087,VNJQ01005393.1,1,1622,9.66068e-06,166412887,0.99116
D.truncata,167897087,VNJQ01004989.1,1,1620,9.64877e-06,166414507,0.99117
D.truncata,167897087,VNJQ01000452.1,1,1619,9.64281e-06,166416126,0.991179
D.truncata,167897087,VNJQ01007009.1,1,1618,9.63686e-06,166417744,0.991189
D.truncata,167897087,VNJQ01006604.1,1,1616,9.62494e-06,166419360,0.991199
D.truncata,167897087,VNJQ01002741.1,1,1615,9.61899e-06,166420975,0.991208
D.truncata,167897087,VNJQ01001268.1,1,1615,9.61899e-06,166422590,0.991218
D.truncata,167897087,VNJQ01007724.1,1,1614,9.61303e-06,166424204,0.991227
D.truncata,167897087,VNJQ01005067.1,1,1614,9.61303e-06,166425818,0.991237
D.truncata,167897087,VNJQ01002859.1,1,1614,9.61303e-06,166427432,0.991247
D.truncata,167897087,VNJQ01006855.1,1,1613,9.60708e-06,166429045,0.991256
D.truncata,167897087,VNJQ01001633.1,1,1613,9.60708e-06,166430658,0.991266
D.truncata,167897087,VNJQ01004187.1,1,1612,9.60112e-06,166432270,0.991276
D.truncata,167897087,VNJQ01006918.1,1,1611,9.59516e-06,166433881,0.991285
D.truncata,167897087,VNJQ01004092.1,1,1611,9.59516e-06,166435492,0.991295
D.truncata,167897087,VNJQ01006010.1,1,1609,9.58325e-06,166437101,0.991304
D.truncata,167897087,VNJQ01004877.1,1,1608,9.5773e-06,166438709,0.991314
D.truncata,167897087,VNJQ01002388.1,1,1607,9.57134e-06,166440316,0.991323
D.truncata,167897087,VNJQ01006667.1,1,1606,9.56538e-06,166441922,0.991333
D.truncata,167897087,VNJQ01001171.1,1,1606,9.56538e-06,166443528,0.991343
D.truncata,167897087,VNJQ01004131.1,1,1605,9.55943e-06,166445133,0.991352
D.truncata,167897087,VNJQ01003190.1,1,1605,9.55943e-06,166446738,0.991362
D.truncata,167897087,VNJQ01003096.1,1,1605,9.55943e-06,166448343,0.991371
D.truncata,167897087,VNJQ01003830.1,1,1604,9.55347e-06,166449947,0.991381
D.truncata,167897087,VNJQ01002640.1,1,1604,9.55347e-06,166451551,0.99139
D.truncata,167897087,VNJQ01001088.1,1,1603,9.54752e-06,166453154,0.9914
D.truncata,167897087,VNJQ01007007.1,1,1601,9.5356e-06,166454755,0.991409
D.truncata,167897087,VNJQ01000323.1,1,1601,9.5356e-06,166456356,0.991419
D.truncata,167897087,VNJQ01000450.1,1,1600,9.52965e-06,166457956,0.991428
D.truncata,167897087,VNJQ01006645.1,1,1598,9.51774e-06,166459554,0.991438
D.truncata,167897087,VNJQ01001877.1,1,1598,9.51774e-06,166461152,0.991448
D.truncata,167897087,VNJQ01006259.1,1,1597,9.51178e-06,166462749,0.991457
D.truncata,167897087,VNJQ01003237.1,1,1597,9.51178e-06,166464346,0.991467
D.truncata,167897087,VNJQ01007143.1,1,1596,9.50582e-06,166465942,0.991476
D.truncata,167897087,VNJQ01007557.1,1,1595,9.49987e-06,166467537,0.991486
D.truncata,167897087,VNJQ01004288.1,1,1595,9.49987e-06,166469132,0.991495
D.truncata,167897087,VNJQ01003061.1,1,1595,9.49987e-06,166470727,0.991505
D.truncata,167897087,VNJQ01002957.1,1,1595,9.49987e-06,166472322,0.991514
D.truncata,167897087,VNJQ01000356.1,1,1595,9.49987e-06,166473917,0.991524
D.truncata,167897087,VNJQ01002555.1,1,1594,9.49391e-06,166475511,0.991533
D.truncata,167897087,VNJQ01001077.1,1,1594,9.49391e-06,166477105,0.991543
D.truncata,167897087,VNJQ01000129.1,1,1593,9.48795e-06,166478698,0.991552
D.truncata,167897087,VNJQ01007428.1,1,1592,9.482e-06,166480290,0.991562
D.truncata,167897087,VNJQ01005086.1,1,1592,9.482e-06,166481882,0.991571
D.truncata,167897087,VNJQ01001169.1,1,1592,9.482e-06,166483474,0.99158
D.truncata,167897087,VNJQ01000712.1,1,1592,9.482e-06,166485066,0.99159
D.truncata,167897087,VNJQ01005577.1,1,1591,9.47604e-06,166486657,0.991599
D.truncata,167897087,VNJQ01003006.1,1,1591,9.47604e-06,166488248,0.991609
D.truncata,167897087,VNJQ01000465.1,1,1591,9.47604e-06,166489839,0.991618
D.truncata,167897087,VNJQ01006871.1,1,1590,9.47009e-06,166491429,0.991628
D.truncata,167897087,VNJQ01002936.1,1,1590,9.47009e-06,166493019,0.991637
D.truncata,167897087,VNJQ01007969.1,1,1589,9.46413e-06,166494608,0.991647
D.truncata,167897087,VNJQ01005689.1,1,1589,9.46413e-06,166496197,0.991656
D.truncata,167897087,VNJQ01004290.1,1,1589,9.46413e-06,166497786,0.991666
D.truncata,167897087,VNJQ01003007.1,1,1589,9.46413e-06,166499375,0.991675
D.truncata,167897087,VNJQ01004723.1,1,1588,9.45817e-06,166500963,0.991685
D.truncata,167897087,VNJQ01007476.1,1,1587,9.45222e-06,166502550,0.991694
D.truncata,167897087,VNJQ01007360.1,1,1587,9.45222e-06,166504137,0.991704
D.truncata,167897087,VNJQ01005927.1,1,1587,9.45222e-06,166505724,0.991713
D.truncata,167897087,VNJQ01003685.1,1,1587,9.45222e-06,166507311,0.991722
D.truncata,167897087,VNJQ01002118.1,1,1587,9.45222e-06,166508898,0.991732
D.truncata,167897087,VNJQ01001916.1,1,1587,9.45222e-06,166510485,0.991741
D.truncata,167897087,VNJQ01006447.1,1,1586,9.44626e-06,166512071,0.991751
D.truncata,167897087,VNJQ01000107.1,1,1586,9.44626e-06,166513657,0.99176
D.truncata,167897087,VNJQ01007630.1,1,1585,9.44031e-06,166515242,0.99177
D.truncata,167897087,VNJQ01004132.1,1,1584,9.43435e-06,166516826,0.991779
D.truncata,167897087,VNJQ01000984.1,1,1584,9.43435e-06,166518410,0.991789
D.truncata,167897087,VNJQ01007726.1,1,1582,9.42244e-06,166519992,0.991798
D.truncata,167897087,VNJQ01002077.1,1,1582,9.42244e-06,166521574,0.991807
D.truncata,167897087,VNJQ01000756.1,1,1581,9.41648e-06,166523155,0.991817
D.truncata,167897087,VNJQ01005419.1,1,1580,9.41053e-06,166524735,0.991826
D.truncata,167897087,VNJQ01003083.1,1,1580,9.41053e-06,166526315,0.991836
D.truncata,167897087,VNJQ01000778.1,1,1579,9.40457e-06,166527894,0.991845
D.truncata,167897087,VNJQ01003226.1,1,1578,9.39861e-06,166529472,0.991854
D.truncata,167897087,VNJQ01005395.1,1,1577,9.39266e-06,166531049,0.991864
D.truncata,167897087,VNJQ01003588.1,1,1577,9.39266e-06,166532626,0.991873
D.truncata,167897087,VNJQ01000588.1,1,1577,9.39266e-06,166534203,0.991883
D.truncata,167897087,VNJQ01000565.1,1,1577,9.39266e-06,166535780,0.991892
D.truncata,167897087,VNJQ01000320.1,1,1577,9.39266e-06,166537357,0.991901
D.truncata,167897087,VNJQ01008076.1,1,1575,9.38075e-06,166538932,0.991911
D.truncata,167897087,VNJQ01002278.1,1,1575,9.38075e-06,166540507,0.99192
D.truncata,167897087,VNJQ01001562.1,1,1574,9.37479e-06,166542081,0.99193
D.truncata,167897087,VNJQ01005681.1,1,1573,9.36883e-06,166543654,0.991939
D.truncata,167897087,VNJQ01004670.1,1,1573,9.36883e-06,166545227,0.991948
D.truncata,167897087,VNJQ01004544.1,1,1573,9.36883e-06,166546800,0.991958
D.truncata,167897087,VNJQ01000060.1,1,1573,9.36883e-06,166548373,0.991967
D.truncata,167897087,VNJQ01007648.1,1,1572,9.36288e-06,166549945,0.991976
D.truncata,167897087,VNJQ01002286.1,1,1569,9.34501e-06,166551514,0.991986
D.truncata,167897087,VNJQ01001131.1,1,1569,9.34501e-06,166553083,0.991995
D.truncata,167897087,VNJQ01008054.1,1,1568,9.33905e-06,166554651,0.992004
D.truncata,167897087,VNJQ01007781.1,1,1568,9.33905e-06,166556219,0.992014
D.truncata,167897087,VNJQ01005420.1,1,1568,9.33905e-06,166557787,0.992023
D.truncata,167897087,VNJQ01000053.1,1,1568,9.33905e-06,166559355,0.992032
D.truncata,167897087,VNJQ01008066.1,1,1566,9.32714e-06,166560921,0.992042
D.truncata,167897087,VNJQ01006941.1,1,1566,9.32714e-06,166562487,0.992051
D.truncata,167897087,VNJQ01004512.1,1,1565,9.32119e-06,166564052,0.99206
D.truncata,167897087,VNJQ01004268.1,1,1565,9.32119e-06,166565617,0.99207
D.truncata,167897087,VNJQ01004076.1,1,1565,9.32119e-06,166567182,0.992079
D.truncata,167897087,VNJQ01003348.1,1,1565,9.32119e-06,166568747,0.992088
D.truncata,167897087,VNJQ01001270.1,1,1565,9.32119e-06,166570312,0.992098
D.truncata,167897087,VNJQ01007995.1,1,1564,9.31523e-06,166571876,0.992107
D.truncata,167897087,VNJQ01002442.1,1,1564,9.31523e-06,166573440,0.992116
D.truncata,167897087,VNJQ01001614.1,1,1564,9.31523e-06,166575004,0.992126
D.truncata,167897087,VNJQ01007527.1,1,1563,9.30927e-06,166576567,0.992135
D.truncata,167897087,VNJQ01003589.1,1,1563,9.30927e-06,166578130,0.992144
D.truncata,167897087,VNJQ01003245.1,1,1562,9.30332e-06,166579692,0.992154
D.truncata,167897087,VNJQ01005115.1,1,1559,9.28545e-06,166581251,0.992163
D.truncata,167897087,VNJQ01004130.1,1,1559,9.28545e-06,166582810,0.992172
D.truncata,167897087,VNJQ01002947.1,1,1559,9.28545e-06,166584369,0.992181
D.truncata,167897087,VNJQ01004990.1,1,1558,9.27949e-06,166585927,0.992191
D.truncata,167897087,VNJQ01004061.1,1,1558,9.27949e-06,166587485,0.9922
D.truncata,167897087,VNJQ01003700.1,1,1558,9.27949e-06,166589043,0.992209
D.truncata,167897087,VNJQ01003030.1,1,1558,9.27949e-06,166590601,0.992219
D.truncata,167897087,VNJQ01005806.1,1,1557,9.27354e-06,166592158,0.992228
D.truncata,167897087,VNJQ01007145.1,1,1556,9.26758e-06,166593714,0.992237
D.truncata,167897087,VNJQ01006320.1,1,1556,9.26758e-06,166595270,0.992246
D.truncata,167897087,VNJQ01008108.1,1,1554,9.25567e-06,166596824,0.992256
D.truncata,167897087,VNJQ01008012.1,1,1554,9.25567e-06,166598378,0.992265
D.truncata,167897087,VNJQ01000622.1,1,1554,9.25567e-06,166599932,0.992274
D.truncata,167897087,VNJQ01004817.1,1,1553,9.24971e-06,166601485,0.992283
D.truncata,167897087,VNJQ01003831.1,1,1553,9.24971e-06,166603038,0.992293
D.truncata,167897087,VNJQ01002887.1,1,1553,9.24971e-06,166604591,0.992302
D.truncata,167897087,VNJQ01004922.1,1,1552,9.24376e-06,166606143,0.992311
D.truncata,167897087,VNJQ01001383.1,1,1552,9.24376e-06,166607695,0.99232
D.truncata,167897087,VNJQ01007262.1,1,1551,9.2378e-06,166609246,0.99233
D.truncata,167897087,VNJQ01007117.1,1,1551,9.2378e-06,166610797,0.992339
D.truncata,167897087,VNJQ01006233.1,1,1551,9.2378e-06,166612348,0.992348
D.truncata,167897087,VNJQ01006291.1,1,1550,9.23185e-06,166613898,0.992357
D.truncata,167897087,VNJQ01001482.1,1,1549,9.22589e-06,166615447,0.992367
D.truncata,167897087,VNJQ01008211.1,1,1548,9.21993e-06,166616995,0.992376
D.truncata,167897087,VNJQ01007723.1,1,1548,9.21993e-06,166618543,0.992385
D.truncata,167897087,VNJQ01004082.1,1,1547,9.21398e-06,166620090,0.992394
D.truncata,167897087,VNJQ01000625.1,1,1547,9.21398e-06,166621637,0.992403
D.truncata,167897087,VNJQ01007924.1,1,1546,9.20802e-06,166623183,0.992413
D.truncata,167897087,VNJQ01005734.1,1,1546,9.20802e-06,166624729,0.992422
D.truncata,167897087,VNJQ01004829.1,1,1546,9.20802e-06,166626275,0.992431
D.truncata,167897087,VNJQ01007564.1,1,1545,9.20207e-06,166627820,0.99244
D.truncata,167897087,VNJQ01001470.1,1,1545,9.20207e-06,166629365,0.992449
D.truncata,167897087,VNJQ01000220.1,1,1543,9.19015e-06,166630908,0.992459
D.truncata,167897087,VNJQ01000066.1,1,1543,9.19015e-06,166632451,0.992468
D.truncata,167897087,VNJQ01006747.1,1,1542,9.1842e-06,166633993,0.992477
D.truncata,167897087,VNJQ01002553.1,1,1542,9.1842e-06,166635535,0.992486
D.truncata,167897087,VNJQ01007430.1,1,1541,9.17824e-06,166637076,0.992495
D.truncata,167897087,VNJQ01006231.1,1,1540,9.17229e-06,166638616,0.992505
D.truncata,167897087,VNJQ01004285.1,1,1539,9.16633e-06,166640155,0.992514
D.truncata,167897087,VNJQ01003727.1,1,1538,9.16037e-06,166641693,0.992523
D.truncata,167897087,VNJQ01005699.1,1,1537,9.15442e-06,166643230,0.992532
D.truncata,167897087,VNJQ01005360.1,1,1537,9.15442e-06,166644767,0.992541
D.truncata,167897087,VNJQ01002699.1,1,1537,9.15442e-06,166646304,0.99255
D.truncata,167897087,VNJQ01001149.1,1,1537,9.15442e-06,166647841,0.992559
D.truncata,167897087,VNJQ01005641.1,1,1536,9.14846e-06,166649377,0.992569
D.truncata,167897087,VNJQ01000105.1,1,1536,9.14846e-06,166650913,0.992578
D.truncata,167897087,VNJQ01003337.1,1,1535,9.14251e-06,166652448,0.992587
D.truncata,167897087,VNJQ01008078.1,1,1533,9.13059e-06,166653981,0.992596
D.truncata,167897087,VNJQ01006985.1,1,1533,9.13059e-06,166655514,0.992605
D.truncata,167897087,VNJQ01003597.1,1,1533,9.13059e-06,166657047,0.992614
D.truncata,167897087,VNJQ01001177.1,1,1533,9.13059e-06,166658580,0.992623
D.truncata,167897087,VNJQ01005881.1,1,1532,9.12464e-06,166660112,0.992633
D.truncata,167897087,VNJQ01002179.1,1,1532,9.12464e-06,166661644,0.992642
D.truncata,167897087,VNJQ01006325.1,1,1531,9.11868e-06,166663175,0.992651
D.truncata,167897087,VNJQ01005118.1,1,1531,9.11868e-06,166664706,0.99266
D.truncata,167897087,VNJQ01005088.1,1,1531,9.11868e-06,166666237,0.992669
D.truncata,167897087,VNJQ01001520.1,1,1531,9.11868e-06,166667768,0.992678
D.truncata,167897087,VNJQ01001352.1,1,1530,9.11273e-06,166669298,0.992687
D.truncata,167897087,VNJQ01007880.1,1,1529,9.10677e-06,166670827,0.992696
D.truncata,167897087,VNJQ01008146.1,1,1528,9.10081e-06,166672355,0.992705
D.truncata,167897087,VNJQ01004894.1,1,1528,9.10081e-06,166673883,0.992715
D.truncata,167897087,VNJQ01008008.1,1,1527,9.09486e-06,166675410,0.992724
D.truncata,167897087,VNJQ01005443.1,1,1526,9.0889e-06,166676936,0.992733
D.truncata,167897087,VNJQ01004916.1,1,1526,9.0889e-06,166678462,0.992742
D.truncata,167897087,VNJQ01004068.1,1,1526,9.0889e-06,166679988,0.992751
D.truncata,167897087,VNJQ01003542.1,1,1525,9.08294e-06,166681513,0.99276
D.truncata,167897087,VNJQ01004239.1,1,1524,9.07699e-06,166683037,0.992769
D.truncata,167897087,VNJQ01003680.1,1,1523,9.07103e-06,166684560,0.992778
D.truncata,167897087,VNJQ01002051.1,1,1523,9.07103e-06,166686083,0.992787
D.truncata,167897087,VNJQ01005550.1,1,1522,9.06508e-06,166687605,0.992796
D.truncata,167897087,VNJQ01004276.1,1,1522,9.06508e-06,166689127,0.992805
D.truncata,167897087,VNJQ01001930.1,1,1522,9.06508e-06,166690649,0.992814
D.truncata,167897087,VNJQ01004721.1,1,1521,9.05912e-06,166692170,0.992823
D.truncata,167897087,VNJQ01002516.1,1,1521,9.05912e-06,166693691,0.992833
D.truncata,167897087,VNJQ01003978.1,1,1520,9.05316e-06,166695211,0.992842
D.truncata,167897087,VNJQ01004412.1,1,1518,9.04125e-06,166696729,0.992851
D.truncata,167897087,VNJQ01006212.1,1,1517,9.0353e-06,166698246,0.99286
D.truncata,167897087,VNJQ01001474.1,1,1517,9.0353e-06,166699763,0.992869
D.truncata,167897087,VNJQ01000057.1,1,1517,9.0353e-06,166701280,0.992878
D.truncata,167897087,VNJQ01005908.1,1,1516,9.02934e-06,166702796,0.992887
D.truncata,167897087,VNJQ01005625.1,1,1516,9.02934e-06,166704312,0.992896
D.truncata,167897087,VNJQ01005429.1,1,1516,9.02934e-06,166705828,0.992905
D.truncata,167897087,VNJQ01003916.1,1,1516,9.02934e-06,166707344,0.992914
D.truncata,167897087,VNJQ01006665.1,1,1515,9.02338e-06,166708859,0.992923
D.truncata,167897087,VNJQ01004149.1,1,1515,9.02338e-06,166710374,0.992932
D.truncata,167897087,VNJQ01000186.1,1,1515,9.02338e-06,166711889,0.992941
D.truncata,167897087,VNJQ01002446.1,1,1514,9.01743e-06,166713403,0.99295
D.truncata,167897087,VNJQ01003499.1,1,1513,9.01147e-06,166714916,0.992959
D.truncata,167897087,VNJQ01007144.1,1,1512,9.00552e-06,166716428,0.992968
D.truncata,167897087,VNJQ01007139.1,1,1512,9.00552e-06,166717940,0.992977
D.truncata,167897087,VNJQ01005445.1,1,1510,8.9936e-06,166719450,0.992986
D.truncata,167897087,VNJQ01005442.1,1,1510,8.9936e-06,166720960,0.992995
D.truncata,167897087,VNJQ01006418.1,1,1508,8.98169e-06,166722468,0.993004
D.truncata,167897087,VNJQ01002696.1,1,1508,8.98169e-06,166723976,0.993013
D.truncata,167897087,VNJQ01006997.1,1,1507,8.97574e-06,166725483,0.993022
D.truncata,167897087,VNJQ01005108.1,1,1507,8.97574e-06,166726990,0.993031
D.truncata,167897087,VNJQ01003349.1,1,1507,8.97574e-06,166728497,0.99304
D.truncata,167897087,VNJQ01003157.1,1,1507,8.97574e-06,166730004,0.993049
D.truncata,167897087,VNJQ01005505.1,1,1506,8.96978e-06,166731510,0.993058
D.truncata,167897087,VNJQ01001908.1,1,1506,8.96978e-06,166733016,0.993067
D.truncata,167897087,VNJQ01002214.1,1,1505,8.96382e-06,166734521,0.993076
D.truncata,167897087,VNJQ01006998.1,1,1503,8.95191e-06,166736024,0.993085
D.truncata,167897087,VNJQ01001695.1,1,1503,8.95191e-06,166737527,0.993094
D.truncata,167897087,VNJQ01006032.1,1,1502,8.94596e-06,166739029,0.993103
D.truncata,167897087,VNJQ01003347.1,1,1502,8.94596e-06,166740531,0.993112
D.truncata,167897087,VNJQ01002512.1,1,1502,8.94596e-06,166742033,0.99312
D.truncata,167897087,VNJQ01006498.1,1,1501,8.94e-06,166743534,0.993129
D.truncata,167897087,VNJQ01002843.1,1,1501,8.94e-06,166745035,0.993138
D.truncata,167897087,VNJQ01005045.1,1,1500,8.93404e-06,166746535,0.993147
D.truncata,167897087,VNJQ01003734.1,1,1500,8.93404e-06,166748035,0.993156
D.truncata,167897087,VNJQ01006542.1,1,1499,8.92809e-06,166749534,0.993165
D.truncata,167897087,VNJQ01000164.1,1,1499,8.92809e-06,166751033,0.993174
D.truncata,167897087,VNJQ01007140.1,1,1497,8.91618e-06,166752530,0.993183
D.truncata,167897087,VNJQ01005446.1,1,1497,8.91618e-06,166754027,0.993192
D.truncata,167897087,VNJQ01005326.1,1,1497,8.91618e-06,166755524,0.993201
D.truncata,167897087,VNJQ01001362.1,1,1497,8.91618e-06,166757021,0.99321
D.truncata,167897087,VNJQ01002794.1,1,1495,8.90426e-06,166758516,0.993219
D.truncata,167897087,VNJQ01002511.1,1,1495,8.90426e-06,166760011,0.993228
D.truncata,167897087,VNJQ01001571.1,1,1495,8.90426e-06,166761506,0.993236
D.truncata,167897087,VNJQ01000097.1,1,1494,8.89831e-06,166763000,0.993245
D.truncata,167897087,VNJQ01003661.1,1,1493,8.89235e-06,166764493,0.993254
D.truncata,167897087,VNJQ01002277.1,1,1493,8.89235e-06,166765986,0.993263
D.truncata,167897087,VNJQ01007338.1,1,1492,8.8864e-06,166767478,0.993272
D.truncata,167897087,VNJQ01007309.1,1,1492,8.8864e-06,166768970,0.993281
D.truncata,167897087,VNJQ01006961.1,1,1492,8.8864e-06,166770462,0.99329
D.truncata,167897087,VNJQ01006381.1,1,1492,8.8864e-06,166771954,0.993299
D.truncata,167897087,VNJQ01002510.1,1,1492,8.8864e-06,166773446,0.993308
D.truncata,167897087,VNJQ01005826.1,1,1491,8.88044e-06,166774937,0.993316
D.truncata,167897087,VNJQ01002115.1,1,1491,8.88044e-06,166776428,0.993325
D.truncata,167897087,VNJQ01005449.1,1,1488,8.86257e-06,166777916,0.993334
D.truncata,167897087,VNJQ01003624.1,1,1488,8.86257e-06,166779404,0.993343
D.truncata,167897087,VNJQ01001064.1,1,1488,8.86257e-06,166780892,0.993352
D.truncata,167897087,VNJQ01007608.1,1,1487,8.85662e-06,166782379,0.993361
D.truncata,167897087,VNJQ01006816.1,1,1487,8.85662e-06,166783866,0.99337
D.truncata,167897087,VNJQ01005448.1,1,1487,8.85662e-06,166785353,0.993378
D.truncata,167897087,VNJQ01002551.1,1,1486,8.85066e-06,166786839,0.993387
D.truncata,167897087,VNJQ01005989.1,1,1485,8.8447e-06,166788324,0.993396
D.truncata,167897087,VNJQ01007393.1,1,1483,8.83279e-06,166789807,0.993405
D.truncata,167897087,VNJQ01001473.1,1,1483,8.83279e-06,166791290,0.993414
D.truncata,167897087,VNJQ01001381.1,1,1483,8.83279e-06,166792773,0.993423
D.truncata,167897087,VNJQ01000218.1,1,1483,8.83279e-06,166794256,0.993432
D.truncata,167897087,VNJQ01007318.1,1,1482,8.82684e-06,166795738,0.99344
D.truncata,167897087,VNJQ01002740.1,1,1482,8.82684e-06,166797220,0.993449
D.truncata,167897087,VNJQ01002117.1,1,1482,8.82684e-06,166798702,0.993458
D.truncata,167897087,VNJQ01006396.1,1,1481,8.82088e-06,166800183,0.993467
D.truncata,167897087,VNJQ01006144.1,1,1481,8.82088e-06,166801664,0.993476
D.truncata,167897087,VNJQ01002297.1,1,1481,8.82088e-06,166803145,0.993484
D.truncata,167897087,VNJQ01002439.1,1,1480,8.81492e-06,166804625,0.993493
D.truncata,167897087,VNJQ01001118.1,1,1480,8.81492e-06,166806105,0.993502
D.truncata,167897087,VNJQ01002341.1,1,1479,8.80897e-06,166807584,0.993511
D.truncata,167897087,VNJQ01000324.1,1,1479,8.80897e-06,166809063,0.99352
D.truncata,167897087,VNJQ01001285.1,1,1476,8.7911e-06,166810539,0.993528
D.truncata,167897087,VNJQ01001271.1,1,1476,8.7911e-06,166812015,0.993537
D.truncata,167897087,VNJQ01001194.1,1,1476,8.7911e-06,166813491,0.993546
D.truncata,167897087,VNJQ01006474.1,1,1475,8.78514e-06,166814966,0.993555
D.truncata,167897087,VNJQ01003792.1,1,1475,8.78514e-06,166816441,0.993564
D.truncata,167897087,VNJQ01007636.1,1,1470,8.75536e-06,166817911,0.993572
D.truncata,167897087,VNJQ01006523.1,1,1470,8.75536e-06,166819381,0.993581
D.truncata,167897087,VNJQ01004718.1,1,1469,8.74941e-06,166820850,0.99359
D.truncata,167897087,VNJQ01008214.1,1,1468,8.74345e-06,166822318,0.993599
D.truncata,167897087,VNJQ01005127.1,1,1468,8.74345e-06,166823786,0.993607
D.truncata,167897087,VNJQ01007135.1,1,1467,8.7375e-06,166825253,0.993616
D.truncata,167897087,VNJQ01006567.1,1,1467,8.7375e-06,166826720,0.993625
D.truncata,167897087,VNJQ01003728.1,1,1466,8.73154e-06,166828186,0.993634
D.truncata,167897087,VNJQ01001514.1,1,1465,8.72558e-06,166829651,0.993642
D.truncata,167897087,VNJQ01007932.1,1,1464,8.71963e-06,166831115,0.993651
D.truncata,167897087,VNJQ01006006.1,1,1464,8.71963e-06,166832579,0.99366
D.truncata,167897087,VNJQ01004954.1,1,1464,8.71963e-06,166834043,0.993668
D.truncata,167897087,VNJQ01003878.1,1,1464,8.71963e-06,166835507,0.993677
D.truncata,167897087,VNJQ01002921.1,1,1463,8.71367e-06,166836970,0.993686
D.truncata,167897087,VNJQ01006416.1,1,1462,8.70772e-06,166838432,0.993695
D.truncata,167897087,VNJQ01007445.1,1,1461,8.70176e-06,166839893,0.993703
D.truncata,167897087,VNJQ01007442.1,1,1461,8.70176e-06,166841354,0.993712
D.truncata,167897087,VNJQ01004712.1,1,1460,8.6958e-06,166842814,0.993721
D.truncata,167897087,VNJQ01005510.1,1,1459,8.68985e-06,166844273,0.993729
D.truncata,167897087,VNJQ01008204.1,1,1458,8.68389e-06,166845731,0.993738
D.truncata,167897087,VNJQ01005719.1,1,1458,8.68389e-06,166847189,0.993747
D.truncata,167897087,VNJQ01003567.1,1,1458,8.68389e-06,166848647,0.993755
D.truncata,167897087,VNJQ01005077.1,1,1457,8.67793e-06,166850104,0.993764
D.truncata,167897087,VNJQ01004050.1,1,1457,8.67793e-06,166851561,0.993773
D.truncata,167897087,VNJQ01002852.1,1,1457,8.67793e-06,166853018,0.993781
D.truncata,167897087,VNJQ01001481.1,1,1457,8.67793e-06,166854475,0.99379
D.truncata,167897087,VNJQ01000949.1,1,1457,8.67793e-06,166855932,0.993799
D.truncata,167897087,VNJQ01005968.1,1,1456,8.67198e-06,166857388,0.993808
D.truncata,167897087,VNJQ01005105.1,1,1456,8.67198e-06,166858844,0.993816
D.truncata,167897087,VNJQ01003311.1,1,1456,8.67198e-06,166860300,0.993825
D.truncata,167897087,VNJQ01003140.1,1,1455,8.66602e-06,166861755,0.993834
D.truncata,167897087,VNJQ01002148.1,1,1455,8.66602e-06,166863210,0.993842
D.truncata,167897087,VNJQ01003782.1,1,1454,8.66007e-06,166864664,0.993851
D.truncata,167897087,VNJQ01003095.1,1,1454,8.66007e-06,166866118,0.99386
D.truncata,167897087,VNJQ01001375.1,1,1454,8.66007e-06,166867572,0.993868
D.truncata,167897087,VNJQ01000338.1,1,1454,8.66007e-06,166869026,0.993877
D.truncata,167897087,VNJQ01006198.1,1,1452,8.64815e-06,166870478,0.993885
D.truncata,167897087,VNJQ01003996.1,1,1452,8.64815e-06,166871930,0.993894
D.truncata,167897087,VNJQ01007836.1,1,1451,8.6422e-06,166873381,0.993903
D.truncata,167897087,VNJQ01003845.1,1,1451,8.6422e-06,166874832,0.993911
D.truncata,167897087,VNJQ01003561.1,1,1451,8.6422e-06,166876283,0.99392
D.truncata,167897087,VNJQ01000628.1,1,1451,8.6422e-06,166877734,0.993929
D.truncata,167897087,VNJQ01007556.1,1,1450,8.63624e-06,166879184,0.993937
D.truncata,167897087,VNJQ01005440.1,1,1449,8.63029e-06,166880633,0.993946
D.truncata,167897087,VNJQ01007576.1,1,1446,8.61242e-06,166882079,0.993955
D.truncata,167897087,VNJQ01004757.1,1,1446,8.61242e-06,166883525,0.993963
D.truncata,167897087,VNJQ01002059.1,1,1446,8.61242e-06,166884971,0.993972
D.truncata,167897087,VNJQ01007844.1,1,1445,8.60646e-06,166886416,0.99398
D.truncata,167897087,VNJQ01000491.1,1,1445,8.60646e-06,166887861,0.993989
D.truncata,167897087,VNJQ01008201.1,1,1444,8.60051e-06,166889305,0.993998
D.truncata,167897087,VNJQ01007397.1,1,1444,8.60051e-06,166890749,0.994006
D.truncata,167897087,VNJQ01002522.1,1,1444,8.60051e-06,166892193,0.994015
D.truncata,167897087,VNJQ01001382.1,1,1444,8.60051e-06,166893637,0.994023
D.truncata,167897087,VNJQ01007927.1,1,1443,8.59455e-06,166895080,0.994032
D.truncata,167897087,VNJQ01004881.1,1,1443,8.59455e-06,166896523,0.994041
D.truncata,167897087,VNJQ01002260.1,1,1443,8.59455e-06,166897966,0.994049
D.truncata,167897087,VNJQ01008142.1,1,1442,8.58859e-06,166899408,0.994058
D.truncata,167897087,VNJQ01005725.1,1,1442,8.58859e-06,166900850,0.994066
D.truncata,167897087,VNJQ01000871.1,1,1442,8.58859e-06,166902292,0.994075
D.truncata,167897087,VNJQ01008053.1,1,1441,8.58264e-06,166903733,0.994084
D.truncata,167897087,VNJQ01007571.1,1,1438,8.56477e-06,166905171,0.994092
D.truncata,167897087,VNJQ01000872.1,1,1438,8.56477e-06,166906609,0.994101
D.truncata,167897087,VNJQ01008107.1,1,1437,8.55881e-06,166908046,0.994109
D.truncata,167897087,VNJQ01003751.1,1,1437,8.55881e-06,166909483,0.994118
D.truncata,167897087,VNJQ01003368.1,1,1437,8.55881e-06,166910920,0.994126
D.truncata,167897087,VNJQ01006903.1,1,1436,8.55286e-06,166912356,0.994135
D.truncata,167897087,VNJQ01007105.1,1,1435,8.5469e-06,166913791,0.994143
D.truncata,167897087,VNJQ01001913.1,1,1435,8.5469e-06,166915226,0.994152
D.truncata,167897087,VNJQ01006990.1,1,1434,8.54095e-06,166916660,0.994161
D.truncata,167897087,VNJQ01004404.1,1,1433,8.53499e-06,166918093,0.994169
D.truncata,167897087,VNJQ01001849.1,1,1432,8.52903e-06,166919525,0.994178
D.truncata,167897087,VNJQ01001637.1,1,1431,8.52308e-06,166920956,0.994186
D.truncata,167897087,VNJQ01000202.1,1,1430,8.51712e-06,166922386,0.994195
D.truncata,167897087,VNJQ01005150.1,1,1429,8.51117e-06,166923815,0.994203
D.truncata,167897087,VNJQ01001932.1,1,1428,8.50521e-06,166925243,0.994212
D.truncata,167897087,VNJQ01004301.1,1,1427,8.49925e-06,166926670,0.99422
D.truncata,167897087,VNJQ01001385.1,1,1427,8.49925e-06,166928097,0.994229
D.truncata,167897087,VNJQ01003058.1,1,1426,8.4933e-06,166929523,0.994237
D.truncata,167897087,VNJQ01006754.1,1,1425,8.48734e-06,166930948,0.994246
D.truncata,167897087,VNJQ01002586.1,1,1424,8.48139e-06,166932372,0.994254
D.truncata,167897087,VNJQ01000874.1,1,1424,8.48139e-06,166933796,0.994263
D.truncata,167897087,VNJQ01000873.1,1,1424,8.48139e-06,166935220,0.994271
D.truncata,167897087,VNJQ01000568.1,1,1424,8.48139e-06,166936644,0.99428
D.truncata,167897087,VNJQ01004553.1,1,1421,8.46352e-06,166938065,0.994288
D.truncata,167897087,VNJQ01000634.1,1,1420,8.45756e-06,166939485,0.994296
D.truncata,167897087,VNJQ01005895.1,1,1419,8.45161e-06,166940904,0.994305
D.truncata,167897087,VNJQ01000803.1,1,1419,8.45161e-06,166942323,0.994313
D.truncata,167897087,VNJQ01002057.1,1,1418,8.44565e-06,166943741,0.994322
D.truncata,167897087,VNJQ01000777.1,1,1418,8.44565e-06,166945159,0.99433
D.truncata,167897087,VNJQ01005722.1,1,1417,8.43969e-06,166946576,0.994339
D.truncata,167897087,VNJQ01006116.1,1,1416,8.43374e-06,166947992,0.994347
D.truncata,167897087,VNJQ01007902.1,1,1415,8.42778e-06,166949407,0.994356
D.truncata,167897087,VNJQ01000681.1,1,1415,8.42778e-06,166950822,0.994364
D.truncata,167897087,VNJQ01006206.1,1,1414,8.42183e-06,166952236,0.994372
D.truncata,167897087,VNJQ01001365.1,1,1414,8.42183e-06,166953650,0.994381
D.truncata,167897087,VNJQ01001963.1,1,1413,8.41587e-06,166955063,0.994389
D.truncata,167897087,VNJQ01000523.1,1,1413,8.41587e-06,166956476,0.994398
D.truncata,167897087,VNJQ01006336.1,1,1412,8.40991e-06,166957888,0.994406
D.truncata,167897087,VNJQ01005961.1,1,1412,8.40991e-06,166959300,0.994415
D.truncata,167897087,VNJQ01005208.1,1,1412,8.40991e-06,166960712,0.994423
D.truncata,167897087,VNJQ01004160.1,1,1412,8.40991e-06,166962124,0.994431
D.truncata,167897087,VNJQ01003828.1,1,1412,8.40991e-06,166963536,0.99444
D.truncata,167897087,VNJQ01002398.1,1,1412,8.40991e-06,166964948,0.994448
D.truncata,167897087,VNJQ01007064.1,1,1411,8.40396e-06,166966359,0.994457
D.truncata,167897087,VNJQ01004806.1,1,1410,8.398e-06,166967769,0.994465
D.truncata,167897087,VNJQ01004382.1,1,1410,8.398e-06,166969179,0.994473
D.truncata,167897087,VNJQ01002869.1,1,1409,8.39205e-06,166970588,0.994482
D.truncata,167897087,VNJQ01002424.1,1,1409,8.39205e-06,166971997,0.99449
D.truncata,167897087,VNJQ01005119.1,1,1408,8.38609e-06,166973405,0.994499
D.truncata,167897087,VNJQ01002789.1,1,1407,8.38013e-06,166974812,0.994507
D.truncata,167897087,VNJQ01001303.1,1,1407,8.38013e-06,166976219,0.994515
D.truncata,167897087,VNJQ01008083.1,1,1406,8.37418e-06,166977625,0.994524
D.truncata,167897087,VNJQ01006541.1,1,1406,8.37418e-06,166979031,0.994532
D.truncata,167897087,VNJQ01006318.1,1,1406,8.37418e-06,166980437,0.99454
D.truncata,167897087,VNJQ01004060.1,1,1406,8.37418e-06,166981843,0.994549
D.truncata,167897087,VNJQ01001992.1,1,1406,8.37418e-06,166983249,0.994557
D.truncata,167897087,VNJQ01000592.1,1,1406,8.37418e-06,166984655,0.994566
D.truncata,167897087,VNJQ01000068.1,1,1406,8.37418e-06,166986061,0.994574
D.truncata,167897087,VNJQ01007016.1,1,1405,8.36822e-06,166987466,0.994582
D.truncata,167897087,VNJQ01006086.1,1,1405,8.36822e-06,166988871,0.994591
D.truncata,167897087,VNJQ01002181.1,1,1405,8.36822e-06,166990276,0.994599
D.truncata,167897087,VNJQ01007331.1,1,1403,8.35631e-06,166991679,0.994607
D.truncata,167897087,VNJQ01001197.1,1,1403,8.35631e-06,166993082,0.994616
D.truncata,167897087,VNJQ01006415.1,1,1402,8.35035e-06,166994484,0.994624
D.truncata,167897087,VNJQ01005180.1,1,1402,8.35035e-06,166995886,0.994632
D.truncata,167897087,VNJQ01001125.1,1,1402,8.35035e-06,166997288,0.994641
D.truncata,167897087,VNJQ01002642.1,1,1401,8.3444e-06,166998689,0.994649
D.truncata,167897087,VNJQ01007904.1,1,1400,8.33844e-06,167000089,0.994657
D.truncata,167897087,VNJQ01003315.1,1,1399,8.33249e-06,167001488,0.994666
D.truncata,167897087,VNJQ01002315.1,1,1398,8.32653e-06,167002886,0.994674
D.truncata,167897087,VNJQ01006728.1,1,1396,8.31462e-06,167004282,0.994682
D.truncata,167897087,VNJQ01006322.1,1,1396,8.31462e-06,167005678,0.994691
D.truncata,167897087,VNJQ01004094.1,1,1396,8.31462e-06,167007074,0.994699
D.truncata,167897087,VNJQ01007040.1,1,1395,8.30866e-06,167008469,0.994707
D.truncata,167897087,VNJQ01000775.1,1,1395,8.30866e-06,167009864,0.994716
D.truncata,167897087,VNJQ01006544.1,1,1394,8.30271e-06,167011258,0.994724
D.truncata,167897087,VNJQ01006241.1,1,1390,8.27888e-06,167012648,0.994732
D.truncata,167897087,VNJQ01004419.1,1,1390,8.27888e-06,167014038,0.994741
D.truncata,167897087,VNJQ01000876.1,1,1390,8.27888e-06,167015428,0.994749
D.truncata,167897087,VNJQ01001904.1,1,1388,8.26697e-06,167016816,0.994757
D.truncata,167897087,VNJQ01001694.1,1,1388,8.26697e-06,167018204,0.994765
D.truncata,167897087,VNJQ01000656.1,1,1388,8.26697e-06,167019592,0.994774
D.truncata,167897087,VNJQ01006543.1,1,1387,8.26101e-06,167020979,0.994782
D.truncata,167897087,VNJQ01006328.1,1,1386,8.25506e-06,167022365,0.99479
D.truncata,167897087,VNJQ01003908.1,1,1386,8.25506e-06,167023751,0.994798
D.truncata,167897087,VNJQ01000109.1,1,1386,8.25506e-06,167025137,0.994807
D.truncata,167897087,VNJQ01003458.1,1,1385,8.2491e-06,167026522,0.994815
D.truncata,167897087,VNJQ01006183.1,1,1384,8.24314e-06,167027906,0.994823
D.truncata,167897087,VNJQ01005720.1,1,1384,8.24314e-06,167029290,0.994831
D.truncata,167897087,VNJQ01005542.1,1,1384,8.24314e-06,167030674,0.99484
D.truncata,167897087,VNJQ01000877.1,1,1383,8.23719e-06,167032057,0.994848
D.truncata,167897087,VNJQ01004559.1,1,1380,8.21932e-06,167033437,0.994856
D.truncata,167897087,VNJQ01004236.1,1,1380,8.21932e-06,167034817,0.994864
D.truncata,167897087,VNJQ01006545.1,1,1379,8.21336e-06,167036196,0.994873
D.truncata,167897087,VNJQ01005126.1,1,1379,8.21336e-06,167037575,0.994881
D.truncata,167897087,VNJQ01005774.1,1,1378,8.20741e-06,167038953,0.994889
D.truncata,167897087,VNJQ01004554.1,1,1378,8.20741e-06,167040331,0.994897
D.truncata,167897087,VNJQ01002327.1,1,1378,8.20741e-06,167041709,0.994905
D.truncata,167897087,VNJQ01000878.1,1,1378,8.20741e-06,167043087,0.994914
D.truncata,167897087,VNJQ01007910.1,1,1377,8.20145e-06,167044464,0.994922
D.truncata,167897087,VNJQ01006659.1,1,1377,8.20145e-06,167045841,0.99493
D.truncata,167897087,VNJQ01005677.1,1,1377,8.20145e-06,167047218,0.994938
D.truncata,167897087,VNJQ01005100.1,1,1377,8.20145e-06,167048595,0.994946
D.truncata,167897087,VNJQ01005962.1,1,1376,8.1955e-06,167049971,0.994955
D.truncata,167897087,VNJQ01004569.1,1,1375,8.18954e-06,167051346,0.994963
D.truncata,167897087,VNJQ01002543.1,1,1375,8.18954e-06,167052721,0.994971
D.truncata,167897087,VNJQ01001976.1,1,1374,8.18358e-06,167054095,0.994979
D.truncata,167897087,VNJQ01004754.1,1,1373,8.17763e-06,167055468,0.994987
D.truncata,167897087,VNJQ01000623.1,1,1372,8.17167e-06,167056840,0.994995
D.truncata,167897087,VNJQ01007042.1,1,1371,8.16572e-06,167058211,0.995004
D.truncata,167897087,VNJQ01006134.1,1,1371,8.16572e-06,167059582,0.995012
D.truncata,167897087,VNJQ01005964.1,1,1371,8.16572e-06,167060953,0.99502
D.truncata,167897087,VNJQ01000988.1,1,1370,8.15976e-06,167062323,0.995028
D.truncata,167897087,VNJQ01003472.1,1,1369,8.1538e-06,167063692,0.995036
D.truncata,167897087,VNJQ01002996.1,1,1369,8.1538e-06,167065061,0.995044
D.truncata,167897087,VNJQ01002180.1,1,1368,8.14785e-06,167066429,0.995053
D.truncata,167897087,VNJQ01003780.1,1,1367,8.14189e-06,167067796,0.995061
D.truncata,167897087,VNJQ01006582.1,1,1366,8.13594e-06,167069162,0.995069
D.truncata,167897087,VNJQ01006581.1,1,1365,8.12998e-06,167070527,0.995077
D.truncata,167897087,VNJQ01001076.1,1,1365,8.12998e-06,167071892,0.995085
D.truncata,167897087,VNJQ01004006.1,1,1363,8.11807e-06,167073255,0.995093
D.truncata,167897087,VNJQ01001595.1,1,1363,8.11807e-06,167074618,0.995101
D.truncata,167897087,VNJQ01005890.1,1,1361,8.10616e-06,167075979,0.995109
D.truncata,167897087,VNJQ01005253.1,1,1361,8.10616e-06,167077340,0.995118
D.truncata,167897087,VNJQ01004992.1,1,1360,8.1002e-06,167078700,0.995126
D.truncata,167897087,VNJQ01004467.1,1,1360,8.1002e-06,167080060,0.995134
D.truncata,167897087,VNJQ01003036.1,1,1359,8.09424e-06,167081419,0.995142
D.truncata,167897087,VNJQ01002289.1,1,1359,8.09424e-06,167082778,0.99515
D.truncata,167897087,VNJQ01001826.1,1,1359,8.09424e-06,167084137,0.995158
D.truncata,167897087,VNJQ01005541.1,1,1358,8.08829e-06,167085495,0.995166
D.truncata,167897087,VNJQ01005111.1,1,1358,8.08829e-06,167086853,0.995174
D.truncata,167897087,VNJQ01002749.1,1,1358,8.08829e-06,167088211,0.995182
D.truncata,167897087,VNJQ01000879.1,1,1358,8.08829e-06,167089569,0.99519
D.truncata,167897087,VNJQ01006428.1,1,1356,8.07638e-06,167090925,0.995198
D.truncata,167897087,VNJQ01002247.1,1,1356,8.07638e-06,167092281,0.995207
D.truncata,167897087,VNJQ01002499.1,1,1355,8.07042e-06,167093636,0.995215
D.truncata,167897087,VNJQ01001938.1,1,1355,8.07042e-06,167094991,0.995223
D.truncata,167897087,VNJQ01000064.1,1,1355,8.07042e-06,167096346,0.995231
D.truncata,167897087,VNJQ01007180.1,1,1353,8.05851e-06,167097699,0.995239
D.truncata,167897087,VNJQ01006661.1,1,1353,8.05851e-06,167099052,0.995247
D.truncata,167897087,VNJQ01000031.1,1,1353,8.05851e-06,167100405,0.995255
D.truncata,167897087,VNJQ01006907.1,1,1351,8.0466e-06,167101756,0.995263
D.truncata,167897087,VNJQ01005525.1,1,1351,8.0466e-06,167103107,0.995271
D.truncata,167897087,VNJQ01004026.1,1,1351,8.0466e-06,167104458,0.995279
D.truncata,167897087,VNJQ01001112.1,1,1351,8.0466e-06,167105809,0.995287
D.truncata,167897087,VNJQ01006538.1,1,1350,8.04064e-06,167107159,0.995295
D.truncata,167897087,VNJQ01002320.1,1,1349,8.03468e-06,167108508,0.995303
D.truncata,167897087,VNJQ01004775.1,1,1348,8.02873e-06,167109856,0.995311
D.truncata,167897087,VNJQ01004062.1,1,1348,8.02873e-06,167111204,0.995319
D.truncata,167897087,VNJQ01005728.1,1,1347,8.02277e-06,167112551,0.995327
D.truncata,167897087,VNJQ01000739.1,1,1347,8.02277e-06,167113898,0.995335
D.truncata,167897087,VNJQ01000499.1,1,1347,8.02277e-06,167115245,0.995343
D.truncata,167897087,VNJQ01003053.1,1,1345,8.01086e-06,167116590,0.995351
D.truncata,167897087,VNJQ01005404.1,1,1344,8.0049e-06,167117934,0.995359
D.truncata,167897087,VNJQ01006321.1,1,1343,7.99895e-06,167119277,0.995367
D.truncata,167897087,VNJQ01006199.1,1,1343,7.99895e-06,167120620,0.995375
D.truncata,167897087,VNJQ01003049.1,1,1343,7.99895e-06,167121963,0.995383
D.truncata,167897087,VNJQ01006606.1,1,1342,7.99299e-06,167123305,0.995391
D.truncata,167897087,VNJQ01002211.1,1,1342,7.99299e-06,167124647,0.995399
D.truncata,167897087,VNJQ01000815.1,1,1342,7.99299e-06,167125989,0.995407
D.truncata,167897087,VNJQ01004542.1,1,1341,7.98704e-06,167127330,0.995415
D.truncata,167897087,VNJQ01003704.1,1,1341,7.98704e-06,167128671,0.995423
D.truncata,167897087,VNJQ01001373.1,1,1341,7.98704e-06,167130012,0.995431
D.truncata,167897087,VNJQ01005136.1,1,1340,7.98108e-06,167131352,0.995439
D.truncata,167897087,VNJQ01001982.1,1,1340,7.98108e-06,167132692,0.995447
D.truncata,167897087,VNJQ01003620.1,1,1339,7.97512e-06,167134031,0.995455
D.truncata,167897087,VNJQ01000946.1,1,1339,7.97512e-06,167135370,0.995463
D.truncata,167897087,VNJQ01006729.1,1,1338,7.96917e-06,167136708,0.995471
D.truncata,167897087,VNJQ01005618.1,1,1336,7.95726e-06,167138044,0.995479
D.truncata,167897087,VNJQ01008047.1,1,1335,7.9513e-06,167139379,0.995487
D.truncata,167897087,VNJQ01001965.1,1,1334,7.94534e-06,167140713,0.995495
D.truncata,167897087,VNJQ01002771.1,1,1332,7.93343e-06,167142045,0.995503
D.truncata,167897087,VNJQ01007500.1,1,1331,7.92748e-06,167143376,0.995511
D.truncata,167897087,VNJQ01005018.1,1,1331,7.92748e-06,167144707,0.995519
D.truncata,167897087,VNJQ01000577.1,1,1331,7.92748e-06,167146038,0.995527
D.truncata,167897087,VNJQ01004388.1,1,1330,7.92152e-06,167147368,0.995535
D.truncata,167897087,VNJQ01002539.1,1,1330,7.92152e-06,167148698,0.995543
D.truncata,167897087,VNJQ01001750.1,1,1330,7.92152e-06,167150028,0.99555
D.truncata,167897087,VNJQ01001424.1,1,1330,7.92152e-06,167151358,0.995558
D.truncata,167897087,VNJQ01006113.1,1,1329,7.91556e-06,167152687,0.995566
D.truncata,167897087,VNJQ01007361.1,1,1327,7.90365e-06,167154014,0.995574
D.truncata,167897087,VNJQ01006169.1,1,1327,7.90365e-06,167155341,0.995582
D.truncata,167897087,VNJQ01003407.1,1,1326,7.8977e-06,167156667,0.99559
D.truncata,167897087,VNJQ01003384.1,1,1326,7.8977e-06,167157993,0.995598
D.truncata,167897087,VNJQ01002548.1,1,1326,7.8977e-06,167159319,0.995606
D.truncata,167897087,VNJQ01000801.1,1,1326,7.8977e-06,167160645,0.995614
D.truncata,167897087,VNJQ01001134.1,1,1325,7.89174e-06,167161970,0.995622
D.truncata,167897087,VNJQ01006758.1,1,1324,7.88578e-06,167163294,0.99563
D.truncata,167897087,VNJQ01007598.1,1,1323,7.87983e-06,167164617,0.995637
D.truncata,167897087,VNJQ01003538.1,1,1323,7.87983e-06,167165940,0.995645
D.truncata,167897087,VNJQ01000653.1,1,1323,7.87983e-06,167167263,0.995653
D.truncata,167897087,VNJQ01007530.1,1,1322,7.87387e-06,167168585,0.995661
D.truncata,167897087,VNJQ01000344.1,1,1322,7.87387e-06,167169907,0.995669
D.truncata,167897087,VNJQ01006759.1,1,1321,7.86791e-06,167171228,0.995677
D.truncata,167897087,VNJQ01003162.1,1,1321,7.86791e-06,167172549,0.995685
D.truncata,167897087,VNJQ01000531.1,1,1321,7.86791e-06,167173870,0.995692
D.truncata,167897087,VNJQ01003834.1,1,1320,7.86196e-06,167175190,0.9957
D.truncata,167897087,VNJQ01000716.1,1,1320,7.86196e-06,167176510,0.995708
D.truncata,167897087,VNJQ01005676.1,1,1319,7.856e-06,167177829,0.995716
D.truncata,167897087,VNJQ01003248.1,1,1319,7.856e-06,167179148,0.995724
D.truncata,167897087,VNJQ01008013.1,1,1317,7.84409e-06,167180465,0.995732
D.truncata,167897087,VNJQ01000752.1,1,1317,7.84409e-06,167181782,0.99574
D.truncata,167897087,VNJQ01002202.1,1,1315,7.83218e-06,167183097,0.995747
D.truncata,167897087,VNJQ01001339.1,1,1315,7.83218e-06,167184412,0.995755
D.truncata,167897087,VNJQ01006111.1,1,1314,7.82622e-06,167185726,0.995763
D.truncata,167897087,VNJQ01002777.1,1,1314,7.82622e-06,167187040,0.995771
D.truncata,167897087,VNJQ01002549.1,1,1314,7.82622e-06,167188354,0.995779
D.truncata,167897087,VNJQ01001066.1,1,1314,7.82622e-06,167189668,0.995787
D.truncata,167897087,VNJQ01008051.1,1,1311,7.80835e-06,167190979,0.995794
D.truncata,167897087,VNJQ01007116.1,1,1311,7.80835e-06,167192290,0.995802
D.truncata,167897087,VNJQ01007074.1,1,1310,7.8024e-06,167193600,0.99581
D.truncata,167897087,VNJQ01004220.1,1,1310,7.8024e-06,167194910,0.995818
D.truncata,167897087,VNJQ01007867.1,1,1308,7.79049e-06,167196218,0.995826
D.truncata,167897087,VNJQ01002718.1,1,1308,7.79049e-06,167197526,0.995833
D.truncata,167897087,VNJQ01002129.1,1,1308,7.79049e-06,167198834,0.995841
D.truncata,167897087,VNJQ01001632.1,1,1308,7.79049e-06,167200142,0.995849
D.truncata,167897087,VNJQ01001250.1,1,1308,7.79049e-06,167201450,0.995857
D.truncata,167897087,VNJQ01000662.1,1,1307,7.78453e-06,167202757,0.995865
D.truncata,167897087,VNJQ01000841.1,1,1306,7.77857e-06,167204063,0.995872
D.truncata,167897087,VNJQ01000632.1,1,1306,7.77857e-06,167205369,0.99588
D.truncata,167897087,VNJQ01008168.1,1,1305,7.77262e-06,167206674,0.995888
D.truncata,167897087,VNJQ01002116.1,1,1305,7.77262e-06,167207979,0.995896
D.truncata,167897087,VNJQ01002058.1,1,1305,7.77262e-06,167209284,0.995903
D.truncata,167897087,VNJQ01005517.1,1,1304,7.76666e-06,167210588,0.995911
D.truncata,167897087,VNJQ01000271.1,1,1304,7.76666e-06,167211892,0.995919
D.truncata,167897087,VNJQ01001377.1,1,1303,7.76071e-06,167213195,0.995927
D.truncata,167897087,VNJQ01000365.1,1,1302,7.75475e-06,167214497,0.995934
D.truncata,167897087,VNJQ01006677.1,1,1300,7.74284e-06,167215797,0.995942
D.truncata,167897087,VNJQ01005545.1,1,1300,7.74284e-06,167217097,0.99595
D.truncata,167897087,VNJQ01003687.1,1,1300,7.74284e-06,167218397,0.995958
D.truncata,167897087,VNJQ01004056.1,1,1299,7.73688e-06,167219696,0.995965
D.truncata,167897087,VNJQ01000571.1,1,1299,7.73688e-06,167220995,0.995973
D.truncata,167897087,VNJQ01005148.1,1,1298,7.73093e-06,167222293,0.995981
D.truncata,167897087,VNJQ01007912.1,1,1297,7.72497e-06,167223590,0.995989
D.truncata,167897087,VNJQ01007827.1,1,1297,7.72497e-06,167224887,0.995996
D.truncata,167897087,VNJQ01006940.1,1,1297,7.72497e-06,167226184,0.996004
D.truncata,167897087,VNJQ01002674.1,1,1296,7.71901e-06,167227480,0.996012
D.truncata,167897087,VNJQ01001122.1,1,1296,7.71901e-06,167228776,0.99602
D.truncata,167897087,VNJQ01000590.1,1,1296,7.71901e-06,167230072,0.996027
D.truncata,167897087,VNJQ01000608.1,1,1295,7.71306e-06,167231367,0.996035
D.truncata,167897087,VNJQ01004805.1,1,1294,7.7071e-06,167232661,0.996043
D.truncata,167897087,VNJQ01002222.1,1,1294,7.7071e-06,167233955,0.99605
D.truncata,167897087,VNJQ01002765.1,1,1293,7.70115e-06,167235248,0.996058
D.truncata,167897087,VNJQ01002030.1,1,1293,7.70115e-06,167236541,0.996066
D.truncata,167897087,VNJQ01007389.1,1,1292,7.69519e-06,167237833,0.996073
D.truncata,167897087,VNJQ01000128.1,1,1292,7.69519e-06,167239125,0.996081
D.truncata,167897087,VNJQ01001506.1,1,1291,7.68923e-06,167240416,0.996089
D.truncata,167897087,VNJQ01006898.1,1,1290,7.68328e-06,167241706,0.996097
D.truncata,167897087,VNJQ01004071.1,1,1290,7.68328e-06,167242996,0.996104
D.truncata,167897087,VNJQ01004657.1,1,1289,7.67732e-06,167244285,0.996112
D.truncata,167897087,VNJQ01002729.1,1,1289,7.67732e-06,167245574,0.99612
D.truncata,167897087,VNJQ01002265.1,1,1289,7.67732e-06,167246863,0.996127
D.truncata,167897087,VNJQ01000982.1,1,1289,7.67732e-06,167248152,0.996135
D.truncata,167897087,VNJQ01004410.1,1,1288,7.67137e-06,167249440,0.996143
D.truncata,167897087,VNJQ01002544.1,1,1288,7.67137e-06,167250728,0.99615
D.truncata,167897087,VNJQ01004248.1,1,1286,7.65945e-06,167252014,0.996158
D.truncata,167897087,VNJQ01001717.1,1,1286,7.65945e-06,167253300,0.996166
D.truncata,167897087,VNJQ01001010.1,1,1286,7.65945e-06,167254586,0.996173
D.truncata,167897087,VNJQ01003241.1,1,1285,7.6535e-06,167255871,0.996181
D.truncata,167897087,VNJQ01002078.1,1,1285,7.6535e-06,167257156,0.996189
D.truncata,167897087,VNJQ01007624.1,1,1284,7.64754e-06,167258440,0.996196
D.truncata,167897087,VNJQ01007900.1,1,1282,7.63563e-06,167259722,0.996204
D.truncata,167897087,VNJQ01006908.1,1,1282,7.63563e-06,167261004,0.996211
D.truncata,167897087,VNJQ01001363.1,1,1282,7.63563e-06,167262286,0.996219
D.truncata,167897087,VNJQ01008009.1,1,1281,7.62967e-06,167263567,0.996227
D.truncata,167897087,VNJQ01004331.1,1,1280,7.62372e-06,167264847,0.996234
D.truncata,167897087,VNJQ01003914.1,1,1280,7.62372e-06,167266127,0.996242
D.truncata,167897087,VNJQ01003715.1,1,1279,7.61776e-06,167267406,0.99625
D.truncata,167897087,VNJQ01002465.1,1,1279,7.61776e-06,167268685,0.996257
D.truncata,167897087,VNJQ01006595.1,1,1278,7.61181e-06,167269963,0.996265
D.truncata,167897087,VNJQ01006723.1,1,1277,7.60585e-06,167271240,0.996272
D.truncata,167897087,VNJQ01003657.1,1,1277,7.60585e-06,167272517,0.99628
D.truncata,167897087,VNJQ01000989.1,1,1277,7.60585e-06,167273794,0.996288
D.truncata,167897087,VNJQ01005697.1,1,1276,7.59989e-06,167275070,0.996295
D.truncata,167897087,VNJQ01001911.1,1,1276,7.59989e-06,167276346,0.996303
D.truncata,167897087,VNJQ01000366.1,1,1276,7.59989e-06,167277622,0.99631
D.truncata,167897087,VNJQ01006518.1,1,1275,7.59394e-06,167278897,0.996318
D.truncata,167897087,VNJQ01006098.1,1,1275,7.59394e-06,167280172,0.996326
D.truncata,167897087,VNJQ01005432.1,1,1275,7.59394e-06,167281447,0.996333
D.truncata,167897087,VNJQ01001235.1,1,1275,7.59394e-06,167282722,0.996341
D.truncata,167897087,VNJQ01000414.1,1,1275,7.59394e-06,167283997,0.996348
D.truncata,167897087,VNJQ01005409.1,1,1274,7.58798e-06,167285271,0.996356
D.truncata,167897087,VNJQ01002013.1,1,1274,7.58798e-06,167286545,0.996364
D.truncata,167897087,VNJQ01005292.1,1,1273,7.58203e-06,167287818,0.996371
D.truncata,167897087,VNJQ01002407.1,1,1273,7.58203e-06,167289091,0.996379
D.truncata,167897087,VNJQ01003146.1,1,1271,7.57011e-06,167290362,0.996386
D.truncata,167897087,VNJQ01001761.1,1,1271,7.57011e-06,167291633,0.996394
D.truncata,167897087,VNJQ01006657.1,1,1270,7.56416e-06,167292903,0.996401
D.truncata,167897087,VNJQ01001609.1,1,1270,7.56416e-06,167294173,0.996409
D.truncata,167897087,VNJQ01007121.1,1,1269,7.5582e-06,167295442,0.996417
D.truncata,167897087,VNJQ01002408.1,1,1268,7.55225e-06,167296710,0.996424
D.truncata,167897087,VNJQ01000981.1,1,1268,7.55225e-06,167297978,0.996432
D.truncata,167897087,VNJQ01004279.1,1,1267,7.54629e-06,167299245,0.996439
D.truncata,167897087,VNJQ01005489.1,1,1265,7.53438e-06,167300510,0.996447
D.truncata,167897087,VNJQ01001975.1,1,1265,7.53438e-06,167301775,0.996454
D.truncata,167897087,VNJQ01005684.1,1,1264,7.52842e-06,167303039,0.996462
D.truncata,167897087,VNJQ01004514.1,1,1264,7.52842e-06,167304303,0.996469
D.truncata,167897087,VNJQ01004866.1,1,1263,7.52247e-06,167305566,0.996477
D.truncata,167897087,VNJQ01005519.1,1,1262,7.51651e-06,167306828,0.996484
D.truncata,167897087,VNJQ01004815.1,1,1262,7.51651e-06,167308090,0.996492
D.truncata,167897087,VNJQ01003682.1,1,1262,7.51651e-06,167309352,0.996499
D.truncata,167897087,VNJQ01003305.1,1,1262,7.51651e-06,167310614,0.996507
D.truncata,167897087,VNJQ01003149.1,1,1262,7.51651e-06,167311876,0.996514
D.truncata,167897087,VNJQ01005642.1,1,1261,7.51055e-06,167313137,0.996522
D.truncata,167897087,VNJQ01005602.1,1,1261,7.51055e-06,167314398,0.996529
D.truncata,167897087,VNJQ01001839.1,1,1260,7.5046e-06,167315658,0.996537
D.truncata,167897087,VNJQ01006324.1,1,1259,7.49864e-06,167316917,0.996544
D.truncata,167897087,VNJQ01008005.1,1,1258,7.49269e-06,167318175,0.996552
D.truncata,167897087,VNJQ01006393.1,1,1258,7.49269e-06,167319433,0.996559
D.truncata,167897087,VNJQ01005399.1,1,1258,7.49269e-06,167320691,0.996567
D.truncata,167897087,VNJQ01000951.1,1,1258,7.49269e-06,167321949,0.996574
D.truncata,167897087,VNJQ01007555.1,1,1257,7.48673e-06,167323206,0.996582
D.truncata,167897087,VNJQ01006831.1,1,1257,7.48673e-06,167324463,0.996589
D.truncata,167897087,VNJQ01007611.1,1,1256,7.48077e-06,167325719,0.996597
D.truncata,167897087,VNJQ01007300.1,1,1256,7.48077e-06,167326975,0.996604
D.truncata,167897087,VNJQ01001057.1,1,1254,7.46886e-06,167328229,0.996612
D.truncata,167897087,VNJQ01008217.1,1,1252,7.45695e-06,167329481,0.996619
D.truncata,167897087,VNJQ01002988.1,1,1252,7.45695e-06,167330733,0.996627
D.truncata,167897087,VNJQ01000369.1,1,1252,7.45695e-06,167331985,0.996634
D.truncata,167897087,VNJQ01004185.1,1,1251,7.45099e-06,167333236,0.996642
D.truncata,167897087,VNJQ01002178.1,1,1251,7.45099e-06,167334487,0.996649
D.truncata,167897087,VNJQ01001618.1,1,1250,7.44504e-06,167335737,0.996657
D.truncata,167897087,VNJQ01007786.1,1,1249,7.43908e-06,167336986,0.996664
D.truncata,167897087,VNJQ01004281.1,1,1249,7.43908e-06,167338235,0.996671
D.truncata,167897087,VNJQ01007665.1,1,1248,7.43312e-06,167339483,0.996679
D.truncata,167897087,VNJQ01006662.1,1,1248,7.43312e-06,167340731,0.996686
D.truncata,167897087,VNJQ01006017.1,1,1248,7.43312e-06,167341979,0.996694
D.truncata,167897087,VNJQ01003650.1,1,1248,7.43312e-06,167343227,0.996701
D.truncata,167897087,VNJQ01002192.1,1,1248,7.43312e-06,167344475,0.996709
D.truncata,167897087,VNJQ01001120.1,1,1247,7.42717e-06,167345722,0.996716
D.truncata,167897087,VNJQ01007171.1,1,1246,7.42121e-06,167346968,0.996723
D.truncata,167897087,VNJQ01002993.1,1,1246,7.42121e-06,167348214,0.996731
D.truncata,167897087,VNJQ01002444.1,1,1246,7.42121e-06,167349460,0.996738
D.truncata,167897087,VNJQ01000495.1,1,1246,7.42121e-06,167350706,0.996746
D.truncata,167897087,VNJQ01003651.1,1,1244,7.4093e-06,167351950,0.996753
D.truncata,167897087,VNJQ01001777.1,1,1244,7.4093e-06,167353194,0.996761
D.truncata,167897087,VNJQ01001765.1,1,1244,7.4093e-06,167354438,0.996768
D.truncata,167897087,VNJQ01004549.1,1,1243,7.40334e-06,167355681,0.996775
D.truncata,167897087,VNJQ01002502.1,1,1243,7.40334e-06,167356924,0.996783
D.truncata,167897087,VNJQ01000103.1,1,1243,7.40334e-06,167358167,0.99679
D.truncata,167897087,VNJQ01008091.1,1,1242,7.39739e-06,167359409,0.996798
D.truncata,167897087,VNJQ01004826.1,1,1241,7.39143e-06,167360650,0.996805
D.truncata,167897087,VNJQ01000448.1,1,1241,7.39143e-06,167361891,0.996812
D.truncata,167897087,VNJQ01003052.1,1,1240,7.38548e-06,167363131,0.99682
D.truncata,167897087,VNJQ01004266.1,1,1239,7.37952e-06,167364370,0.996827
D.truncata,167897087,VNJQ01003277.1,1,1239,7.37952e-06,167365609,0.996835
D.truncata,167897087,VNJQ01007785.1,1,1238,7.37356e-06,167366847,0.996842
D.truncata,167897087,VNJQ01006988.1,1,1238,7.37356e-06,167368085,0.996849
D.truncata,167897087,VNJQ01005892.1,1,1238,7.37356e-06,167369323,0.996857
D.truncata,167897087,VNJQ01005211.1,1,1238,7.37356e-06,167370561,0.996864
D.truncata,167897087,VNJQ01004097.1,1,1238,7.37356e-06,167371799,0.996871
D.truncata,167897087,VNJQ01003847.1,1,1238,7.37356e-06,167373037,0.996879
D.truncata,167897087,VNJQ01006732.1,1,1237,7.36761e-06,167374274,0.996886
D.truncata,167897087,VNJQ01006232.1,1,1236,7.36165e-06,167375510,0.996893
D.truncata,167897087,VNJQ01005147.1,1,1236,7.36165e-06,167376746,0.996901
D.truncata,167897087,VNJQ01005069.1,1,1236,7.36165e-06,167377982,0.996908
D.truncata,167897087,VNJQ01002769.1,1,1236,7.36165e-06,167379218,0.996916
D.truncata,167897087,VNJQ01002618.1,1,1236,7.36165e-06,167380454,0.996923
D.truncata,167897087,VNJQ01007051.1,1,1235,7.3557e-06,167381689,0.99693
D.truncata,167897087,VNJQ01005667.1,1,1235,7.3557e-06,167382924,0.996938
D.truncata,167897087,VNJQ01003777.1,1,1235,7.3557e-06,167384159,0.996945
D.truncata,167897087,VNJQ01003029.1,1,1235,7.3557e-06,167385394,0.996952
D.truncata,167897087,VNJQ01002406.1,1,1235,7.3557e-06,167386629,0.99696
D.truncata,167897087,VNJQ01002175.1,1,1235,7.3557e-06,167387864,0.996967
D.truncata,167897087,VNJQ01007753.1,1,1233,7.34378e-06,167389097,0.996974
D.truncata,167897087,VNJQ01006045.1,1,1233,7.34378e-06,167390330,0.996982
D.truncata,167897087,VNJQ01001357.1,1,1233,7.34378e-06,167391563,0.996989
D.truncata,167897087,VNJQ01007764.1,1,1232,7.33783e-06,167392795,0.996996
D.truncata,167897087,VNJQ01002454.1,1,1232,7.33783e-06,167394027,0.997004
D.truncata,167897087,VNJQ01000963.1,1,1231,7.33187e-06,167395258,0.997011
D.truncata,167897087,VNJQ01008041.1,1,1230,7.32592e-06,167396488,0.997018
D.truncata,167897087,VNJQ01004571.1,1,1230,7.32592e-06,167397718,0.997026
D.truncata,167897087,VNJQ01003062.1,1,1229,7.31996e-06,167398947,0.997033
D.truncata,167897087,VNJQ01000760.1,1,1229,7.31996e-06,167400176,0.99704
D.truncata,167897087,VNJQ01000698.1,1,1229,7.31996e-06,167401405,0.997048
D.truncata,167897087,VNJQ01006880.1,1,1228,7.314e-06,167402633,0.997055
D.truncata,167897087,VNJQ01004480.1,1,1228,7.314e-06,167403861,0.997062
D.truncata,167897087,VNJQ01000362.1,1,1228,7.314e-06,167405089,0.99707
D.truncata,167897087,VNJQ01008011.1,1,1226,7.30209e-06,167406315,0.997077
D.truncata,167897087,VNJQ01002119.1,1,1226,7.30209e-06,167407541,0.997084
D.truncata,167897087,VNJQ01001931.1,1,1226,7.30209e-06,167408767,0.997092
D.truncata,167897087,VNJQ01004565.1,1,1225,7.29614e-06,167409992,0.997099
D.truncata,167897087,VNJQ01003730.1,1,1225,7.29614e-06,167411217,0.997106
D.truncata,167897087,VNJQ01003064.1,1,1224,7.29018e-06,167412441,0.997113
D.truncata,167897087,VNJQ01003289.1,1,1223,7.28422e-06,167413664,0.997121
D.truncata,167897087,VNJQ01002951.1,1,1222,7.27827e-06,167414886,0.997128
D.truncata,167897087,VNJQ01005665.1,1,1220,7.26636e-06,167416106,0.997135
D.truncata,167897087,VNJQ01000065.1,1,1220,7.26636e-06,167417326,0.997143
D.truncata,167897087,VNJQ01007325.1,1,1219,7.2604e-06,167418545,0.99715
D.truncata,167897087,VNJQ01004968.1,1,1219,7.2604e-06,167419764,0.997157
D.truncata,167897087,VNJQ01007352.1,1,1218,7.25444e-06,167420982,0.997164
D.truncata,167897087,VNJQ01007073.1,1,1218,7.25444e-06,167422200,0.997172
D.truncata,167897087,VNJQ01006431.1,1,1218,7.25444e-06,167423418,0.997179
D.truncata,167897087,VNJQ01006159.1,1,1218,7.25444e-06,167424636,0.997186
D.truncata,167897087,VNJQ01005344.1,1,1218,7.25444e-06,167425854,0.997193
D.truncata,167897087,VNJQ01002829.1,1,1218,7.25444e-06,167427072,0.997201
D.truncata,167897087,VNJQ01002266.1,1,1218,7.25444e-06,167428290,0.997208
D.truncata,167897087,VNJQ01007535.1,1,1217,7.24849e-06,167429507,0.997215
D.truncata,167897087,VNJQ01005152.1,1,1217,7.24849e-06,167430724,0.997222
D.truncata,167897087,VNJQ01004963.1,1,1217,7.24849e-06,167431941,0.99723
D.truncata,167897087,VNJQ01003982.1,1,1217,7.24849e-06,167433158,0.997237
D.truncata,167897087,VNJQ01003327.1,1,1217,7.24849e-06,167434375,0.997244
D.truncata,167897087,VNJQ01005786.1,1,1216,7.24253e-06,167435591,0.997251
D.truncata,167897087,VNJQ01005946.1,1,1215,7.23658e-06,167436806,0.997259
D.truncata,167897087,VNJQ01000985.1,1,1215,7.23658e-06,167438021,0.997266
D.truncata,167897087,VNJQ01005116.1,1,1214,7.23062e-06,167439235,0.997273
D.truncata,167897087,VNJQ01007324.1,1,1213,7.22466e-06,167440448,0.99728
D.truncata,167897087,VNJQ01004900.1,1,1213,7.22466e-06,167441661,0.997287
D.truncata,167897087,VNJQ01004306.1,1,1213,7.22466e-06,167442874,0.997295
D.truncata,167897087,VNJQ01007540.1,1,1212,7.21871e-06,167444086,0.997302
D.truncata,167897087,VNJQ01002194.1,1,1212,7.21871e-06,167445298,0.997309
D.truncata,167897087,VNJQ01007841.1,1,1211,7.21275e-06,167446509,0.997316
D.truncata,167897087,VNJQ01002082.1,1,1211,7.21275e-06,167447720,0.997324
D.truncata,167897087,VNJQ01005952.1,1,1210,7.2068e-06,167448930,0.997331
D.truncata,167897087,VNJQ01005151.1,1,1209,7.20084e-06,167450139,0.997338
D.truncata,167897087,VNJQ01003330.1,1,1209,7.20084e-06,167451348,0.997345
D.truncata,167897087,VNJQ01002758.1,1,1209,7.20084e-06,167452557,0.997352
D.truncata,167897087,VNJQ01003392.1,1,1208,7.19488e-06,167453765,0.99736
D.truncata,167897087,VNJQ01001667.1,1,1208,7.19488e-06,167454973,0.997367
D.truncata,167897087,VNJQ01001445.1,1,1208,7.19488e-06,167456181,0.997374
D.truncata,167897087,VNJQ01000180.1,1,1208,7.19488e-06,167457389,0.997381
D.truncata,167897087,VNJQ01006068.1,1,1207,7.18893e-06,167458596,0.997388
D.truncata,167897087,VNJQ01001298.1,1,1207,7.18893e-06,167459803,0.997396
D.truncata,167897087,VNJQ01007783.1,1,1206,7.18297e-06,167461009,0.997403
D.truncata,167897087,VNJQ01000563.1,1,1206,7.18297e-06,167462215,0.99741
D.truncata,167897087,VNJQ01004178.1,1,1205,7.17702e-06,167463420,0.997417
D.truncata,167897087,VNJQ01002080.1,1,1205,7.17702e-06,167464625,0.997424
D.truncata,167897087,VNJQ01001569.1,1,1204,7.17106e-06,167465829,0.997431
D.truncata,167897087,VNJQ01000235.1,1,1204,7.17106e-06,167467033,0.997439
D.truncata,167897087,VNJQ01000710.1,1,1203,7.1651e-06,167468236,0.997446
D.truncata,167897087,VNJQ01000664.1,1,1203,7.1651e-06,167469439,0.997453
D.truncata,167897087,VNJQ01005156.1,1,1202,7.15915e-06,167470641,0.99746
D.truncata,167897087,VNJQ01003966.1,1,1202,7.15915e-06,167471843,0.997467
D.truncata,167897087,VNJQ01003821.1,1,1200,7.14724e-06,167473043,0.997474
D.truncata,167897087,VNJQ01004058.1,1,1199,7.14128e-06,167474242,0.997482
D.truncata,167897087,VNJQ01007100.1,1,1198,7.13532e-06,167475440,0.997489
D.truncata,167897087,VNJQ01006872.1,1,1198,7.13532e-06,167476638,0.997496
D.truncata,167897087,VNJQ01006133.1,1,1197,7.12937e-06,167477835,0.997503
D.truncata,167897087,VNJQ01002242.1,1,1197,7.12937e-06,167479032,0.99751
D.truncata,167897087,VNJQ01006087.1,1,1196,7.12341e-06,167480228,0.997517
D.truncata,167897087,VNJQ01006814.1,1,1195,7.11746e-06,167481423,0.997524
D.truncata,167897087,VNJQ01006266.1,1,1194,7.1115e-06,167482617,0.997531
D.truncata,167897087,VNJQ01001658.1,1,1194,7.1115e-06,167483811,0.997539
D.truncata,167897087,VNJQ01002858.1,1,1193,7.10554e-06,167485004,0.997546
D.truncata,167897087,VNJQ01001760.1,1,1193,7.10554e-06,167486197,0.997553
D.truncata,167897087,VNJQ01000825.1,1,1193,7.10554e-06,167487390,0.99756
D.truncata,167897087,VNJQ01000807.1,1,1193,7.10554e-06,167488583,0.997567
D.truncata,167897087,VNJQ01005924.1,1,1192,7.09959e-06,167489775,0.997574
D.truncata,167897087,VNJQ01002645.1,1,1191,7.09363e-06,167490966,0.997581
D.truncata,167897087,VNJQ01006066.1,1,1190,7.08768e-06,167492156,0.997588
D.truncata,167897087,VNJQ01003090.1,1,1190,7.08768e-06,167493346,0.997595
D.truncata,167897087,VNJQ01001758.1,1,1190,7.08768e-06,167494536,0.997602
D.truncata,167897087,VNJQ01007898.1,1,1189,7.08172e-06,167495725,0.997609
D.truncata,167897087,VNJQ01005134.1,1,1189,7.08172e-06,167496914,0.997617
D.truncata,167897087,VNJQ01000247.1,1,1189,7.08172e-06,167498103,0.997624
D.truncata,167897087,VNJQ01006420.1,1,1187,7.06981e-06,167499290,0.997631
D.truncata,167897087,VNJQ01002056.1,1,1187,7.06981e-06,167500477,0.997638
D.truncata,167897087,VNJQ01000679.1,1,1186,7.06385e-06,167501663,0.997645
D.truncata,167897087,VNJQ01004089.1,1,1185,7.05789e-06,167502848,0.997652
D.truncata,167897087,VNJQ01001764.1,1,1185,7.05789e-06,167504033,0.997659
D.truncata,167897087,VNJQ01001759.1,1,1185,7.05789e-06,167505218,0.997666
D.truncata,167897087,VNJQ01002114.1,1,1184,7.05194e-06,167506402,0.997673
D.truncata,167897087,VNJQ01000113.1,1,1184,7.05194e-06,167507586,0.99768
D.truncata,167897087,VNJQ01004406.1,1,1182,7.04003e-06,167508768,0.997687
D.truncata,167897087,VNJQ01003694.1,1,1182,7.04003e-06,167509950,0.997694
D.truncata,167897087,VNJQ01005114.1,1,1181,7.03407e-06,167511131,0.997701
D.truncata,167897087,VNJQ01008036.1,1,1180,7.02811e-06,167512311,0.997708
D.truncata,167897087,VNJQ01002537.1,1,1180,7.02811e-06,167513491,0.997715
D.truncata,167897087,VNJQ01000624.1,1,1180,7.02811e-06,167514671,0.997722
D.truncata,167897087,VNJQ01001660.1,1,1179,7.02216e-06,167515850,0.997729
D.truncata,167897087,VNJQ01003736.1,1,1178,7.0162e-06,167517028,0.997736
D.truncata,167897087,VNJQ01001762.1,1,1178,7.0162e-06,167518206,0.997743
D.truncata,167897087,VNJQ01005945.1,1,1177,7.01025e-06,167519383,0.99775
D.truncata,167897087,VNJQ01004929.1,1,1177,7.01025e-06,167520560,0.997757
D.truncata,167897087,VNJQ01004697.1,1,1177,7.01025e-06,167521737,0.997764
D.truncata,167897087,VNJQ01003731.1,1,1177,7.01025e-06,167522914,0.997771
D.truncata,167897087,VNJQ01003141.1,1,1177,7.01025e-06,167524091,0.997778
D.truncata,167897087,VNJQ01000870.1,1,1177,7.01025e-06,167525268,0.997785
D.truncata,167897087,VNJQ01000714.1,1,1177,7.01025e-06,167526445,0.997792
D.truncata,167897087,VNJQ01003268.1,1,1176,7.00429e-06,167527621,0.997799
D.truncata,167897087,VNJQ01002550.1,1,1176,7.00429e-06,167528797,0.997806
D.truncata,167897087,VNJQ01002824.1,1,1175,6.99833e-06,167529972,0.997813
D.truncata,167897087,VNJQ01007440.1,1,1174,6.99238e-06,167531146,0.99782
D.truncata,167897087,VNJQ01005472.1,1,1173,6.98642e-06,167532319,0.997827
D.truncata,167897087,VNJQ01004476.1,1,1173,6.98642e-06,167533492,0.997834
D.truncata,167897087,VNJQ01002960.1,1,1171,6.97451e-06,167534663,0.997841
D.truncata,167897087,VNJQ01006264.1,1,1170,6.96855e-06,167535833,0.997848
D.truncata,167897087,VNJQ01001566.1,1,1168,6.95664e-06,167537001,0.997855
D.truncata,167897087,VNJQ01004889.1,1,1167,6.95069e-06,167538168,0.997862
D.truncata,167897087,VNJQ01004550.1,1,1167,6.95069e-06,167539335,0.997869
D.truncata,167897087,VNJQ01005040.1,1,1166,6.94473e-06,167540501,0.997876
D.truncata,167897087,VNJQ01003692.1,1,1166,6.94473e-06,167541667,0.997883
D.truncata,167897087,VNJQ01007809.1,1,1165,6.93877e-06,167542832,0.99789
D.truncata,167897087,VNJQ01004568.1,1,1165,6.93877e-06,167543997,0.997897
D.truncata,167897087,VNJQ01006168.1,1,1164,6.93282e-06,167545161,0.997904
D.truncata,167897087,VNJQ01005953.1,1,1163,6.92686e-06,167546324,0.997911
D.truncata,167897087,VNJQ01005364.1,1,1163,6.92686e-06,167547487,0.997918
D.truncata,167897087,VNJQ01002176.1,1,1163,6.92686e-06,167548650,0.997925
D.truncata,167897087,VNJQ01004789.1,1,1161,6.91495e-06,167549811,0.997932
D.truncata,167897087,VNJQ01001212.1,1,1161,6.91495e-06,167550972,0.997939
D.truncata,167897087,VNJQ01006226.1,1,1160,6.90899e-06,167552132,0.997945
D.truncata,167897087,VNJQ01004557.1,1,1160,6.90899e-06,167553292,0.997952
D.truncata,167897087,VNJQ01003416.1,1,1160,6.90899e-06,167554452,0.997959
D.truncata,167897087,VNJQ01002686.1,1,1160,6.90899e-06,167555612,0.997966
D.truncata,167897087,VNJQ01002650.1,1,1159,6.90304e-06,167556771,0.997973
D.truncata,167897087,VNJQ01005978.1,1,1158,6.89708e-06,167557929,0.99798
D.truncata,167897087,VNJQ01004470.1,1,1158,6.89708e-06,167559087,0.997987
D.truncata,167897087,VNJQ01000048.1,1,1158,6.89708e-06,167560245,0.997994
D.truncata,167897087,VNJQ01005238.1,1,1157,6.89113e-06,167561402,0.998001
D.truncata,167897087,VNJQ01002128.1,1,1157,6.89113e-06,167562559,0.998008
D.truncata,167897087,VNJQ01000261.1,1,1157,6.89113e-06,167563716,0.998014
D.truncata,167897087,VNJQ01007603.1,1,1156,6.88517e-06,167564872,0.998021
D.truncata,167897087,VNJQ01006514.1,1,1156,6.88517e-06,167566028,0.998028
D.truncata,167897087,VNJQ01005044.1,1,1155,6.87921e-06,167567183,0.998035
D.truncata,167897087,VNJQ01004832.1,1,1155,6.87921e-06,167568338,0.998042
D.truncata,167897087,VNJQ01003539.1,1,1155,6.87921e-06,167569493,0.998049
D.truncata,167897087,VNJQ01002403.1,1,1154,6.87326e-06,167570647,0.998056
D.truncata,167897087,VNJQ01006186.1,1,1152,6.86135e-06,167571799,0.998063
D.truncata,167897087,VNJQ01004546.1,1,1150,6.84943e-06,167572949,0.998069
D.truncata,167897087,VNJQ01005328.1,1,1148,6.83752e-06,167574097,0.998076
D.truncata,167897087,VNJQ01003070.1,1,1148,6.83752e-06,167575245,0.998083
D.truncata,167897087,VNJQ01006167.1,1,1147,6.83157e-06,167576392,0.99809
D.truncata,167897087,VNJQ01005514.1,1,1147,6.83157e-06,167577539,0.998097
D.truncata,167897087,VNJQ01004964.1,1,1147,6.83157e-06,167578686,0.998104
D.truncata,167897087,VNJQ01003547.1,1,1147,6.83157e-06,167579833,0.99811
D.truncata,167897087,VNJQ01002405.1,1,1147,6.83157e-06,167580980,0.998117
D.truncata,167897087,VNJQ01006767.1,1,1146,6.82561e-06,167582126,0.998124
D.truncata,167897087,VNJQ01002281.1,1,1146,6.82561e-06,167583272,0.998131
D.truncata,167897087,VNJQ01000578.1,1,1146,6.82561e-06,167584418,0.998138
D.truncata,167897087,VNJQ01004095.1,1,1145,6.81965e-06,167585563,0.998145
D.truncata,167897087,VNJQ01005947.1,1,1144,6.8137e-06,167586707,0.998151
D.truncata,167897087,VNJQ01003649.1,1,1144,6.8137e-06,167587851,0.998158
D.truncata,167897087,VNJQ01004151.1,1,1143,6.80774e-06,167588994,0.998165
D.truncata,167897087,VNJQ01002306.1,1,1143,6.80774e-06,167590137,0.998172
D.truncata,167897087,VNJQ01000663.1,1,1143,6.80774e-06,167591280,0.998179
D.truncata,167897087,VNJQ01000381.1,1,1140,6.78987e-06,167592420,0.998185
D.truncata,167897087,VNJQ01002524.1,1,1139,6.78392e-06,167593559,0.998192
D.truncata,167897087,VNJQ01002171.1,1,1139,6.78392e-06,167594698,0.998199
D.truncata,167897087,VNJQ01001651.1,1,1139,6.78392e-06,167595837,0.998206
D.truncata,167897087,VNJQ01007722.1,1,1138,6.77796e-06,167596975,0.998213
D.truncata,167897087,VNJQ01006409.1,1,1137,6.77201e-06,167598112,0.998219
D.truncata,167897087,VNJQ01004967.1,1,1137,6.77201e-06,167599249,0.998226
D.truncata,167897087,VNJQ01004465.1,1,1137,6.77201e-06,167600386,0.998233
D.truncata,167897087,VNJQ01003284.1,1,1137,6.77201e-06,167601523,0.99824
D.truncata,167897087,VNJQ01001631.1,1,1137,6.77201e-06,167602660,0.998246
D.truncata,167897087,VNJQ01004117.1,1,1136,6.76605e-06,167603796,0.998253
D.truncata,167897087,VNJQ01002219.1,1,1135,6.76009e-06,167604931,0.99826
D.truncata,167897087,VNJQ01000805.1,1,1135,6.76009e-06,167606066,0.998267
D.truncata,167897087,VNJQ01005473.1,1,1134,6.75414e-06,167607200,0.998273
D.truncata,167897087,VNJQ01003632.1,1,1134,6.75414e-06,167608334,0.99828
D.truncata,167897087,VNJQ01003531.1,1,1134,6.75414e-06,167609468,0.998287
D.truncata,167897087,VNJQ01002538.1,1,1134,6.75414e-06,167610602,0.998294
D.truncata,167897087,VNJQ01000265.1,1,1134,6.75414e-06,167611736,0.9983
D.truncata,167897087,VNJQ01005131.1,1,1132,6.74223e-06,167612868,0.998307
D.truncata,167897087,VNJQ01004241.1,1,1132,6.74223e-06,167614000,0.998314
D.truncata,167897087,VNJQ01003443.1,1,1132,6.74223e-06,167615132,0.998321
D.truncata,167897087,VNJQ01000925.1,1,1132,6.74223e-06,167616264,0.998327
D.truncata,167897087,VNJQ01006235.1,1,1131,6.73627e-06,167617395,0.998334
D.truncata,167897087,VNJQ01006760.1,1,1130,6.73031e-06,167618525,0.998341
D.truncata,167897087,VNJQ01002961.1,1,1130,6.73031e-06,167619655,0.998348
D.truncata,167897087,VNJQ01008209.1,1,1129,6.72436e-06,167620784,0.998354
D.truncata,167897087,VNJQ01007623.1,1,1129,6.72436e-06,167621913,0.998361
D.truncata,167897087,VNJQ01006675.1,1,1129,6.72436e-06,167623042,0.998368
D.truncata,167897087,VNJQ01000502.1,1,1129,6.72436e-06,167624171,0.998375
D.truncata,167897087,VNJQ01000215.1,1,1128,6.7184e-06,167625299,0.998381
D.truncata,167897087,VNJQ01007725.1,1,1127,6.71245e-06,167626426,0.998388
D.truncata,167897087,VNJQ01001331.1,1,1127,6.71245e-06,167627553,0.998395
D.truncata,167897087,VNJQ01004987.1,1,1124,6.69458e-06,167628677,0.998401
D.truncata,167897087,VNJQ01005333.1,1,1123,6.68862e-06,167629800,0.998408
D.truncata,167897087,VNJQ01002248.1,1,1123,6.68862e-06,167630923,0.998415
D.truncata,167897087,VNJQ01001846.1,1,1123,6.68862e-06,167632046,0.998421
D.truncata,167897087,VNJQ01001768.1,1,1123,6.68862e-06,167633169,0.998428
D.truncata,167897087,VNJQ01006021.1,1,1122,6.68267e-06,167634291,0.998435
D.truncata,167897087,VNJQ01005857.1,1,1122,6.68267e-06,167635413,0.998441
D.truncata,167897087,VNJQ01004454.1,1,1122,6.68267e-06,167636535,0.998448
D.truncata,167897087,VNJQ01005392.1,1,1121,6.67671e-06,167637656,0.998455
D.truncata,167897087,VNJQ01007607.1,1,1120,6.67075e-06,167638776,0.998461
D.truncata,167897087,VNJQ01003827.1,1,1119,6.6648e-06,167639895,0.998468
D.truncata,167897087,VNJQ01006456.1,1,1118,6.65884e-06,167641013,0.998475
D.truncata,167897087,VNJQ01006412.1,1,1118,6.65884e-06,167642131,0.998481
D.truncata,167897087,VNJQ01005575.1,1,1118,6.65884e-06,167643249,0.998488
D.truncata,167897087,VNJQ01003796.1,1,1117,6.65288e-06,167644366,0.998495
D.truncata,167897087,VNJQ01002215.1,1,1117,6.65288e-06,167645483,0.998501
D.truncata,167897087,VNJQ01001364.1,1,1117,6.65288e-06,167646600,0.998508
D.truncata,167897087,VNJQ01008114.1,1,1115,6.64097e-06,167647715,0.998515
D.truncata,167897087,VNJQ01002213.1,1,1115,6.64097e-06,167648830,0.998521
D.truncata,167897087,VNJQ01008111.1,1,1114,6.63502e-06,167649944,0.998528
D.truncata,167897087,VNJQ01006552.1,1,1114,6.63502e-06,167651058,0.998535
D.truncata,167897087,VNJQ01003918.1,1,1114,6.63502e-06,167652172,0.998541
D.truncata,167897087,VNJQ01005948.1,1,1113,6.62906e-06,167653285,0.998548
D.truncata,167897087,VNJQ01006020.1,1,1112,6.6231e-06,167654397,0.998555
D.truncata,167897087,VNJQ01005290.1,1,1112,6.6231e-06,167655509,0.998561
D.truncata,167897087,VNJQ01002272.1,1,1112,6.6231e-06,167656621,0.998568
D.truncata,167897087,VNJQ01006586.1,1,1111,6.61715e-06,167657732,0.998574
D.truncata,167897087,VNJQ01003776.1,1,1111,6.61715e-06,167658843,0.998581
D.truncata,167897087,VNJQ01003917.1,1,1110,6.61119e-06,167659953,0.998588
D.truncata,167897087,VNJQ01001998.1,1,1110,6.61119e-06,167661063,0.998594
D.truncata,167897087,VNJQ01001927.1,1,1110,6.61119e-06,167662173,0.998601
D.truncata,167897087,VNJQ01000498.1,1,1110,6.61119e-06,167663283,0.998607
D.truncata,167897087,VNJQ01005426.1,1,1108,6.59928e-06,167664391,0.998614
D.truncata,167897087,VNJQ01003409.1,1,1108,6.59928e-06,167665499,0.998621
D.truncata,167897087,VNJQ01003287.1,1,1108,6.59928e-06,167666607,0.998627
D.truncata,167897087,VNJQ01005938.1,1,1107,6.59332e-06,167667714,0.998634
D.truncata,167897087,VNJQ01004809.1,1,1107,6.59332e-06,167668821,0.99864
D.truncata,167897087,VNJQ01004547.1,1,1107,6.59332e-06,167669928,0.998647
D.truncata,167897087,VNJQ01003457.1,1,1107,6.59332e-06,167671035,0.998654
D.truncata,167897087,VNJQ01002089.1,1,1107,6.59332e-06,167672142,0.99866
D.truncata,167897087,VNJQ01001004.1,1,1107,6.59332e-06,167673249,0.998667
D.truncata,167897087,VNJQ01006857.1,1,1106,6.58737e-06,167674355,0.998673
D.truncata,167897087,VNJQ01006023.1,1,1106,6.58737e-06,167675461,0.99868
D.truncata,167897087,VNJQ01000709.1,1,1106,6.58737e-06,167676567,0.998687
D.truncata,167897087,VNJQ01002437.1,1,1105,6.58141e-06,167677672,0.998693
D.truncata,167897087,VNJQ01008004.1,1,1104,6.57546e-06,167678776,0.9987
D.truncata,167897087,VNJQ01006493.1,1,1104,6.57546e-06,167679880,0.998706
D.truncata,167897087,VNJQ01005046.1,1,1104,6.57546e-06,167680984,0.998713
D.truncata,167897087,VNJQ01003254.1,1,1102,6.56354e-06,167682086,0.998719
D.truncata,167897087,VNJQ01003630.1,1,1101,6.55759e-06,167683187,0.998726
D.truncata,167897087,VNJQ01008085.1,1,1100,6.55163e-06,167684287,0.998733
D.truncata,167897087,VNJQ01006022.1,1,1100,6.55163e-06,167685387,0.998739
D.truncata,167897087,VNJQ01005048.1,1,1100,6.55163e-06,167686487,0.998746
D.truncata,167897087,VNJQ01005027.1,1,1100,6.55163e-06,167687587,0.998752
D.truncata,167897087,VNJQ01007076.1,1,1099,6.54568e-06,167688686,0.998759
D.truncata,167897087,VNJQ01002291.1,1,1099,6.54568e-06,167689785,0.998765
D.truncata,167897087,VNJQ01001952.1,1,1096,6.52781e-06,167690881,0.998772
D.truncata,167897087,VNJQ01001347.1,1,1096,6.52781e-06,167691977,0.998778
D.truncata,167897087,VNJQ01006766.1,1,1095,6.52185e-06,167693072,0.998785
D.truncata,167897087,VNJQ01006822.1,1,1094,6.5159e-06,167694166,0.998791
D.truncata,167897087,VNJQ01005493.1,1,1094,6.5159e-06,167695260,0.998798
D.truncata,167897087,VNJQ01007513.1,1,1093,6.50994e-06,167696353,0.998804
D.truncata,167897087,VNJQ01003215.1,1,1093,6.50994e-06,167697446,0.998811
D.truncata,167897087,VNJQ01002962.1,1,1093,6.50994e-06,167698539,0.998817
D.truncata,167897087,VNJQ01005905.1,1,1092,6.50398e-06,167699631,0.998824
D.truncata,167897087,VNJQ01005578.1,1,1090,6.49207e-06,167700721,0.99883
D.truncata,167897087,VNJQ01004334.1,1,1090,6.49207e-06,167701811,0.998837
D.truncata,167897087,VNJQ01003910.1,1,1090,6.49207e-06,167702901,0.998843
D.truncata,167897087,VNJQ01003806.1,1,1090,6.49207e-06,167703991,0.99885
D.truncata,167897087,VNJQ01002768.1,1,1090,6.49207e-06,167705081,0.998856
D.truncata,167897087,VNJQ01004897.1,1,1088,6.48016e-06,167706169,0.998863
D.truncata,167897087,VNJQ01004810.1,1,1087,6.4742e-06,167707256,0.998869
D.truncata,167897087,VNJQ01003004.1,1,1086,6.46825e-06,167708342,0.998876
D.truncata,167897087,VNJQ01000117.1,1,1083,6.45038e-06,167709425,0.998882
D.truncata,167897087,VNJQ01006016.1,1,1082,6.44442e-06,167710507,0.998889
D.truncata,167897087,VNJQ01004612.1,1,1082,6.44442e-06,167711589,0.998895
D.truncata,167897087,VNJQ01002610.1,1,1082,6.44442e-06,167712671,0.998902
D.truncata,167897087,VNJQ01000473.1,1,1082,6.44442e-06,167713753,0.998908
D.truncata,167897087,VNJQ01007337.1,1,1081,6.43847e-06,167714834,0.998914
D.truncata,167897087,VNJQ01000291.1,1,1081,6.43847e-06,167715915,0.998921
D.truncata,167897087,VNJQ01006827.1,1,1080,6.43251e-06,167716995,0.998927
D.truncata,167897087,VNJQ01007357.1,1,1079,6.42656e-06,167718074,0.998934
D.truncata,167897087,VNJQ01004975.1,1,1079,6.42656e-06,167719153,0.99894
D.truncata,167897087,VNJQ01001039.1,1,1079,6.42656e-06,167720232,0.998947
D.truncata,167897087,VNJQ01000820.1,1,1079,6.42656e-06,167721311,0.998953
D.truncata,167897087,VNJQ01007292.1,1,1078,6.4206e-06,167722389,0.998959
D.truncata,167897087,VNJQ01006285.1,1,1078,6.4206e-06,167723467,0.998966
D.truncata,167897087,VNJQ01006018.1,1,1078,6.4206e-06,167724545,0.998972
D.truncata,167897087,VNJQ01002244.1,1,1078,6.4206e-06,167725623,0.998979
D.truncata,167897087,VNJQ01004213.1,1,1076,6.40869e-06,167726699,0.998985
D.truncata,167897087,VNJQ01002328.1,1,1076,6.40869e-06,167727775,0.998992
D.truncata,167897087,VNJQ01005896.1,1,1075,6.40273e-06,167728850,0.998998
D.truncata,167897087,VNJQ01006026.1,1,1074,6.39678e-06,167729924,0.999004
D.truncata,167897087,VNJQ01007163.1,1,1073,6.39082e-06,167730997,0.999011
D.truncata,167897087,VNJQ01006025.1,1,1073,6.39082e-06,167732070,0.999017
D.truncata,167897087,VNJQ01005835.1,1,1073,6.39082e-06,167733143,0.999024
D.truncata,167897087,VNJQ01000073.1,1,1073,6.39082e-06,167734216,0.99903
D.truncata,167897087,VNJQ01007128.1,1,1072,6.38486e-06,167735288,0.999036
D.truncata,167897087,VNJQ01002054.1,1,1072,6.38486e-06,167736360,0.999043
D.truncata,167897087,VNJQ01001290.1,1,1072,6.38486e-06,167737432,0.999049
D.truncata,167897087,VNJQ01001219.1,1,1072,6.38486e-06,167738504,0.999055
D.truncata,167897087,VNJQ01000429.1,1,1072,6.38486e-06,167739576,0.999062
D.truncata,167897087,VNJQ01000277.1,1,1072,6.38486e-06,167740648,0.999068
D.truncata,167897087,VNJQ01004776.1,1,1071,6.37891e-06,167741719,0.999075
D.truncata,167897087,VNJQ01002830.1,1,1071,6.37891e-06,167742790,0.999081
D.truncata,167897087,VNJQ01006761.1,1,1070,6.37295e-06,167743860,0.999087
D.truncata,167897087,VNJQ01003192.1,1,1069,6.367e-06,167744929,0.999094
D.truncata,167897087,VNJQ01000994.1,1,1069,6.367e-06,167745998,0.9991
D.truncata,167897087,VNJQ01006958.1,1,1067,6.35508e-06,167747065,0.999106
D.truncata,167897087,VNJQ01007637.1,1,1066,6.34913e-06,167748131,0.999113
D.truncata,167897087,VNJQ01007321.1,1,1066,6.34913e-06,167749197,0.999119
D.truncata,167897087,VNJQ01002216.1,1,1066,6.34913e-06,167750263,0.999126
D.truncata,167897087,VNJQ01007605.1,1,1065,6.34317e-06,167751328,0.999132
D.truncata,167897087,VNJQ01001517.1,1,1065,6.34317e-06,167752393,0.999138
D.truncata,167897087,VNJQ01005186.1,1,1064,6.33722e-06,167753457,0.999145
D.truncata,167897087,VNJQ01003278.1,1,1064,6.33722e-06,167754521,0.999151
D.truncata,167897087,VNJQ01000217.1,1,1064,6.33722e-06,167755585,0.999157
D.truncata,167897087,VNJQ01008165.1,1,1063,6.33126e-06,167756648,0.999164
D.truncata,167897087,VNJQ01005988.1,1,1062,6.3253e-06,167757710,0.99917
D.truncata,167897087,VNJQ01007290.1,1,1061,6.31935e-06,167758771,0.999176
D.truncata,167897087,VNJQ01004282.1,1,1061,6.31935e-06,167759832,0.999183
D.truncata,167897087,VNJQ01003634.1,1,1061,6.31935e-06,167760893,0.999189
D.truncata,167897087,VNJQ01001447.1,1,1061,6.31935e-06,167761954,0.999195
D.truncata,167897087,VNJQ01000030.1,1,1061,6.31935e-06,167763015,0.999201
D.truncata,167897087,VNJQ01007362.1,1,1060,6.31339e-06,167764075,0.999208
D.truncata,167897087,VNJQ01005362.1,1,1060,6.31339e-06,167765135,0.999214
D.truncata,167897087,VNJQ01004659.1,1,1059,6.30744e-06,167766194,0.99922
D.truncata,167897087,VNJQ01003726.1,1,1059,6.30744e-06,167767253,0.999227
D.truncata,167897087,VNJQ01003463.1,1,1059,6.30744e-06,167768312,0.999233
D.truncata,167897087,VNJQ01001448.1,1,1059,6.30744e-06,167769371,0.999239
D.truncata,167897087,VNJQ01006227.1,1,1058,6.30148e-06,167770429,0.999246
D.truncata,167897087,VNJQ01005555.1,1,1058,6.30148e-06,167771487,0.999252
D.truncata,167897087,VNJQ01005185.1,1,1058,6.30148e-06,167772545,0.999258
D.truncata,167897087,VNJQ01001806.1,1,1058,6.30148e-06,167773603,0.999265
D.truncata,167897087,VNJQ01004671.1,1,1057,6.29552e-06,167774660,0.999271
D.truncata,167897087,VNJQ01001990.1,1,1056,6.28957e-06,167775716,0.999277
D.truncata,167897087,VNJQ01001449.1,1,1056,6.28957e-06,167776772,0.999283
D.truncata,167897087,VNJQ01004701.1,1,1055,6.28361e-06,167777827,0.99929
D.truncata,167897087,VNJQ01003383.1,1,1055,6.28361e-06,167778882,0.999296
D.truncata,167897087,VNJQ01006200.1,1,1054,6.27766e-06,167779936,0.999302
D.truncata,167897087,VNJQ01005400.1,1,1054,6.27766e-06,167780990,0.999309
D.truncata,167897087,VNJQ01002582.1,1,1054,6.27766e-06,167782044,0.999315
D.truncata,167897087,VNJQ01000275.1,1,1054,6.27766e-06,167783098,0.999321
D.truncata,167897087,VNJQ01007013.1,1,1052,6.26574e-06,167784150,0.999327
D.truncata,167897087,VNJQ01007580.1,1,1051,6.25979e-06,167785201,0.999334
D.truncata,167897087,VNJQ01008113.1,1,1050,6.25383e-06,167786251,0.99934
D.truncata,167897087,VNJQ01004258.1,1,1050,6.25383e-06,167787301,0.999346
D.truncata,167897087,VNJQ01006479.1,1,1049,6.24787e-06,167788350,0.999352
D.truncata,167897087,VNJQ01002753.1,1,1049,6.24787e-06,167789399,0.999359
D.truncata,167897087,VNJQ01000496.1,1,1049,6.24787e-06,167790448,0.999365
D.truncata,167897087,VNJQ01007825.1,1,1048,6.24192e-06,167791496,0.999371
D.truncata,167897087,VNJQ01007631.1,1,1048,6.24192e-06,167792544,0.999377
D.truncata,167897087,VNJQ01007287.1,1,1048,6.24192e-06,167793592,0.999384
D.truncata,167897087,VNJQ01004728.1,1,1048,6.24192e-06,167794640,0.99939
D.truncata,167897087,VNJQ01003724.1,1,1048,6.24192e-06,167795688,0.999396
D.truncata,167897087,VNJQ01002530.1,1,1048,6.24192e-06,167796736,0.999402
D.truncata,167897087,VNJQ01001450.1,1,1048,6.24192e-06,167797784,0.999409
D.truncata,167897087,VNJQ01002837.1,1,1047,6.23596e-06,167798831,0.999415
D.truncata,167897087,VNJQ01007823.1,1,1046,6.23001e-06,167799877,0.999421
D.truncata,167897087,VNJQ01003152.1,1,1046,6.23001e-06,167800923,0.999427
D.truncata,167897087,VNJQ01006307.1,1,1045,6.22405e-06,167801968,0.999433
D.truncata,167897087,VNJQ01001572.1,1,1045,6.22405e-06,167803013,0.99944
D.truncata,167897087,VNJQ01008034.1,1,1044,6.21809e-06,167804057,0.999446
D.truncata,167897087,VNJQ01006854.1,1,1044,6.21809e-06,167805101,0.999452
D.truncata,167897087,VNJQ01007852.1,1,1043,6.21214e-06,167806144,0.999458
D.truncata,167897087,VNJQ01005361.1,1,1043,6.21214e-06,167807187,0.999465
D.truncata,167897087,VNJQ01000713.1,1,1043,6.21214e-06,167808230,0.999471
D.truncata,167897087,VNJQ01007261.1,1,1041,6.20023e-06,167809271,0.999477
D.truncata,167897087,VNJQ01001662.1,1,1040,6.19427e-06,167810311,0.999483
D.truncata,167897087,VNJQ01000116.1,1,1040,6.19427e-06,167811351,0.999489
D.truncata,167897087,VNJQ01007965.1,1,1039,6.18831e-06,167812390,0.999496
D.truncata,167897087,VNJQ01004284.1,1,1039,6.18831e-06,167813429,0.999502
D.truncata,167897087,VNJQ01002438.1,1,1039,6.18831e-06,167814468,0.999508
D.truncata,167897087,VNJQ01001443.1,1,1039,6.18831e-06,167815507,0.999514
D.truncata,167897087,VNJQ01007994.1,1,1038,6.18236e-06,167816545,0.99952
D.truncata,167897087,VNJQ01005317.1,1,1038,6.18236e-06,167817583,0.999526
D.truncata,167897087,VNJQ01005228.1,1,1038,6.18236e-06,167818621,0.999533
D.truncata,167897087,VNJQ01003367.1,1,1038,6.18236e-06,167819659,0.999539
D.truncata,167897087,VNJQ01000658.1,1,1038,6.18236e-06,167820697,0.999545
D.truncata,167897087,VNJQ01007668.1,1,1037,6.1764e-06,167821734,0.999551
D.truncata,167897087,VNJQ01008215.1,1,1036,6.17045e-06,167822770,0.999557
D.truncata,167897087,VNJQ01007222.1,1,1036,6.17045e-06,167823806,0.999564
D.truncata,167897087,VNJQ01005319.1,1,1036,6.17045e-06,167824842,0.99957
D.truncata,167897087,VNJQ01005078.1,1,1036,6.17045e-06,167825878,0.999576
D.truncata,167897087,VNJQ01002377.1,1,1036,6.17045e-06,167826914,0.999582
D.truncata,167897087,VNJQ01001671.1,1,1035,6.16449e-06,167827949,0.999588
D.truncata,167897087,VNJQ01001099.1,1,1035,6.16449e-06,167828984,0.999594
D.truncata,167897087,VNJQ01007256.1,1,1034,6.15853e-06,167830018,0.999601
D.truncata,167897087,VNJQ01005423.1,1,1034,6.15853e-06,167831052,0.999607
D.truncata,167897087,VNJQ01001444.1,1,1034,6.15853e-06,167832086,0.999613
D.truncata,167897087,VNJQ01007326.1,1,1032,6.14662e-06,167833118,0.999619
D.truncata,167897087,VNJQ01003783.1,1,1032,6.14662e-06,167834150,0.999625
D.truncata,167897087,VNJQ01007929.1,1,1031,6.14067e-06,167835181,0.999631
D.truncata,167897087,VNJQ01007023.1,1,1031,6.14067e-06,167836212,0.999637
D.truncata,167897087,VNJQ01006193.1,1,1031,6.14067e-06,167837243,0.999644
D.truncata,167897087,VNJQ01006639.1,1,1030,6.13471e-06,167838273,0.99965
D.truncata,167897087,VNJQ01004128.1,1,1030,6.13471e-06,167839303,0.999656
D.truncata,167897087,VNJQ01003593.1,1,1029,6.12875e-06,167840332,0.999662
D.truncata,167897087,VNJQ01002721.1,1,1029,6.12875e-06,167841361,0.999668
D.truncata,167897087,VNJQ01006125.1,1,1028,6.1228e-06,167842389,0.999674
D.truncata,167897087,VNJQ01004988.1,1,1028,6.1228e-06,167843417,0.99968
D.truncata,167897087,VNJQ01000678.1,1,1028,6.1228e-06,167844445,0.999686
D.truncata,167897087,VNJQ01002503.1,1,1027,6.11684e-06,167845472,0.999693
D.truncata,167897087,VNJQ01002841.1,1,1026,6.11089e-06,167846498,0.999699
D.truncata,167897087,VNJQ01008055.1,1,1025,6.10493e-06,167847523,0.999705
D.truncata,167897087,VNJQ01000432.1,1,1025,6.10493e-06,167848548,0.999711
D.truncata,167897087,VNJQ01001388.1,1,1024,6.09897e-06,167849572,0.999717
D.truncata,167897087,VNJQ01007008.1,1,1022,6.08706e-06,167850594,0.999723
D.truncata,167897087,VNJQ01002197.1,1,1022,6.08706e-06,167851616,0.999729
D.truncata,167897087,VNJQ01007086.1,1,1021,6.08111e-06,167852637,0.999735
D.truncata,167897087,VNJQ01001446.1,1,1021,6.08111e-06,167853658,0.999741
D.truncata,167897087,VNJQ01001441.1,1,1021,6.08111e-06,167854679,0.999747
D.truncata,167897087,VNJQ01005428.1,1,1020,6.07515e-06,167855699,0.999753
D.truncata,167897087,VNJQ01004620.1,1,1020,6.07515e-06,167856719,0.99976
D.truncata,167897087,VNJQ01006660.1,1,1019,6.06919e-06,167857738,0.999766
D.truncata,167897087,VNJQ01004637.1,1,1019,6.06919e-06,167858757,0.999772
D.truncata,167897087,VNJQ01007329.1,1,1018,6.06324e-06,167859775,0.999778
D.truncata,167897087,VNJQ01003654.1,1,1016,6.05133e-06,167860791,0.999784
D.truncata,167897087,VNJQ01006050.1,1,1015,6.04537e-06,167861806,0.99979
D.truncata,167897087,VNJQ01002770.1,1,1015,6.04537e-06,167862821,0.999796
D.truncata,167897087,VNJQ01001442.1,1,1015,6.04537e-06,167863836,0.999802
D.truncata,167897087,VNJQ01006913.1,1,1014,6.03941e-06,167864850,0.999808
D.truncata,167897087,VNJQ01006736.1,1,1014,6.03941e-06,167865864,0.999814
D.truncata,167897087,VNJQ01003320.1,1,1014,6.03941e-06,167866878,0.99982
D.truncata,167897087,VNJQ01007854.1,1,1013,6.03346e-06,167867891,0.999826
D.truncata,167897087,VNJQ01007148.1,1,1013,6.03346e-06,167868904,0.999832
D.truncata,167897087,VNJQ01005291.1,1,1013,6.03346e-06,167869917,0.999838
D.truncata,167897087,VNJQ01004166.1,1,1012,6.0275e-06,167870929,0.999844
D.truncata,167897087,VNJQ01002033.1,1,1012,6.0275e-06,167871941,0.99985
D.truncata,167897087,VNJQ01001380.1,1,1011,6.02155e-06,167872952,0.999856
D.truncata,167897087,VNJQ01007789.1,1,1010,6.01559e-06,167873962,0.999862
D.truncata,167897087,VNJQ01006598.1,1,1010,6.01559e-06,167874972,0.999868
D.truncata,167897087,VNJQ01005715.1,1,1010,6.01559e-06,167875982,0.999874
D.truncata,167897087,VNJQ01006326.1,1,1009,6.00963e-06,167876991,0.99988
D.truncata,167897087,VNJQ01000821.1,1,1009,6.00963e-06,167878000,0.999886
D.truncata,167897087,VNJQ01007229.1,1,1008,6.00368e-06,167879008,0.999892
D.truncata,167897087,VNJQ01006481.1,1,1008,6.00368e-06,167880016,0.999898
D.truncata,167897087,VNJQ01006102.1,1,1008,6.00368e-06,167881024,0.999904
D.truncata,167897087,VNJQ01002964.1,1,1008,6.00368e-06,167882032,0.99991
D.truncata,167897087,VNJQ01004008.1,1,1007,5.99772e-06,167883039,0.999916
D.truncata,167897087,VNJQ01003784.1,1,1007,5.99772e-06,167884046,0.999922
D.truncata,167897087,VNJQ01002919.1,1,1007,5.99772e-06,167885053,0.999928
D.truncata,167897087,VNJQ01000657.1,1,1007,5.99772e-06,167886060,0.999934
D.truncata,167897087,VNJQ01004181.1,1,1006,5.99177e-06,167887066,0.99994
D.truncata,167897087,VNJQ01006714.1,1,1005,5.98581e-06,167888071,0.999946
D.truncata,167897087,VNJQ01004985.1,1,1003,5.9739e-06,167889074,0.999952
D.truncata,167897087,VNJQ01004506.1,1,1003,5.9739e-06,167890077,0.999958
D.truncata,167897087,VNJQ01001896.1,1,1003,5.9739e-06,167891080,0.999964
D.truncata,167897087,VNJQ01000203.1,1,1003,5.9739e-06,167892083,0.99997
D.truncata,167897087,VNJQ01007787.1,1,1002,5.96794e-06,167893085,0.999976
D.truncata,167897087,VNJQ01006906.1,1,1001,5.96199e-06,167894086,0.999982
D.truncata,167897087,VNJQ01003108.1,1,1001,5.96199e-06,167895087,0.999988
D.truncata,167897087,VNJQ01004727.1,1,1000,5.95603e-06,167896087,0.999994
D.truncata,167897087,VNJQ01001610.1,1,1000,5.95603e-06,167897087,1
D.bocki,140010837,464848,1,320692,0.00229048,320692,0.00229048
D.bocki,140010837,465052,1,298599,0.00213268,619291,0.00442316
D.bocki,140010837,464873,1,288833,0.00206293,908124,0.0064861
D.bocki,140010837,465029,1,285793,0.00204122,1193917,0.00852732
D.bocki,140010837,464755,1,254791,0.00181979,1448708,0.0103471
D.bocki,140010837,464133,1,249930,0.00178508,1698638,0.0121322
D.bocki,140010837,455933,1,241349,0.00172379,1939987,0.013856
D.bocki,140010837,464878,1,228770,0.00163394,2168757,0.0154899
D.bocki,140010837,464662,1,227082,0.00162189,2395839,0.0171118
D.bocki,140010837,464668,1,220155,0.00157241,2615994,0.0186842
D.bocki,140010837,464841,1,219852,0.00157025,2835846,0.0202545
D.bocki,140010837,464228,1,219801,0.00156989,3055647,0.0218244
D.bocki,140010837,463433,1,215612,0.00153997,3271259,0.0233643
D.bocki,140010837,464656,1,215307,0.00153779,3486566,0.0249021
D.bocki,140010837,459031,1,215179,0.00153687,3701745,0.026439
D.bocki,140010837,464415,1,202835,0.00144871,3904580,0.0278877
D.bocki,140010837,460614,1,202819,0.0014486,4107399,0.0293363
D.bocki,140010837,464007,1,200056,0.00142886,4307455,0.0307652
D.bocki,140010837,464778,1,199654,0.00142599,4507109,0.0321911
D.bocki,140010837,459137,1,196242,0.00140162,4703351,0.0335928
D.bocki,140010837,464294,1,194690,0.00139054,4898041,0.0349833
D.bocki,140010837,464414,1,193797,0.00138416,5091838,0.0363675
D.bocki,140010837,464600,1,193201,0.0013799,5285039,0.0377474
D.bocki,140010837,464386,1,191034,0.00136442,5476073,0.0391118
D.bocki,140010837,462875,1,189117,0.00135073,5665190,0.0404625
D.bocki,140010837,454050,1,185571,0.0013254,5850761,0.0417879
D.bocki,140010837,464678,1,185497,0.00132488,6036258,0.0431128
D.bocki,140010837,456782,1,185255,0.00132315,6221513,0.0444359
D.bocki,140010837,457603,1,183905,0.00131351,6405418,0.0457494
D.bocki,140010837,464561,1,183605,0.00131136,6589023,0.0470608
D.bocki,140010837,464623,1,182894,0.00130628,6771917,0.0483671
D.bocki,140010837,464081,1,182423,0.00130292,6954340,0.04967
D.bocki,140010837,464763,1,181762,0.0012982,7136102,0.0509682
D.bocki,140010837,464084,1,181689,0.00129768,7317791,0.0522659
D.bocki,140010837,331726,1,180846,0.00129166,7498637,0.0535575
D.bocki,140010837,289788,1,179997,0.00128559,7678634,0.0548431
D.bocki,140010837,464634,1,178401,0.00127419,7857035,0.0561173
D.bocki,140010837,459094,1,177628,0.00126867,8034663,0.057386
D.bocki,140010837,457305,1,177137,0.00126517,8211800,0.0586512
D.bocki,140010837,464411,1,173931,0.00124227,8385731,0.0598934
D.bocki,140010837,464161,1,170679,0.00121904,8556410,0.0611125
D.bocki,140010837,463090,1,170060,0.00121462,8726470,0.0623271
D.bocki,140010837,460937,1,169801,0.00121277,8896271,0.0635399
D.bocki,140010837,460918,1,169452,0.00121028,9065723,0.0647502
D.bocki,140010837,461511,1,169300,0.00120919,9235023,0.0659593
D.bocki,140010837,463877,1,168649,0.00120454,9403672,0.0671639
D.bocki,140010837,464617,1,167528,0.00119654,9571200,0.0683604
D.bocki,140010837,462367,1,166842,0.00119164,9738042,0.0695521
D.bocki,140010837,463623,1,165375,0.00118116,9903417,0.0707332
D.bocki,140010837,464682,1,163914,0.00117072,10067331,0.0719039
D.bocki,140010837,456404,1,163873,0.00117043,10231204,0.0730744
D.bocki,140010837,464550,1,163406,0.0011671,10394610,0.0742415
D.bocki,140010837,464529,1,162100,0.00115777,10556710,0.0753992
D.bocki,140010837,463856,1,161385,0.00115266,10718095,0.0765519
D.bocki,140010837,464523,1,160999,0.0011499,10879094,0.0777018
D.bocki,140010837,464645,1,160371,0.00114542,11039465,0.0788472
D.bocki,140010837,458916,1,159260,0.00113748,11198725,0.0799847
D.bocki,140010837,463722,1,156684,0.00111908,11355409,0.0811038
D.bocki,140010837,459867,1,155839,0.00111305,11511248,0.0822168
D.bocki,140010837,464803,1,155295,0.00110916,11666543,0.083326
D.bocki,140010837,456060,1,155148,0.00110811,11821691,0.0844341
D.bocki,140010837,464995,1,154300,0.00110206,11975991,0.0855362
D.bocki,140010837,464030,1,153557,0.00109675,12129548,0.0866329
D.bocki,140010837,465071,1,151931,0.00108514,12281479,0.0877181
D.bocki,140010837,456119,1,150944,0.00107809,12432423,0.0887961
D.bocki,140010837,464966,1,149575,0.00106831,12581998,0.0898645
D.bocki,140010837,464814,1,149513,0.00106787,12731511,0.0909323
D.bocki,140010837,464924,1,149477,0.00106761,12880988,0.0919999
D.bocki,140010837,464262,1,146995,0.00104988,13027983,0.0930498
D.bocki,140010837,464399,1,146295,0.00104488,13174278,0.0940947
D.bocki,140010837,464244,1,145494,0.00103916,13319772,0.0951339
D.bocki,140010837,459289,1,145336,0.00103803,13465108,0.0961719
D.bocki,140010837,464675,1,144966,0.00103539,13610074,0.0972073
D.bocki,140010837,465070,1,144732,0.00103372,13754806,0.098241
D.bocki,140010837,462154,1,144300,0.00103063,13899106,0.0992716
D.bocki,140010837,465111,1,144221,0.00103007,14043327,0.100302
D.bocki,140010837,464120,1,144024,0.00102866,14187351,0.10133
D.bocki,140010837,464273,1,143708,0.00102641,14331059,0.102357
D.bocki,140010837,461619,1,143454,0.00102459,14474513,0.103381
D.bocki,140010837,464397,1,142433,0.0010173,14616946,0.104399
D.bocki,140010837,461063,1,141628,0.00101155,14758574,0.10541
D.bocki,140010837,459340,1,141236,0.00100875,14899810,0.106419
D.bocki,140010837,461549,1,140450,0.00100314,15040260,0.107422
D.bocki,140010837,464886,1,139920,0.000999351,15180180,0.108421
D.bocki,140010837,456904,1,139907,0.000999258,15320087,0.109421
D.bocki,140010837,458389,1,139800,0.000998494,15459887,0.110419
D.bocki,140010837,464857,1,139304,0.000994952,15599191,0.111414
D.bocki,140010837,459362,1,139244,0.000994523,15738435,0.112409
D.bocki,140010837,456125,1,139194,0.000994166,15877629,0.113403
D.bocki,140010837,461921,1,138311,0.000987859,16015940,0.114391
D.bocki,140010837,464850,1,137647,0.000983117,16153587,0.115374
D.bocki,140010837,462522,1,137636,0.000983038,16291223,0.116357
D.bocki,140010837,457569,1,137516,0.000982181,16428739,0.117339
D.bocki,140010837,464112,1,136312,0.000973582,16565051,0.118313
D.bocki,140010837,7987,1,136043,0.000971661,16701094,0.119284
D.bocki,140010837,461716,1,135658,0.000968911,16836752,0.120253
D.bocki,140010837,461996,1,134996,0.000964183,16971748,0.121217
D.bocki,140010837,464648,1,134608,0.000961411,17106356,0.122179
D.bocki,140010837,461713,1,134051,0.000957433,17240407,0.123136
D.bocki,140010837,460576,1,133129,0.000950848,17373536,0.124087
D.bocki,140010837,456294,1,132990,0.000949855,17506526,0.125037
D.bocki,140010837,456748,1,132651,0.000947434,17639177,0.125984
D.bocki,140010837,456011,1,132185,0.000944105,17771362,0.126928
D.bocki,140010837,464261,1,131723,0.000940806,17903085,0.127869
D.bocki,140010837,465059,1,130447,0.000931692,18033532,0.128801
D.bocki,140010837,457353,1,130111,0.000929292,18163643,0.12973
D.bocki,140010837,456836,1,129880,0.000927642,18293523,0.130658
D.bocki,140010837,463910,1,129548,0.000925271,18423071,0.131583
D.bocki,140010837,459723,1,128928,0.000920843,18551999,0.132504
D.bocki,140010837,464609,1,128926,0.000920829,18680925,0.133425
D.bocki,140010837,457400,1,128307,0.000916408,18809232,0.134341
D.bocki,140010837,460437,1,127430,0.000910144,18936662,0.135251
D.bocki,140010837,459014,1,127336,0.000909472,19063998,0.136161
D.bocki,140010837,462651,1,127189,0.000908423,19191187,0.137069
D.bocki,140010837,463533,1,126455,0.00090318,19317642,0.137972
D.bocki,140010837,464775,1,125804,0.00089853,19443446,0.138871
D.bocki,140010837,460829,1,125688,0.000897702,19569134,0.139769
D.bocki,140010837,464894,1,125098,0.000893488,19694232,0.140662
D.bocki,140010837,464931,1,125000,0.000892788,19819232,0.141555
D.bocki,140010837,460193,1,124830,0.000891574,19944062,0.142447
D.bocki,140010837,463096,1,124665,0.000890395,20068727,0.143337
D.bocki,140010837,456308,1,124632,0.00089016,20193359,0.144227
D.bocki,140010837,458270,1,124341,0.000888081,20317700,0.145115
D.bocki,140010837,464981,1,123696,0.000883474,20441396,0.145999
D.bocki,140010837,458472,1,123071,0.000879011,20564467,0.146878
D.bocki,140010837,456555,1,122770,0.000876861,20687237,0.147755
D.bocki,140010837,462082,1,122704,0.000876389,20809941,0.148631
D.bocki,140010837,459649,1,122571,0.000875439,20932512,0.149506
D.bocki,140010837,460722,1,121649,0.000868854,21054161,0.150375
D.bocki,140010837,464493,1,121525,0.000867969,21175686,0.151243
D.bocki,140010837,458596,1,121521,0.00086794,21297207,0.152111
D.bocki,140010837,457601,1,121178,0.00086549,21418385,0.152977
D.bocki,140010837,462418,1,120826,0.000862976,21539211,0.15384
D.bocki,140010837,464883,1,120531,0.000860869,21659742,0.1547
D.bocki,140010837,464832,1,119733,0.00085517,21779475,0.155556
D.bocki,140010837,455797,1,119453,0.00085317,21898928,0.156409
D.bocki,140010837,464789,1,119446,0.00085312,22018374,0.157262
D.bocki,140010837,464434,1,119297,0.000852055,22137671,0.158114
D.bocki,140010837,464986,1,119226,0.000851548,22256897,0.158966
D.bocki,140010837,463760,1,118881,0.000849084,22375778,0.159815
D.bocki,140010837,464772,1,118775,0.000848327,22494553,0.160663
D.bocki,140010837,464162,1,118731,0.000848013,22613284,0.161511
D.bocki,140010837,464363,1,118710,0.000847863,22731994,0.162359
D.bocki,140010837,460440,1,118631,0.000847299,22850625,0.163206
D.bocki,140010837,462283,1,118530,0.000846577,22969155,0.164053
D.bocki,140010837,465113,1,117751,0.000841013,23086906,0.164894
D.bocki,140010837,462052,1,117693,0.000840599,23204599,0.165734
D.bocki,140010837,465084,1,117568,0.000839706,23322167,0.166574
D.bocki,140010837,465144,1,117122,0.000836521,23439289,0.167411
D.bocki,140010837,464102,1,116085,0.000829114,23555374,0.16824
D.bocki,140010837,463057,1,115950,0.00082815,23671324,0.169068
D.bocki,140010837,457445,1,115565,0.0008254,23786889,0.169893
D.bocki,140010837,464585,1,114722,0.000819379,23901611,0.170713
D.bocki,140010837,457906,1,114162,0.00081538,24015773,0.171528
D.bocki,140010837,463545,1,114034,0.000814466,24129807,0.172342
D.bocki,140010837,461487,1,113852,0.000813166,24243659,0.173156
D.bocki,140010837,459459,1,113427,0.00081013,24357086,0.173966
D.bocki,140010837,465028,1,113414,0.000810037,24470500,0.174776
D.bocki,140010837,456088,1,113020,0.000807223,24583520,0.175583
D.bocki,140010837,464219,1,112993,0.00080703,24696513,0.17639
D.bocki,140010837,463768,1,112982,0.000806952,24809495,0.177197
D.bocki,140010837,463621,1,112702,0.000804952,24922197,0.178002
D.bocki,140010837,461883,1,112664,0.000804681,25034861,0.178807
D.bocki,140010837,456774,1,112602,0.000804238,25147463,0.179611
D.bocki,140010837,464625,1,112594,0.000804181,25260057,0.180415
D.bocki,140010837,455962,1,112552,0.000803881,25372609,0.181219
D.bocki,140010837,463631,1,112397,0.000802774,25485006,0.182022
D.bocki,140010837,457726,1,112207,0.000801417,25597213,0.182823
D.bocki,140010837,463833,1,112006,0.000799981,25709219,0.183623
D.bocki,140010837,464461,1,111606,0.000797124,25820825,0.18442
D.bocki,140010837,464516,1,110795,0.000791332,25931620,0.185212
D.bocki,140010837,459139,1,110164,0.000786825,26041784,0.185998
D.bocki,140010837,456040,1,110033,0.000785889,26151817,0.186784
D.bocki,140010837,430877,1,109484,0.000781968,26261301,0.187566
D.bocki,140010837,462141,1,109288,0.000780568,26370589,0.188347
D.bocki,140010837,464357,1,109031,0.000778733,26479620,0.189126
D.bocki,140010837,464958,1,108875,0.000777618,26588495,0.189903
D.bocki,140010837,456614,1,108868,0.000777568,26697363,0.190681
D.bocki,140010837,462973,1,108797,0.000777061,26806160,0.191458
D.bocki,140010837,459780,1,108151,0.000772447,26914311,0.19223
D.bocki,140010837,456441,1,108093,0.000772033,27022404,0.193002
D.bocki,140010837,456796,1,107805,0.000769976,27130209,0.193772
D.bocki,140010837,465021,1,107574,0.000768326,27237783,0.194541
D.bocki,140010837,464122,1,107342,0.000766669,27345125,0.195307
D.bocki,140010837,464866,1,106443,0.000760248,27451568,0.196067
D.bocki,140010837,464711,1,105562,0.000753956,27557130,0.196821
D.bocki,140010837,461499,1,105334,0.000752327,27662464,0.197574
D.bocki,140010837,462569,1,105170,0.000751156,27767634,0.198325
D.bocki,140010837,464608,1,105125,0.000750835,27872759,0.199076
D.bocki,140010837,459309,1,105069,0.000750435,27977828,0.199826
D.bocki,140010837,456184,1,104977,0.000749778,28082805,0.200576
D.bocki,140010837,464947,1,104697,0.000747778,28187502,0.201324
D.bocki,140010837,281982,1,104591,0.000747021,28292093,0.202071
D.bocki,140010837,462108,1,103949,0.000742435,28396042,0.202813
D.bocki,140010837,459271,1,103755,0.00074105,28499797,0.203554
D.bocki,140010837,457393,1,103714,0.000740757,28603511,0.204295
D.bocki,140010837,462405,1,103244,0.0007374,28706755,0.205032
D.bocki,140010837,463268,1,103192,0.000737029,28809947,0.205769
D.bocki,140010837,464664,1,103051,0.000736022,28912998,0.206505
D.bocki,140010837,463680,1,102931,0.000735165,29015929,0.207241
D.bocki,140010837,464518,1,102224,0.000730115,29118153,0.207971
D.bocki,140010837,464483,1,102217,0.000730065,29220370,0.208701
D.bocki,140010837,464033,1,102204,0.000729972,29322574,0.209431
D.bocki,140010837,460051,1,101708,0.000726429,29424282,0.210157
D.bocki,140010837,464614,1,101512,0.00072503,29525794,0.210882
D.bocki,140010837,458933,1,101292,0.000723458,29627086,0.211606
D.bocki,140010837,464422,1,100796,0.000719916,29727882,0.212326
D.bocki,140010837,461576,1,100730,0.000719444,29828612,0.213045
D.bocki,140010837,462238,1,100590,0.000718444,29929202,0.213763
D.bocki,140010837,460320,1,100249,0.000716009,30029451,0.214479
D.bocki,140010837,458967,1,99909,0.00071358,30129360,0.215193
D.bocki,140010837,458900,1,99507,0.000710709,30228867,0.215904
D.bocki,140010837,462703,1,99416,0.000710059,30328283,0.216614
D.bocki,140010837,463613,1,99353,0.000709609,30427636,0.217323
D.bocki,140010837,463047,1,99318,0.000709359,30526954,0.218033
D.bocki,140010837,462692,1,99069,0.000707581,30626023,0.21874
D.bocki,140010837,459637,1,98928,0.000706574,30724951,0.219447
D.bocki,140010837,461179,1,98835,0.00070591,30823786,0.220153
D.bocki,140010837,464578,1,98378,0.000702646,30922164,0.220856
D.bocki,140010837,464105,1,97695,0.000697767,31019859,0.221553
D.bocki,140010837,464619,1,97654,0.000697475,31117513,0.222251
D.bocki,140010837,457282,1,97577,0.000696925,31215090,0.222948
D.bocki,140010837,461175,1,97321,0.000695096,31312411,0.223643
D.bocki,140010837,460591,1,97148,0.000693861,31409559,0.224337
D.bocki,140010837,456734,1,96775,0.000691196,31506334,0.225028
D.bocki,140010837,464193,1,96353,0.000688182,31602687,0.225716
D.bocki,140010837,464782,1,96330,0.000688018,31699017,0.226404
D.bocki,140010837,464647,1,96049,0.000686011,31795066,0.22709
D.bocki,140010837,458031,1,95985,0.000685554,31891051,0.227776
D.bocki,140010837,459134,1,95912,0.000685033,31986963,0.228461
D.bocki,140010837,459924,1,95865,0.000684697,32082828,0.229145
D.bocki,140010837,461266,1,95742,0.000683818,32178570,0.229829
D.bocki,140010837,457843,1,95627,0.000682997,32274197,0.230512
D.bocki,140010837,459141,1,95491,0.000682026,32369688,0.231194
D.bocki,140010837,464855,1,95218,0.000680076,32464906,0.231874
D.bocki,140010837,458408,1,94952,0.000678176,32559858,0.232552
D.bocki,140010837,457126,1,94749,0.000676726,32654607,0.233229
D.bocki,140010837,459442,1,94484,0.000674833,32749091,0.233904
D.bocki,140010837,463838,1,94089,0.000672012,32843180,0.234576
D.bocki,140010837,464555,1,94069,0.000671869,32937249,0.235248
D.bocki,140010837,457877,1,93911,0.000670741,33031160,0.235919
D.bocki,140010837,464009,1,93898,0.000670648,33125058,0.236589
D.bocki,140010837,464729,1,93601,0.000668527,33218659,0.237258
D.bocki,140010837,463174,1,93528,0.000668005,33312187,0.237926
D.bocki,140010837,462545,1,93476,0.000667634,33405663,0.238593
D.bocki,140010837,464453,1,93368,0.000666863,33499031,0.23926
D.bocki,140010837,459496,1,93095,0.000664913,33592126,0.239925
D.bocki,140010837,462178,1,93033,0.00066447,33685159,0.24059
D.bocki,140010837,462451,1,93009,0.000664299,33778168,0.241254
D.bocki,140010837,464265,1,92767,0.00066257,33870935,0.241917
D.bocki,140010837,462308,1,92467,0.000660427,33963402,0.242577
D.bocki,140010837,462534,1,92439,0.000660227,34055841,0.243237
D.bocki,140010837,459451,1,92323,0.000659399,34148164,0.243897
D.bocki,140010837,463901,1,92279,0.000659085,34240443,0.244556
D.bocki,140010837,458192,1,92210,0.000658592,34332653,0.245214
D.bocki,140010837,462623,1,92145,0.000658128,34424798,0.245872
D.bocki,140010837,458211,1,91783,0.000655542,34516581,0.246528
D.bocki,140010837,457942,1,91613,0.000654328,34608194,0.247182
D.bocki,140010837,464506,1,91507,0.000653571,34699701,0.247836
D.bocki,140010837,456037,1,91387,0.000652714,34791088,0.248489
D.bocki,140010837,464405,1,91355,0.000652485,34882443,0.249141
D.bocki,140010837,458228,1,91200,0.000651378,34973643,0.249792
D.bocki,140010837,463711,1,91045,0.000650271,35064688,0.250443
D.bocki,140010837,464852,1,91029,0.000650157,35155717,0.251093
D.bocki,140010837,277526,1,90994,0.000649907,35246711,0.251743
D.bocki,140010837,465130,1,90974,0.000649764,35337685,0.252392
D.bocki,140010837,461531,1,90688,0.000647721,35428373,0.25304
D.bocki,140010837,464394,1,90604,0.000647121,35518977,0.253687
D.bocki,140010837,460993,1,90582,0.000646964,35609559,0.254334
D.bocki,140010837,460663,1,90374,0.000645479,35699933,0.25498
D.bocki,140010837,461270,1,90345,0.000645271,35790278,0.255625
D.bocki,140010837,464042,1,89904,0.000642122,35880182,0.256267
D.bocki,140010837,464843,1,89835,0.000641629,35970017,0.256909
D.bocki,140010837,464630,1,89833,0.000641615,36059850,0.25755
D.bocki,140010837,455745,1,89711,0.000640743,36149561,0.258191
D.bocki,140010837,464867,1,89698,0.00064065,36239259,0.258832
D.bocki,140010837,464983,1,89610,0.000640022,36328869,0.259472
D.bocki,140010837,459905,1,89512,0.000639322,36418381,0.260111
D.bocki,140010837,460287,1,89304,0.000637836,36507685,0.260749
D.bocki,140010837,457277,1,89243,0.000637401,36596928,0.261386
D.bocki,140010837,455867,1,88883,0.000634829,36685811,0.262021
D.bocki,140010837,464865,1,88806,0.000634279,36774617,0.262656
D.bocki,140010837,460358,1,88805,0.000634272,36863422,0.26329
D.bocki,140010837,459762,1,88671,0.000633315,36952093,0.263923
D.bocki,140010837,457919,1,88460,0.000631808,37040553,0.264555
D.bocki,140010837,463588,1,88381,0.000631244,37128934,0.265186
D.bocki,140010837,464670,1,88355,0.000631058,37217289,0.265817
D.bocki,140010837,458183,1,87947,0.000628144,37305236,0.266445
D.bocki,140010837,463544,1,87765,0.000626844,37393001,0.267072
D.bocki,140010837,460990,1,87277,0.000623359,37480278,0.267696
D.bocki,140010837,462262,1,87115,0.000622202,37567393,0.268318
D.bocki,140010837,455894,1,87073,0.000621902,37654466,0.26894
D.bocki,140010837,465007,1,87005,0.000621416,37741471,0.269561
D.bocki,140010837,461168,1,86849,0.000620302,37828320,0.270181
D.bocki,140010837,462927,1,86708,0.000619295,37915028,0.270801
D.bocki,140010837,460192,1,86604,0.000618552,38001632,0.271419
D.bocki,140010837,462859,1,86257,0.000616074,38087889,0.272035
D.bocki,140010837,455932,1,86151,0.000615317,38174040,0.272651
D.bocki,140010837,463813,1,86144,0.000615267,38260184,0.273266
D.bocki,140010837,464822,1,86047,0.000614574,38346231,0.27388
D.bocki,140010837,459033,1,85828,0.00061301,38432059,0.274493
D.bocki,140010837,459172,1,85767,0.000612574,38517826,0.275106
D.bocki,140010837,460961,1,85626,0.000611567,38603452,0.275718
D.bocki,140010837,464833,1,85602,0.000611396,38689054,0.276329
D.bocki,140010837,460678,1,85512,0.000610753,38774566,0.27694
D.bocki,140010837,462329,1,85159,0.000608231,38859725,0.277548
D.bocki,140010837,459024,1,85155,0.000608203,38944880,0.278156
D.bocki,140010837,456901,1,85103,0.000607832,39029983,0.278764
D.bocki,140010837,456957,1,84354,0.000602482,39114337,0.279366
D.bocki,140010837,458439,1,84235,0.000601632,39198572,0.279968
D.bocki,140010837,464723,1,84111,0.000600746,39282683,0.280569
D.bocki,140010837,462730,1,83558,0.000596797,39366241,0.281166
D.bocki,140010837,465146,1,83311,0.000595033,39449552,0.281761
D.bocki,140010837,460464,1,83293,0.000594904,39532845,0.282356
D.bocki,140010837,460801,1,83102,0.00059354,39615947,0.282949
D.bocki,140010837,463661,1,83092,0.000593468,39699039,0.283543
D.bocki,140010837,458095,1,83011,0.00059289,39782050,0.284136
D.bocki,140010837,456219,1,82928,0.000592297,39864978,0.284728
D.bocki,140010837,457996,1,82910,0.000592168,39947888,0.28532
D.bocki,140010837,463585,1,82824,0.000591554,40030712,0.285912
D.bocki,140010837,459329,1,82733,0.000590904,40113445,0.286502
D.bocki,140010837,457306,1,82692,0.000590611,40196137,0.287093
D.bocki,140010837,463179,1,82524,0.000589412,40278661,0.287682
D.bocki,140010837,464221,1,82508,0.000589297,40361169,0.288272
D.bocki,140010837,464560,1,81918,0.000585083,40443087,0.288857
D.bocki,140010837,464229,1,81911,0.000585033,40524998,0.289442
D.bocki,140010837,463893,1,81792,0.000584183,40606790,0.290026
D.bocki,140010837,459109,1,81664,0.000583269,40688454,0.290609
D.bocki,140010837,465131,1,81634,0.000583055,40770088,0.291192
D.bocki,140010837,464750,1,81550,0.000582455,40851638,0.291775
D.bocki,140010837,461430,1,81534,0.000582341,40933172,0.292357
D.bocki,140010837,462529,1,81533,0.000582333,41014705,0.29294
D.bocki,140010837,456434,1,81490,0.000582026,41096195,0.293522
D.bocki,140010837,455747,1,81409,0.000581448,41177604,0.294103
D.bocki,140010837,457618,1,81363,0.000581119,41258967,0.294684
D.bocki,140010837,464760,1,81336,0.000580926,41340303,0.295265
D.bocki,140010837,185399,1,80891,0.000577748,41421194,0.295843
D.bocki,140010837,457255,1,80761,0.00057682,41501955,0.29642
D.bocki,140010837,463814,1,80621,0.00057582,41582576,0.296995
D.bocki,140010837,458181,1,80394,0.000574198,41662970,0.29757
D.bocki,140010837,463911,1,80110,0.00057217,41743080,0.298142
D.bocki,140010837,458738,1,80103,0.00057212,41823183,0.298714
D.bocki,140010837,463460,1,79990,0.000571313,41903173,0.299285
D.bocki,140010837,457094,1,79480,0.00056767,41982653,0.299853
D.bocki,140010837,464169,1,79350,0.000566742,42062003,0.30042
D.bocki,140010837,463686,1,79042,0.000564542,42141045,0.300984
D.bocki,140010837,464293,1,78962,0.000563971,42220007,0.301548
D.bocki,140010837,459045,1,78792,0.000562756,42298799,0.302111
D.bocki,140010837,458652,1,78727,0.000562292,42377526,0.302673
D.bocki,140010837,464901,1,78705,0.000562135,42456231,0.303235
D.bocki,140010837,465010,1,78601,0.000561392,42534832,0.303797
D.bocki,140010837,459501,1,78395,0.000559921,42613227,0.304357
D.bocki,140010837,461865,1,78250,0.000558885,42691477,0.304916
D.bocki,140010837,39793,1,78009,0.000557164,42769486,0.305473
D.bocki,140010837,457373,1,77898,0.000556371,42847384,0.306029
D.bocki,140010837,456090,1,77728,0.000555157,42925112,0.306584
D.bocki,140010837,464272,1,77370,0.0005526,43002482,0.307137
D.bocki,140010837,456945,1,77276,0.000551929,43079758,0.307689
D.bocki,140010837,458935,1,77052,0.000550329,43156810,0.308239
D.bocki,140010837,37628,1,76908,0.0005493,43233718,0.308788
D.bocki,140010837,456929,1,76840,0.000548815,43310558,0.309337
D.bocki,140010837,457073,1,76687,0.000547722,43387245,0.309885
D.bocki,140010837,461455,1,76626,0.000547286,43463871,0.310432
D.bocki,140010837,462944,1,76514,0.000546486,43540385,0.310979
D.bocki,140010837,460540,1,76464,0.000546129,43616849,0.311525
D.bocki,140010837,459377,1,76416,0.000545786,43693265,0.312071
D.bocki,140010837,464570,1,76379,0.000545522,43769644,0.312616
D.bocki,140010837,459103,1,76354,0.000545344,43845998,0.313161
D.bocki,140010837,464417,1,76335,0.000545208,43922333,0.313707
D.bocki,140010837,457001,1,76271,0.000544751,43998604,0.314251
D.bocki,140010837,460761,1,75920,0.000542244,44074524,0.314794
D.bocki,140010837,464537,1,75904,0.000542129,44150428,0.315336
D.bocki,140010837,285371,1,75736,0.00054093,44226164,0.315877
D.bocki,140010837,455730,1,75637,0.000540222,44301801,0.316417
D.bocki,140010837,457034,1,75330,0.00053803,44377131,0.316955
D.bocki,140010837,464830,1,75293,0.000537766,44452424,0.317493
D.bocki,140010837,463752,1,75050,0.00053603,44527474,0.318029
D.bocki,140010837,461075,1,75013,0.000535766,44602487,0.318565
D.bocki,140010837,464492,1,74967,0.000535437,44677454,0.3191
D.bocki,140010837,458909,1,74868,0.00053473,44752322,0.319635
D.bocki,140010837,336383,1,74782,0.000534116,44827104,0.320169
D.bocki,140010837,456162,1,74717,0.000533652,44901821,0.320702
D.bocki,140010837,458252,1,74526,0.000532287,44976347,0.321235
D.bocki,140010837,456570,1,74506,0.000532145,45050853,0.321767
D.bocki,140010837,455716,1,74298,0.000530659,45125151,0.322298
D.bocki,140010837,460752,1,74289,0.000530595,45199440,0.322828
D.bocki,140010837,461706,1,74233,0.000530195,45273673,0.323358
D.bocki,140010837,457191,1,74216,0.000530073,45347889,0.323888
D.bocki,140010837,457182,1,74177,0.000529795,45422066,0.324418
D.bocki,140010837,464528,1,74171,0.000529752,45496237,0.324948
D.bocki,140010837,464902,1,73864,0.000527559,45570101,0.325476
D.bocki,140010837,464880,1,73630,0.000525888,45643731,0.326001
D.bocki,140010837,462811,1,73182,0.000522688,45716913,0.326524
D.bocki,140010837,463601,1,72847,0.000520295,45789760,0.327044
D.bocki,140010837,464703,1,72689,0.000519167,45862449,0.327564
D.bocki,140010837,464741,1,72527,0.00051801,45934976,0.328082
D.bocki,140010837,459065,1,72451,0.000517467,46007427,0.328599
D.bocki,140010837,463958,1,72344,0.000516703,46079771,0.329116
D.bocki,140010837,459741,1,72313,0.000516481,46152084,0.329632
D.bocki,140010837,464427,1,72293,0.000516339,46224377,0.330149
D.bocki,140010837,124656,1,72265,0.000516139,46296642,0.330665
D.bocki,140010837,464963,1,72138,0.000515232,46368780,0.33118
D.bocki,140010837,456714,1,71816,0.000512932,46440596,0.331693
D.bocki,140010837,464569,1,71718,0.000512232,46512314,0.332205
D.bocki,140010837,465040,1,71602,0.000511403,46583916,0.332717
D.bocki,140010837,458568,1,71164,0.000508275,46655080,0.333225
D.bocki,140010837,460833,1,71163,0.000508268,46726243,0.333733
D.bocki,140010837,460747,1,71155,0.000508211,46797398,0.334241
D.bocki,140010837,464735,1,71074,0.000507632,46868472,0.334749
D.bocki,140010837,458478,1,71039,0.000507382,46939511,0.335256
D.bocki,140010837,461529,1,71015,0.000507211,47010526,0.335763
D.bocki,140010837,462852,1,71010,0.000507175,47081536,0.336271
D.bocki,140010837,457792,1,71004,0.000507132,47152540,0.336778
D.bocki,140010837,465064,1,70954,0.000506775,47223494,0.337285
D.bocki,140010837,460254,1,70947,0.000506725,47294441,0.337791
D.bocki,140010837,463532,1,70888,0.000506304,47365329,0.338298
D.bocki,140010837,456690,1,70853,0.000506054,47436182,0.338804
D.bocki,140010837,464707,1,70820,0.000505818,47507002,0.339309
D.bocki,140010837,459609,1,70768,0.000505447,47577770,0.339815
D.bocki,140010837,464960,1,70693,0.000504911,47648463,0.34032
D.bocki,140010837,464378,1,70310,0.000502175,47718773,0.340822
D.bocki,140010837,464557,1,70297,0.000502083,47789070,0.341324
D.bocki,140010837,461990,1,70168,0.000501161,47859238,0.341825
D.bocki,140010837,457835,1,70073,0.000500483,47929311,0.342326
D.bocki,140010837,462315,1,69997,0.00049994,47999308,0.342826
D.bocki,140010837,457815,1,69907,0.000499297,48069215,0.343325
D.bocki,140010837,464715,1,69888,0.000499161,48139103,0.343824
D.bocki,140010837,464690,1,69730,0.000498033,48208833,0.344322
D.bocki,140010837,459881,1,69706,0.000497861,48278539,0.34482
D.bocki,140010837,456559,1,69670,0.000497604,48348209,0.345318
D.bocki,140010837,271176,1,69629,0.000497312,48417838,0.345815
D.bocki,140010837,461771,1,69547,0.000496726,48487385,0.346312
D.bocki,140010837,458423,1,69491,0.000496326,48556876,0.346808
D.bocki,140010837,458474,1,69471,0.000496183,48626347,0.347304
D.bocki,140010837,461606,1,69446,0.000496004,48695793,0.3478
D.bocki,140010837,462499,1,69428,0.000495876,48765221,0.348296
D.bocki,140010837,464684,1,69338,0.000495233,48834559,0.348791
D.bocki,140010837,465056,1,69312,0.000495047,48903871,0.349286
D.bocki,140010837,462393,1,69293,0.000494912,48973164,0.349781
D.bocki,140010837,456315,1,69274,0.000494776,49042438,0.350276
D.bocki,140010837,460539,1,69224,0.000494419,49111662,0.35077
D.bocki,140010837,462034,1,69188,0.000494162,49180850,0.351265
D.bocki,140010837,463993,1,68939,0.000492383,49249789,0.351757
D.bocki,140010837,464204,1,68879,0.000491955,49318668,0.352249
D.bocki,140010837,458129,1,68777,0.000491226,49387445,0.35274
D.bocki,140010837,153129,1,68750,0.000491033,49456195,0.353231
D.bocki,140010837,463438,1,68742,0.000490976,49524937,0.353722
D.bocki,140010837,458787,1,68646,0.000490291,49593583,0.354212
D.bocki,140010837,248294,1,68498,0.000489234,49662081,0.354702
D.bocki,140010837,456423,1,68489,0.000489169,49730570,0.355191
D.bocki,140010837,458487,1,68186,0.000487005,49798756,0.355678
D.bocki,140010837,464435,1,68032,0.000485905,49866788,0.356164
D.bocki,140010837,460071,1,67923,0.000485127,49934711,0.356649
D.bocki,140010837,147576,1,67923,0.000485127,50002634,0.357134
D.bocki,140010837,462403,1,67809,0.000484313,50070443,0.357618
D.bocki,140010837,455873,1,67796,0.00048422,50138239,0.358103
D.bocki,140010837,455944,1,67783,0.000484127,50206022,0.358587
D.bocki,140010837,464155,1,67757,0.000483941,50273779,0.359071
D.bocki,140010837,465079,1,67689,0.000483455,50341468,0.359554
D.bocki,140010837,459104,1,67682,0.000483405,50409150,0.360037
D.bocki,140010837,464718,1,67648,0.000483163,50476798,0.360521
D.bocki,140010837,462505,1,67556,0.000482506,50544354,0.361003
D.bocki,140010837,465008,1,67517,0.000482227,50611871,0.361485
D.bocki,140010837,464589,1,67359,0.000481098,50679230,0.361966
D.bocki,140010837,464395,1,67299,0.00048067,50746529,0.362447
D.bocki,140010837,464720,1,67286,0.000480577,50813815,0.362928
D.bocki,140010837,456187,1,67245,0.000480284,50881060,0.363408
D.bocki,140010837,457354,1,67233,0.000480199,50948293,0.363888
D.bocki,140010837,243546,1,67206,0.000480006,51015499,0.364368
D.bocki,140010837,458666,1,67179,0.000479813,51082678,0.364848
D.bocki,140010837,463597,1,66972,0.000478334,51149650,0.365326
D.bocki,140010837,463998,1,66901,0.000477827,51216551,0.365804
D.bocki,140010837,464259,1,66894,0.000477777,51283445,0.366282
D.bocki,140010837,456859,1,66894,0.000477777,51350339,0.36676
D.bocki,140010837,464374,1,66817,0.000477227,51417156,0.367237
D.bocki,140010837,464736,1,66803,0.000477127,51483959,0.367714
D.bocki,140010837,464904,1,66789,0.000477027,51550748,0.368191
D.bocki,140010837,457773,1,66616,0.000475792,51617364,0.368667
D.bocki,140010837,457123,1,66586,0.000475577,51683950,0.369142
D.bocki,140010837,463608,1,66481,0.000474828,51750431,0.369617
D.bocki,140010837,464323,1,66364,0.000473992,51816795,0.370091
D.bocki,140010837,458966,1,66339,0.000473813,51883134,0.370565
D.bocki,140010837,459622,1,66278,0.000473378,51949412,0.371039
D.bocki,140010837,460515,1,66194,0.000472778,52015606,0.371511
D.bocki,140010837,458203,1,66112,0.000472192,52081718,0.371983
D.bocki,140010837,463758,1,66077,0.000471942,52147795,0.372455
D.bocki,140010837,464627,1,66000,0.000471392,52213795,0.372927
D.bocki,140010837,458501,1,65934,0.000470921,52279729,0.373398
D.bocki,140010837,412465,1,65687,0.000469157,52345416,0.373867
D.bocki,140010837,456824,1,65615,0.000468642,52411031,0.374336
D.bocki,140010837,464912,1,65608,0.000468592,52476639,0.374804
D.bocki,140010837,208605,1,65587,0.000468442,52542226,0.375273
D.bocki,140010837,463603,1,65568,0.000468307,52607794,0.375741
D.bocki,140010837,459880,1,65469,0.0004676,52673263,0.376208
D.bocki,140010837,462435,1,65465,0.000467571,52738728,0.376676
D.bocki,140010837,464965,1,65439,0.000467385,52804167,0.377143
D.bocki,140010837,461291,1,65430,0.000467321,52869597,0.377611
D.bocki,140010837,464879,1,65403,0.000467128,52935000,0.378078
D.bocki,140010837,464834,1,65310,0.000466464,53000310,0.378544
D.bocki,140010837,461392,1,65295,0.000466357,53065605,0.379011
D.bocki,140010837,464469,1,65134,0.000465207,53130739,0.379476
D.bocki,140010837,460361,1,64887,0.000463443,53195626,0.379939
D.bocki,140010837,464364,1,64835,0.000463071,53260461,0.380402
D.bocki,140010837,461813,1,64715,0.000462214,53325176,0.380865
D.bocki,140010837,455854,1,64585,0.000461286,53389761,0.381326
D.bocki,140010837,464407,1,64447,0.0004603,53454208,0.381786
D.bocki,140010837,464895,1,64391,0.0004599,53518599,0.382246
D.bocki,140010837,456083,1,64379,0.000459814,53582978,0.382706
D.bocki,140010837,201844,1,64335,0.0004595,53647313,0.383165
D.bocki,140010837,464526,1,64230,0.00045875,53711543,0.383624
D.bocki,140010837,461302,1,64067,0.000457586,53775610,0.384082
D.bocki,140010837,464241,1,64008,0.000457165,53839618,0.384539
D.bocki,140010837,464956,1,63958,0.000456807,53903576,0.384996
D.bocki,140010837,461220,1,63894,0.00045635,53967470,0.385452
D.bocki,140010837,462594,1,63810,0.00045575,54031280,0.385908
D.bocki,140010837,464533,1,63800,0.000455679,54095080,0.386364
D.bocki,140010837,456630,1,63706,0.000455008,54158786,0.386819
D.bocki,140010837,463296,1,63677,0.000454801,54222463,0.387273
D.bocki,140010837,464442,1,63667,0.000454729,54286130,0.387728
D.bocki,140010837,461062,1,63658,0.000454665,54349788,0.388183
D.bocki,140010837,462228,1,63639,0.000454529,54413427,0.388637
D.bocki,140010837,459645,1,63543,0.000453843,54476970,0.389091
D.bocki,140010837,464861,1,63513,0.000453629,54540483,0.389545
D.bocki,140010837,456965,1,63499,0.000453529,54603982,0.389998
D.bocki,140010837,464063,1,63480,0.000453393,54667462,0.390452
D.bocki,140010837,463592,1,63430,0.000453036,54730892,0.390905
D.bocki,140010837,462650,1,63416,0.000452936,54794308,0.391358
D.bocki,140010837,464787,1,63386,0.000452722,54857694,0.39181
D.bocki,140010837,462629,1,63383,0.000452701,54921077,0.392263
D.bocki,140010837,461040,1,63330,0.000452322,54984407,0.392715
D.bocki,140010837,464846,1,63241,0.000451686,55047648,0.393167
D.bocki,140010837,464476,1,63233,0.000451629,55110881,0.393619
D.bocki,140010837,464694,1,63189,0.000451315,55174070,0.39407
D.bocki,140010837,463662,1,63176,0.000451222,55237246,0.394521
D.bocki,140010837,458128,1,63159,0.000451101,55300405,0.394972
D.bocki,140010837,460328,1,63105,0.000450715,55363510,0.395423
D.bocki,140010837,463700,1,62938,0.000449522,55426448,0.395873
D.bocki,140010837,463519,1,62884,0.000449137,55489332,0.396322
D.bocki,140010837,2169,1,62808,0.000448594,55552140,0.39677
D.bocki,140010837,463964,1,62740,0.000448108,55614880,0.397218
D.bocki,140010837,464697,1,62571,0.000446901,55677451,0.397665
D.bocki,140010837,464531,1,62560,0.000446823,55740011,0.398112
D.bocki,140010837,459238,1,62541,0.000446687,55802552,0.398559
D.bocki,140010837,460271,1,62506,0.000446437,55865058,0.399005
D.bocki,140010837,458910,1,62493,0.000446344,55927551,0.399452
D.bocki,140010837,460810,1,62392,0.000445623,55989943,0.399897
D.bocki,140010837,455961,1,62382,0.000445551,56052325,0.400343
D.bocki,140010837,462113,1,62297,0.000444944,56114622,0.400788
D.bocki,140010837,377270,1,62265,0.000444716,56176887,0.401232
D.bocki,140010837,463424,1,62239,0.00044453,56239126,0.401677
D.bocki,140010837,455946,1,62190,0.00044418,56301316,0.402121
D.bocki,140010837,458159,1,61915,0.000442216,56363231,0.402563
D.bocki,140010837,464938,1,61858,0.000441809,56425089,0.403005
D.bocki,140010837,464413,1,61825,0.000441573,56486914,0.403447
D.bocki,140010837,44211,1,61777,0.00044123,56548691,0.403888
D.bocki,140010837,460360,1,61739,0.000440959,56610430,0.404329
D.bocki,140010837,464243,1,61728,0.00044088,56672158,0.40477
D.bocki,140010837,458710,1,61696,0.000440652,56733854,0.40521
D.bocki,140010837,461849,1,61652,0.000440337,56795506,0.405651
D.bocki,140010837,458614,1,61553,0.00043963,56857059,0.40609
D.bocki,140010837,463835,1,61527,0.000439445,56918586,0.40653
D.bocki,140010837,456123,1,61491,0.000439187,56980077,0.406969
D.bocki,140010837,462959,1,61427,0.00043873,57041504,0.407408
D.bocki,140010837,461505,1,61427,0.00043873,57102931,0.407847
D.bocki,140010837,458633,1,61296,0.000437795,57164227,0.408284
D.bocki,140010837,458436,1,61291,0.000437759,57225518,0.408722
D.bocki,140010837,462258,1,61269,0.000437602,57286787,0.40916
D.bocki,140010837,456838,1,61237,0.000437373,57348024,0.409597
D.bocki,140010837,464462,1,61235,0.000437359,57409259,0.410034
D.bocki,140010837,463767,1,61164,0.000436852,57470423,0.410471
D.bocki,140010837,460617,1,61100,0.000436395,57531523,0.410908
D.bocki,140010837,463965,1,61072,0.000436195,57592595,0.411344
D.bocki,140010837,463926,1,61027,0.000435873,57653622,0.41178
D.bocki,140010837,463849,1,60876,0.000434795,57714498,0.412215
D.bocki,140010837,464276,1,60747,0.000433874,57775245,0.412648
D.bocki,140010837,460278,1,60727,0.000433731,57835972,0.413082
D.bocki,140010837,461306,1,60697,0.000433516,57896669,0.413516
D.bocki,140010837,464245,1,60650,0.000433181,57957319,0.413949
D.bocki,140010837,464151,1,60598,0.000432809,58017917,0.414382
D.bocki,140010837,460812,1,60595,0.000432788,58078512,0.414814
D.bocki,140010837,464618,1,60525,0.000432288,58139037,0.415247
D.bocki,140010837,459457,1,60481,0.000431974,58199518,0.415679
D.bocki,140010837,464466,1,60444,0.000431709,58259962,0.41611
D.bocki,140010837,461567,1,60371,0.000431188,58320333,0.416542
D.bocki,140010837,463586,1,60364,0.000431138,58380697,0.416973
D.bocki,140010837,463278,1,60300,0.000430681,58440997,0.417403
D.bocki,140010837,460186,1,60240,0.000430252,58501237,0.417834
D.bocki,140010837,465086,1,60227,0.00043016,58561464,0.418264
D.bocki,140010837,460897,1,60159,0.000429674,58621623,0.418693
D.bocki,140010837,462686,1,60025,0.000428717,58681648,0.419122
D.bocki,140010837,461804,1,59915,0.000427931,58741563,0.41955
D.bocki,140010837,460950,1,59887,0.000427731,58801450,0.419978
D.bocki,140010837,463746,1,59875,0.000427645,58861325,0.420405
D.bocki,140010837,464082,1,59754,0.000426781,58921079,0.420832
D.bocki,140010837,457428,1,59683,0.000426274,58980762,0.421259
D.bocki,140010837,462737,1,59668,0.000426167,59040430,0.421685
D.bocki,140010837,461863,1,59592,0.000425624,59100022,0.42211
D.bocki,140010837,464653,1,59548,0.00042531,59159570,0.422536
D.bocki,140010837,464505,1,59548,0.00042531,59219118,0.422961
D.bocki,140010837,273362,1,59533,0.000425203,59278651,0.423386
D.bocki,140010837,460726,1,59479,0.000424817,59338130,0.423811
D.bocki,140010837,464693,1,59294,0.000423496,59397424,0.424234
D.bocki,140010837,460644,1,59284,0.000423424,59456708,0.424658
D.bocki,140010837,461476,1,59062,0.000421839,59515770,0.42508
D.bocki,140010837,464503,1,59015,0.000421503,59574785,0.425501
D.bocki,140010837,458667,1,58983,0.000421275,59633768,0.425923
D.bocki,140010837,464939,1,58862,0.00042041,59692630,0.426343
D.bocki,140010837,456542,1,58855,0.00042036,59751485,0.426763
D.bocki,140010837,462654,1,58508,0.000417882,59809993,0.427181
D.bocki,140010837,457894,1,58467,0.000417589,59868460,0.427599
D.bocki,140010837,465035,1,58341,0.000416689,59926801,0.428015
D.bocki,140010837,461262,1,58309,0.000416461,59985110,0.428432
D.bocki,140010837,464309,1,58254,0.000416068,60043364,0.428848
D.bocki,140010837,463769,1,58216,0.000415796,60101580,0.429264
D.bocki,140010837,460146,1,58211,0.000415761,60159791,0.42968
D.bocki,140010837,464716,1,58207,0.000415732,60217998,0.430095
D.bocki,140010837,459006,1,58180,0.000415539,60276178,0.430511
D.bocki,140010837,457600,1,58129,0.000415175,60334307,0.430926
D.bocki,140010837,463954,1,57774,0.000412639,60392081,0.431339
D.bocki,140010837,460659,1,57653,0.000411775,60449734,0.43175
D.bocki,140010837,461309,1,57585,0.00041129,60507319,0.432162
D.bocki,140010837,459877,1,57576,0.000411225,60564895,0.432573
D.bocki,140010837,460376,1,57509,0.000410747,60622404,0.432984
D.bocki,140010837,219117,1,57456,0.000410368,60679860,0.433394
D.bocki,140010837,464190,1,57390,0.000409897,60737250,0.433804
D.bocki,140010837,458190,1,57310,0.000409325,60794560,0.434213
D.bocki,140010837,461034,1,57297,0.000409233,60851857,0.434622
D.bocki,140010837,457131,1,57122,0.000407983,60908979,0.43503
D.bocki,140010837,463982,1,57105,0.000407861,60966084,0.435438
D.bocki,140010837,463837,1,57072,0.000407626,61023156,0.435846
D.bocki,140010837,464073,1,57012,0.000407197,61080168,0.436253
D.bocki,140010837,458135,1,56976,0.00040694,61137144,0.43666
D.bocki,140010837,463807,1,56942,0.000406697,61194086,0.437067
D.bocki,140010837,463417,1,56885,0.00040629,61250971,0.437473
D.bocki,140010837,464897,1,56805,0.000405719,61307776,0.437879
D.bocki,140010837,313074,1,56606,0.000404297,61364382,0.438283
D.bocki,140010837,41110,1,56594,0.000404212,61420976,0.438687
D.bocki,140010837,463899,1,56551,0.000403904,61477527,0.439091
D.bocki,140010837,464917,1,56394,0.000402783,61533921,0.439494
D.bocki,140010837,456241,1,56255,0.00040179,61590176,0.439896
D.bocki,140010837,457412,1,56130,0.000400898,61646306,0.440297
D.bocki,140010837,458023,1,56115,0.00040079,61702421,0.440697
D.bocki,140010837,460377,1,56103,0.000400705,61758524,0.441098
D.bocki,140010837,460534,1,56039,0.000400248,61814563,0.441498
D.bocki,140010837,460907,1,55994,0.000399926,61870557,0.441898
D.bocki,140010837,457791,1,55918,0.000399383,61926475,0.442298
D.bocki,140010837,464159,1,55892,0.000399198,61982367,0.442697
D.bocki,140010837,461703,1,55805,0.000398576,62038172,0.443096
D.bocki,140010837,462810,1,55729,0.000398033,62093901,0.443494
D.bocki,140010837,461025,1,55720,0.000397969,62149621,0.443892
D.bocki,140010837,463785,1,55717,0.000397948,62205338,0.444289
D.bocki,140010837,457358,1,55626,0.000397298,62260964,0.444687
D.bocki,140010837,464860,1,55583,0.000396991,62316547,0.445084
D.bocki,140010837,457088,1,55583,0.000396991,62372130,0.445481
D.bocki,140010837,460326,1,55577,0.000396948,62427707,0.445878
D.bocki,140010837,457749,1,55559,0.000396819,62483266,0.446274
D.bocki,140010837,461537,1,55546,0.000396726,62538812,0.446671
D.bocki,140010837,460337,1,55518,0.000396526,62594330,0.447068
D.bocki,140010837,457643,1,55409,0.000395748,62649739,0.447463
D.bocki,140010837,463639,1,55402,0.000395698,62705141,0.447859
D.bocki,140010837,461592,1,55317,0.000395091,62760458,0.448254
D.bocki,140010837,464984,1,55286,0.000394869,62815744,0.448649
D.bocki,140010837,457235,1,55194,0.000394212,62870938,0.449043
D.bocki,140010837,458518,1,55059,0.000393248,62925997,0.449437
D.bocki,140010837,464370,1,54975,0.000392648,62980972,0.449829
D.bocki,140010837,465142,1,54938,0.000392384,63035910,0.450222
D.bocki,140010837,457608,1,54915,0.00039222,63090825,0.450614
D.bocki,140010837,458140,1,54905,0.000392148,63145730,0.451006
D.bocki,140010837,463817,1,54884,0.000391998,63200614,0.451398
D.bocki,140010837,457415,1,54786,0.000391298,63255400,0.451789
D.bocki,140010837,460029,1,54747,0.00039102,63310147,0.45218
D.bocki,140010837,460957,1,54743,0.000390991,63364890,0.452571
D.bocki,140010837,455755,1,54686,0.000390584,63419576,0.452962
D.bocki,140010837,459419,1,54467,0.00038902,63474043,0.453351
D.bocki,140010837,456251,1,54371,0.000388334,63528414,0.453739
D.bocki,140010837,457049,1,54336,0.000388084,63582750,0.454127
D.bocki,140010837,462419,1,54198,0.000387099,63636948,0.454514
D.bocki,140010837,426230,1,54187,0.00038702,63691135,0.454901
D.bocki,140010837,464687,1,54145,0.00038672,63745280,0.455288
D.bocki,140010837,457292,1,54103,0.00038642,63799383,0.455675
D.bocki,140010837,88876,1,54066,0.000386156,63853449,0.456061
D.bocki,140010837,460123,1,54034,0.000385927,63907483,0.456447
D.bocki,140010837,462921,1,53991,0.00038562,63961474,0.456832
D.bocki,140010837,457061,1,53944,0.000385284,64015418,0.457218
D.bocki,140010837,455902,1,53885,0.000384863,64069303,0.457602
D.bocki,140010837,459563,1,53851,0.00038462,64123154,0.457987
D.bocki,140010837,465067,1,53845,0.000384577,64176999,0.458372
D.bocki,140010837,320892,1,53777,0.000384092,64230776,0.458756
D.bocki,140010837,144961,1,53738,0.000383813,64284514,0.45914
D.bocki,140010837,32007,1,53680,0.000383399,64338194,0.459523
D.bocki,140010837,457938,1,53640,0.000383113,64391834,0.459906
D.bocki,140010837,455978,1,53595,0.000382792,64445429,0.460289
D.bocki,140010837,464996,1,53502,0.000382128,64498931,0.460671
D.bocki,140010837,464583,1,53356,0.000381085,64552287,0.461052
D.bocki,140010837,464260,1,53338,0.000380956,64605625,0.461433
D.bocki,140010837,462700,1,53316,0.000380799,64658941,0.461814
D.bocki,140010837,464692,1,53230,0.000380185,64712171,0.462194
D.bocki,140010837,464936,1,53194,0.000379928,64765365,0.462574
D.bocki,140010837,464552,1,53133,0.000379492,64818498,0.462953
D.bocki,140010837,464511,1,53024,0.000378714,64871522,0.463332
D.bocki,140010837,458547,1,52857,0.000377521,64924379,0.46371
D.bocki,140010837,461114,1,52856,0.000377514,64977235,0.464087
D.bocki,140010837,227200,1,52767,0.000376878,65030002,0.464464
D.bocki,140010837,464976,1,52698,0.000376385,65082700,0.46484
D.bocki,140010837,458827,1,52650,0.000376042,65135350,0.465216
D.bocki,140010837,195762,1,52588,0.000375599,65187938,0.465592
D.bocki,140010837,463775,1,52584,0.000375571,65240522,0.465968
D.bocki,140010837,456340,1,52557,0.000375378,65293079,0.466343
D.bocki,140010837,464251,1,52519,0.000375107,65345598,0.466718
D.bocki,140010837,456121,1,52503,0.000374992,65398101,0.467093
D.bocki,140010837,146512,1,52352,0.000373914,65450453,0.467467
D.bocki,140010837,250211,1,52241,0.000373121,65502694,0.46784
D.bocki,140010837,409945,1,52190,0.000372757,65554884,0.468213
D.bocki,140010837,464819,1,52057,0.000371807,65606941,0.468585
D.bocki,140010837,459891,1,52045,0.000371721,65658986,0.468956
D.bocki,140010837,455757,1,51940,0.000370971,65710926,0.469327
D.bocki,140010837,459032,1,51936,0.000370943,65762862,0.469698
D.bocki,140010837,464859,1,51926,0.000370871,65814788,0.470069
D.bocki,140010837,463699,1,51868,0.000370457,65866656,0.47044
D.bocki,140010837,457075,1,51834,0.000370214,65918490,0.47081
D.bocki,140010837,456760,1,51796,0.000369943,65970286,0.47118
D.bocki,140010837,464607,1,51766,0.000369729,66022052,0.47155
D.bocki,140010837,455879,1,51736,0.000369514,66073788,0.471919
D.bocki,140010837,463589,1,51715,0.000369364,66125503,0.472288
D.bocki,140010837,460862,1,51422,0.000367272,66176925,0.472656
D.bocki,140010837,458889,1,51375,0.000366936,66228300,0.473023
D.bocki,140010837,463503,1,51358,0.000366814,66279658,0.473389
D.bocki,140010837,463908,1,51285,0.000366293,66330943,0.473756
D.bocki,140010837,463248,1,51254,0.000366072,66382197,0.474122
D.bocki,140010837,458357,1,51212,0.000365772,66433409,0.474488
D.bocki,140010837,463799,1,51178,0.000365529,66484587,0.474853
D.bocki,140010837,460346,1,51095,0.000364936,66535682,0.475218
D.bocki,140010837,221785,1,51067,0.000364736,66586749,0.475583
D.bocki,140010837,464177,1,51050,0.000364615,66637799,0.475947
D.bocki,140010837,455913,1,51018,0.000364386,66688817,0.476312
D.bocki,140010837,464239,1,50937,0.000363808,66739754,0.476676
D.bocki,140010837,458895,1,50916,0.000363658,66790670,0.477039
D.bocki,140010837,464624,1,50852,0.0003632,66841522,0.477402
D.bocki,140010837,465034,1,50727,0.000362308,66892249,0.477765
D.bocki,140010837,463992,1,50724,0.000362286,66942973,0.478127
D.bocki,140010837,456639,1,50696,0.000362086,66993669,0.478489
D.bocki,140010837,464134,1,50650,0.000361758,67044319,0.478851
D.bocki,140010837,456057,1,50617,0.000361522,67094936,0.479212
D.bocki,140010837,459405,1,50601,0.000361408,67145537,0.479574
D.bocki,140010837,459444,1,50576,0.000361229,67196113,0.479935
D.bocki,140010837,459042,1,50449,0.000360322,67246562,0.480295
D.bocki,140010837,456695,1,50448,0.000360315,67297010,0.480656
D.bocki,140010837,327050,1,50439,0.000360251,67347449,0.481016
D.bocki,140010837,458813,1,50413,0.000360065,67397862,0.481376
D.bocki,140010837,464508,1,50393,0.000359922,67448255,0.481736
D.bocki,140010837,456825,1,50277,0.000359094,67498532,0.482095
D.bocki,140010837,458343,1,50211,0.000358622,67548743,0.482454
D.bocki,140010837,460986,1,50111,0.000357908,67598854,0.482812
D.bocki,140010837,464532,1,50089,0.000357751,67648943,0.483169
D.bocki,140010837,464586,1,50080,0.000357687,67699023,0.483527
D.bocki,140010837,462632,1,50060,0.000357544,67749083,0.483885
D.bocki,140010837,464071,1,50005,0.000357151,67799088,0.484242
D.bocki,140010837,461517,1,49988,0.00035703,67849076,0.484599
D.bocki,140010837,456263,1,49943,0.000356708,67899019,0.484955
D.bocki,140010837,457125,1,49911,0.00035648,67948930,0.485312
D.bocki,140010837,457675,1,49813,0.00035578,67998743,0.485668
D.bocki,140010837,460731,1,49750,0.00035533,68048493,0.486023
D.bocki,140010837,458627,1,49695,0.000354937,68098188,0.486378
D.bocki,140010837,464521,1,49668,0.000354744,68147856,0.486733
D.bocki,140010837,462588,1,49634,0.000354501,68197490,0.487087
D.bocki,140010837,458848,1,49554,0.00035393,68247044,0.487441
D.bocki,140010837,463377,1,49547,0.00035388,68296591,0.487795
D.bocki,140010837,463420,1,49515,0.000353651,68346106,0.488149
D.bocki,140010837,457342,1,49482,0.000353416,68395588,0.488502
D.bocki,140010837,462982,1,49466,0.000353301,68445054,0.488855
D.bocki,140010837,459140,1,49462,0.000353273,68494516,0.489209
D.bocki,140010837,463581,1,49456,0.00035323,68543972,0.489562
D.bocki,140010837,140953,1,49344,0.00035243,68593316,0.489914
D.bocki,140010837,458027,1,49289,0.000352037,68642605,0.490266
D.bocki,140010837,460552,1,49220,0.000351544,68691825,0.490618
D.bocki,140010837,455937,1,49216,0.000351516,68741041,0.490969
D.bocki,140010837,463903,1,49206,0.000351444,68790247,0.491321
D.bocki,140010837,458686,1,49146,0.000351016,68839393,0.491672
D.bocki,140010837,419188,1,49105,0.000350723,68888498,0.492023
D.bocki,140010837,464478,1,48952,0.00034963,68937450,0.492372
D.bocki,140010837,464444,1,48863,0.000348994,68986313,0.492721
D.bocki,140010837,464849,1,48844,0.000348859,69035157,0.49307
D.bocki,140010837,458014,1,48674,0.000347645,69083831,0.493418
D.bocki,140010837,456674,1,48661,0.000347552,69132492,0.493765
D.bocki,140010837,460001,1,48658,0.00034753,69181150,0.494113
D.bocki,140010837,459774,1,48645,0.000347437,69229795,0.49446
D.bocki,140010837,459015,1,48528,0.000346602,69278323,0.494807
D.bocki,140010837,461320,1,48526,0.000346587,69326849,0.495153
D.bocki,140010837,464441,1,48509,0.000346466,69375358,0.4955
D.bocki,140010837,464826,1,48427,0.00034588,69423785,0.495846
D.bocki,140010837,459746,1,48269,0.000344752,69472054,0.496191
D.bocki,140010837,463895,1,48254,0.000344645,69520308,0.496535
D.bocki,140010837,464263,1,48214,0.000344359,69568522,0.49688
D.bocki,140010837,454609,1,48207,0.000344309,69616729,0.497224
D.bocki,140010837,464440,1,48192,0.000344202,69664921,0.497568
D.bocki,140010837,463874,1,48173,0.000344066,69713094,0.497912
D.bocki,140010837,462724,1,48143,0.000343852,69761237,0.498256
D.bocki,140010837,459752,1,48112,0.000343631,69809349,0.4986
D.bocki,140010837,231473,1,48072,0.000343345,69857421,0.498943
D.bocki,140010837,463577,1,48054,0.000343216,69905475,0.499286
D.bocki,140010837,458255,1,48038,0.000343102,69953513,0.499629
D.bocki,140010837,462204,1,47988,0.000342745,70001501,0.499972
D.bocki,140010837,460868,1,47885,0.000342009,70049386,0.500314
D.bocki,140010837,464103,1,47857,0.000341809,70097243,0.500656
D.bocki,140010837,458039,1,47797,0.000341381,70145040,0.500997
D.bocki,140010837,463959,1,47775,0.000341224,70192815,0.501338
D.bocki,140010837,458697,1,47774,0.000341216,70240589,0.50168
D.bocki,140010837,142689,1,47763,0.000341138,70288352,0.502021
D.bocki,140010837,463689,1,47744,0.000341002,70336096,0.502362
D.bocki,140010837,456247,1,47701,0.000340695,70383797,0.502702
D.bocki,140010837,464139,1,47697,0.000340666,70431494,0.503043
D.bocki,140010837,464238,1,47679,0.000340538,70479173,0.503384
D.bocki,140010837,461737,1,47660,0.000340402,70526833,0.503724
D.bocki,140010837,464766,1,47588,0.000339888,70574421,0.504064
D.bocki,140010837,461190,1,47412,0.000338631,70621833,0.504403
D.bocki,140010837,456063,1,47388,0.00033846,70669221,0.504741
D.bocki,140010837,460845,1,47310,0.000337902,70716531,0.505079
D.bocki,140010837,194707,1,47237,0.000337381,70763768,0.505416
D.bocki,140010837,456042,1,47157,0.00033681,70810925,0.505753
D.bocki,140010837,464507,1,47140,0.000336688,70858065,0.50609
D.bocki,140010837,464059,1,47080,0.00033626,70905145,0.506426
D.bocki,140010837,456335,1,47062,0.000336131,70952207,0.506762
D.bocki,140010837,463961,1,47057,0.000336095,70999264,0.507098
D.bocki,140010837,463550,1,46905,0.00033501,71046169,0.507433
D.bocki,140010837,453615,1,46866,0.000334731,71093035,0.507768
D.bocki,140010837,244270,1,46832,0.000334488,71139867,0.508103
D.bocki,140010837,459960,1,46768,0.000334031,71186635,0.508437
D.bocki,140010837,461880,1,46734,0.000333788,71233369,0.50877
D.bocki,140010837,455859,1,46726,0.000333731,71280095,0.509104
D.bocki,140010837,457472,1,46680,0.000333403,71326775,0.509438
D.bocki,140010837,465066,1,46651,0.000333196,71373426,0.509771
D.bocki,140010837,462678,1,46649,0.000333181,71420075,0.510104
D.bocki,140010837,458178,1,46516,0.000332231,71466591,0.510436
D.bocki,140010837,460007,1,46513,0.00033221,71513104,0.510768
D.bocki,140010837,242075,1,46432,0.000331631,71559536,0.5111
D.bocki,140010837,456631,1,46423,0.000331567,71605959,0.511432
D.bocki,140010837,460788,1,46334,0.000330932,71652293,0.511762
D.bocki,140010837,464756,1,46290,0.000330617,71698583,0.512093
D.bocki,140010837,465042,1,46222,0.000330132,71744805,0.512423
D.bocki,140010837,459339,1,46195,0.000329939,71791000,0.512753
D.bocki,140010837,162036,1,46182,0.000329846,71837182,0.513083
D.bocki,140010837,462366,1,46143,0.000329567,71883325,0.513413
D.bocki,140010837,463716,1,46134,0.000329503,71929459,0.513742
D.bocki,140010837,457874,1,46134,0.000329503,71975593,0.514072
D.bocki,140010837,458957,1,46095,0.000329225,72021688,0.514401
D.bocki,140010837,462096,1,45863,0.000327568,72067551,0.514728
D.bocki,140010837,456386,1,45863,0.000327568,72113414,0.515056
D.bocki,140010837,457332,1,45861,0.000327553,72159275,0.515383
D.bocki,140010837,456476,1,45830,0.000327332,72205105,0.515711
D.bocki,140010837,460916,1,45792,0.00032706,72250897,0.516038
D.bocki,140010837,464579,1,45744,0.000326718,72296641,0.516365
D.bocki,140010837,464968,1,45738,0.000326675,72342379,0.516691
D.bocki,140010837,464795,1,45699,0.000326396,72388078,0.517018
D.bocki,140010837,457951,1,45693,0.000326353,72433771,0.517344
D.bocki,140010837,463881,1,45691,0.000326339,72479462,0.51767
D.bocki,140010837,457800,1,45632,0.000325918,72525094,0.517996
D.bocki,140010837,464637,1,45582,0.000325561,72570676,0.518322
D.bocki,140010837,458454,1,45575,0.000325511,72616251,0.518647
D.bocki,140010837,457983,1,45543,0.000325282,72661794,0.518973
D.bocki,140010837,464457,1,45530,0.000325189,72707324,0.519298
D.bocki,140010837,460282,1,45528,0.000325175,72752852,0.519623
D.bocki,140010837,232910,1,45497,0.000324953,72798349,0.519948
D.bocki,140010837,457807,1,45444,0.000324575,72843793,0.520273
D.bocki,140010837,464101,1,45441,0.000324553,72889234,0.520597
D.bocki,140010837,461627,1,45313,0.000323639,72934547,0.520921
D.bocki,140010837,463451,1,45194,0.000322789,72979741,0.521244
D.bocki,140010837,463882,1,45106,0.000322161,73024847,0.521566
D.bocki,140010837,456201,1,45064,0.000321861,73069911,0.521888
D.bocki,140010837,464284,1,45026,0.000321589,73114937,0.522209
D.bocki,140010837,464971,1,45021,0.000321554,73159958,0.522531
D.bocki,140010837,462093,1,45017,0.000321525,73204975,0.522852
D.bocki,140010837,457788,1,44927,0.000320882,73249902,0.523173
D.bocki,140010837,463797,1,44842,0.000320275,73294744,0.523493
D.bocki,140010837,460908,1,44736,0.000319518,73339480,0.523813
D.bocki,140010837,463858,1,44723,0.000319425,73384203,0.524132
D.bocki,140010837,463441,1,44714,0.000319361,73428917,0.524452
D.bocki,140010837,464868,1,44664,0.000319004,73473581,0.524771
D.bocki,140010837,92434,1,44555,0.000318225,73518136,0.525089
D.bocki,140010837,458342,1,44417,0.00031724,73562553,0.525406
D.bocki,140010837,460309,1,44412,0.000317204,73606965,0.525723
D.bocki,140010837,278882,1,44412,0.000317204,73651377,0.526041
D.bocki,140010837,459984,1,44385,0.000317011,73695762,0.526358
D.bocki,140010837,464194,1,44384,0.000317004,73740146,0.526675
D.bocki,140010837,464032,1,44369,0.000316897,73784515,0.526991
D.bocki,140010837,456069,1,44308,0.000316461,73828823,0.527308
D.bocki,140010837,464235,1,44281,0.000316268,73873104,0.527624
D.bocki,140010837,464230,1,44275,0.000316226,73917379,0.52794
D.bocki,140010837,461090,1,44268,0.000316176,73961647,0.528257
D.bocki,140010837,463309,1,44249,0.00031604,74005896,0.528573
D.bocki,140010837,463605,1,44244,0.000316004,74050140,0.528889
D.bocki,140010837,463875,1,44218,0.000315818,74094358,0.529204
D.bocki,140010837,459112,1,44171,0.000315483,74138529,0.52952
D.bocki,140010837,273476,1,44141,0.000315268,74182670,0.529835
D.bocki,140010837,456435,1,44136,0.000315233,74226806,0.53015
D.bocki,140010837,462068,1,44126,0.000315161,74270932,0.530466
D.bocki,140010837,460028,1,44065,0.000314726,74314997,0.53078
D.bocki,140010837,456862,1,44048,0.000314604,74359045,0.531095
D.bocki,140010837,455940,1,44045,0.000314583,74403090,0.53141
D.bocki,140010837,458805,1,44041,0.000314554,74447131,0.531724
D.bocki,140010837,357775,1,43956,0.000313947,74491087,0.532038
D.bocki,140010837,459673,1,43865,0.000313297,74534952,0.532351
D.bocki,140010837,464918,1,43841,0.000313126,74578793,0.532664
D.bocki,140010837,458306,1,43771,0.000312626,74622564,0.532977
D.bocki,140010837,460469,1,43754,0.000312504,74666318,0.53329
D.bocki,140010837,457410,1,43727,0.000312312,74710045,0.533602
D.bocki,140010837,462563,1,43721,0.000312269,74753766,0.533914
D.bocki,140010837,456109,1,43644,0.000311719,74797410,0.534226
D.bocki,140010837,459601,1,43642,0.000311704,74841052,0.534538
D.bocki,140010837,464287,1,43602,0.000311419,74884654,0.534849
D.bocki,140010837,463781,1,43594,0.000311362,74928248,0.53516
D.bocki,140010837,458434,1,43536,0.000310947,74971784,0.535471
D.bocki,140010837,456554,1,43522,0.000310847,75015306,0.535782
D.bocki,140010837,464563,1,43486,0.00031059,75058792,0.536093
D.bocki,140010837,464888,1,43452,0.000310347,75102244,0.536403
D.bocki,140010837,464380,1,43437,0.00031024,75145681,0.536713
D.bocki,140010837,459862,1,43397,0.000309955,75189078,0.537023
D.bocki,140010837,461856,1,43280,0.000309119,75232358,0.537332
D.bocki,140010837,460340,1,43252,0.000308919,75275610,0.537641
D.bocki,140010837,461795,1,43243,0.000308855,75318853,0.53795
D.bocki,140010837,464053,1,43199,0.00030854,75362052,0.538259
D.bocki,140010837,464739,1,43170,0.000308333,75405222,0.538567
D.bocki,140010837,457119,1,43154,0.000308219,75448376,0.538875
D.bocki,140010837,461348,1,43077,0.000307669,75491453,0.539183
D.bocki,140010837,464520,1,43062,0.000307562,75534515,0.53949
D.bocki,140010837,96051,1,42972,0.000306919,75577487,0.539797
D.bocki,140010837,464654,1,42792,0.000305633,75620279,0.540103
D.bocki,140010837,456160,1,42774,0.000305505,75663053,0.540409
D.bocki,140010837,458166,1,42752,0.000305348,75705805,0.540714
D.bocki,140010837,463282,1,42734,0.000305219,75748539,0.541019
D.bocki,140010837,460274,1,42706,0.000305019,75791245,0.541324
D.bocki,140010837,464673,1,42705,0.000305012,75833950,0.541629
D.bocki,140010837,464093,1,42691,0.000304912,75876641,0.541934
D.bocki,140010837,463811,1,42676,0.000304805,75919317,0.542239
D.bocki,140010837,456226,1,42673,0.000304784,75961990,0.542544
D.bocki,140010837,459452,1,42623,0.000304426,76004613,0.542848
D.bocki,140010837,457369,1,42579,0.000304112,76047192,0.543152
D.bocki,140010837,461731,1,42529,0.000303755,76089721,0.543456
D.bocki,140010837,462121,1,42479,0.000303398,76132200,0.543759
D.bocki,140010837,459127,1,42477,0.000303384,76174677,0.544063
D.bocki,140010837,464209,1,42228,0.000301605,76216905,0.544364
D.bocki,140010837,456658,1,42224,0.000301577,76259129,0.544666
D.bocki,140010837,459670,1,42220,0.000301548,76301349,0.544967
D.bocki,140010837,244359,1,42058,0.000300391,76343407,0.545268
D.bocki,140010837,459686,1,42033,0.000300212,76385440,0.545568
D.bocki,140010837,48269,1,41980,0.000299834,76427420,0.545868
D.bocki,140010837,459856,1,41945,0.000299584,76469365,0.546167
D.bocki,140010837,465135,1,41902,0.000299277,76511267,0.546467
D.bocki,140010837,149776,1,41832,0.000298777,76553099,0.546766
D.bocki,140010837,464524,1,41784,0.000298434,76594883,0.547064
D.bocki,140010837,463675,1,41732,0.000298063,76636615,0.547362
D.bocki,140010837,249565,1,41697,0.000297813,76678312,0.54766
D.bocki,140010837,463902,1,41692,0.000297777,76720004,0.547958
D.bocki,140010837,457099,1,41625,0.000297298,76761629,0.548255
D.bocki,140010837,464651,1,41615,0.000297227,76803244,0.548552
D.bocki,140010837,457054,1,41603,0.000297141,76844847,0.548849
D.bocki,140010837,465048,1,41560,0.000296834,76886407,0.549146
D.bocki,140010837,463112,1,41555,0.000296798,76927962,0.549443
D.bocki,140010837,464460,1,41551,0.00029677,76969513,0.54974
D.bocki,140010837,460741,1,41496,0.000296377,77011009,0.550036
D.bocki,140010837,460919,1,41455,0.000296084,77052464,0.550332
D.bocki,140010837,459747,1,41412,0.000295777,77093876,0.550628
D.bocki,140010837,459066,1,41319,0.000295113,77135195,0.550923
D.bocki,140010837,464933,1,41288,0.000294891,77176483,0.551218
D.bocki,140010837,460528,1,41268,0.000294749,77217751,0.551513
D.bocki,140010837,464929,1,41255,0.000294656,77259006,0.551807
D.bocki,140010837,464593,1,41227,0.000294456,77300233,0.552102
D.bocki,140010837,461276,1,41210,0.000294334,77341443,0.552396
D.bocki,140010837,455921,1,41174,0.000294077,77382617,0.55269
D.bocki,140010837,465050,1,41167,0.000294027,77423784,0.552984
D.bocki,140010837,15343,1,41122,0.000293706,77464906,0.553278
D.bocki,140010837,459195,1,41094,0.000293506,77506000,0.553571
D.bocki,140010837,461031,1,41064,0.000293292,77547064,0.553865
D.bocki,140010837,464559,1,41055,0.000293227,77588119,0.554158
D.bocki,140010837,465075,1,41039,0.000293113,77629158,0.554451
D.bocki,140010837,460839,1,41000,0.000292834,77670158,0.554744
D.bocki,140010837,465026,1,40926,0.000292306,77711084,0.555036
D.bocki,140010837,457251,1,40890,0.000292049,77751974,0.555328
D.bocki,140010837,462587,1,40883,0.000291999,77792857,0.55562
D.bocki,140010837,459318,1,40883,0.000291999,77833740,0.555912
D.bocki,140010837,461985,1,40817,0.000291527,77874557,0.556204
D.bocki,140010837,460737,1,40786,0.000291306,77915343,0.556495
D.bocki,140010837,464264,1,40648,0.00029032,77955991,0.556785
D.bocki,140010837,461797,1,40623,0.000290142,77996614,0.557076
D.bocki,140010837,459179,1,40583,0.000289856,78037197,0.557365
D.bocki,140010837,464558,1,40578,0.00028982,78077775,0.557655
D.bocki,140010837,464472,1,40522,0.00028942,78118297,0.557945
D.bocki,140010837,460294,1,40494,0.00028922,78158791,0.558234
D.bocki,140010837,464973,1,40473,0.00028907,78199264,0.558523
D.bocki,140010837,455768,1,40473,0.00028907,78239737,0.558812
D.bocki,140010837,462695,1,40449,0.000288899,78280186,0.559101
D.bocki,140010837,463974,1,40362,0.000288278,78320548,0.559389
D.bocki,140010837,465129,1,40328,0.000288035,78360876,0.559677
D.bocki,140010837,260937,1,40312,0.000287921,78401188,0.559965
D.bocki,140010837,464626,1,40301,0.000287842,78441489,0.560253
D.bocki,140010837,460222,1,40282,0.000287706,78481771,0.560541
D.bocki,140010837,463487,1,40208,0.000287178,78521979,0.560828
D.bocki,140010837,459473,1,40193,0.000287071,78562172,0.561115
D.bocki,140010837,461118,1,40139,0.000286685,78602311,0.561402
D.bocki,140010837,459818,1,40108,0.000286464,78642419,0.561688
D.bocki,140010837,459039,1,40044,0.000286006,78682463,0.561974
D.bocki,140010837,463788,1,40041,0.000285985,78722504,0.56226
D.bocki,140010837,456314,1,40029,0.000285899,78762533,0.562546
D.bocki,140010837,459993,1,40024,0.000285864,78802557,0.562832
D.bocki,140010837,429456,1,40019,0.000285828,78842576,0.563118
D.bocki,140010837,463085,1,40014,0.000285792,78882590,0.563403
D.bocki,140010837,464798,1,39944,0.000285292,78922534,0.563689
D.bocki,140010837,456749,1,39865,0.000284728,78962399,0.563973
D.bocki,140010837,464419,1,39856,0.000284664,79002255,0.564258
D.bocki,140010837,462764,1,39850,0.000284621,79042105,0.564543
D.bocki,140010837,464336,1,39842,0.000284564,79081947,0.564827
D.bocki,140010837,458127,1,39800,0.000284264,79121747,0.565112
D.bocki,140010837,463967,1,39728,0.000283749,79161475,0.565395
D.bocki,140010837,326113,1,39652,0.000283207,79201127,0.565679
D.bocki,140010837,464217,1,39637,0.0002831,79240764,0.565962
D.bocki,140010837,464807,1,39630,0.00028305,79280394,0.566245
D.bocki,140010837,462526,1,39629,0.000283042,79320023,0.566528
D.bocki,140010837,463873,1,39592,0.000282778,79359615,0.566811
D.bocki,140010837,459497,1,39569,0.000282614,79399184,0.567093
D.bocki,140010837,461085,1,39561,0.000282557,79438745,0.567376
D.bocki,140010837,297341,1,39529,0.000282328,79478274,0.567658
D.bocki,140010837,460611,1,39527,0.000282314,79517801,0.56794
D.bocki,140010837,465017,1,39463,0.000281857,79557264,0.568222
D.bocki,140010837,234046,1,39374,0.000281221,79596638,0.568503
D.bocki,140010837,460982,1,39339,0.000280971,79635977,0.568784
D.bocki,140010837,457146,1,39313,0.000280785,79675290,0.569065
D.bocki,140010837,463200,1,39302,0.000280707,79714592,0.569346
D.bocki,140010837,459800,1,39264,0.000280435,79753856,0.569626
D.bocki,140010837,459425,1,39220,0.000280121,79793076,0.569906
D.bocki,140010837,456881,1,39214,0.000280078,79832290,0.570187
D.bocki,140010837,456260,1,39094,0.000279221,79871384,0.570466
D.bocki,140010837,464725,1,38991,0.000278486,79910375,0.570744
D.bocki,140010837,456522,1,38972,0.00027835,79949347,0.571023
D.bocki,140010837,458137,1,38894,0.000277793,79988241,0.5713
D.bocki,140010837,456307,1,38875,0.000277657,80027116,0.571578
D.bocki,140010837,460503,1,38845,0.000277443,80065961,0.571855
D.bocki,140010837,462883,1,38843,0.000277429,80104804,0.572133
D.bocki,140010837,126448,1,38732,0.000276636,80143536,0.57241
D.bocki,140010837,404540,1,38730,0.000276621,80182266,0.572686
D.bocki,140010837,464345,1,38716,0.000276521,80220982,0.572963
D.bocki,140010837,464604,1,38701,0.000276414,80259683,0.573239
D.bocki,140010837,460281,1,38668,0.000276179,80298351,0.573515
D.bocki,140010837,454597,1,38639,0.000275971,80336990,0.573791
D.bocki,140010837,465072,1,38592,0.000275636,80375582,0.574067
D.bocki,140010837,458764,1,38586,0.000275593,80414168,0.574342
D.bocki,140010837,459123,1,38545,0.0002753,80452713,0.574618
D.bocki,140010837,460492,1,38525,0.000275157,80491238,0.574893
D.bocki,140010837,464788,1,38388,0.000274179,80529626,0.575167
D.bocki,140010837,461854,1,38372,0.000274064,80567998,0.575441
D.bocki,140010837,462274,1,38306,0.000273593,80606304,0.575715
D.bocki,140010837,464591,1,38241,0.000273129,80644545,0.575988
D.bocki,140010837,459254,1,38233,0.000273072,80682778,0.576261
D.bocki,140010837,458511,1,38198,0.000272822,80720976,0.576534
D.bocki,140010837,456076,1,38176,0.000272665,80759152,0.576806
D.bocki,140010837,462286,1,38167,0.0002726,80797319,0.577079
D.bocki,140010837,463994,1,38154,0.000272507,80835473,0.577352
D.bocki,140010837,460605,1,38153,0.0002725,80873626,0.577624
D.bocki,140010837,464465,1,38125,0.0002723,80911751,0.577896
D.bocki,140010837,457805,1,38091,0.000272058,80949842,0.578168
D.bocki,140010837,464490,1,38073,0.000271929,80987915,0.57844
D.bocki,140010837,464450,1,38069,0.0002719,81025984,0.578712
D.bocki,140010837,456847,1,38023,0.000271572,81064007,0.578984
D.bocki,140010837,459205,1,38016,0.000271522,81102023,0.579255
D.bocki,140010837,464632,1,38009,0.000271472,81140032,0.579527
D.bocki,140010837,455907,1,37895,0.000270658,81177927,0.579797
D.bocki,140010837,459381,1,37865,0.000270443,81215792,0.580068
D.bocki,140010837,456450,1,37813,0.000270072,81253605,0.580338
D.bocki,140010837,464048,1,37811,0.000270058,81291416,0.580608
D.bocki,140010837,465103,1,37801,0.000269986,81329217,0.580878
D.bocki,140010837,464274,1,37785,0.000269872,81367002,0.581148
D.bocki,140010837,465140,1,37775,0.000269801,81404777,0.581418
D.bocki,140010837,24880,1,37715,0.000269372,81442492,0.581687
D.bocki,140010837,56542,1,37666,0.000269022,81480158,0.581956
D.bocki,140010837,456174,1,37618,0.000268679,81517776,0.582225
D.bocki,140010837,460002,1,37589,0.000268472,81555365,0.582493
D.bocki,140010837,464022,1,37526,0.000268022,81592891,0.582761
D.bocki,140010837,463629,1,37513,0.000267929,81630404,0.583029
D.bocki,140010837,459303,1,37510,0.000267908,81667914,0.583297
D.bocki,140010837,462369,1,37413,0.000267215,81705327,0.583564
D.bocki,140010837,452548,1,37401,0.000267129,81742728,0.583831
D.bocki,140010837,459734,1,37394,0.000267079,81780122,0.584099
D.bocki,140010837,163645,1,37366,0.000266879,81817488,0.584365
D.bocki,140010837,463782,1,37364,0.000266865,81854852,0.584632
D.bocki,140010837,465032,1,37354,0.000266794,81892206,0.584899
D.bocki,140010837,457875,1,37340,0.000266694,81929546,0.585166
D.bocki,140010837,463774,1,37334,0.000266651,81966880,0.585432
D.bocki,140010837,175358,1,37315,0.000266515,82004195,0.585699
D.bocki,140010837,185059,1,37193,0.000265644,82041388,0.585965
D.bocki,140010837,464728,1,37165,0.000265444,82078553,0.58623
D.bocki,140010837,339790,1,37160,0.000265408,82115713,0.586495
D.bocki,140010837,460700,1,37104,0.000265008,82152817,0.58676
D.bocki,140010837,460665,1,37034,0.000264508,82189851,0.587025
D.bocki,140010837,335701,1,37030,0.00026448,82226881,0.587289
D.bocki,140010837,42282,1,37004,0.000264294,82263885,0.587554
D.bocki,140010837,464884,1,36966,0.000264022,82300851,0.587818
D.bocki,140010837,464497,1,36887,0.000263458,82337738,0.588081
D.bocki,140010837,457108,1,36882,0.000263422,82374620,0.588345
D.bocki,140010837,463600,1,36810,0.000262908,82411430,0.588608
D.bocki,140010837,464794,1,36791,0.000262773,82448221,0.58887
D.bocki,140010837,457825,1,36673,0.00026193,82484894,0.589132
D.bocki,140010837,39822,1,36665,0.000261873,82521559,0.589394
D.bocki,140010837,462808,1,36657,0.000261815,82558216,0.589656
D.bocki,140010837,464646,1,36540,0.00026098,82594756,0.589917
D.bocki,140010837,3525,1,36508,0.000260751,82631264,0.590178
D.bocki,140010837,463483,1,36430,0.000260194,82667694,0.590438
D.bocki,140010837,463226,1,36415,0.000260087,82704109,0.590698
D.bocki,140010837,456395,1,36402,0.000259994,82740511,0.590958
D.bocki,140010837,456330,1,36346,0.000259594,82776857,0.591217
D.bocki,140010837,460191,1,36333,0.000259501,82813190,0.591477
D.bocki,140010837,457196,1,36323,0.00025943,82849513,0.591736
D.bocki,140010837,455968,1,36276,0.000259094,82885789,0.591996
D.bocki,140010837,461852,1,36218,0.00025868,82922007,0.592254
D.bocki,140010837,464117,1,36192,0.000258494,82958199,0.592513
D.bocki,140010837,458406,1,36166,0.000258309,82994365,0.592771
D.bocki,140010837,462890,1,36142,0.000258137,83030507,0.593029
D.bocki,140010837,458267,1,36122,0.000257994,83066629,0.593287
D.bocki,140010837,462024,1,35992,0.000257066,83102621,0.593544
D.bocki,140010837,410954,1,35992,0.000257066,83138613,0.593801
D.bocki,140010837,464941,1,35989,0.000257044,83174602,0.594058
D.bocki,140010837,456269,1,35965,0.000256873,83210567,0.594315
D.bocki,140010837,457025,1,35946,0.000256737,83246513,0.594572
D.bocki,140010837,464163,1,35916,0.000256523,83282429,0.594828
D.bocki,140010837,461645,1,35831,0.000255916,83318260,0.595084
D.bocki,140010837,290122,1,35826,0.00025588,83354086,0.59534
D.bocki,140010837,464844,1,35806,0.000255737,83389892,0.595596
D.bocki,140010837,464222,1,35805,0.00025573,83425697,0.595852
D.bocki,140010837,464940,1,35798,0.00025568,83461495,0.596107
D.bocki,140010837,372062,1,35798,0.00025568,83497293,0.596363
D.bocki,140010837,462487,1,35746,0.000255309,83533039,0.596618
D.bocki,140010837,461621,1,35728,0.00025518,83568767,0.596874
D.bocki,140010837,464253,1,35725,0.000255159,83604492,0.597129
D.bocki,140010837,456533,1,35722,0.000255137,83640214,0.597384
D.bocki,140010837,456775,1,35713,0.000255073,83675927,0.597639
D.bocki,140010837,459557,1,35712,0.000255066,83711639,0.597894
D.bocki,140010837,460495,1,35693,0.00025493,83747332,0.598149
D.bocki,140010837,458422,1,35679,0.00025483,83783011,0.598404
D.bocki,140010837,459158,1,35644,0.00025458,83818655,0.598658
D.bocki,140010837,458620,1,35510,0.000253623,83854165,0.598912
D.bocki,140010837,462628,1,35339,0.000252402,83889504,0.599164
D.bocki,140010837,464999,1,35318,0.000252252,83924822,0.599417
D.bocki,140010837,365819,1,35304,0.000252152,83960126,0.599669
D.bocki,140010837,457602,1,35300,0.000252123,83995426,0.599921
D.bocki,140010837,462079,1,35276,0.000251952,84030702,0.600173
D.bocki,140010837,462092,1,35196,0.000251381,84065898,0.600424
D.bocki,140010837,462049,1,35191,0.000251345,84101089,0.600676
D.bocki,140010837,461623,1,35158,0.000251109,84136247,0.600927
D.bocki,140010837,465145,1,35139,0.000250973,84171386,0.601178
D.bocki,140010837,464887,1,35020,0.000250123,84206406,0.601428
D.bocki,140010837,460144,1,34906,0.000249309,84241312,0.601677
D.bocki,140010837,458924,1,34777,0.000248388,84276089,0.601925
D.bocki,140010837,463934,1,34775,0.000248374,84310864,0.602174
D.bocki,140010837,464072,1,34754,0.000248224,84345618,0.602422
D.bocki,140010837,459131,1,34741,0.000248131,84380359,0.60267
D.bocki,140010837,460610,1,34630,0.000247338,84414989,0.602918
D.bocki,140010837,461734,1,34626,0.000247309,84449615,0.603165
D.bocki,140010837,457013,1,34611,0.000247202,84484226,0.603412
D.bocki,140010837,173246,1,34600,0.000247124,84518826,0.603659
D.bocki,140010837,464455,1,34593,0.000247074,84553419,0.603906
D.bocki,140010837,464717,1,34544,0.000246724,84587963,0.604153
D.bocki,140010837,459485,1,34476,0.000246238,84622439,0.604399
D.bocki,140010837,46057,1,34466,0.000246167,84656905,0.604645
D.bocki,140010837,460936,1,34353,0.00024536,84691258,0.604891
D.bocki,140010837,464484,1,34239,0.000244545,84725497,0.605135
D.bocki,140010837,465023,1,34196,0.000244238,84759693,0.60538
D.bocki,140010837,462377,1,34184,0.000244153,84793877,0.605624
D.bocki,140010837,463751,1,34147,0.000243888,84828024,0.605868
D.bocki,140010837,461530,1,34126,0.000243738,84862150,0.606111
D.bocki,140010837,362089,1,34117,0.000243674,84896267,0.606355
D.bocki,140010837,460247,1,34095,0.000243517,84930362,0.606598
D.bocki,140010837,464791,1,33996,0.00024281,84964358,0.606841
D.bocki,140010837,459541,1,33966,0.000242596,84998324,0.607084
D.bocki,140010837,459384,1,33958,0.000242538,85032282,0.607326
D.bocki,140010837,461079,1,33901,0.000242131,85066183,0.607569
D.bocki,140010837,464432,1,33798,0.000241396,85099981,0.60781
D.bocki,140010837,456601,1,33795,0.000241374,85133776,0.608051
D.bocki,140010837,459761,1,33777,0.000241246,85167553,0.608293
D.bocki,140010837,462328,1,33743,0.000241003,85201296,0.608534
D.bocki,140010837,463312,1,33690,0.000240624,85234986,0.608774
D.bocki,140010837,461228,1,33658,0.000240396,85268644,0.609015
D.bocki,140010837,463643,1,33649,0.000240331,85302293,0.609255
D.bocki,140010837,463985,1,33636,0.000240239,85335929,0.609495
D.bocki,140010837,464280,1,33624,0.000240153,85369553,0.609735
D.bocki,140010837,460087,1,33612,0.000240067,85403165,0.609975
D.bocki,140010837,460527,1,33585,0.000239874,85436750,0.610215
D.bocki,140010837,457609,1,33556,0.000239667,85470306,0.610455
D.bocki,140010837,456122,1,33541,0.00023956,85503847,0.610694
D.bocki,140010837,464371,1,33524,0.000239439,85537371,0.610934
D.bocki,140010837,463564,1,33499,0.00023926,85570870,0.611173
D.bocki,140010837,464691,1,33478,0.00023911,85604348,0.611412
D.bocki,140010837,459092,1,33356,0.000238239,85637704,0.611651
D.bocki,140010837,464907,1,33347,0.000238174,85671051,0.611889
D.bocki,140010837,464667,1,33343,0.000238146,85704394,0.612127
D.bocki,140010837,461571,1,33330,0.000238053,85737724,0.612365
D.bocki,140010837,460545,1,33324,0.00023801,85771048,0.612603
D.bocki,140010837,463871,1,33296,0.00023781,85804344,0.612841
D.bocki,140010837,463894,1,33291,0.000237774,85837635,0.613079
D.bocki,140010837,461958,1,33286,0.000237739,85870921,0.613316
D.bocki,140010837,99996,1,33283,0.000237717,85904204,0.613554
D.bocki,140010837,457588,1,33280,0.000237696,85937484,0.613792
D.bocki,140010837,458377,1,33243,0.000237432,85970727,0.614029
D.bocki,140010837,457343,1,33192,0.000237067,86003919,0.614266
D.bocki,140010837,462500,1,33165,0.000236875,86037084,0.614503
D.bocki,140010837,463383,1,33164,0.000236867,86070248,0.61474
D.bocki,140010837,457578,1,33160,0.000236839,86103408,0.614977
D.bocki,140010837,464463,1,33142,0.00023671,86136550,0.615213
D.bocki,140010837,464366,1,33135,0.00023666,86169685,0.61545
D.bocki,140010837,458243,1,33124,0.000236582,86202809,0.615687
D.bocki,140010837,463674,1,33100,0.00023641,86235909,0.615923
D.bocki,140010837,464688,1,33091,0.000236346,86269000,0.616159
D.bocki,140010837,457714,1,33089,0.000236332,86302089,0.616396
D.bocki,140010837,456944,1,33074,0.000236225,86335163,0.616632
D.bocki,140010837,456427,1,33065,0.00023616,86368228,0.616868
D.bocki,140010837,463480,1,33056,0.000236096,86401284,0.617104
D.bocki,140010837,464471,1,33026,0.000235882,86434310,0.61734
D.bocki,140010837,450803,1,33024,0.000235867,86467334,0.617576
D.bocki,140010837,458850,1,33011,0.000235775,86500345,0.617812
D.bocki,140010837,458874,1,33002,0.00023571,86533347,0.618047
D.bocki,140010837,377877,1,32974,0.00023551,86566321,0.618283
D.bocki,140010837,456778,1,32962,0.000235425,86599283,0.618518
D.bocki,140010837,464572,1,32961,0.000235417,86632244,0.618754
D.bocki,140010837,458586,1,32929,0.000235189,86665173,0.618989
D.bocki,140010837,464424,1,32910,0.000235053,86698083,0.619224
D.bocki,140010837,464367,1,32787,0.000234175,86730870,0.619458
D.bocki,140010837,363512,1,32767,0.000234032,86763637,0.619692
D.bocki,140010837,459216,1,32765,0.000234018,86796402,0.619926
D.bocki,140010837,464385,1,32757,0.00023396,86829159,0.62016
D.bocki,140010837,457598,1,32755,0.000233946,86861914,0.620394
D.bocki,140010837,460514,1,32736,0.00023381,86894650,0.620628
D.bocki,140010837,459559,1,32730,0.000233768,86927380,0.620862
D.bocki,140010837,462472,1,32707,0.000233603,86960087,0.621095
D.bocki,140010837,456648,1,32684,0.000233439,86992771,0.621329
D.bocki,140010837,464993,1,32672,0.000233353,87025443,0.621562
D.bocki,140010837,7939,1,32664,0.000233296,87058107,0.621795
D.bocki,140010837,463968,1,32664,0.000233296,87090771,0.622029
D.bocki,140010837,460407,1,32652,0.000233211,87123423,0.622262
D.bocki,140010837,457448,1,32608,0.000232896,87156031,0.622495
D.bocki,140010837,464242,1,32590,0.000232768,87188621,0.622728
D.bocki,140010837,14530,1,32588,0.000232753,87221209,0.62296
D.bocki,140010837,461311,1,32578,0.000232682,87253787,0.623193
D.bocki,140010837,459865,1,32538,0.000232396,87286325,0.623425
D.bocki,140010837,214128,1,32533,0.000232361,87318858,0.623658
D.bocki,140010837,460050,1,32523,0.000232289,87351381,0.62389
D.bocki,140010837,457508,1,32456,0.000231811,87383837,0.624122
D.bocki,140010837,348240,1,32445,0.000231732,87416282,0.624354
D.bocki,140010837,64117,1,32430,0.000231625,87448712,0.624585
D.bocki,140010837,464721,1,32405,0.000231446,87481117,0.624817
D.bocki,140010837,457331,1,32401,0.000231418,87513518,0.625048
D.bocki,140010837,464616,1,32380,0.000231268,87545898,0.625279
D.bocki,140010837,462799,1,32376,0.000231239,87578274,0.625511
D.bocki,140010837,463812,1,32355,0.000231089,87610629,0.625742
D.bocki,140010837,459803,1,32351,0.000231061,87642980,0.625973
D.bocki,140010837,456118,1,32333,0.000230932,87675313,0.626204
D.bocki,140010837,463612,1,32301,0.000230704,87707614,0.626434
D.bocki,140010837,457546,1,32189,0.000229904,87739803,0.626664
D.bocki,140010837,462693,1,32148,0.000229611,87771951,0.626894
D.bocki,140010837,464978,1,32128,0.000229468,87804079,0.627123
D.bocki,140010837,464765,1,32058,0.000228968,87836137,0.627352
D.bocki,140010837,464368,1,32057,0.000228961,87868194,0.627581
D.bocki,140010837,455901,1,32056,0.000228954,87900250,0.62781
D.bocki,140010837,279039,1,32055,0.000228947,87932305,0.628039
D.bocki,140010837,456204,1,32046,0.000228882,87964351,0.628268
D.bocki,140010837,462711,1,32024,0.000228725,87996375,0.628497
D.bocki,140010837,460846,1,32015,0.000228661,88028390,0.628726
D.bocki,140010837,461862,1,31983,0.000228432,88060373,0.628954
D.bocki,140010837,455874,1,31973,0.000228361,88092346,0.629182
D.bocki,140010837,464613,1,31920,0.000227982,88124266,0.62941
D.bocki,140010837,464223,1,31869,0.000227618,88156135,0.629638
D.bocki,140010837,463946,1,31847,0.000227461,88187982,0.629865
D.bocki,140010837,461669,1,31816,0.00022724,88219798,0.630093
D.bocki,140010837,458341,1,31790,0.000227054,88251588,0.63032
D.bocki,140010837,462546,1,31778,0.000226968,88283366,0.630547
D.bocki,140010837,464266,1,31775,0.000226947,88315141,0.630774
D.bocki,140010837,459832,1,31764,0.000226868,88346905,0.631
D.bocki,140010837,462118,1,31730,0.000226625,88378635,0.631227
D.bocki,140010837,464500,1,31698,0.000226397,88410333,0.631453
D.bocki,140010837,456961,1,31668,0.000226182,88442001,0.63168
D.bocki,140010837,459478,1,31664,0.000226154,88473665,0.631906
D.bocki,140010837,308256,1,31659,0.000226118,88505324,0.632132
D.bocki,140010837,458256,1,31644,0.000226011,88536968,0.632358
D.bocki,140010837,459773,1,31625,0.000225875,88568593,0.632584
D.bocki,140010837,458138,1,31615,0.000225804,88600208,0.63281
D.bocki,140010837,460044,1,31586,0.000225597,88631794,0.633035
D.bocki,140010837,461068,1,31533,0.000225218,88663327,0.63326
D.bocki,140010837,464985,1,31529,0.00022519,88694856,0.633486
D.bocki,140010837,227072,1,31498,0.000224968,88726354,0.633711
D.bocki,140010837,72636,1,31494,0.00022494,88757848,0.633936
D.bocki,140010837,464491,1,31480,0.00022484,88789328,0.63416
D.bocki,140010837,456622,1,31466,0.00022474,88820794,0.634385
D.bocki,140010837,455740,1,31417,0.00022439,88852211,0.63461
D.bocki,140010837,134521,1,31400,0.000224268,88883611,0.634834
D.bocki,140010837,459592,1,31364,0.000224011,88914975,0.635058
D.bocki,140010837,236213,1,31362,0.000223997,88946337,0.635282
D.bocki,140010837,153515,1,31335,0.000223804,88977672,0.635506
D.bocki,140010837,462899,1,31321,0.000223704,89008993,0.635729
D.bocki,140010837,463844,1,31311,0.000223633,89040304,0.635953
D.bocki,140010837,290381,1,31200,0.00022284,89071504,0.636176
D.bocki,140010837,460984,1,31143,0.000222433,89102647,0.636398
D.bocki,140010837,456892,1,31140,0.000222411,89133787,0.636621
D.bocki,140010837,456213,1,31132,0.000222354,89164919,0.636843
D.bocki,140010837,455916,1,31131,0.000222347,89196050,0.637065
D.bocki,140010837,458347,1,31119,0.000222261,89227169,0.637288
D.bocki,140010837,464900,1,31117,0.000222247,89258286,0.63751
D.bocki,140010837,465108,1,31088,0.00022204,89289374,0.637732
D.bocki,140010837,464571,1,30971,0.000221204,89320345,0.637953
D.bocki,140010837,457556,1,30970,0.000221197,89351315,0.638174
D.bocki,140010837,456839,1,30963,0.000221147,89382278,0.638395
D.bocki,140010837,22055,1,30941,0.00022099,89413219,0.638616
D.bocki,140010837,461199,1,30929,0.000220904,89444148,0.638837
D.bocki,140010837,459804,1,30913,0.00022079,89475061,0.639058
D.bocki,140010837,463917,1,30880,0.000220554,89505941,0.639279
D.bocki,140010837,458683,1,30879,0.000220547,89536820,0.639499
D.bocki,140010837,456210,1,30868,0.000220469,89567688,0.63972
D.bocki,140010837,457079,1,30856,0.000220383,89598544,0.63994
D.bocki,140010837,180379,1,30828,0.000220183,89629372,0.64016
D.bocki,140010837,464400,1,30814,0.000220083,89660186,0.64038
D.bocki,140010837,463886,1,30804,0.000220012,89690990,0.6406
D.bocki,140010837,22481,1,30776,0.000219812,89721766,0.64082
D.bocki,140010837,461144,1,30745,0.00021959,89752511,0.64104
D.bocki,140010837,464871,1,30657,0.000218962,89783168,0.641259
D.bocki,140010837,346459,1,30652,0.000218926,89813820,0.641478
D.bocki,140010837,464890,1,30642,0.000218854,89844462,0.641696
D.bocki,140010837,459885,1,30634,0.000218797,89875096,0.641915
D.bocki,140010837,459186,1,30630,0.000218769,89905726,0.642134
D.bocki,140010837,464141,1,30622,0.000218712,89936348,0.642353
D.bocki,140010837,310441,1,30575,0.000218376,89966923,0.642571
D.bocki,140010837,464566,1,30489,0.000217762,89997412,0.642789
D.bocki,140010837,464076,1,30467,0.000217605,90027879,0.643007
D.bocki,140010837,459445,1,30458,0.00021754,90058337,0.643224
D.bocki,140010837,458299,1,30406,0.000217169,90088743,0.643441
D.bocki,140010837,460265,1,30340,0.000216698,90119083,0.643658
D.bocki,140010837,463593,1,30338,0.000216683,90149421,0.643875
D.bocki,140010837,459643,1,30308,0.000216469,90179729,0.644091
D.bocki,140010837,455885,1,30284,0.000216298,90210013,0.644307
D.bocki,140010837,458559,1,30246,0.000216026,90240259,0.644523
D.bocki,140010837,464543,1,30237,0.000215962,90270496,0.644739
D.bocki,140010837,464066,1,30219,0.000215833,90300715,0.644955
D.bocki,140010837,463352,1,30199,0.00021569,90330914,0.645171
D.bocki,140010837,458593,1,30198,0.000215683,90361112,0.645387
D.bocki,140010837,465068,1,30166,0.000215455,90391278,0.645602
D.bocki,140010837,464125,1,30137,0.000215248,90421415,0.645817
D.bocki,140010837,346335,1,30127,0.000215176,90451542,0.646032
D.bocki,140010837,459389,1,30113,0.000215076,90481655,0.646248
D.bocki,140010837,455746,1,30106,0.000215026,90511761,0.646463
D.bocki,140010837,465033,1,30075,0.000214805,90541836,0.646677
D.bocki,140010837,461023,1,30071,0.000214776,90571907,0.646892
D.bocki,140010837,460133,1,30062,0.000214712,90601969,0.647107
D.bocki,140010837,460275,1,30046,0.000214598,90632015,0.647321
D.bocki,140010837,457993,1,30023,0.000214433,90662038,0.647536
D.bocki,140010837,84031,1,30019,0.000214405,90692057,0.64775
D.bocki,140010837,457651,1,30015,0.000214376,90722072,0.647965
D.bocki,140010837,463744,1,30008,0.000214326,90752080,0.648179
D.bocki,140010837,459505,1,29999,0.000214262,90782079,0.648393
D.bocki,140010837,458227,1,29985,0.000214162,90812064,0.648607
D.bocki,140010837,456599,1,29932,0.000213783,90841996,0.648821
D.bocki,140010837,464256,1,29928,0.000213755,90871924,0.649035
D.bocki,140010837,463578,1,29909,0.000213619,90901833,0.649249
D.bocki,140010837,38622,1,29902,0.000213569,90931735,0.649462
D.bocki,140010837,464762,1,29897,0.000213533,90961632,0.649676
D.bocki,140010837,458110,1,29887,0.000213462,90991519,0.649889
D.bocki,140010837,461779,1,29858,0.000213255,91021377,0.650102
D.bocki,140010837,463900,1,29841,0.000213134,91051218,0.650316
D.bocki,140010837,459125,1,29815,0.000212948,91081033,0.650528
D.bocki,140010837,464980,1,29788,0.000212755,91110821,0.650741
D.bocki,140010837,457348,1,29784,0.000212726,91140605,0.650954
D.bocki,140010837,464827,1,29769,0.000212619,91170374,0.651167
D.bocki,140010837,464474,1,29766,0.000212598,91200140,0.651379
D.bocki,140010837,462277,1,29674,0.000211941,91229814,0.651591
D.bocki,140010837,464352,1,29670,0.000211912,91259484,0.651803
D.bocki,140010837,461421,1,29649,0.000211762,91289133,0.652015
D.bocki,140010837,464659,1,29603,0.000211434,91318736,0.652226
D.bocki,140010837,465058,1,29601,0.000211419,91348337,0.652438
D.bocki,140010837,459223,1,29563,0.000211148,91377900,0.652649
D.bocki,140010837,392016,1,29547,0.000211034,91407447,0.65286
D.bocki,140010837,462668,1,29511,0.000210777,91436958,0.653071
D.bocki,140010837,465000,1,29429,0.000210191,91466387,0.653281
D.bocki,140010837,457699,1,29401,0.000209991,91495788,0.653491
D.bocki,140010837,460258,1,29400,0.000209984,91525188,0.653701
D.bocki,140010837,458573,1,29312,0.000209355,91554500,0.65391
D.bocki,140010837,465112,1,29282,0.000209141,91583782,0.654119
D.bocki,140010837,465147,1,29258,0.00020897,91613040,0.654328
D.bocki,140010837,461535,1,29229,0.000208762,91642269,0.654537
D.bocki,140010837,464658,1,29197,0.000208534,91671466,0.654746
D.bocki,140010837,461655,1,29177,0.000208391,91700643,0.654954
D.bocki,140010837,464396,1,29164,0.000208298,91729807,0.655162
D.bocki,140010837,465009,1,29161,0.000208277,91758968,0.65537
D.bocki,140010837,456481,1,29145,0.000208162,91788113,0.655579
D.bocki,140010837,465053,1,29131,0.000208062,91817244,0.655787
D.bocki,140010837,462200,1,29018,0.000207255,91846262,0.655994
D.bocki,140010837,457542,1,29011,0.000207205,91875273,0.656201
D.bocki,140010837,458709,1,29005,0.000207163,91904278,0.656408
D.bocki,140010837,458795,1,28970,0.000206913,91933248,0.656615
D.bocki,140010837,460760,1,28891,0.000206348,91962139,0.656822
D.bocki,140010837,460443,1,28888,0.000206327,91991027,0.657028
D.bocki,140010837,464291,1,28877,0.000206248,92019904,0.657234
D.bocki,140010837,465057,1,28844,0.000206013,92048748,0.65744
D.bocki,140010837,459233,1,28844,0.000206013,92077592,0.657646
D.bocki,140010837,461136,1,28756,0.000205384,92106348,0.657852
D.bocki,140010837,465047,1,28720,0.000205127,92135068,0.658057
D.bocki,140010837,221779,1,28719,0.00020512,92163787,0.658262
D.bocki,140010837,456228,1,28700,0.000204984,92192487,0.658467
D.bocki,140010837,461733,1,28696,0.000204956,92221183,0.658672
D.bocki,140010837,464210,1,28641,0.000204563,92249824,0.658876
D.bocki,140010837,462126,1,28639,0.000204548,92278463,0.659081
D.bocki,140010837,463847,1,28558,0.00020397,92307021,0.659285
D.bocki,140010837,456680,1,28552,0.000203927,92335573,0.659489
D.bocki,140010837,134891,1,28500,0.000203556,92364073,0.659692
D.bocki,140010837,465044,1,28466,0.000203313,92392539,0.659896
D.bocki,140010837,456858,1,28466,0.000203313,92421005,0.660099
D.bocki,140010837,458773,1,28457,0.000203249,92449462,0.660302
D.bocki,140010837,464351,1,28455,0.000203234,92477917,0.660505
D.bocki,140010837,457908,1,28427,0.000203034,92506344,0.660708
D.bocki,140010837,455709,1,28426,0.000203027,92534770,0.660911
D.bocki,140010837,54048,1,28415,0.000202949,92563185,0.661114
D.bocki,140010837,456364,1,28375,0.000202663,92591560,0.661317
D.bocki,140010837,455994,1,28372,0.000202641,92619932,0.66152
D.bocki,140010837,175357,1,28336,0.000202384,92648268,0.661722
D.bocki,140010837,456163,1,28327,0.00020232,92676595,0.661924
D.bocki,140010837,459996,1,28324,0.000202299,92704919,0.662127
D.bocki,140010837,134860,1,28304,0.000202156,92733223,0.662329
D.bocki,140010837,464027,1,28303,0.000202149,92761526,0.662531
D.bocki,140010837,459732,1,28296,0.000202099,92789822,0.662733
D.bocki,140010837,458724,1,28234,0.000201656,92818056,0.662935
D.bocki,140010837,463820,1,28205,0.000201449,92846261,0.663136
D.bocki,140010837,458448,1,28202,0.000201427,92874463,0.663338
D.bocki,140010837,458816,1,28191,0.000201349,92902654,0.663539
D.bocki,140010837,461989,1,28190,0.000201342,92930844,0.66374
D.bocki,140010837,463995,1,28144,0.000201013,92958988,0.663941
D.bocki,140010837,459836,1,28084,0.000200584,92987072,0.664142
D.bocki,140010837,461554,1,28052,0.000200356,93015124,0.664342
D.bocki,140010837,459985,1,28051,0.000200349,93043175,0.664543
D.bocki,140010837,207247,1,28016,0.000200099,93071191,0.664743
D.bocki,140010837,464172,1,28011,0.000200063,93099202,0.664943
D.bocki,140010837,458549,1,28009,0.000200049,93127211,0.665143
D.bocki,140010837,118149,1,27994,0.000199942,93155205,0.665343
D.bocki,140010837,457745,1,27975,0.000199806,93183180,0.665543
D.bocki,140010837,464216,1,27954,0.000199656,93211134,0.665742
D.bocki,140010837,456041,1,27931,0.000199492,93239065,0.665942
D.bocki,140010837,464189,1,27895,0.000199235,93266960,0.666141
D.bocki,140010837,461032,1,27845,0.000198877,93294805,0.66634
D.bocki,140010837,455918,1,27820,0.000198699,93322625,0.666539
D.bocki,140010837,463940,1,27817,0.000198677,93350442,0.666737
D.bocki,140010837,462062,1,27813,0.000198649,93378255,0.666936
D.bocki,140010837,463499,1,27800,0.000198556,93406055,0.667134
D.bocki,140010837,458174,1,27771,0.000198349,93433826,0.667333
D.bocki,140010837,457130,1,27754,0.000198228,93461580,0.667531
D.bocki,140010837,464944,1,27698,0.000197828,93489278,0.667729
D.bocki,140010837,463403,1,27633,0.000197363,93516911,0.667926
D.bocki,140010837,463786,1,27630,0.000197342,93544541,0.668124
D.bocki,140010837,462173,1,27614,0.000197228,93572155,0.668321
D.bocki,140010837,460751,1,27612,0.000197213,93599767,0.668518
D.bocki,140010837,460214,1,27599,0.00019712,93627366,0.668715
D.bocki,140010837,464388,1,27595,0.000197092,93654961,0.668912
D.bocki,140010837,464994,1,27571,0.00019692,93682532,0.669109
D.bocki,140010837,462208,1,27505,0.000196449,93710037,0.669306
D.bocki,140010837,459661,1,27478,0.000196256,93737515,0.669502
D.bocki,140010837,460266,1,27445,0.000196021,93764960,0.669698
D.bocki,140010837,462236,1,27439,0.000195978,93792399,0.669894
D.bocki,140010837,456580,1,27429,0.000195906,93819828,0.67009
D.bocki,140010837,458864,1,27426,0.000195885,93847254,0.670286
D.bocki,140010837,427889,1,27415,0.000195806,93874669,0.670481
D.bocki,140010837,7537,1,27402,0.000195713,93902071,0.670677
D.bocki,140010837,461590,1,27378,0.000195542,93929449,0.670873
D.bocki,140010837,461656,1,27367,0.000195463,93956816,0.671068
D.bocki,140010837,459011,1,27346,0.000195313,93984162,0.671263
D.bocki,140010837,458628,1,27346,0.000195313,94011508,0.671459
D.bocki,140010837,457236,1,27336,0.000195242,94038844,0.671654
D.bocki,140010837,461684,1,27320,0.000195128,94066164,0.671849
D.bocki,140010837,465097,1,27247,0.000194606,94093411,0.672044
D.bocki,140010837,464751,1,27239,0.000194549,94120650,0.672238
D.bocki,140010837,464247,1,27188,0.000194185,94147838,0.672433
D.bocki,140010837,459336,1,27185,0.000194164,94175023,0.672627
D.bocki,140010837,456973,1,27184,0.000194156,94202207,0.672821
D.bocki,140010837,458204,1,27178,0.000194114,94229385,0.673015
D.bocki,140010837,459775,1,27176,0.000194099,94256561,0.673209
D.bocki,140010837,459968,1,27175,0.000194092,94283736,0.673403
D.bocki,140010837,31058,1,27169,0.000194049,94310905,0.673597
D.bocki,140010837,456137,1,27164,0.000194014,94338069,0.673791
D.bocki,140010837,464288,1,27162,0.000193999,94365231,0.673985
D.bocki,140010837,460023,1,27130,0.000193771,94392361,0.674179
D.bocki,140010837,464726,1,27098,0.000193542,94419459,0.674373
D.bocki,140010837,456809,1,27075,0.000193378,94446534,0.674566
D.bocki,140010837,459962,1,27073,0.000193364,94473607,0.674759
D.bocki,140010837,461142,1,27069,0.000193335,94500676,0.674953
D.bocki,140010837,460904,1,27049,0.000193192,94527725,0.675146
D.bocki,140010837,458101,1,27020,0.000192985,94554745,0.675339
D.bocki,140010837,456994,1,26990,0.000192771,94581735,0.675532
D.bocki,140010837,459760,1,26979,0.000192692,94608714,0.675724
D.bocki,140010837,461475,1,26968,0.000192614,94635682,0.675917
D.bocki,140010837,462347,1,26957,0.000192535,94662639,0.676109
D.bocki,140010837,464800,1,26948,0.000192471,94689587,0.676302
D.bocki,140010837,458286,1,26893,0.000192078,94716480,0.676494
D.bocki,140010837,464539,1,26884,0.000192014,94743364,0.676686
D.bocki,140010837,464451,1,26858,0.000191828,94770222,0.676878
D.bocki,140010837,464480,1,26852,0.000191785,94797074,0.67707
D.bocki,140010837,460770,1,26798,0.000191399,94823872,0.677261
D.bocki,140010837,456047,1,26786,0.000191314,94850658,0.677452
D.bocki,140010837,461857,1,26759,0.000191121,94877417,0.677643
D.bocki,140010837,457837,1,26734,0.000190942,94904151,0.677834
D.bocki,140010837,462401,1,26732,0.000190928,94930883,0.678025
D.bocki,140010837,463717,1,26702,0.000190714,94957585,0.678216
D.bocki,140010837,458539,1,26680,0.000190557,94984265,0.678407
D.bocki,140010837,458987,1,26641,0.000190278,95010906,0.678597
D.bocki,140010837,259455,1,26615,0.000190092,95037521,0.678787
D.bocki,140010837,459051,1,26560,0.0001897,95064081,0.678977
D.bocki,140010837,460840,1,26550,0.000189628,95090631,0.679166
D.bocki,140010837,460215,1,26547,0.000189607,95117178,0.679356
D.bocki,140010837,463472,1,26480,0.000189128,95143658,0.679545
D.bocki,140010837,456354,1,26476,0.0001891,95170134,0.679734
D.bocki,140010837,462844,1,26470,0.000189057,95196604,0.679923
D.bocki,140010837,459315,1,26460,0.000188985,95223064,0.680112
D.bocki,140010837,461844,1,26451,0.000188921,95249515,0.680301
D.bocki,140010837,459901,1,26449,0.000188907,95275964,0.68049
D.bocki,140010837,463214,1,26447,0.000188893,95302411,0.680679
D.bocki,140010837,458045,1,26443,0.000188864,95328854,0.680868
D.bocki,140010837,463656,1,26438,0.000188828,95355292,0.681057
D.bocki,140010837,461442,1,26431,0.000188778,95381723,0.681245
D.bocki,140010837,462234,1,26404,0.000188585,95408127,0.681434
D.bocki,140010837,456535,1,26346,0.000188171,95434473,0.681622
D.bocki,140010837,458589,1,26342,0.000188143,95460815,0.68181
D.bocki,140010837,457584,1,26289,0.000187764,95487104,0.681998
D.bocki,140010837,464281,1,26270,0.000187628,95513374,0.682186
D.bocki,140010837,464392,1,26203,0.00018715,95539577,0.682373
D.bocki,140010837,457958,1,26202,0.000187143,95565779,0.68256
D.bocki,140010837,464638,1,26197,0.000187107,95591976,0.682747
D.bocki,140010837,462502,1,26193,0.000187078,95618169,0.682934
D.bocki,140010837,457654,1,26188,0.000187043,95644357,0.683121
D.bocki,140010837,232603,1,26170,0.000186914,95670527,0.683308
D.bocki,140010837,464436,1,26123,0.000186578,95696650,0.683495
D.bocki,140010837,376871,1,26122,0.000186571,95722772,0.683681
D.bocki,140010837,464943,1,26116,0.000186528,95748888,0.683868
D.bocki,140010837,461564,1,26116,0.000186528,95775004,0.684054
D.bocki,140010837,459532,1,26079,0.000186264,95801083,0.68424
D.bocki,140010837,463750,1,26056,0.0001861,95827139,0.684427
D.bocki,140010837,463905,1,26055,0.000186093,95853194,0.684613
D.bocki,140010837,462028,1,26037,0.000185964,95879231,0.684799
D.bocki,140010837,457802,1,26011,0.000185778,95905242,0.684984
D.bocki,140010837,460702,1,26010,0.000185771,95931252,0.68517
D.bocki,140010837,464946,1,25997,0.000185678,95957249,0.685356
D.bocki,140010837,458382,1,25961,0.000185421,95983210,0.685541
D.bocki,140010837,463925,1,25938,0.000185257,96009148,0.685727
D.bocki,140010837,112236,1,25930,0.0001852,96035078,0.685912
D.bocki,140010837,459919,1,25922,0.000185143,96061000,0.686097
D.bocki,140010837,139947,1,25906,0.000185029,96086906,0.686282
D.bocki,140010837,462612,1,25844,0.000184586,96112750,0.686467
D.bocki,140010837,461603,1,25831,0.000184493,96138581,0.686651
D.bocki,140010837,463428,1,25815,0.000184379,96164396,0.686835
D.bocki,140010837,461833,1,25815,0.000184379,96190211,0.68702
D.bocki,140010837,327492,1,25815,0.000184379,96216026,0.687204
D.bocki,140010837,440032,1,25798,0.000184257,96241824,0.687388
D.bocki,140010837,460759,1,25794,0.000184229,96267618,0.687573
D.bocki,140010837,464389,1,25793,0.000184221,96293411,0.687757
D.bocki,140010837,455835,1,25777,0.000184107,96319188,0.687941
D.bocki,140010837,463945,1,25735,0.000183807,96344923,0.688125
D.bocki,140010837,463294,1,25711,0.000183636,96370634,0.688308
D.bocki,140010837,464885,1,25686,0.000183457,96396320,0.688492
D.bocki,140010837,464779,1,25647,0.000183179,96421967,0.688675
D.bocki,140010837,457350,1,25541,0.000182422,96447508,0.688857
D.bocki,140010837,462010,1,25498,0.000182114,96473006,0.68904
D.bocki,140010837,462698,1,25497,0.000182107,96498503,0.689222
D.bocki,140010837,464248,1,25495,0.000182093,96523998,0.689404
D.bocki,140010837,457732,1,25486,0.000182029,96549484,0.689586
D.bocki,140010837,462303,1,25477,0.000181964,96574961,0.689768
D.bocki,140010837,456390,1,25408,0.000181472,96600369,0.689949
D.bocki,140010837,462189,1,25384,0.0001813,96625753,0.690131
D.bocki,140010837,464738,1,25376,0.000181243,96651129,0.690312
D.bocki,140010837,462309,1,25311,0.000180779,96676440,0.690493
D.bocki,140010837,463949,1,25285,0.000180593,96701725,0.690673
D.bocki,140010837,56828,1,25266,0.000180457,96726991,0.690854
D.bocki,140010837,463308,1,25247,0.000180322,96752238,0.691034
D.bocki,140010837,464401,1,25224,0.000180157,96777462,0.691214
D.bocki,140010837,456505,1,25222,0.000180143,96802684,0.691394
D.bocki,140010837,458079,1,25202,0.00018,96827886,0.691574
D.bocki,140010837,105466,1,25182,0.000179858,96853068,0.691754
D.bocki,140010837,459719,1,25177,0.000179822,96878245,0.691934
D.bocki,140010837,462362,1,25161,0.000179708,96903406,0.692114
D.bocki,140010837,457518,1,25158,0.000179686,96928564,0.692293
D.bocki,140010837,457376,1,25149,0.000179622,96953713,0.692473
D.bocki,140010837,464246,1,25147,0.000179608,96978860,0.692653
D.bocki,140010837,464672,1,25129,0.000179479,97003989,0.692832
D.bocki,140010837,465041,1,25122,0.000179429,97029111,0.693011
D.bocki,140010837,462608,1,25103,0.000179293,97054214,0.693191
D.bocki,140010837,458716,1,25101,0.000179279,97079315,0.69337
D.bocki,140010837,461648,1,25094,0.000179229,97104409,0.693549
D.bocki,140010837,459276,1,25078,0.000179115,97129487,0.693728
D.bocki,140010837,457626,1,25076,0.0001791,97154563,0.693907
D.bocki,140010837,463687,1,25002,0.000178572,97179565,0.694086
D.bocki,140010837,444218,1,24963,0.000178293,97204528,0.694264
D.bocki,140010837,461170,1,24944,0.000178158,97229472,0.694442
D.bocki,140010837,103579,1,24926,0.000178029,97254398,0.694621
D.bocki,140010837,462240,1,24894,0.000177801,97279292,0.694798
D.bocki,140010837,459522,1,24886,0.000177743,97304178,0.694976
D.bocki,140010837,167733,1,24869,0.000177622,97329047,0.695154
D.bocki,140010837,461874,1,24852,0.000177501,97353899,0.695331
D.bocki,140010837,457238,1,24779,0.000176979,97378678,0.695508
D.bocki,140010837,463091,1,24741,0.000176708,97403419,0.695685
D.bocki,140010837,229965,1,24729,0.000176622,97428148,0.695861
D.bocki,140010837,464391,1,24692,0.000176358,97452840,0.696038
D.bocki,140010837,459018,1,24680,0.000176272,97477520,0.696214
D.bocki,140010837,465106,1,24668,0.000176186,97502188,0.69639
D.bocki,140010837,458136,1,24645,0.000176022,97526833,0.696566
D.bocki,140010837,457107,1,24642,0.000176001,97551475,0.696742
D.bocki,140010837,462304,1,24625,0.000175879,97576100,0.696918
D.bocki,140010837,337631,1,24611,0.000175779,97600711,0.697094
D.bocki,140010837,463596,1,24570,0.000175486,97625281,0.697269
D.bocki,140010837,463304,1,24554,0.000175372,97649835,0.697445
D.bocki,140010837,463326,1,24530,0.000175201,97674365,0.69762
D.bocki,140010837,459450,1,24474,0.000174801,97698839,0.697795
D.bocki,140010837,464347,1,24459,0.000174694,97723298,0.69797
D.bocki,140010837,464730,1,24455,0.000174665,97747753,0.698144
D.bocki,140010837,102522,1,24437,0.000174536,97772190,0.698319
D.bocki,140010837,459938,1,24391,0.000174208,97796581,0.698493
D.bocki,140010837,464292,1,24369,0.000174051,97820950,0.698667
D.bocki,140010837,464959,1,24360,0.000173987,97845310,0.698841
D.bocki,140010837,458294,1,24360,0.000173987,97869670,0.699015
D.bocki,140010837,465091,1,24353,0.000173937,97894023,0.699189
D.bocki,140010837,11121,1,24316,0.000173672,97918339,0.699363
D.bocki,140010837,460837,1,24296,0.000173529,97942635,0.699536
D.bocki,140010837,457719,1,24292,0.000173501,97966927,0.69971
D.bocki,140010837,456831,1,24268,0.000173329,97991195,0.699883
D.bocki,140010837,458964,1,24252,0.000173215,98015447,0.700056
D.bocki,140010837,115180,1,24239,0.000173122,98039686,0.700229
D.bocki,140010837,458677,1,24237,0.000173108,98063923,0.700402
D.bocki,140010837,463757,1,24232,0.000173072,98088155,0.700575
D.bocki,140010837,452651,1,24208,0.000172901,98112363,0.700748
D.bocki,140010837,457808,1,24203,0.000172865,98136566,0.700921
D.bocki,140010837,464650,1,24169,0.000172622,98160735,0.701094
D.bocki,140010837,456996,1,24150,0.000172487,98184885,0.701266
D.bocki,140010837,463839,1,24145,0.000172451,98209030,0.701439
D.bocki,140010837,464127,1,24106,0.000172172,98233136,0.701611
D.bocki,140010837,457471,1,24092,0.000172072,98257228,0.701783
D.bocki,140010837,457053,1,24087,0.000172037,98281315,0.701955
D.bocki,140010837,457418,1,24082,0.000172001,98305397,0.702127
D.bocki,140010837,463113,1,24049,0.000171765,98329446,0.702299
D.bocki,140010837,464582,1,24036,0.000171672,98353482,0.70247
D.bocki,140010837,464335,1,24028,0.000171615,98377510,0.702642
D.bocki,140010837,459249,1,24023,0.00017158,98401533,0.702814
D.bocki,140010837,456378,1,24023,0.00017158,98425556,0.702985
D.bocki,140010837,459593,1,24013,0.000171508,98449569,0.703157
D.bocki,140010837,456842,1,23979,0.000171265,98473548,0.703328
D.bocki,140010837,464553,1,23970,0.000171201,98497518,0.703499
D.bocki,140010837,460389,1,23958,0.000171115,98521476,0.70367
D.bocki,140010837,456456,1,23949,0.000171051,98545425,0.703841
D.bocki,140010837,464628,1,23948,0.000171044,98569373,0.704012
D.bocki,140010837,465120,1,23932,0.00017093,98593305,0.704183
D.bocki,140010837,460289,1,23897,0.00017068,98617202,0.704354
D.bocki,140010837,36389,1,23877,0.000170537,98641079,0.704525
D.bocki,140010837,465003,1,23869,0.00017048,98664948,0.704695
D.bocki,140010837,456215,1,23851,0.000170351,98688799,0.704865
D.bocki,140010837,462448,1,23842,0.000170287,98712641,0.705036
D.bocki,140010837,464733,1,23834,0.00017023,98736475,0.705206
D.bocki,140010837,458144,1,23824,0.000170158,98760299,0.705376
D.bocki,140010837,457514,1,23816,0.000170101,98784115,0.705546
D.bocki,140010837,458473,1,23807,0.000170037,98807922,0.705716
D.bocki,140010837,460903,1,23768,0.000169758,98831690,0.705886
D.bocki,140010837,234488,1,23736,0.00016953,98855426,0.706056
D.bocki,140010837,460236,1,23703,0.000169294,98879129,0.706225
D.bocki,140010837,460149,1,23698,0.000169258,98902827,0.706394
D.bocki,140010837,463729,1,23689,0.000169194,98926516,0.706563
D.bocki,140010837,459898,1,23685,0.000169165,98950201,0.706732
D.bocki,140010837,464454,1,23632,0.000168787,98973833,0.706901
D.bocki,140010837,459920,1,23631,0.00016878,98997464,0.70707
D.bocki,140010837,463920,1,23626,0.000168744,99021090,0.707239
D.bocki,140010837,463022,1,23625,0.000168737,99044715,0.707407
D.bocki,140010837,464458,1,23619,0.000168694,99068334,0.707576
D.bocki,140010837,464086,1,23610,0.00016863,99091944,0.707745
D.bocki,140010837,463929,1,23601,0.000168566,99115545,0.707913
D.bocki,140010837,459642,1,23601,0.000168566,99139146,0.708082
D.bocki,140010837,448238,1,23554,0.00016823,99162700,0.70825
D.bocki,140010837,457014,1,23507,0.000167894,99186207,0.708418
D.bocki,140010837,462275,1,23489,0.000167766,99209696,0.708586
D.bocki,140010837,458420,1,23464,0.000167587,99233160,0.708753
D.bocki,140010837,464732,1,23458,0.000167544,99256618,0.708921
D.bocki,140010837,461629,1,23452,0.000167501,99280070,0.709088
D.bocki,140010837,165612,1,23446,0.000167458,99303516,0.709256
D.bocki,140010837,461282,1,23435,0.00016738,99326951,0.709423
D.bocki,140010837,462385,1,23419,0.000167266,99350370,0.709591
D.bocki,140010837,460321,1,23419,0.000167266,99373789,0.709758
D.bocki,140010837,190256,1,23373,0.000166937,99397162,0.709925
D.bocki,140010837,218553,1,23361,0.000166851,99420523,0.710092
D.bocki,140010837,464876,1,23352,0.000166787,99443875,0.710258
D.bocki,140010837,463969,1,23349,0.000166766,99467224,0.710425
D.bocki,140010837,456332,1,23293,0.000166366,99490517,0.710592
D.bocki,140010837,464340,1,23292,0.000166359,99513809,0.710758
D.bocki,140010837,460416,1,23268,0.000166187,99537077,0.710924
D.bocki,140010837,455881,1,23260,0.00016613,99560337,0.71109
D.bocki,140010837,459585,1,23257,0.000166109,99583594,0.711256
D.bocki,140010837,461255,1,23244,0.000166016,99606838,0.711422
D.bocki,140010837,457953,1,23229,0.000165909,99630067,0.711588
D.bocki,140010837,464080,1,23224,0.000165873,99653291,0.711754
D.bocki,140010837,460662,1,23214,0.000165801,99676505,0.71192
D.bocki,140010837,459413,1,23187,0.000165609,99699692,0.712086
D.bocki,140010837,456411,1,23156,0.000165387,99722848,0.712251
D.bocki,140010837,460413,1,23143,0.000165294,99745991,0.712416
D.bocki,140010837,461894,1,23136,0.000165244,99769127,0.712581
D.bocki,140010837,455989,1,23098,0.000164973,99792225,0.712746
D.bocki,140010837,464706,1,23083,0.000164866,99815308,0.712911
D.bocki,140010837,459343,1,23037,0.000164537,99838345,0.713076
D.bocki,140010837,464318,1,23034,0.000164516,99861379,0.71324
D.bocki,140010837,462714,1,23033,0.000164509,99884412,0.713405
D.bocki,140010837,464049,1,22991,0.000164209,99907403,0.713569
D.bocki,140010837,462373,1,22990,0.000164202,99930393,0.713733
D.bocki,140010837,464420,1,22989,0.000164194,99953382,0.713897
D.bocki,140010837,462895,1,22931,0.00016378,99976313,0.714061
D.bocki,140010837,458360,1,22927,0.000163752,99999240,0.714225
D.bocki,140010837,456960,1,22925,0.000163737,100022165,0.714389
D.bocki,140010837,228297,1,22897,0.000163537,100045062,0.714552
D.bocki,140010837,463551,1,22874,0.000163373,100067936,0.714716
D.bocki,140010837,459928,1,22843,0.000163152,100090779,0.714879
D.bocki,140010837,461786,1,22839,0.000163123,100113618,0.715042
D.bocki,140010837,463651,1,22835,0.000163095,100136453,0.715205
D.bocki,140010837,461569,1,22740,0.000162416,100159193,0.715367
D.bocki,140010837,455769,1,22737,0.000162395,100181930,0.71553
D.bocki,140010837,86385,1,22731,0.000162352,100204661,0.715692
D.bocki,140010837,462353,1,22728,0.00016233,100227389,0.715855
D.bocki,140010837,457655,1,22718,0.000162259,100250107,0.716017
D.bocki,140010837,460885,1,22696,0.000162102,100272803,0.716179
D.bocki,140010837,462673,1,22689,0.000162052,100295492,0.716341
D.bocki,140010837,448378,1,22682,0.000162002,100318174,0.716503
D.bocki,140010837,464534,1,22672,0.00016193,100340846,0.716665
D.bocki,140010837,456951,1,22666,0.000161887,100363512,0.716827
D.bocki,140010837,464475,1,22663,0.000161866,100386175,0.716989
D.bocki,140010837,457538,1,22649,0.000161766,100408824,0.71715
D.bocki,140010837,459351,1,22627,0.000161609,100431451,0.717312
D.bocki,140010837,457477,1,22620,0.000161559,100454071,0.717474
D.bocki,140010837,464977,1,22600,0.000161416,100476671,0.717635
D.bocki,140010837,232278,1,22594,0.000161373,100499265,0.717796
D.bocki,140010837,464864,1,22591,0.000161352,100521856,0.717958
D.bocki,140010837,464535,1,22590,0.000161345,100544446,0.718119
D.bocki,140010837,463445,1,22570,0.000161202,100567016,0.71828
D.bocki,140010837,458247,1,22566,0.000161173,100589582,0.718441
D.bocki,140010837,462543,1,22556,0.000161102,100612138,0.718603
D.bocki,140010837,458831,1,22553,0.00016108,100634691,0.718764
D.bocki,140010837,14616,1,22545,0.000161023,100657236,0.718925
D.bocki,140010837,118417,1,22538,0.000160973,100679774,0.719086
D.bocki,140010837,464191,1,22499,0.000160695,100702273,0.719246
D.bocki,140010837,283362,1,22489,0.000160623,100724762,0.719407
D.bocki,140010837,459294,1,22483,0.00016058,100747245,0.719567
D.bocki,140010837,463559,1,22464,0.000160445,100769709,0.719728
D.bocki,140010837,456777,1,22460,0.000160416,100792169,0.719888
D.bocki,140010837,464731,1,22439,0.000160266,100814608,0.720049
D.bocki,140010837,464602,1,22439,0.000160266,100837047,0.720209
D.bocki,140010837,465063,1,22407,0.000160038,100859454,0.720369
D.bocki,140010837,459782,1,22407,0.000160038,100881861,0.720529
D.bocki,140010837,460216,1,22356,0.000159673,100904217,0.720689
D.bocki,140010837,464201,1,22355,0.000159666,100926572,0.720848
D.bocki,140010837,459778,1,22347,0.000159609,100948919,0.721008
D.bocki,140010837,463415,1,22257,0.000158966,100971176,0.721167
D.bocki,140010837,463259,1,22223,0.000158723,100993399,0.721326
D.bocki,140010837,412748,1,22178,0.000158402,101015577,0.721484
D.bocki,140010837,456519,1,22164,0.000158302,101037741,0.721642
D.bocki,140010837,465022,1,22162,0.000158288,101059903,0.721801
D.bocki,140010837,456200,1,22149,0.000158195,101082052,0.721959
D.bocki,140010837,460143,1,22148,0.000158188,101104200,0.722117
D.bocki,140010837,458383,1,22116,0.000157959,101126316,0.722275
D.bocki,140010837,459694,1,22069,0.000157624,101148385,0.722433
D.bocki,140010837,463257,1,22061,0.000157566,101170446,0.72259
D.bocki,140010837,456432,1,22049,0.000157481,101192495,0.722748
D.bocki,140010837,464124,1,22037,0.000157395,101214532,0.722905
D.bocki,140010837,462765,1,22016,0.000157245,101236548,0.723062
D.bocki,140010837,456640,1,21987,0.000157038,101258535,0.723219
D.bocki,140010837,461948,1,21964,0.000156874,101280499,0.723376
D.bocki,140010837,189464,1,21943,0.000156724,101302442,0.723533
D.bocki,140010837,463442,1,21887,0.000156324,101324329,0.723689
D.bocki,140010837,81698,1,21875,0.000156238,101346204,0.723845
D.bocki,140010837,465099,1,21869,0.000156195,101368073,0.724002
D.bocki,140010837,463950,1,21861,0.000156138,101389934,0.724158
D.bocki,140010837,464786,1,21853,0.000156081,101411787,0.724314
D.bocki,140010837,44399,1,21852,0.000156074,101433639,0.72447
D.bocki,140010837,456899,1,21850,0.000156059,101455489,0.724626
D.bocki,140010837,457821,1,21835,0.000155952,101477324,0.724782
D.bocki,140010837,462319,1,21763,0.000155438,101499087,0.724937
D.bocki,140010837,465127,1,21758,0.000155402,101520845,0.725093
D.bocki,140010837,465043,1,21747,0.000155324,101542592,0.725248
D.bocki,140010837,464231,1,21730,0.000155202,101564322,0.725403
D.bocki,140010837,462151,1,21716,0.000155102,101586038,0.725558
D.bocki,140010837,459769,1,21699,0.000154981,101607737,0.725713
D.bocki,140010837,348239,1,21692,0.000154931,101629429,0.725868
D.bocki,140010837,460848,1,21669,0.000154767,101651098,0.726023
D.bocki,140010837,462339,1,21654,0.000154659,101672752,0.726178
D.bocki,140010837,94821,1,21649,0.000154624,101694401,0.726332
D.bocki,140010837,462255,1,21649,0.000154624,101716050,0.726487
D.bocki,140010837,457440,1,21589,0.000154195,101737639,0.726641
D.bocki,140010837,464464,1,21581,0.000154138,101759220,0.726795
D.bocki,140010837,456787,1,21551,0.000153924,101780771,0.726949
D.bocki,140010837,464269,1,21546,0.000153888,101802317,0.727103
D.bocki,140010837,206272,1,21542,0.00015386,101823859,0.727257
D.bocki,140010837,461796,1,21540,0.000153845,101845399,0.727411
D.bocki,140010837,455784,1,21528,0.00015376,101866927,0.727565
D.bocki,140010837,455934,1,21476,0.000153388,101888403,0.727718
D.bocki,140010837,458663,1,21473,0.000153367,101909876,0.727871
D.bocki,140010837,465030,1,21460,0.000153274,101931336,0.728025
D.bocki,140010837,462857,1,21445,0.000153167,101952781,0.728178
D.bocki,140010837,464657,1,21417,0.000152967,101974198,0.728331
D.bocki,140010837,457885,1,21410,0.000152917,101995608,0.728484
D.bocki,140010837,462652,1,21407,0.000152895,102017015,0.728637
D.bocki,140010837,456248,1,21383,0.000152724,102038398,0.728789
D.bocki,140010837,456399,1,21350,0.000152488,102059748,0.728942
D.bocki,140010837,330251,1,21335,0.000152381,102081083,0.729094
D.bocki,140010837,460348,1,21323,0.000152295,102102406,0.729246
D.bocki,140010837,459173,1,21311,0.00015221,102123717,0.729399
D.bocki,140010837,463960,1,21301,0.000152138,102145018,0.729551
D.bocki,140010837,461869,1,21273,0.000151938,102166291,0.729703
D.bocki,140010837,464322,1,21272,0.000151931,102187563,0.729855
D.bocki,140010837,462361,1,21272,0.000151931,102208835,0.730007
D.bocki,140010837,457947,1,21270,0.000151917,102230105,0.730159
D.bocki,140010837,459990,1,21240,0.000151703,102251345,0.73031
D.bocki,140010837,460531,1,21235,0.000151667,102272580,0.730462
D.bocki,140010837,464384,1,21144,0.000151017,102293724,0.730613
D.bocki,140010837,464568,1,21133,0.000150938,102314857,0.730764
D.bocki,140010837,464250,1,21086,0.000150603,102335943,0.730914
D.bocki,140010837,462332,1,21054,0.000150374,102356997,0.731065
D.bocki,140010837,456478,1,21039,0.000150267,102378036,0.731215
D.bocki,140010837,462059,1,21025,0.000150167,102399061,0.731365
D.bocki,140010837,120755,1,20983,0.000149867,102420044,0.731515
D.bocki,140010837,464477,1,20967,0.000149753,102441011,0.731665
D.bocki,140010837,118927,1,20941,0.000149567,102461952,0.731814
D.bocki,140010837,456784,1,20940,0.00014956,102482892,0.731964
D.bocki,140010837,462171,1,20907,0.000149324,102503799,0.732113
D.bocki,140010837,455777,1,20898,0.00014926,102524697,0.732263
D.bocki,140010837,463546,1,20883,0.000149153,102545580,0.732412
D.bocki,140010837,462081,1,20882,0.000149146,102566462,0.732561
D.bocki,140010837,457076,1,20871,0.000149067,102587333,0.73271
D.bocki,140010837,455790,1,20841,0.000148853,102608174,0.732859
D.bocki,140010837,464927,1,20769,0.000148339,102628943,0.733007
D.bocki,140010837,456468,1,20758,0.00014826,102649701,0.733155
D.bocki,140010837,458021,1,20732,0.000148074,102670433,0.733303
D.bocki,140010837,463676,1,20717,0.000147967,102691150,0.733451
D.bocki,140010837,464525,1,20710,0.000147917,102711860,0.733599
D.bocki,140010837,462129,1,20709,0.00014791,102732569,0.733747
D.bocki,140010837,463526,1,20694,0.000147803,102753263,0.733895
D.bocki,140010837,458788,1,20668,0.000147617,102773931,0.734043
D.bocki,140010837,462952,1,20666,0.000147603,102794597,0.73419
D.bocki,140010837,458958,1,20643,0.000147439,102815240,0.734338
D.bocki,140010837,420180,1,20636,0.000147389,102835876,0.734485
D.bocki,140010837,458992,1,20619,0.000147267,102856495,0.734632
D.bocki,140010837,463216,1,20606,0.000147174,102877101,0.73478
D.bocki,140010837,461275,1,20601,0.000147139,102897702,0.734927
D.bocki,140010837,463869,1,20569,0.00014691,102918271,0.735074
D.bocki,140010837,459049,1,20566,0.000146889,102938837,0.73522
D.bocki,140010837,457746,1,20515,0.000146524,102959352,0.735367
D.bocki,140010837,458229,1,20497,0.000146396,102979849,0.735513
D.bocki,140010837,30036,1,20497,0.000146396,103000346,0.73566
D.bocki,140010837,458035,1,20466,0.000146174,103020812,0.735806
D.bocki,140010837,345910,1,20450,0.00014606,103041262,0.735952
D.bocki,140010837,463303,1,20442,0.000146003,103061704,0.736098
D.bocki,140010837,288237,1,20436,0.00014596,103082140,0.736244
D.bocki,140010837,463576,1,20432,0.000145932,103102572,0.73639
D.bocki,140010837,458171,1,20416,0.000145817,103122988,0.736536
D.bocki,140010837,459060,1,20413,0.000145796,103143401,0.736682
D.bocki,140010837,461637,1,20381,0.000145567,103163782,0.736827
D.bocki,140010837,463173,1,20362,0.000145432,103184144,0.736973
D.bocki,140010837,457222,1,20349,0.000145339,103204493,0.737118
D.bocki,140010837,464549,1,20331,0.00014521,103224824,0.737263
D.bocki,140010837,463617,1,20325,0.000145167,103245149,0.737408
D.bocki,140010837,456679,1,20325,0.000145167,103265474,0.737553
D.bocki,140010837,463707,1,20324,0.00014516,103285798,0.737699
D.bocki,140010837,458099,1,20320,0.000145132,103306118,0.737844
D.bocki,140010837,456131,1,20310,0.00014506,103326428,0.737989
D.bocki,140010837,402287,1,20269,0.000144767,103346697,0.738134
D.bocki,140010837,461660,1,20251,0.000144639,103366948,0.738278
D.bocki,140010837,456419,1,20248,0.000144617,103387196,0.738423
D.bocki,140010837,458186,1,20241,0.000144567,103407437,0.738567
D.bocki,140010837,461941,1,20211,0.000144353,103427648,0.738712
D.bocki,140010837,457861,1,20210,0.000144346,103447858,0.738856
D.bocki,140010837,461410,1,20207,0.000144325,103468065,0.739
D.bocki,140010837,458919,1,20207,0.000144325,103488272,0.739145
D.bocki,140010837,460418,1,20199,0.000144267,103508471,0.739289
D.bocki,140010837,32549,1,20168,0.000144046,103528639,0.739433
D.bocki,140010837,463888,1,20162,0.000144003,103548801,0.739577
D.bocki,140010837,460892,1,20161,0.000143996,103568962,0.739721
D.bocki,140010837,391414,1,20158,0.000143975,103589120,0.739865
D.bocki,140010837,460351,1,20145,0.000143882,103609265,0.740009
D.bocki,140010837,461481,1,20142,0.00014386,103629407,0.740153
D.bocki,140010837,459751,1,20107,0.00014361,103649514,0.740296
D.bocki,140010837,460329,1,20077,0.000143396,103669591,0.74044
D.bocki,140010837,464584,1,20056,0.000143246,103689647,0.740583
D.bocki,140010837,456539,1,20046,0.000143175,103709693,0.740726
D.bocki,140010837,464955,1,20021,0.000142996,103729714,0.740869
D.bocki,140010837,464817,1,20019,0.000142982,103749733,0.741012
D.bocki,140010837,462471,1,19996,0.000142818,103769729,0.741155
D.bocki,140010837,464233,1,19993,0.000142796,103789722,0.741298
D.bocki,140010837,461119,1,19993,0.000142796,103809715,0.741441
D.bocki,140010837,458164,1,19966,0.000142603,103829681,0.741583
D.bocki,140010837,463921,1,19961,0.000142568,103849642,0.741726
D.bocki,140010837,465011,1,19958,0.000142546,103869600,0.741868
D.bocki,140010837,462162,1,19952,0.000142503,103889552,0.742011
D.bocki,140010837,464183,1,19923,0.000142296,103909475,0.742153
D.bocki,140010837,455754,1,19912,0.000142218,103929387,0.742295
D.bocki,140010837,459846,1,19878,0.000141975,103949265,0.742437
D.bocki,140010837,458240,1,19875,0.000141953,103969140,0.742579
D.bocki,140010837,464577,1,19868,0.000141903,103989008,0.742721
D.bocki,140010837,458548,1,19855,0.00014181,104008863,0.742863
D.bocki,140010837,461065,1,19850,0.000141775,104028713,0.743005
D.bocki,140010837,459433,1,19825,0.000141596,104048538,0.743146
D.bocki,140010837,456096,1,19824,0.000141589,104068362,0.743288
D.bocki,140010837,458399,1,19816,0.000141532,104088178,0.743429
D.bocki,140010837,459767,1,19809,0.000141482,104107987,0.743571
D.bocki,140010837,464319,1,19794,0.000141375,104127781,0.743712
D.bocki,140010837,457437,1,19789,0.000141339,104147570,0.743854
D.bocki,140010837,271062,1,19770,0.000141203,104167340,0.743995
D.bocki,140010837,459613,1,19763,0.000141153,104187103,0.744136
D.bocki,140010837,456675,1,19750,0.000141061,104206853,0.744277
D.bocki,140010837,464757,1,19702,0.000140718,104226555,0.744418
D.bocki,140010837,462357,1,19678,0.000140546,104246233,0.744558
D.bocki,140010837,464408,1,19660,0.000140418,104265893,0.744699
D.bocki,140010837,459845,1,19614,0.000140089,104285507,0.744839
D.bocki,140010837,464891,1,19613,0.000140082,104305120,0.744979
D.bocki,140010837,462637,1,19587,0.000139896,104324707,0.745119
D.bocki,140010837,458421,1,19587,0.000139896,104344294,0.745259
D.bocki,140010837,459397,1,19559,0.000139696,104363853,0.745398
D.bocki,140010837,465141,1,19551,0.000139639,104383404,0.745538
D.bocki,140010837,464567,1,19539,0.000139553,104402943,0.745678
D.bocki,140010837,464872,1,19501,0.000139282,104422444,0.745817
D.bocki,140010837,460621,1,19474,0.000139089,104441918,0.745956
D.bocki,140010837,457247,1,19470,0.000139061,104461388,0.746095
D.bocki,140010837,27530,1,19450,0.000138918,104480838,0.746234
D.bocki,140010837,33126,1,19432,0.000138789,104500270,0.746373
D.bocki,140010837,465124,1,19426,0.000138746,104519696,0.746511
D.bocki,140010837,457660,1,19417,0.000138682,104539113,0.74665
D.bocki,140010837,461931,1,19410,0.000138632,104558523,0.746789
D.bocki,140010837,458213,1,19404,0.000138589,104577927,0.746927
D.bocki,140010837,464622,1,19381,0.000138425,104597308,0.747066
D.bocki,140010837,461822,1,19331,0.000138068,104616639,0.747204
D.bocki,140010837,463970,1,19323,0.000138011,104635962,0.747342
D.bocki,140010837,457931,1,19298,0.000137832,104655260,0.74748
D.bocki,140010837,68898,1,19257,0.000137539,104674517,0.747617
D.bocki,140010837,464326,1,19255,0.000137525,104693772,0.747755
D.bocki,140010837,458172,1,19249,0.000137482,104713021,0.747892
D.bocki,140010837,460940,1,19240,0.000137418,104732261,0.74803
D.bocki,140010837,464509,1,19235,0.000137382,104751496,0.748167
D.bocki,140010837,463272,1,19226,0.000137318,104770722,0.748304
D.bocki,140010837,457629,1,19214,0.000137232,104789936,0.748442
D.bocki,140010837,465114,1,19201,0.000137139,104809137,0.748579
D.bocki,140010837,460819,1,19198,0.000137118,104828335,0.748716
D.bocki,140010837,461177,1,19182,0.000137004,104847517,0.748853
D.bocki,140010837,462179,1,19142,0.000136718,104866659,0.74899
D.bocki,140010837,462452,1,19127,0.000136611,104885786,0.749126
D.bocki,140010837,464317,1,19115,0.000136525,104904901,0.749263
D.bocki,140010837,464479,1,19104,0.000136447,104924005,0.749399
D.bocki,140010837,464057,1,19103,0.000136439,104943108,0.749536
D.bocki,140010837,463765,1,19096,0.000136389,104962204,0.749672
D.bocki,140010837,245871,1,19071,0.000136211,104981275,0.749808
D.bocki,140010837,458495,1,19069,0.000136197,105000344,0.749944
D.bocki,140010837,458500,1,19043,0.000136011,105019387,0.75008
D.bocki,140010837,459295,1,19038,0.000135975,105038425,0.750216
D.bocki,140010837,461907,1,19037,0.000135968,105057462,0.750352
D.bocki,140010837,458906,1,19023,0.000135868,105076485,0.750488
D.bocki,140010837,464305,1,19018,0.000135832,105095503,0.750624
D.bocki,140010837,464686,1,19001,0.000135711,105114504,0.75076
D.bocki,140010837,464631,1,18989,0.000135625,105133493,0.750895
D.bocki,140010837,255879,1,18970,0.00013549,105152463,0.751031
D.bocki,140010837,464942,1,18959,0.000135411,105171422,0.751166
D.bocki,140010837,464680,1,18942,0.00013529,105190364,0.751302
D.bocki,140010837,462269,1,18942,0.00013529,105209306,0.751437
D.bocki,140010837,457738,1,18873,0.000134797,105228179,0.751572
D.bocki,140010837,456229,1,18871,0.000134782,105247050,0.751706
D.bocki,140010837,13624,1,18829,0.000134482,105265879,0.751841
D.bocki,140010837,465039,1,18810,0.000134347,105284689,0.751975
D.bocki,140010837,465148,1,18806,0.000134318,105303495,0.75211
D.bocki,140010837,455704,1,18794,0.000134232,105322289,0.752244
D.bocki,140010837,463490,1,18790,0.000134204,105341079,0.752378
D.bocki,140010837,458711,1,18769,0.000134054,105359848,0.752512
D.bocki,140010837,122084,1,18763,0.000134011,105378611,0.752646
D.bocki,140010837,464021,1,18758,0.000133975,105397369,0.75278
D.bocki,140010837,460860,1,18752,0.000133932,105416121,0.752914
D.bocki,140010837,459314,1,18749,0.000133911,105434870,0.753048
D.bocki,140010837,464747,1,18745,0.000133882,105453615,0.753182
D.bocki,140010837,463477,1,18730,0.000133775,105472345,0.753316
D.bocki,140010837,457003,1,18728,0.000133761,105491073,0.753449
D.bocki,140010837,459854,1,18727,0.000133754,105509800,0.753583
D.bocki,140010837,457901,1,18725,0.00013374,105528525,0.753717
D.bocki,140010837,461922,1,18720,0.000133704,105547245,0.753851
D.bocki,140010837,459611,1,18689,0.000133483,105565934,0.753984
D.bocki,140010837,457396,1,18688,0.000133475,105584622,0.754117
D.bocki,140010837,457383,1,18685,0.000133454,105603307,0.754251
D.bocki,140010837,464824,1,18662,0.00013329,105621969,0.754384
D.bocki,140010837,463887,1,18649,0.000133197,105640618,0.754517
D.bocki,140010837,462295,1,18644,0.000133161,105659262,0.754651
D.bocki,140010837,464926,1,18637,0.000133111,105677899,0.754784
D.bocki,140010837,459482,1,18631,0.000133068,105696530,0.754917
D.bocki,140010837,67472,1,18609,0.000132911,105715139,0.75505
D.bocki,140010837,464313,1,18604,0.000132875,105733743,0.755183
D.bocki,140010837,465019,1,18587,0.000132754,105752330,0.755315
D.bocki,140010837,462273,1,18586,0.000132747,105770916,0.755448
D.bocki,140010837,459270,1,18584,0.000132733,105789500,0.755581
D.bocki,140010837,457888,1,18584,0.000132733,105808084,0.755714
D.bocki,140010837,459491,1,18565,0.000132597,105826649,0.755846
D.bocki,140010837,464920,1,18563,0.000132583,105845212,0.755979
D.bocki,140010837,458322,1,18558,0.000132547,105863770,0.756111
D.bocki,140010837,458170,1,18551,0.000132497,105882321,0.756244
D.bocki,140010837,464426,1,18548,0.000132475,105900869,0.756376
D.bocki,140010837,465125,1,18544,0.000132447,105919413,0.756509
D.bocki,140010837,455973,1,18526,0.000132318,105937939,0.756641
D.bocki,140010837,456986,1,18493,0.000132083,105956432,0.756773
D.bocki,140010837,457248,1,18483,0.000132011,105974915,0.756905
D.bocki,140010837,411539,1,18442,0.000131718,105993357,0.757037
D.bocki,140010837,457395,1,18430,0.000131633,106011787,0.757168
D.bocki,140010837,459017,1,18410,0.00013149,106030197,0.7573
D.bocki,140010837,121668,1,18383,0.000131297,106048580,0.757431
D.bocki,140010837,461325,1,18356,0.000131104,106066936,0.757562
D.bocki,140010837,457216,1,18329,0.000130911,106085265,0.757693
D.bocki,140010837,245685,1,18297,0.000130683,106103562,0.757824
D.bocki,140010837,243888,1,18294,0.000130661,106121856,0.757955
D.bocki,140010837,456420,1,18291,0.00013064,106140147,0.758085
D.bocki,140010837,464816,1,18285,0.000130597,106158432,0.758216
D.bocki,140010837,463725,1,18285,0.000130597,106176717,0.758346
D.bocki,140010837,458061,1,18285,0.000130597,106195002,0.758477
D.bocki,140010837,459220,1,18277,0.00013054,106213279,0.758608
D.bocki,140010837,460338,1,18273,0.000130511,106231552,0.758738
D.bocki,140010837,457233,1,18254,0.000130376,106249806,0.758868
D.bocki,140010837,461054,1,18238,0.000130261,106268044,0.758999
D.bocki,140010837,456368,1,18236,0.000130247,106286280,0.759129
D.bocki,140010837,457543,1,18200,0.00012999,106304480,0.759259
D.bocki,140010837,460896,1,18176,0.000129819,106322656,0.759389
D.bocki,140010837,457827,1,18162,0.000129719,106340818,0.759518
D.bocki,140010837,459641,1,18161,0.000129711,106358979,0.759648
D.bocki,140010837,462813,1,18157,0.000129683,106377136,0.759778
D.bocki,140010837,456449,1,18136,0.000129533,106395272,0.759907
D.bocki,140010837,457666,1,18106,0.000129319,106413378,0.760037
D.bocki,140010837,461850,1,18101,0.000129283,106431479,0.760166
D.bocki,140010837,73894,1,18073,0.000129083,106449552,0.760295
D.bocki,140010837,464856,1,18068,0.000129047,106467620,0.760424
D.bocki,140010837,459573,1,18062,0.000129004,106485682,0.760553
D.bocki,140010837,464811,1,18054,0.000128947,106503736,0.760682
D.bocki,140010837,463773,1,18054,0.000128947,106521790,0.760811
D.bocki,140010837,456645,1,18001,0.000128569,106539791,0.76094
D.bocki,140010837,460521,1,17978,0.000128404,106557769,0.761068
D.bocki,140010837,464948,1,17953,0.000128226,106575722,0.761196
D.bocki,140010837,459994,1,17946,0.000128176,106593668,0.761324
D.bocki,140010837,462509,1,17943,0.000128154,106611611,0.761453
D.bocki,140010837,457037,1,17941,0.00012814,106629552,0.761581
D.bocki,140010837,464831,1,17876,0.000127676,106647428,0.761708
D.bocki,140010837,461697,1,17875,0.000127669,106665303,0.761836
D.bocki,140010837,457468,1,17855,0.000127526,106683158,0.761964
D.bocki,140010837,464923,1,17834,0.000127376,106700992,0.762091
D.bocki,140010837,411878,1,17812,0.000127219,106718804,0.762218
D.bocki,140010837,461243,1,17808,0.00012719,106736612,0.762345
D.bocki,140010837,4286,1,17800,0.000127133,106754412,0.762472
D.bocki,140010837,458612,1,17755,0.000126812,106772167,0.762599
D.bocki,140010837,464797,1,17747,0.000126754,106789914,0.762726
D.bocki,140010837,457705,1,17743,0.000126726,106807657,0.762853
D.bocki,140010837,461082,1,17737,0.000126683,106825394,0.762979
D.bocki,140010837,18664,1,17715,0.000126526,106843109,0.763106
D.bocki,140010837,464016,1,17672,0.000126219,106860781,0.763232
D.bocki,140010837,459689,1,17671,0.000126212,106878452,0.763358
D.bocki,140010837,462504,1,17658,0.000126119,106896110,0.763485
D.bocki,140010837,458464,1,17630,0.000125919,106913740,0.76361
D.bocki,140010837,179181,1,17613,0.000125797,106931353,0.763736
D.bocki,140010837,460675,1,17604,0.000125733,106948957,0.763862
D.bocki,140010837,465025,1,17570,0.00012549,106966527,0.763987
D.bocki,140010837,462749,1,17567,0.000125469,106984094,0.764113
D.bocki,140010837,463072,1,17549,0.00012534,107001643,0.764238
D.bocki,140010837,459749,1,17545,0.000125312,107019188,0.764364
D.bocki,140010837,240198,1,17512,0.000125076,107036700,0.764489
D.bocki,140010837,464783,1,17495,0.000124955,107054195,0.764614
D.bocki,140010837,458114,1,17491,0.000124926,107071686,0.764739
D.bocki,140010837,461916,1,17485,0.000124883,107089171,0.764863
D.bocki,140010837,464308,1,17464,0.000124733,107106635,0.764988
D.bocki,140010837,455882,1,17428,0.000124476,107124063,0.765113
D.bocki,140010837,460301,1,17408,0.000124333,107141471,0.765237
D.bocki,140010837,464704,1,17403,0.000124298,107158874,0.765361
D.bocki,140010837,456460,1,17403,0.000124298,107176277,0.765486
D.bocki,140010837,361322,1,17398,0.000124262,107193675,0.76561
D.bocki,140010837,349359,1,17373,0.000124083,107211048,0.765734
D.bocki,140010837,465045,1,17360,0.00012399,107228408,0.765858
D.bocki,140010837,458221,1,17349,0.000123912,107245757,0.765982
D.bocki,140010837,464784,1,17338,0.000123833,107263095,0.766106
D.bocki,140010837,457335,1,17337,0.000123826,107280432,0.766229
D.bocki,140010837,464527,1,17331,0.000123783,107297763,0.766353
D.bocki,140010837,458152,1,17330,0.000123776,107315093,0.766477
D.bocki,140010837,464327,1,17305,0.000123598,107332398,0.766601
D.bocki,140010837,457949,1,17302,0.000123576,107349700,0.766724
D.bocki,140010837,459579,1,17278,0.000123405,107366978,0.766848
D.bocki,140010837,460316,1,17275,0.000123383,107384253,0.766971
D.bocki,140010837,319788,1,17255,0.00012324,107401508,0.767094
D.bocki,140010837,464482,1,17240,0.000123133,107418748,0.767217
D.bocki,140010837,458293,1,17176,0.000122676,107435924,0.76734
D.bocki,140010837,464727,1,17173,0.000122655,107453097,0.767463
D.bocki,140010837,257133,1,17169,0.000122626,107470266,0.767585
D.bocki,140010837,49176,1,17168,0.000122619,107487434,0.767708
D.bocki,140010837,464603,1,17133,0.000122369,107504567,0.76783
D.bocki,140010837,457575,1,17125,0.000122312,107521692,0.767953
D.bocki,140010837,455979,1,17123,0.000122298,107538815,0.768075
D.bocki,140010837,459602,1,17116,0.000122248,107555931,0.768197
D.bocki,140010837,464473,1,17111,0.000122212,107573042,0.768319
D.bocki,140010837,461936,1,17110,0.000122205,107590152,0.768442
D.bocki,140010837,457943,1,17073,0.000121941,107607225,0.768564
D.bocki,140010837,460682,1,17060,0.000121848,107624285,0.768685
D.bocki,140010837,458354,1,17059,0.000121841,107641344,0.768807
D.bocki,140010837,461471,1,17012,0.000121505,107658356,0.768929
D.bocki,140010837,167152,1,16981,0.000121283,107675337,0.76905
D.bocki,140010837,464178,1,16980,0.000121276,107692317,0.769171
D.bocki,140010837,461858,1,16978,0.000121262,107709295,0.769293
D.bocki,140010837,425155,1,16941,0.000120998,107726236,0.769414
D.bocki,140010837,464403,1,16924,0.000120876,107743160,0.769534
D.bocki,140010837,461759,1,16922,0.000120862,107760082,0.769655
D.bocki,140010837,82881,1,16921,0.000120855,107777003,0.769776
D.bocki,140010837,463147,1,16895,0.000120669,107793898,0.769897
D.bocki,140010837,460169,1,16892,0.000120648,107810790,0.770017
D.bocki,140010837,456181,1,16884,0.000120591,107827674,0.770138
D.bocki,140010837,227112,1,16853,0.000120369,107844527,0.770258
D.bocki,140010837,464836,1,16844,0.000120305,107861371,0.770379
D.bocki,140010837,463696,1,16843,0.000120298,107878214,0.770499
D.bocki,140010837,181618,1,16839,0.000120269,107895053,0.770619
D.bocki,140010837,457536,1,16814,0.000120091,107911867,0.770739
D.bocki,140010837,457785,1,16801,0.000119998,107928668,0.770859
D.bocki,140010837,464562,1,16792,0.000119934,107945460,0.770979
D.bocki,140010837,286823,1,16786,0.000119891,107962246,0.771099
D.bocki,140010837,457978,1,16776,0.000119819,107979022,0.771219
D.bocki,140010837,458176,1,16765,0.000119741,107995787,0.771339
D.bocki,140010837,458141,1,16747,0.000119612,108012534,0.771458
D.bocki,140010837,456667,1,16746,0.000119605,108029280,0.771578
D.bocki,140010837,457823,1,16712,0.000119362,108045992,0.771697
D.bocki,140010837,461663,1,16710,0.000119348,108062702,0.771817
D.bocki,140010837,157082,1,16708,0.000119334,108079410,0.771936
D.bocki,140010837,464896,1,16701,0.000119284,108096111,0.772055
D.bocki,140010837,459629,1,16676,0.000119105,108112787,0.772174
D.bocki,140010837,457922,1,16671,0.000119069,108129458,0.772293
D.bocki,140010837,458071,1,16668,0.000119048,108146126,0.772413
D.bocki,140010837,465090,1,16667,0.000119041,108162793,0.772532
D.bocki,140010837,464666,1,16654,0.000118948,108179447,0.772651
D.bocki,140010837,456098,1,16654,0.000118948,108196101,0.772769
D.bocki,140010837,293675,1,16650,0.000118919,108212751,0.772888
D.bocki,140010837,419806,1,16644,0.000118877,108229395,0.773007
D.bocki,140010837,465065,1,16629,0.000118769,108246024,0.773126
D.bocki,140010837,369222,1,16626,0.000118748,108262650,0.773245
D.bocki,140010837,463698,1,16605,0.000118598,108279255,0.773363
D.bocki,140010837,464669,1,16602,0.000118577,108295857,0.773482
D.bocki,140010837,458195,1,16601,0.000118569,108312458,0.773601
D.bocki,140010837,465110,1,16592,0.000118505,108329050,0.773719
D.bocki,140010837,456048,1,16590,0.000118491,108345640,0.773838
D.bocki,140010837,461670,1,16586,0.000118462,108362226,0.773956
D.bocki,140010837,463611,1,16576,0.000118391,108378802,0.774074
D.bocki,140010837,464661,1,16563,0.000118298,108395365,0.774193
D.bocki,140010837,464774,1,16552,0.000118219,108411917,0.774311
D.bocki,140010837,458880,1,16540,0.000118134,108428457,0.774429
D.bocki,140010837,457845,1,16535,0.000118098,108444992,0.774547
D.bocki,140010837,461458,1,16532,0.000118077,108461524,0.774665
D.bocki,140010837,465137,1,16529,0.000118055,108478053,0.774783
D.bocki,140010837,456374,1,16510,0.000117919,108494563,0.774901
D.bocki,140010837,146344,1,16508,0.000117905,108511071,0.775019
D.bocki,140010837,458778,1,16506,0.000117891,108527577,0.775137
D.bocki,140010837,465136,1,16500,0.000117848,108544077,0.775255
D.bocki,140010837,72690,1,16495,0.000117812,108560572,0.775373
D.bocki,140010837,50689,1,16479,0.000117698,108577051,0.77549
D.bocki,140010837,457674,1,16450,0.000117491,108593501,0.775608
D.bocki,140010837,462325,1,16437,0.000117398,108609938,0.775725
D.bocki,140010837,282596,1,16423,0.000117298,108626361,0.775843
D.bocki,140010837,464077,1,16392,0.000117077,108642753,0.77596
D.bocki,140010837,464889,1,16388,0.000117048,108659141,0.776077
D.bocki,140010837,460699,1,16387,0.000117041,108675528,0.776194
D.bocki,140010837,464373,1,16376,0.000116962,108691904,0.776311
D.bocki,140010837,459097,1,16368,0.000116905,108708272,0.776428
D.bocki,140010837,458681,1,16364,0.000116877,108724636,0.776544
D.bocki,140010837,461047,1,16361,0.000116855,108740997,0.776661
D.bocki,140010837,464749,1,16309,0.000116484,108757306,0.776778
D.bocki,140010837,401426,1,16309,0.000116484,108773615,0.776894
D.bocki,140010837,456400,1,16308,0.000116477,108789923,0.777011
D.bocki,140010837,179152,1,16301,0.000116427,108806224,0.777127
D.bocki,140010837,463488,1,16296,0.000116391,108822520,0.777244
D.bocki,140010837,461011,1,16296,0.000116391,108838816,0.77736
D.bocki,140010837,456676,1,16273,0.000116227,108855089,0.777476
D.bocki,140010837,319878,1,16263,0.000116155,108871352,0.777592
D.bocki,140010837,460972,1,16253,0.000116084,108887605,0.777708
D.bocki,140010837,461561,1,16227,0.000115898,108903832,0.777824
D.bocki,140010837,455706,1,16207,0.000115755,108920039,0.77794
D.bocki,140010837,460111,1,16188,0.00011562,108936227,0.778056
D.bocki,140010837,458456,1,16168,0.000115477,108952395,0.778171
D.bocki,140010837,460480,1,16164,0.000115448,108968559,0.778287
D.bocki,140010837,456769,1,16156,0.000115391,108984715,0.778402
D.bocki,140010837,458218,1,16116,0.000115105,109000831,0.778517
D.bocki,140010837,457869,1,16112,0.000115077,109016943,0.778632
D.bocki,140010837,460660,1,16111,0.00011507,109033054,0.778747
D.bocki,140010837,457566,1,16106,0.000115034,109049160,0.778862
D.bocki,140010837,464303,1,16098,0.000114977,109065258,0.778977
D.bocki,140010837,463188,1,16089,0.000114913,109081347,0.779092
D.bocki,140010837,464346,1,16074,0.000114805,109097421,0.779207
D.bocki,140010837,463194,1,16074,0.000114805,109113495,0.779322
D.bocki,140010837,349178,1,16070,0.000114777,109129565,0.779437
D.bocki,140010837,460516,1,16069,0.00011477,109145634,0.779551
D.bocki,140010837,461578,1,16067,0.000114755,109161701,0.779666
D.bocki,140010837,457224,1,16040,0.000114563,109177741,0.779781
D.bocki,140010837,222282,1,16025,0.000114455,109193766,0.779895
D.bocki,140010837,463084,1,16021,0.000114427,109209787,0.78001
D.bocki,140010837,458507,1,16006,0.00011432,109225793,0.780124
D.bocki,140010837,464512,1,15982,0.000114148,109241775,0.780238
D.bocki,140010837,455789,1,15981,0.000114141,109257756,0.780352
D.bocki,140010837,463573,1,15976,0.000114105,109273732,0.780466
D.bocki,140010837,463852,1,15963,0.000114013,109289695,0.78058
D.bocki,140010837,461523,1,15944,0.000113877,109305639,0.780694
D.bocki,140010837,247389,1,15942,0.000113863,109321581,0.780808
D.bocki,140010837,465096,1,15923,0.000113727,109337504,0.780922
D.bocki,140010837,464655,1,15907,0.000113613,109353411,0.781035
D.bocki,140010837,464997,1,15905,0.000113598,109369316,0.781149
D.bocki,140010837,463988,1,15901,0.00011357,109385217,0.781263
D.bocki,140010837,464770,1,15900,0.000113563,109401117,0.781376
D.bocki,140010837,459075,1,15900,0.000113563,109417017,0.78149
D.bocki,140010837,462181,1,15898,0.000113548,109432915,0.781603
D.bocki,140010837,463208,1,15897,0.000113541,109448812,0.781717
D.bocki,140010837,465133,1,15889,0.000113484,109464701,0.78183
D.bocki,140010837,464863,1,15877,0.000113398,109480578,0.781944
D.bocki,140010837,464433,1,15863,0.000113298,109496441,0.782057
D.bocki,140010837,464097,1,15855,0.000113241,109512296,0.78217
D.bocki,140010837,456064,1,15837,0.000113113,109528133,0.782283
D.bocki,140010837,464599,1,15829,0.000113056,109543962,0.782396
D.bocki,140010837,455743,1,15820,0.000112991,109559782,0.782509
D.bocki,140010837,462782,1,15813,0.000112941,109575595,0.782622
D.bocki,140010837,457631,1,15795,0.000112813,109591390,0.782735
D.bocki,140010837,157666,1,15782,0.00011272,109607172,0.782848
D.bocki,140010837,457520,1,15779,0.000112698,109622951,0.78296
D.bocki,140010837,459809,1,15778,0.000112691,109638729,0.783073
D.bocki,140010837,462585,1,15774,0.000112663,109654503,0.783186
D.bocki,140010837,119690,1,15763,0.000112584,109670266,0.783298
D.bocki,140010837,460454,1,15762,0.000112577,109686028,0.783411
D.bocki,140010837,464012,1,15761,0.00011257,109701789,0.783524
D.bocki,140010837,303802,1,15754,0.00011252,109717543,0.783636
D.bocki,140010837,234193,1,15748,0.000112477,109733291,0.783749
D.bocki,140010837,464376,1,15742,0.000112434,109749033,0.783861
D.bocki,140010837,459789,1,15726,0.00011232,109764759,0.783973
D.bocki,140010837,464611,1,15719,0.00011227,109780478,0.784086
D.bocki,140010837,464796,1,15705,0.00011217,109796183,0.784198
D.bocki,140010837,459591,1,15681,0.000111998,109811864,0.78431
D.bocki,140010837,461871,1,15661,0.000111856,109827525,0.784422
D.bocki,140010837,464761,1,15651,0.000111784,109843176,0.784533
D.bocki,140010837,463036,1,15641,0.000111713,109858817,0.784645
D.bocki,140010837,463990,1,15609,0.000111484,109874426,0.784757
D.bocki,140010837,456857,1,15558,0.00011112,109889984,0.784868
D.bocki,140010837,464342,1,15533,0.000110941,109905517,0.784979
D.bocki,140010837,461033,1,15531,0.000110927,109921048,0.78509
D.bocki,140010837,459160,1,15522,0.000110863,109936570,0.7852
D.bocki,140010837,464970,1,15518,0.000110834,109952088,0.785311
D.bocki,140010837,456287,1,15514,0.000110806,109967602,0.785422
D.bocki,140010837,458394,1,15505,0.000110741,109983107,0.785533
D.bocki,140010837,464605,1,15503,0.000110727,109998610,0.785644
D.bocki,140010837,451503,1,15501,0.000110713,110014111,0.785754
D.bocki,140010837,463459,1,15489,0.000110627,110029600,0.785865
D.bocki,140010837,464813,1,15480,0.000110563,110045080,0.785975
D.bocki,140010837,464575,1,15480,0.000110563,110060560,0.786086
D.bocki,140010837,464099,1,15464,0.000110449,110076024,0.786196
D.bocki,140010837,292694,1,15458,0.000110406,110091482,0.786307
D.bocki,140010837,458585,1,15431,0.000110213,110106913,0.786417
D.bocki,140010837,464199,1,15428,0.000110191,110122341,0.786527
D.bocki,140010837,462586,1,15401,0.000109999,110137742,0.786637
D.bocki,140010837,167376,1,15380,0.000109849,110153122,0.786747
D.bocki,140010837,463604,1,15375,0.000109813,110168497,0.786857
D.bocki,140010837,456075,1,15370,0.000109777,110183867,0.786967
D.bocki,140010837,459976,1,15361,0.000109713,110199228,0.787076
D.bocki,140010837,463167,1,15355,0.00010967,110214583,0.787186
D.bocki,140010837,127257,1,15353,0.000109656,110229936,0.787296
D.bocki,140010837,460076,1,15352,0.000109649,110245288,0.787405
D.bocki,140010837,464362,1,15349,0.000109627,110260637,0.787515
D.bocki,140010837,463020,1,15327,0.00010947,110275964,0.787624
D.bocki,140010837,459345,1,15300,0.000109277,110291264,0.787734
D.bocki,140010837,458990,1,15281,0.000109142,110306545,0.787843
D.bocki,140010837,456883,1,15243,0.00010887,110321788,0.787952
D.bocki,140010837,461384,1,15236,0.00010882,110337024,0.788061
D.bocki,140010837,462057,1,15231,0.000108784,110352255,0.788169
D.bocki,140010837,464828,1,15227,0.000108756,110367482,0.788278
D.bocki,140010837,460235,1,15221,0.000108713,110382703,0.788387
D.bocki,140010837,456751,1,15194,0.00010852,110397897,0.788495
D.bocki,140010837,457937,1,15178,0.000108406,110413075,0.788604
D.bocki,140010837,464025,1,15156,0.000108249,110428231,0.788712
D.bocki,140010837,465037,1,15148,0.000108192,110443379,0.78882
D.bocki,140010837,460094,1,15143,0.000108156,110458522,0.788928
D.bocki,140010837,463511,1,15142,0.000108149,110473664,0.789037
D.bocki,140010837,463679,1,15139,0.000108127,110488803,0.789145
D.bocki,140010837,9494,1,15119,0.000107984,110503922,0.789253
D.bocki,140010837,465013,1,15100,0.000107849,110519022,0.78936
D.bocki,140010837,463666,1,15094,0.000107806,110534116,0.789468
D.bocki,140010837,461095,1,15088,0.000107763,110549204,0.789576
D.bocki,140010837,463255,1,15078,0.000107692,110564282,0.789684
D.bocki,140010837,464935,1,15064,0.000107592,110579346,0.789791
D.bocki,140010837,461196,1,15054,0.00010752,110594400,0.789899
D.bocki,140010837,457390,1,15047,0.00010747,110609447,0.790006
D.bocki,140010837,461516,1,15042,0.000107435,110624489,0.790114
D.bocki,140010837,458217,1,15026,0.00010732,110639515,0.790221
D.bocki,140010837,464406,1,15016,0.000107249,110654531,0.790328
D.bocki,140010837,461954,1,15001,0.000107142,110669532,0.790435
D.bocki,140010837,460889,1,14968,0.000106906,110684500,0.790542
D.bocki,140010837,463019,1,14958,0.000106835,110699458,0.790649
D.bocki,140010837,457319,1,14925,0.000106599,110714383,0.790756
D.bocki,140010837,456497,1,14911,0.000106499,110729294,0.790862
D.bocki,140010837,461081,1,14880,0.000106277,110744174,0.790969
D.bocki,140010837,464950,1,14875,0.000106242,110759049,0.791075
D.bocki,140010837,464330,1,14870,0.000106206,110773919,0.791181
D.bocki,140010837,460989,1,14847,0.000106042,110788766,0.791287
D.bocki,140010837,458903,1,14844,0.00010602,110803610,0.791393
D.bocki,140010837,18896,1,14817,0.000105828,110818427,0.791499
D.bocki,140010837,463761,1,14793,0.000105656,110833220,0.791605
D.bocki,140010837,458471,1,14786,0.000105606,110848006,0.79171
D.bocki,140010837,30322,1,14772,0.000105506,110862778,0.791816
D.bocki,140010837,460783,1,14765,0.000105456,110877543,0.791921
D.bocki,140010837,457132,1,14745,0.000105313,110892288,0.792026
D.bocki,140010837,463659,1,14744,0.000105306,110907032,0.792132
D.bocki,140010837,459668,1,14733,0.000105228,110921765,0.792237
D.bocki,140010837,464643,1,14719,0.000105128,110936484,0.792342
D.bocki,140010837,465081,1,14713,0.000105085,110951197,0.792447
D.bocki,140010837,462831,1,14697,0.00010497,110965894,0.792552
D.bocki,140010837,458245,1,14640,0.000104563,110980534,0.792657
D.bocki,140010837,459171,1,14636,0.000104535,110995170,0.792761
D.bocki,140010837,463069,1,14632,0.000104506,111009802,0.792866
D.bocki,140010837,460408,1,14628,0.000104478,111024430,0.79297
D.bocki,140010837,463355,1,14619,0.000104413,111039049,0.793075
D.bocki,140010837,459625,1,14616,0.000104392,111053665,0.793179
D.bocki,140010837,460438,1,14612,0.000104363,111068277,0.793283
D.bocki,140010837,5706,1,14606,0.00010432,111082883,0.793388
D.bocki,140010837,463402,1,14551,0.000103928,111097434,0.793492
D.bocki,140010837,457414,1,14532,0.000103792,111111966,0.793595
D.bocki,140010837,424400,1,14524,0.000103735,111126490,0.793699
D.bocki,140010837,459627,1,14523,0.000103728,111141013,0.793803
D.bocki,140010837,463641,1,14513,0.000103656,111155526,0.793907
D.bocki,140010837,457163,1,14504,0.000103592,111170030,0.79401
D.bocki,140010837,461314,1,14502,0.000103578,111184532,0.794114
D.bocki,140010837,460139,1,14482,0.000103435,111199014,0.794217
D.bocki,140010837,462266,1,14480,0.000103421,111213494,0.794321
D.bocki,140010837,463851,1,14471,0.000103356,111227965,0.794424
D.bocki,140010837,457865,1,14463,0.000103299,111242428,0.794527
D.bocki,140010837,459135,1,14454,0.000103235,111256882,0.794631
D.bocki,140010837,465077,1,14434,0.000103092,111271316,0.794734
D.bocki,140010837,460582,1,14422,0.000103006,111285738,0.794837
D.bocki,140010837,443572,1,14419,0.000102985,111300157,0.79494
D.bocki,140010837,463089,1,14418,0.000102978,111314575,0.795043
D.bocki,140010837,464498,1,14365,0.000102599,111328940,0.795145
D.bocki,140010837,459332,1,14356,0.000102535,111343296,0.795248
D.bocki,140010837,460018,1,14337,0.000102399,111357633,0.79535
D.bocki,140010837,463720,1,14331,0.000102356,111371964,0.795452
D.bocki,140010837,457767,1,14330,0.000102349,111386294,0.795555
D.bocki,140010837,456492,1,14323,0.000102299,111400617,0.795657
D.bocki,140010837,331445,1,14313,0.000102228,111414930,0.795759
D.bocki,140010837,463909,1,14289,0.000102056,111429219,0.795861
D.bocki,140010837,463055,1,14288,0.000102049,111443507,0.795963
D.bocki,140010837,464629,1,14274,0.000101949,111457781,0.796065
D.bocki,140010837,461781,1,14274,0.000101949,111472055,0.796167
D.bocki,140010837,464390,1,14268,0.000101906,111486323,0.796269
D.bocki,140010837,454722,1,14267,0.000101899,111500590,0.796371
D.bocki,140010837,457697,1,14256,0.000101821,111514846,0.796473
D.bocki,140010837,456507,1,14233,0.000101656,111529079,0.796575
D.bocki,140010837,455927,1,14227,0.000101614,111543306,0.796676
D.bocki,140010837,464916,1,14206,0.000101464,111557512,0.796778
D.bocki,140010837,460041,1,14180,0.000101278,111571692,0.796879
D.bocki,140010837,464641,1,14171,0.000101214,111585863,0.79698
D.bocki,140010837,459917,1,14161,0.000101142,111600024,0.797081
D.bocki,140010837,463861,1,14155,0.000101099,111614179,0.797182
D.bocki,140010837,457969,1,14135,0.000100956,111628314,0.797283
D.bocki,140010837,457083,1,14134,0.000100949,111642448,0.797384
D.bocki,140010837,457581,1,14110,0.000100778,111656558,0.797485
D.bocki,140010837,456336,1,14107,0.000100756,111670665,0.797586
D.bocki,140010837,464987,1,14103,0.000100728,111684768,0.797687
D.bocki,140010837,95456,1,14073,0.000100514,111698841,0.797787
D.bocki,140010837,462577,1,14064,0.000100449,111712905,0.797888
D.bocki,140010837,460431,1,14050,0.000100349,111726955,0.797988
D.bocki,140010837,464823,1,14049,0.000100342,111741004,0.798088
D.bocki,140010837,459688,1,14043,0.000100299,111755047,0.798189
D.bocki,140010837,456222,1,14016,0.000100107,111769063,0.798289
D.bocki,140010837,460213,1,14013,0.000100085,111783076,0.798389
D.bocki,140010837,463086,1,13999,9.99851e-05,111797075,0.798489
D.bocki,140010837,461003,1,13987,9.98994e-05,111811062,0.798589
D.bocki,140010837,464249,1,13972,9.97923e-05,111825034,0.798688
D.bocki,140010837,153518,1,13971,9.97851e-05,111839005,0.798788
D.bocki,140010837,462671,1,13963,9.9728e-05,111852968,0.798888
D.bocki,140010837,458259,1,13958,9.96923e-05,111866926,0.798988
D.bocki,140010837,461195,1,13956,9.9678e-05,111880882,0.799087
D.bocki,140010837,212252,1,13939,9.95566e-05,111894821,0.799187
D.bocki,140010837,464862,1,13907,9.9328e-05,111908728,0.799286
D.bocki,140010837,456758,1,13893,9.9228e-05,111922621,0.799385
D.bocki,140010837,464839,1,13877,9.91138e-05,111936498,0.799485
D.bocki,140010837,464812,1,13876,9.91066e-05,111950374,0.799584
D.bocki,140010837,464714,1,13857,9.89709e-05,111964231,0.799683
D.bocki,140010837,457607,1,13830,9.87781e-05,111978061,0.799781
D.bocki,140010837,464514,1,13817,9.86852e-05,111991878,0.79988
D.bocki,140010837,463196,1,13786,9.84638e-05,112005664,0.799979
D.bocki,140010837,458804,1,13777,9.83995e-05,112019441,0.800077
D.bocki,140010837,462022,1,13765,9.83138e-05,112033206,0.800175
D.bocki,140010837,353306,1,13763,9.82995e-05,112046969,0.800274
D.bocki,140010837,462450,1,13740,9.81353e-05,112060709,0.800372
D.bocki,140010837,455960,1,13724,9.8021e-05,112074433,0.80047
D.bocki,140010837,462069,1,13698,9.78353e-05,112088131,0.800568
D.bocki,140010837,458876,1,13686,9.77496e-05,112101817,0.800665
D.bocki,140010837,458723,1,13673,9.76567e-05,112115490,0.800763
D.bocki,140010837,464487,1,13669,9.76282e-05,112129159,0.800861
D.bocki,140010837,465049,1,13664,9.75924e-05,112142823,0.800958
D.bocki,140010837,463737,1,13664,9.75924e-05,112156487,0.801056
D.bocki,140010837,459950,1,13653,9.75139e-05,112170140,0.801153
D.bocki,140010837,464781,1,13651,9.74996e-05,112183791,0.801251
D.bocki,140010837,456939,1,13645,9.74567e-05,112197436,0.801348
D.bocki,140010837,460381,1,13633,9.7371e-05,112211069,0.801446
D.bocki,140010837,458838,1,13621,9.72853e-05,112224690,0.801543
D.bocki,140010837,135479,1,13593,9.70853e-05,112238283,0.80164
D.bocki,140010837,456925,1,13548,9.67639e-05,112251831,0.801737
D.bocki,140010837,463610,1,13546,9.67497e-05,112265377,0.801833
D.bocki,140010837,459886,1,13542,9.67211e-05,112278919,0.80193
D.bocki,140010837,464130,1,13533,9.66568e-05,112292452,0.802027
D.bocki,140010837,463706,1,13528,9.66211e-05,112305980,0.802123
D.bocki,140010837,456587,1,13505,9.64568e-05,112319485,0.80222
D.bocki,140010837,464764,1,13486,9.63211e-05,112332971,0.802316
D.bocki,140010837,463748,1,13480,9.62783e-05,112346451,0.802413
D.bocki,140010837,457062,1,13476,9.62497e-05,112359927,0.802509
D.bocki,140010837,464485,1,13469,9.61997e-05,112373396,0.802605
D.bocki,140010837,458726,1,13455,9.60997e-05,112386851,0.802701
D.bocki,140010837,456576,1,13450,9.6064e-05,112400301,0.802797
D.bocki,140010837,464275,1,13440,9.59926e-05,112413741,0.802893
D.bocki,140010837,463405,1,13439,9.59854e-05,112427180,0.802989
D.bocki,140010837,130119,1,13433,9.59426e-05,112440613,0.803085
D.bocki,140010837,459106,1,13407,9.57569e-05,112454020,0.803181
D.bocki,140010837,464587,1,13403,9.57283e-05,112467423,0.803277
D.bocki,140010837,464545,1,13403,9.57283e-05,112480826,0.803372
D.bocki,140010837,463754,1,13396,9.56783e-05,112494222,0.803468
D.bocki,140010837,463093,1,13381,9.55712e-05,112507603,0.803564
D.bocki,140010837,464979,1,13380,9.5564e-05,112520983,0.803659
D.bocki,140010837,463290,1,13371,9.54998e-05,112534354,0.803755
D.bocki,140010837,460551,1,13361,9.54283e-05,112547715,0.80385
D.bocki,140010837,465078,1,13360,9.54212e-05,112561075,0.803945
D.bocki,140010837,332165,1,13358,9.54069e-05,112574433,0.804041
D.bocki,140010837,462261,1,13354,9.53783e-05,112587787,0.804136
D.bocki,140010837,254049,1,13354,9.53783e-05,112601141,0.804232
D.bocki,140010837,463094,1,13353,9.53712e-05,112614494,0.804327
D.bocki,140010837,463316,1,13349,9.53426e-05,112627843,0.804422
D.bocki,140010837,460217,1,13336,9.52498e-05,112641179,0.804518
D.bocki,140010837,125133,1,13324,9.51641e-05,112654503,0.804613
D.bocki,140010837,458829,1,13297,9.49712e-05,112667800,0.804708
D.bocki,140010837,460849,1,13275,9.48141e-05,112681075,0.804803
D.bocki,140010837,459224,1,13258,9.46927e-05,112694333,0.804897
D.bocki,140010837,351263,1,13251,9.46427e-05,112707584,0.804992
D.bocki,140010837,233631,1,13240,9.45641e-05,112720824,0.805086
D.bocki,140010837,94192,1,13230,9.44927e-05,112734054,0.805181
D.bocki,140010837,464355,1,13227,9.44713e-05,112747281,0.805275
D.bocki,140010837,458807,1,13222,9.44355e-05,112760503,0.80537
D.bocki,140010837,464094,1,13219,9.44141e-05,112773722,0.805464
D.bocki,140010837,456574,1,13208,9.43356e-05,112786930,0.805559
D.bocki,140010837,240140,1,13207,9.43284e-05,112800137,0.805653
D.bocki,140010837,456816,1,13197,9.4257e-05,112813334,0.805747
D.bocki,140010837,462299,1,13190,9.4207e-05,112826524,0.805841
D.bocki,140010837,283468,1,13188,9.41927e-05,112839712,0.805936
D.bocki,140010837,463331,1,13180,9.41356e-05,112852892,0.80603
D.bocki,140010837,463818,1,13173,9.40856e-05,112866065,0.806124
D.bocki,140010837,114598,1,13150,9.39213e-05,112879215,0.806218
D.bocki,140010837,194773,1,13148,9.3907e-05,112892363,0.806312
D.bocki,140010837,462352,1,13142,9.38642e-05,112905505,0.806405
D.bocki,140010837,464870,1,13136,9.38213e-05,112918641,0.806499
D.bocki,140010837,22096,1,13136,9.38213e-05,112931777,0.806593
D.bocki,140010837,465126,1,13129,9.37713e-05,112944906,0.806687
D.bocki,140010837,460251,1,13123,9.37285e-05,112958029,0.806781
D.bocki,140010837,457994,1,13121,9.37142e-05,112971150,0.806874
D.bocki,140010837,463376,1,13106,9.3607e-05,112984256,0.806968
D.bocki,140010837,465134,1,13093,9.35142e-05,112997349,0.807061
D.bocki,140010837,460750,1,13083,9.34428e-05,113010432,0.807155
D.bocki,140010837,459796,1,13080,9.34213e-05,113023512,0.807248
D.bocki,140010837,461624,1,13074,9.33785e-05,113036586,0.807342
D.bocki,140010837,457118,1,13045,9.31714e-05,113049631,0.807435
D.bocki,140010837,464925,1,13037,9.31142e-05,113062668,0.807528
D.bocki,140010837,373726,1,13003,9.28714e-05,113075671,0.807621
D.bocki,140010837,465069,1,13000,9.285e-05,113088671,0.807714
D.bocki,140010837,457156,1,12997,9.28285e-05,113101668,0.807807
D.bocki,140010837,460046,1,12990,9.27785e-05,113114658,0.807899
D.bocki,140010837,463669,1,12981,9.27143e-05,113127639,0.807992
D.bocki,140010837,463471,1,12975,9.26714e-05,113140614,0.808085
D.bocki,140010837,462256,1,12968,9.26214e-05,113153582,0.808177
D.bocki,140010837,464547,1,12931,9.23571e-05,113166513,0.80827
D.bocki,140010837,464713,1,12923,9.23e-05,113179436,0.808362
D.bocki,140010837,354271,1,12889,9.20572e-05,113192325,0.808454
D.bocki,140010837,455896,1,12884,9.20214e-05,113205209,0.808546
D.bocki,140010837,462048,1,12881,9.2e-05,113218090,0.808638
D.bocki,140010837,425951,1,12881,9.2e-05,113230971,0.80873
D.bocki,140010837,458757,1,12871,9.19286e-05,113243842,0.808822
D.bocki,140010837,465005,1,12869,9.19143e-05,113256711,0.808914
D.bocki,140010837,463001,1,12865,9.18857e-05,113269576,0.809006
D.bocki,140010837,456845,1,12860,9.185e-05,113282436,0.809098
D.bocki,140010837,457085,1,12854,9.18072e-05,113295290,0.809189
D.bocki,140010837,457768,1,12852,9.17929e-05,113308142,0.809281
D.bocki,140010837,464502,1,12849,9.17715e-05,113320991,0.809373
D.bocki,140010837,276615,1,12847,9.17572e-05,113333838,0.809465
D.bocki,140010837,464752,1,12846,9.175e-05,113346684,0.809557
D.bocki,140010837,459213,1,12824,9.15929e-05,113359508,0.809648
D.bocki,140010837,457583,1,12823,9.15858e-05,113372331,0.80974
D.bocki,140010837,458225,1,12817,9.15429e-05,113385148,0.809831
D.bocki,140010837,464660,1,12816,9.15358e-05,113397964,0.809923
D.bocki,140010837,88373,1,12810,9.14929e-05,113410774,0.810014
D.bocki,140010837,459932,1,12791,9.13572e-05,113423565,0.810106
D.bocki,140010837,462591,1,12789,9.13429e-05,113436354,0.810197
D.bocki,140010837,465116,1,12786,9.13215e-05,113449140,0.810288
D.bocki,140010837,462507,1,12775,9.12429e-05,113461915,0.81038
D.bocki,140010837,457349,1,12771,9.12144e-05,113474686,0.810471
D.bocki,140010837,464100,1,12762,9.11501e-05,113487448,0.810562
D.bocki,140010837,270960,1,12738,9.09787e-05,113500186,0.810653
D.bocki,140010837,464695,1,12736,9.09644e-05,113512922,0.810744
D.bocki,140010837,461641,1,12730,9.09215e-05,113525652,0.810835
D.bocki,140010837,320238,1,12719,9.0843e-05,113538371,0.810926
D.bocki,140010837,465101,1,12716,9.08215e-05,113551087,0.811016
D.bocki,140010837,271517,1,12702,9.07215e-05,113563789,0.811107
D.bocki,140010837,460390,1,12687,9.06144e-05,113576476,0.811198
D.bocki,140010837,465122,1,12686,9.06073e-05,113589162,0.811288
D.bocki,140010837,67918,1,12673,9.05144e-05,113601835,0.811379
D.bocki,140010837,464341,1,12672,9.05073e-05,113614507,0.811469
D.bocki,140010837,459513,1,12668,9.04787e-05,113627175,0.81156
D.bocki,140010837,218336,1,12657,9.04001e-05,113639832,0.81165
D.bocki,140010837,460856,1,12654,9.03787e-05,113652486,0.811741
D.bocki,140010837,457976,1,12650,9.03501e-05,113665136,0.811831
D.bocki,140010837,158806,1,12649,9.0343e-05,113677785,0.811921
D.bocki,140010837,461602,1,12643,9.03002e-05,113690428,0.812012
D.bocki,140010837,460008,1,12625,9.01716e-05,113703053,0.812102
D.bocki,140010837,459023,1,12623,9.01573e-05,113715676,0.812192
D.bocki,140010837,460054,1,12617,9.01145e-05,113728293,0.812282
D.bocki,140010837,464674,1,12596,8.99645e-05,113740889,0.812372
D.bocki,140010837,458687,1,12579,8.9843e-05,113753468,0.812462
D.bocki,140010837,463630,1,12569,8.97716e-05,113766037,0.812552
D.bocki,140010837,457503,1,12569,8.97716e-05,113778606,0.812641
D.bocki,140010837,462109,1,12563,8.97288e-05,113791169,0.812731
D.bocki,140010837,464991,1,12561,8.97145e-05,113803730,0.812821
D.bocki,140010837,460943,1,12556,8.96788e-05,113816286,0.812911
D.bocki,140010837,462519,1,12554,8.96645e-05,113828840,0.813
D.bocki,140010837,465100,1,12498,8.92645e-05,113841338,0.813089
D.bocki,140010837,465102,1,12494,8.92359e-05,113853832,0.813179
D.bocki,140010837,464892,1,12449,8.89145e-05,113866281,0.813268
D.bocki,140010837,458275,1,12433,8.88003e-05,113878714,0.813356
D.bocki,140010837,461321,1,12420,8.87074e-05,113891134,0.813445
D.bocki,140010837,458034,1,12415,8.86717e-05,113903549,0.813534
D.bocki,140010837,455752,1,12414,8.86646e-05,113915963,0.813622
D.bocki,140010837,149431,1,12410,8.8636e-05,113928373,0.813711
D.bocki,140010837,456150,1,12406,8.86074e-05,113940779,0.8138
D.bocki,140010837,457086,1,12401,8.85717e-05,113953180,0.813888
D.bocki,140010837,462077,1,12343,8.81575e-05,113965523,0.813976
D.bocki,140010837,464208,1,12306,8.78932e-05,113977829,0.814064
D.bocki,140010837,459772,1,12273,8.76575e-05,113990102,0.814152
D.bocki,140010837,464129,1,12272,8.76504e-05,114002374,0.81424
D.bocki,140010837,463848,1,12270,8.76361e-05,114014644,0.814327
D.bocki,140010837,458800,1,12255,8.75289e-05,114026899,0.814415
D.bocki,140010837,456451,1,12248,8.74789e-05,114039147,0.814502
D.bocki,140010837,458016,1,12243,8.74432e-05,114051390,0.81459
D.bocki,140010837,458675,1,12233,8.73718e-05,114063623,0.814677
D.bocki,140010837,456329,1,12232,8.73647e-05,114075855,0.814764
D.bocki,140010837,463628,1,12217,8.72575e-05,114088072,0.814852
D.bocki,140010837,464354,1,12213,8.7229e-05,114100285,0.814939
D.bocki,140010837,459193,1,12172,8.69361e-05,114112457,0.815026
D.bocki,140010837,463073,1,12171,8.6929e-05,114124628,0.815113
D.bocki,140010837,459756,1,12164,8.6879e-05,114136792,0.8152
D.bocki,140010837,464310,1,12163,8.68718e-05,114148955,0.815287
D.bocki,140010837,464167,1,12163,8.68718e-05,114161118,0.815373
D.bocki,140010837,462828,1,12140,8.67076e-05,114173258,0.81546
D.bocki,140010837,458142,1,12137,8.66861e-05,114185395,0.815547
D.bocki,140010837,463042,1,12136,8.6679e-05,114197531,0.815634
D.bocki,140010837,464170,1,12119,8.65576e-05,114209650,0.81572
D.bocki,140010837,461469,1,12107,8.64719e-05,114221757,0.815807
D.bocki,140010837,465060,1,12083,8.63005e-05,114233840,0.815893
D.bocki,140010837,456518,1,12082,8.62933e-05,114245922,0.815979
D.bocki,140010837,463413,1,12079,8.62719e-05,114258001,0.816065
D.bocki,140010837,456715,1,12070,8.62076e-05,114270071,0.816152
D.bocki,140010837,101116,1,12056,8.61076e-05,114282127,0.816238
D.bocki,140010837,420328,1,12045,8.60291e-05,114294172,0.816324
D.bocki,140010837,462955,1,12038,8.59791e-05,114306210,0.81641
D.bocki,140010837,462146,1,12037,8.59719e-05,114318247,0.816496
D.bocki,140010837,463486,1,12029,8.59148e-05,114330276,0.816582
D.bocki,140010837,459132,1,12026,8.58934e-05,114342302,0.816668
D.bocki,140010837,448704,1,12024,8.58791e-05,114354326,0.816753
D.bocki,140010837,455813,1,12018,8.58362e-05,114366344,0.816839
D.bocki,140010837,459900,1,12011,8.57862e-05,114378355,0.816925
D.bocki,140010837,465036,1,12009,8.57719e-05,114390364,0.817011
D.bocki,140010837,462850,1,11996,8.56791e-05,114402360,0.817096
D.bocki,140010837,465015,1,11987,8.56148e-05,114414347,0.817182
D.bocki,140010837,464934,1,11976,8.55362e-05,114426323,0.817268
D.bocki,140010837,464837,1,11971,8.55005e-05,114438294,0.817353
D.bocki,140010837,464744,1,11969,8.54862e-05,114450263,0.817439
D.bocki,140010837,463591,1,11967,8.5472e-05,114462230,0.817524
D.bocki,140010837,463792,1,11960,8.5422e-05,114474190,0.817609
D.bocki,140010837,458355,1,11958,8.54077e-05,114486148,0.817695
D.bocki,140010837,464353,1,11949,8.53434e-05,114498097,0.81778
D.bocki,140010837,464051,1,11931,8.52148e-05,114510028,0.817865
D.bocki,140010837,464542,1,11929,8.52005e-05,114521957,0.817951
D.bocki,140010837,459479,1,11924,8.51648e-05,114533881,0.818036
D.bocki,140010837,276624,1,11924,8.51648e-05,114545805,0.818121
D.bocki,140010837,451151,1,11915,8.51006e-05,114557720,0.818206
D.bocki,140010837,462870,1,11914,8.50934e-05,114569634,0.818291
D.bocki,140010837,464001,1,11906,8.50363e-05,114581540,0.818376
D.bocki,140010837,175782,1,11899,8.49863e-05,114593439,0.818461
D.bocki,140010837,462416,1,11889,8.49149e-05,114605328,0.818546
D.bocki,140010837,460202,1,11889,8.49149e-05,114617217,0.818631
D.bocki,140010837,459328,1,11886,8.48934e-05,114629103,0.818716
D.bocki,140010837,462413,1,11885,8.48863e-05,114640988,0.818801
D.bocki,140010837,462293,1,11883,8.4872e-05,114652871,0.818886
D.bocki,140010837,459057,1,11882,8.48649e-05,114664753,0.818971
D.bocki,140010837,64849,1,11879,8.48434e-05,114676632,0.819055
D.bocki,140010837,457687,1,11876,8.4822e-05,114688508,0.81914
D.bocki,140010837,230010,1,11876,8.4822e-05,114700384,0.819225
D.bocki,140010837,462259,1,11866,8.47506e-05,114712250,0.81931
D.bocki,140010837,460625,1,11863,8.47292e-05,114724113,0.819395
D.bocki,140010837,456383,1,11863,8.47292e-05,114735976,0.819479
D.bocki,140010837,460126,1,11841,8.4572e-05,114747817,0.819564
D.bocki,140010837,77438,1,11829,8.44863e-05,114759646,0.819648
D.bocki,140010837,460100,1,11829,8.44863e-05,114771475,0.819733
D.bocki,140010837,456290,1,11823,8.44435e-05,114783298,0.819817
D.bocki,140010837,460704,1,11799,8.4272e-05,114795097,0.819902
D.bocki,140010837,460170,1,11792,8.42221e-05,114806889,0.819986
D.bocki,140010837,461145,1,11788,8.41935e-05,114818677,0.82007
D.bocki,140010837,462039,1,11767,8.40435e-05,114830444,0.820154
D.bocki,140010837,460165,1,11756,8.39649e-05,114842200,0.820238
D.bocki,140010837,464387,1,11732,8.37935e-05,114853932,0.820322
D.bocki,140010837,462860,1,11728,8.37649e-05,114865660,0.820405
D.bocki,140010837,461793,1,11726,8.37507e-05,114877386,0.820489
D.bocki,140010837,464519,1,11724,8.37364e-05,114889110,0.820573
D.bocki,140010837,457497,1,11724,8.37364e-05,114900834,0.820657
D.bocki,140010837,457964,1,11723,8.37292e-05,114912557,0.82074
D.bocki,140010837,457024,1,11723,8.37292e-05,114924280,0.820824
D.bocki,140010837,457533,1,11722,8.37221e-05,114936002,0.820908
D.bocki,140010837,463411,1,11714,8.3665e-05,114947716,0.820992
D.bocki,140010837,456577,1,11696,8.35364e-05,114959412,0.821075
D.bocki,140010837,464267,1,11656,8.32507e-05,114971068,0.821158
D.bocki,140010837,458708,1,11652,8.32221e-05,114982720,0.821242
D.bocki,140010837,455803,1,11647,8.31864e-05,114994367,0.821325
D.bocki,140010837,462974,1,11641,8.31436e-05,115006008,0.821408
D.bocki,140010837,10819,1,11639,8.31293e-05,115017647,0.821491
D.bocki,140010837,465004,1,11629,8.30579e-05,115029276,0.821574
D.bocki,140010837,464594,1,11624,8.30221e-05,115040900,0.821657
D.bocki,140010837,460444,1,11622,8.30079e-05,115052522,0.82174
D.bocki,140010837,462978,1,11610,8.29222e-05,115064132,0.821823
D.bocki,140010837,464702,1,11603,8.28722e-05,115075735,0.821906
D.bocki,140010837,462517,1,11599,8.28436e-05,115087334,0.821989
D.bocki,140010837,402531,1,11597,8.28293e-05,115098931,0.822072
D.bocki,140010837,459435,1,11586,8.27507e-05,115110517,0.822154
D.bocki,140010837,350934,1,11584,8.27365e-05,115122101,0.822237
D.bocki,140010837,464298,1,11583,8.27293e-05,115133684,0.82232
D.bocki,140010837,460414,1,11582,8.27222e-05,115145266,0.822403
D.bocki,140010837,194167,1,11577,8.26865e-05,115156843,0.822485
D.bocki,140010837,457790,1,11567,8.2615e-05,115168410,0.822568
D.bocki,140010837,138361,1,11559,8.25579e-05,115179969,0.82265
D.bocki,140010837,459852,1,11553,8.2515e-05,115191522,0.822733
D.bocki,140010837,456322,1,11539,8.2415e-05,115203061,0.822815
D.bocki,140010837,455838,1,11530,8.23508e-05,115214591,0.822898
D.bocki,140010837,459692,1,11529,8.23436e-05,115226120,0.82298
D.bocki,140010837,117714,1,11526,8.23222e-05,115237646,0.823062
D.bocki,140010837,397098,1,11525,8.23151e-05,115249171,0.823145
D.bocki,140010837,463962,1,11493,8.20865e-05,115260664,0.823227
D.bocki,140010837,451772,1,11479,8.19865e-05,115272143,0.823309
D.bocki,140010837,459786,1,11472,8.19365e-05,115283615,0.823391
D.bocki,140010837,463906,1,11470,8.19222e-05,115295085,0.823473
D.bocki,140010837,440541,1,11470,8.19222e-05,115306555,0.823555
D.bocki,140010837,456414,1,11452,8.17937e-05,115318007,0.823636
D.bocki,140010837,464467,1,11448,8.17651e-05,115329455,0.823718
D.bocki,140010837,462376,1,11441,8.17151e-05,115340896,0.8238
D.bocki,140010837,464740,1,11438,8.16937e-05,115352334,0.823881
D.bocki,140010837,455841,1,11434,8.16651e-05,115363768,0.823963
D.bocki,140010837,294266,1,11418,8.15508e-05,115375186,0.824045
D.bocki,140010837,460826,1,11407,8.14723e-05,115386593,0.824126
D.bocki,140010837,460013,1,11406,8.14651e-05,115397999,0.824208
D.bocki,140010837,464372,1,11391,8.1358e-05,115409390,0.824289
D.bocki,140010837,458385,1,11381,8.12866e-05,115420771,0.82437
D.bocki,140010837,460344,1,11370,8.1208e-05,115432141,0.824451
D.bocki,140010837,402496,1,11368,8.11937e-05,115443509,0.824533
D.bocki,140010837,455999,1,11356,8.1108e-05,115454865,0.824614
D.bocki,140010837,464338,1,11351,8.10723e-05,115466216,0.824695
D.bocki,140010837,463986,1,11350,8.10652e-05,115477566,0.824776
D.bocki,140010837,321993,1,11349,8.1058e-05,115488915,0.824857
D.bocki,140010837,150411,1,11347,8.10437e-05,115500262,0.824938
D.bocki,140010837,461061,1,11336,8.09652e-05,115511598,0.825019
D.bocki,140010837,465094,1,11332,8.09366e-05,115522930,0.8251
D.bocki,140010837,455724,1,11324,8.08795e-05,115534254,0.825181
D.bocki,140010837,455864,1,11321,8.0858e-05,115545575,0.825262
D.bocki,140010837,464540,1,11320,8.08509e-05,115556895,0.825343
D.bocki,140010837,457921,1,11269,8.04866e-05,115568164,0.825423
D.bocki,140010837,464005,1,11250,8.03509e-05,115579414,0.825503
D.bocki,140010837,464328,1,11249,8.03438e-05,115590663,0.825584
D.bocki,140010837,457561,1,11248,8.03366e-05,115601911,0.825664
D.bocki,140010837,252388,1,11248,8.03366e-05,115613159,0.825744
D.bocki,140010837,464712,1,11239,8.02724e-05,115624398,0.825825
D.bocki,140010837,459454,1,11232,8.02224e-05,115635630,0.825905
D.bocki,140010837,464348,1,11226,8.01795e-05,115646856,0.825985
D.bocki,140010837,461343,1,11214,8.00938e-05,115658070,0.826065
D.bocki,140010837,458940,1,11195,7.99581e-05,115669265,0.826145
D.bocki,140010837,463017,1,11194,7.9951e-05,115680459,0.826225
D.bocki,140010837,215552,1,11194,7.9951e-05,115691653,0.826305
D.bocki,140010837,461888,1,11189,7.99152e-05,115702842,0.826385
D.bocki,140010837,227196,1,11179,7.98438e-05,115714021,0.826465
D.bocki,140010837,85647,1,11169,7.97724e-05,115725190,0.826545
D.bocki,140010837,460323,1,11152,7.9651e-05,115736342,0.826624
D.bocki,140010837,464504,1,11148,7.96224e-05,115747490,0.826704
D.bocki,140010837,462763,1,11134,7.95224e-05,115758624,0.826783
D.bocki,140010837,455792,1,11129,7.94867e-05,115769753,0.826863
D.bocki,140010837,464000,1,11115,7.93867e-05,115780868,0.826942
D.bocki,140010837,462056,1,11115,7.93867e-05,115791983,0.827022
D.bocki,140010837,464921,1,11114,7.93796e-05,115803097,0.827101
D.bocki,140010837,464224,1,11113,7.93724e-05,115814210,0.82718
D.bocki,140010837,458353,1,11096,7.9251e-05,115825306,0.82726
D.bocki,140010837,457562,1,11083,7.91582e-05,115836389,0.827339
D.bocki,140010837,405739,1,11070,7.90653e-05,115847459,0.827418
D.bocki,140010837,464952,1,11063,7.90153e-05,115858522,0.827497
D.bocki,140010837,162340,1,11054,7.8951e-05,115869576,0.827576
D.bocki,140010837,464383,1,11021,7.87153e-05,115880597,0.827654
D.bocki,140010837,283522,1,11019,7.87011e-05,115891616,0.827733
D.bocki,140010837,123258,1,11015,7.86725e-05,115902631,0.827812
D.bocki,140010837,461192,1,11002,7.85796e-05,115913633,0.82789
D.bocki,140010837,451640,1,11001,7.85725e-05,115924634,0.827969
D.bocki,140010837,464083,1,10991,7.85011e-05,115935625,0.828048
D.bocki,140010837,288582,1,10982,7.84368e-05,115946607,0.828126
D.bocki,140010837,463952,1,10970,7.83511e-05,115957577,0.828204
D.bocki,140010837,452807,1,10962,7.82939e-05,115968539,0.828283
D.bocki,140010837,464701,1,10951,7.82154e-05,115979490,0.828361
D.bocki,140010837,462030,1,10951,7.82154e-05,115990441,0.828439
D.bocki,140010837,369576,1,10950,7.82082e-05,116001391,0.828517
D.bocki,140010837,463595,1,10943,7.81582e-05,116012334,0.828595
D.bocki,140010837,457816,1,10909,7.79154e-05,116023243,0.828673
D.bocki,140010837,298630,1,10876,7.76797e-05,116034119,0.828751
D.bocki,140010837,463148,1,10859,7.75583e-05,116044978,0.828829
D.bocki,140010837,79848,1,10837,7.74012e-05,116055815,0.828906
D.bocki,140010837,465089,1,10834,7.73797e-05,116066649,0.828983
D.bocki,140010837,464146,1,10824,7.73083e-05,116077473,0.829061
D.bocki,140010837,457665,1,10821,7.72869e-05,116088294,0.829138
D.bocki,140010837,458630,1,10820,7.72797e-05,116099114,0.829215
D.bocki,140010837,464621,1,10816,7.72512e-05,116109930,0.829292
D.bocki,140010837,462931,1,10804,7.71655e-05,116120734,0.82937
D.bocki,140010837,240077,1,10800,7.71369e-05,116131534,0.829447
D.bocki,140010837,456569,1,10797,7.71155e-05,116142331,0.829524
D.bocki,140010837,463647,1,10790,7.70655e-05,116153121,0.829601
D.bocki,140010837,462938,1,10781,7.70012e-05,116163902,0.829678
D.bocki,140010837,459480,1,10779,7.69869e-05,116174681,0.829755
D.bocki,140010837,463660,1,10762,7.68655e-05,116185443,0.829832
D.bocki,140010837,461986,1,10761,7.68583e-05,116196204,0.829909
D.bocki,140010837,460599,1,10756,7.68226e-05,116206960,0.829985
D.bocki,140010837,461391,1,10755,7.68155e-05,116217715,0.830062
D.bocki,140010837,463056,1,10740,7.67083e-05,116228455,0.830139
D.bocki,140010837,236702,1,10736,7.66798e-05,116239191,0.830216
D.bocki,140010837,464297,1,10731,7.66441e-05,116249922,0.830292
D.bocki,140010837,464423,1,10729,7.66298e-05,116260651,0.830369
D.bocki,140010837,462298,1,10719,7.65584e-05,116271370,0.830446
D.bocki,140010837,271661,1,10709,7.64869e-05,116282079,0.830522
D.bocki,140010837,462968,1,10703,7.64441e-05,116292782,0.830598
D.bocki,140010837,456070,1,10694,7.63798e-05,116303476,0.830675
D.bocki,140010837,455764,1,10693,7.63727e-05,116314169,0.830751
D.bocki,140010837,460547,1,10690,7.63512e-05,116324859,0.830828
D.bocki,140010837,465076,1,10686,7.63227e-05,116335545,0.830904
D.bocki,140010837,464804,1,10683,7.63012e-05,116346228,0.83098
D.bocki,140010837,462523,1,10682,7.62941e-05,116356910,0.831056
D.bocki,140010837,464825,1,10675,7.62441e-05,116367585,0.831133
D.bocki,140010837,23837,1,10665,7.61727e-05,116378250,0.831209
D.bocki,140010837,460011,1,10660,7.6137e-05,116388910,0.831285
D.bocki,140010837,460777,1,10659,7.61298e-05,116399569,0.831361
D.bocki,140010837,459669,1,10656,7.61084e-05,116410225,0.831437
D.bocki,140010837,462987,1,10638,7.59798e-05,116420863,0.831513
D.bocki,140010837,456556,1,10614,7.58084e-05,116431477,0.831589
D.bocki,140010837,464200,1,10608,7.57656e-05,116442085,0.831665
D.bocki,140010837,461559,1,10603,7.57299e-05,116452688,0.831741
D.bocki,140010837,463808,1,10602,7.57227e-05,116463290,0.831816
D.bocki,140010837,111216,1,10599,7.57013e-05,116473889,0.831892
D.bocki,140010837,464974,1,10597,7.5687e-05,116484486,0.831968
D.bocki,140010837,463446,1,10590,7.5637e-05,116495076,0.832043
D.bocki,140010837,464150,1,10588,7.56227e-05,116505664,0.832119
D.bocki,140010837,464035,1,10566,7.54656e-05,116516230,0.832194
D.bocki,140010837,461992,1,10544,7.53085e-05,116526774,0.83227
D.bocki,140010837,457157,1,10544,7.53085e-05,116537318,0.832345
D.bocki,140010837,464290,1,10538,7.52656e-05,116547856,0.83242
D.bocki,140010837,458359,1,10534,7.5237e-05,116558390,0.832495
D.bocki,140010837,464333,1,10519,7.51299e-05,116568909,0.832571
D.bocki,140010837,185744,1,10519,7.51299e-05,116579428,0.832646
D.bocki,140010837,463348,1,10513,7.5087e-05,116589941,0.832721
D.bocki,140010837,457956,1,10504,7.50228e-05,116600445,0.832796
D.bocki,140010837,464331,1,10495,7.49585e-05,116610940,0.832871
D.bocki,140010837,460086,1,10492,7.49371e-05,116621432,0.832946
D.bocki,140010837,457757,1,10491,7.49299e-05,116631923,0.833021
D.bocki,140010837,458037,1,10489,7.49156e-05,116642412,0.833096
D.bocki,140010837,307840,1,10489,7.49156e-05,116652901,0.833171
D.bocki,140010837,462078,1,10483,7.48728e-05,116663384,0.833245
D.bocki,140010837,457291,1,10482,7.48656e-05,116673866,0.83332
D.bocki,140010837,461269,1,10467,7.47585e-05,116684333,0.833395
D.bocki,140010837,4245,1,10463,7.47299e-05,116694796,0.83347
D.bocki,140010837,448294,1,10461,7.47156e-05,116705257,0.833544
D.bocki,140010837,461917,1,10459,7.47014e-05,116715716,0.833619
D.bocki,140010837,465109,1,10453,7.46585e-05,116726169,0.833694
D.bocki,140010837,456500,1,10452,7.46514e-05,116736621,0.833768
D.bocki,140010837,84817,1,10448,7.46228e-05,116747069,0.833843
D.bocki,140010837,456772,1,10447,7.46157e-05,116757516,0.833918
D.bocki,140010837,457143,1,10443,7.45871e-05,116767959,0.833992
D.bocki,140010837,464350,1,10439,7.45585e-05,116778398,0.834067
D.bocki,140010837,460996,1,10439,7.45585e-05,116788837,0.834141
D.bocki,140010837,84237,1,10428,7.44799e-05,116799265,0.834216
D.bocki,140010837,465046,1,10428,7.44799e-05,116809693,0.83429
D.bocki,140010837,463759,1,10422,7.44371e-05,116820115,0.834365
D.bocki,140010837,464349,1,10420,7.44228e-05,116830535,0.834439
D.bocki,140010837,462580,1,10418,7.44085e-05,116840953,0.834514
D.bocki,140010837,30037,1,10412,7.43657e-05,116851365,0.834588
D.bocki,140010837,457435,1,10393,7.423e-05,116861758,0.834662
D.bocki,140010837,462592,1,10389,7.42014e-05,116872147,0.834736
D.bocki,140010837,459080,1,10389,7.42014e-05,116882536,0.834811
D.bocki,140010837,464689,1,10388,7.41943e-05,116892924,0.834885
D.bocki,140010837,456566,1,10382,7.41514e-05,116903306,0.834959
D.bocki,140010837,464028,1,10377,7.41157e-05,116913683,0.835033
D.bocki,140010837,464314,1,10376,7.41085e-05,116924059,0.835107
D.bocki,140010837,456538,1,10369,7.40586e-05,116934428,0.835181
D.bocki,140010837,456482,1,10364,7.40228e-05,116944792,0.835255
D.bocki,140010837,461479,1,10347,7.39014e-05,116955139,0.835329
D.bocki,140010837,464679,1,10337,7.383e-05,116965476,0.835403
D.bocki,140010837,464195,1,10321,7.37157e-05,116975797,0.835477
D.bocki,140010837,300305,1,10318,7.36943e-05,116986115,0.83555
D.bocki,140010837,462818,1,10307,7.36157e-05,116996422,0.835624
D.bocki,140010837,458158,1,10295,7.353e-05,117006717,0.835698
D.bocki,140010837,245937,1,10285,7.34586e-05,117017002,0.835771
D.bocki,140010837,462011,1,10284,7.34515e-05,117027286,0.835844
D.bocki,140010837,459245,1,10281,7.343e-05,117037567,0.835918
D.bocki,140010837,458426,1,10278,7.34086e-05,117047845,0.835991
D.bocki,140010837,459298,1,10275,7.33872e-05,117058120,0.836065
D.bocki,140010837,456245,1,10274,7.338e-05,117068394,0.836138
D.bocki,140010837,441553,1,10268,7.33372e-05,117078662,0.836211
D.bocki,140010837,462209,1,10265,7.33158e-05,117088927,0.836285
D.bocki,140010837,463868,1,10252,7.32229e-05,117099179,0.836358
D.bocki,140010837,456765,1,10246,7.318e-05,117109425,0.836431
D.bocki,140010837,462964,1,10234,7.30943e-05,117119659,0.836504
D.bocki,140010837,458669,1,10230,7.30658e-05,117129889,0.836577
D.bocki,140010837,461691,1,10224,7.30229e-05,117140113,0.83665
D.bocki,140010837,455830,1,10191,7.27872e-05,117150304,0.836723
D.bocki,140010837,455942,1,10185,7.27444e-05,117160489,0.836796
D.bocki,140010837,465115,1,10167,7.26158e-05,117170656,0.836868
D.bocki,140010837,464011,1,10155,7.25301e-05,117180811,0.836941
D.bocki,140010837,464311,1,10154,7.2523e-05,117190965,0.837014
D.bocki,140010837,455812,1,10153,7.25158e-05,117201118,0.837086
D.bocki,140010837,456618,1,10150,7.24944e-05,117211268,0.837159
D.bocki,140010837,456984,1,10145,7.24587e-05,117221413,0.837231
D.bocki,140010837,458285,1,10144,7.24515e-05,117231557,0.837303
D.bocki,140010837,464581,1,10143,7.24444e-05,117241700,0.837376
D.bocki,140010837,463776,1,10143,7.24444e-05,117251843,0.837448
D.bocki,140010837,435791,1,10143,7.24444e-05,117261986,0.837521
D.bocki,140010837,456866,1,10132,7.23658e-05,117272118,0.837593
D.bocki,140010837,461638,1,10126,7.2323e-05,117282244,0.837665
D.bocki,140010837,415437,1,10112,7.2223e-05,117292356,0.837738
D.bocki,140010837,465027,1,10111,7.22158e-05,117302467,0.83781
D.bocki,140010837,464321,1,10111,7.22158e-05,117312578,0.837882
D.bocki,140010837,462864,1,10108,7.21944e-05,117322686,0.837954
D.bocki,140010837,463976,1,10107,7.21873e-05,117332793,0.838027
D.bocki,140010837,178682,1,10100,7.21373e-05,117342893,0.838099
D.bocki,140010837,110401,1,10100,7.21373e-05,117352993,0.838171
D.bocki,140010837,464304,1,10097,7.21158e-05,117363090,0.838243
D.bocki,140010837,457905,1,10095,7.21016e-05,117373185,0.838315
D.bocki,140010837,456104,1,10093,7.20873e-05,117383278,0.838387
D.bocki,140010837,457429,1,10091,7.2073e-05,117393369,0.838459
D.bocki,140010837,460705,1,10088,7.20516e-05,117403457,0.838531
D.bocki,140010837,458336,1,10083,7.20159e-05,117413540,0.838603
D.bocki,140010837,461604,1,10078,7.19801e-05,117423618,0.838675
D.bocki,140010837,154725,1,10077,7.1973e-05,117433695,0.838747
D.bocki,140010837,460650,1,10031,7.16445e-05,117443726,0.838819
D.bocki,140010837,464237,1,10018,7.15516e-05,117453744,0.83889
D.bocki,140010837,158900,1,9991,7.13588e-05,117463735,0.838962
D.bocki,140010837,464299,1,9987,7.13302e-05,117473722,0.839033
D.bocki,140010837,465016,1,9982,7.12945e-05,117483704,0.839104
D.bocki,140010837,463857,1,9977,7.12588e-05,117493681,0.839176
D.bocki,140010837,462321,1,9974,7.12373e-05,117503655,0.839247
D.bocki,140010837,463842,1,9970,7.12088e-05,117513625,0.839318
D.bocki,140010837,465038,1,9962,7.11516e-05,117523587,0.839389
D.bocki,140010837,457887,1,9962,7.11516e-05,117533549,0.83946
D.bocki,140010837,462903,1,9958,7.11231e-05,117543507,0.839531
D.bocki,140010837,461565,1,9958,7.11231e-05,117553465,0.839603
D.bocki,140010837,463395,1,9957,7.11159e-05,117563422,0.839674
D.bocki,140010837,325424,1,9957,7.11159e-05,117573379,0.839745
D.bocki,140010837,464218,1,9945,7.10302e-05,117583324,0.839816
D.bocki,140010837,464835,1,9941,7.10016e-05,117593265,0.839887
D.bocki,140010837,218952,1,9927,7.09017e-05,117603192,0.839958
D.bocki,140010837,461649,1,9916,7.08231e-05,117613108,0.840029
D.bocki,140010837,464777,1,9907,7.07588e-05,117623015,0.840099
D.bocki,140010837,465051,1,9904,7.07374e-05,117632919,0.84017
D.bocki,140010837,461701,1,9904,7.07374e-05,117642823,0.840241
D.bocki,140010837,455780,1,9904,7.07374e-05,117652727,0.840312
D.bocki,140010837,458301,1,9898,7.06945e-05,117662625,0.840382
D.bocki,140010837,464447,1,9895,7.06731e-05,117672520,0.840453
D.bocki,140010837,229613,1,9892,7.06517e-05,117682412,0.840524
D.bocki,140010837,461993,1,9884,7.05945e-05,117692296,0.840594
D.bocki,140010837,463421,1,9874,7.05231e-05,117702170,0.840665
D.bocki,140010837,464903,1,9870,7.04945e-05,117712040,0.840735
D.bocki,140010837,464382,1,9868,7.04803e-05,117721908,0.840806
D.bocki,140010837,464914,1,9864,7.04517e-05,117731772,0.840876
D.bocki,140010837,460902,1,9861,7.04303e-05,117741633,0.840947
D.bocki,140010837,455779,1,9857,7.04017e-05,117751490,0.841017
D.bocki,140010837,464722,1,9849,7.03446e-05,117761339,0.841087
D.bocki,140010837,464212,1,9844,7.03088e-05,117771183,0.841158
D.bocki,140010837,457929,1,9843,7.03017e-05,117781026,0.841228
D.bocki,140010837,459635,1,9830,7.02089e-05,117790856,0.841298
D.bocki,140010837,458268,1,9825,7.01731e-05,117800681,0.841368
D.bocki,140010837,453028,1,9815,7.01017e-05,117810496,0.841438
D.bocki,140010837,23984,1,9807,7.00446e-05,117820303,0.841508
D.bocki,140010837,458599,1,9801,7.00017e-05,117830104,0.841578
D.bocki,140010837,462757,1,9798,6.99803e-05,117839902,0.841648
D.bocki,140010837,464810,1,9795,6.99589e-05,117849697,0.841718
D.bocki,140010837,458897,1,9790,6.99232e-05,117859487,0.841788
D.bocki,140010837,463392,1,9787,6.99017e-05,117869274,0.841858
D.bocki,140010837,462446,1,9783,6.98732e-05,117879057,0.841928
D.bocki,140010837,461825,1,9777,6.98303e-05,117888834,0.841998
D.bocki,140010837,457668,1,9766,6.97517e-05,117898600,0.842068
D.bocki,140010837,445178,1,9759,6.97017e-05,117908359,0.842137
D.bocki,140010837,460082,1,9751,6.96446e-05,117918110,0.842207
D.bocki,140010837,457939,1,9751,6.96446e-05,117927861,0.842277
D.bocki,140010837,370431,1,9746,6.96089e-05,117937607,0.842346
D.bocki,140010837,460155,1,9731,6.95018e-05,117947338,0.842416
D.bocki,140010837,94686,1,9729,6.94875e-05,117957067,0.842485
D.bocki,140010837,459481,1,9723,6.94446e-05,117966790,0.842555
D.bocki,140010837,463423,1,9714,6.93803e-05,117976504,0.842624
D.bocki,140010837,456443,1,9714,6.93803e-05,117986218,0.842693
D.bocki,140010837,463249,1,9696,6.92518e-05,117995914,0.842763
D.bocki,140010837,462743,1,9692,6.92232e-05,118005606,0.842832
D.bocki,140010837,456572,1,9673,6.90875e-05,118015279,0.842901
D.bocki,140010837,463465,1,9668,6.90518e-05,118024947,0.84297
D.bocki,140010837,461935,1,9664,6.90232e-05,118034611,0.843039
D.bocki,140010837,465118,1,9657,6.89732e-05,118044268,0.843108
D.bocki,140010837,157355,1,9656,6.89661e-05,118053924,0.843177
D.bocki,140010837,457147,1,9652,6.89375e-05,118063576,0.843246
D.bocki,140010837,464792,1,9647,6.89018e-05,118073223,0.843315
D.bocki,140010837,461991,1,9631,6.87875e-05,118082854,0.843384
D.bocki,140010837,462350,1,9627,6.8759e-05,118092481,0.843452
D.bocki,140010837,459002,1,9626,6.87518e-05,118102107,0.843521
D.bocki,140010837,460177,1,9602,6.85804e-05,118111709,0.84359
D.bocki,140010837,88723,1,9595,6.85304e-05,118121304,0.843658
D.bocki,140010837,461765,1,9592,6.8509e-05,118130896,0.843727
D.bocki,140010837,459826,1,9584,6.84518e-05,118140480,0.843795
D.bocki,140010837,395199,1,9577,6.84018e-05,118150057,0.843864
D.bocki,140010837,464806,1,9570,6.83519e-05,118159627,0.843932
D.bocki,140010837,464951,1,9556,6.82519e-05,118169183,0.844
D.bocki,140010837,459005,1,9551,6.82161e-05,118178734,0.844068
D.bocki,140010837,462573,1,9545,6.81733e-05,118188279,0.844137
D.bocki,140010837,145235,1,9544,6.81662e-05,118197823,0.844205
D.bocki,140010837,463109,1,9534,6.80947e-05,118207357,0.844273
D.bocki,140010837,457325,1,9527,6.80447e-05,118216884,0.844341
D.bocki,140010837,58385,1,9523,6.80162e-05,118226407,0.844409
D.bocki,140010837,464431,1,9523,6.80162e-05,118235930,0.844477
D.bocki,140010837,418102,1,9523,6.80162e-05,118245453,0.844545
D.bocki,140010837,460471,1,9519,6.79876e-05,118254972,0.844613
D.bocki,140010837,463222,1,9514,6.79519e-05,118264486,0.844681
D.bocki,140010837,461742,1,9512,6.79376e-05,118273998,0.844749
D.bocki,140010837,460888,1,9488,6.77662e-05,118283486,0.844817
D.bocki,140010837,465138,1,9487,6.7759e-05,118292973,0.844884
D.bocki,140010837,463948,1,9487,6.7759e-05,118302460,0.844952
D.bocki,140010837,460823,1,9479,6.77019e-05,118311939,0.84502
D.bocki,140010837,128215,1,9477,6.76876e-05,118321416,0.845088
D.bocki,140010837,460572,1,9476,6.76805e-05,118330892,0.845155
D.bocki,140010837,462508,1,9458,6.75519e-05,118340350,0.845223
D.bocki,140010837,463598,1,9450,6.74948e-05,118349800,0.84529
D.bocki,140010837,464915,1,9430,6.73519e-05,118359230,0.845358
D.bocki,140010837,465093,1,9414,6.72377e-05,118368644,0.845425
D.bocki,140010837,464110,1,9413,6.72305e-05,118378057,0.845492
D.bocki,140010837,458339,1,9413,6.72305e-05,118387470,0.845559
D.bocki,140010837,457930,1,9408,6.71948e-05,118396878,0.845627
D.bocki,140010837,18134,1,9402,6.71519e-05,118406280,0.845694
D.bocki,140010837,462013,1,9400,6.71377e-05,118415680,0.845761
D.bocki,140010837,464337,1,9386,6.70377e-05,118425066,0.845828
D.bocki,140010837,461676,1,9382,6.70091e-05,118434448,0.845895
D.bocki,140010837,464930,1,9375,6.69591e-05,118443823,0.845962
D.bocki,140010837,462934,1,9372,6.69377e-05,118453195,0.846029
D.bocki,140010837,460954,1,9366,6.68948e-05,118462561,0.846096
D.bocki,140010837,458457,1,9364,6.68805e-05,118471925,0.846163
D.bocki,140010837,461674,1,9358,6.68377e-05,118481283,0.846229
D.bocki,140010837,462644,1,9351,6.67877e-05,118490634,0.846296
D.bocki,140010837,464893,1,9343,6.67305e-05,118499977,0.846363
D.bocki,140010837,463607,1,9343,6.67305e-05,118509320,0.84643
D.bocki,140010837,162159,1,9340,6.67091e-05,118518660,0.846496
D.bocki,140010837,464596,1,9333,6.66591e-05,118527993,0.846563
D.bocki,140010837,463144,1,9327,6.66163e-05,118537320,0.84663
D.bocki,140010837,245194,1,9324,6.65948e-05,118546644,0.846696
D.bocki,140010837,462239,1,9323,6.65877e-05,118555967,0.846763
D.bocki,140010837,461504,1,9321,6.65734e-05,118565288,0.846829
D.bocki,140010837,261332,1,9321,6.65734e-05,118574609,0.846896
D.bocki,140010837,463896,1,9318,6.6552e-05,118583927,0.846962
D.bocki,140010837,463388,1,9315,6.65306e-05,118593242,0.847029
D.bocki,140010837,456764,1,9314,6.65234e-05,118602556,0.847096
D.bocki,140010837,462772,1,9311,6.6502e-05,118611867,0.847162
D.bocki,140010837,451239,1,9302,6.64377e-05,118621169,0.847228
D.bocki,140010837,460703,1,9300,6.64234e-05,118630469,0.847295
D.bocki,140010837,463515,1,9296,6.63949e-05,118639765,0.847361
D.bocki,140010837,219379,1,9295,6.63877e-05,118649060,0.847428
D.bocki,140010837,223176,1,9294,6.63806e-05,118658354,0.847494
D.bocki,140010837,460666,1,9292,6.63663e-05,118667646,0.84756
D.bocki,140010837,464360,1,9291,6.63591e-05,118676937,0.847627
D.bocki,140010837,464601,1,9280,6.62806e-05,118686217,0.847693
D.bocki,140010837,463021,1,9273,6.62306e-05,118695490,0.847759
D.bocki,140010837,465123,1,9237,6.59735e-05,118704727,0.847825
D.bocki,140010837,430124,1,9237,6.59735e-05,118713964,0.847891
D.bocki,140010837,463264,1,9223,6.58735e-05,118723187,0.847957
D.bocki,140010837,148899,1,9220,6.5852e-05,118732407,0.848023
D.bocki,140010837,464992,1,9218,6.58378e-05,118741625,0.848089
D.bocki,140010837,457611,1,9214,6.58092e-05,118750839,0.848155
D.bocki,140010837,464003,1,9210,6.57806e-05,118760049,0.84822
D.bocki,140010837,464538,1,9207,6.57592e-05,118769256,0.848286
D.bocki,140010837,462020,1,9193,6.56592e-05,118778449,0.848352
D.bocki,140010837,464644,1,9186,6.56092e-05,118787635,0.848417
D.bocki,140010837,463791,1,9185,6.56021e-05,118796820,0.848483
D.bocki,140010837,462950,1,9185,6.56021e-05,118806005,0.848549
D.bocki,140010837,462858,1,9173,6.55164e-05,118815178,0.848614
D.bocki,140010837,464307,1,9167,6.54735e-05,118824345,0.84868
D.bocki,140010837,463884,1,9156,6.53949e-05,118833501,0.848745
D.bocki,140010837,459665,1,9151,6.53592e-05,118842652,0.84881
D.bocki,140010837,456871,1,9151,6.53592e-05,118851803,0.848876
D.bocki,140010837,464598,1,9127,6.51878e-05,118860930,0.848941
D.bocki,140010837,464282,1,9118,6.51235e-05,118870048,0.849006
D.bocki,140010837,93597,1,9106,6.50378e-05,118879154,0.849071
D.bocki,140010837,455995,1,9098,6.49807e-05,118888252,0.849136
D.bocki,140010837,458067,1,9086,6.4895e-05,118897338,0.849201
D.bocki,140010837,463068,1,9073,6.48021e-05,118906411,0.849266
D.bocki,140010837,464013,1,9072,6.4795e-05,118915483,0.849331
D.bocki,140010837,457914,1,9071,6.47878e-05,118924554,0.849395
D.bocki,140010837,461111,1,9068,6.47664e-05,118933622,0.84946
D.bocki,140010837,458414,1,9064,6.47378e-05,118942686,0.849525
D.bocki,140010837,464790,1,9057,6.46878e-05,118951743,0.84959
D.bocki,140010837,458581,1,9050,6.46379e-05,118960793,0.849654
D.bocki,140010837,461365,1,9039,6.45593e-05,118969832,0.849719
D.bocki,140010837,459517,1,9038,6.45521e-05,118978870,0.849783
D.bocki,140010837,459352,1,9030,6.4495e-05,118987900,0.849848
D.bocki,140010837,464699,1,9029,6.44879e-05,118996929,0.849912
D.bocki,140010837,463553,1,9012,6.43664e-05,119005941,0.849977
D.bocki,140010837,464681,1,9009,6.4345e-05,119014950,0.850041
D.bocki,140010837,464652,1,9009,6.4345e-05,119023959,0.850105
D.bocki,140010837,464040,1,9008,6.43379e-05,119032967,0.85017
D.bocki,140010837,462756,1,9001,6.42879e-05,119041968,0.850234
D.bocki,140010837,459837,1,8989,6.42022e-05,119050957,0.850298
D.bocki,140010837,459942,1,8984,6.41665e-05,119059941,0.850362
D.bocki,140010837,457177,1,8981,6.4145e-05,119068922,0.850426
D.bocki,140010837,463014,1,8978,6.41236e-05,119077900,0.850491
D.bocki,140010837,251097,1,8971,6.40736e-05,119086871,0.850555
D.bocki,140010837,452384,1,8970,6.40665e-05,119095841,0.850619
D.bocki,140010837,462706,1,8969,6.40593e-05,119104810,0.850683
D.bocki,140010837,463051,1,8952,6.39379e-05,119113762,0.850747
D.bocki,140010837,280258,1,8950,6.39236e-05,119122712,0.850811
D.bocki,140010837,461347,1,8949,6.39165e-05,119131661,0.850875
D.bocki,140010837,464496,1,8946,6.38951e-05,119140607,0.850938
D.bocki,140010837,464513,1,8941,6.38593e-05,119149548,0.851002
D.bocki,140010837,464179,1,8934,6.38093e-05,119158482,0.851066
D.bocki,140010837,463318,1,8931,6.37879e-05,119167413,0.85113
D.bocki,140010837,465132,1,8929,6.37736e-05,119176342,0.851194
D.bocki,140010837,464494,1,8926,6.37522e-05,119185268,0.851257
D.bocki,140010837,457842,1,8925,6.37451e-05,119194193,0.851321
D.bocki,140010837,456379,1,8911,6.36451e-05,119203104,0.851385
D.bocki,140010837,463916,1,8906,6.36094e-05,119212010,0.851448
D.bocki,140010837,464573,1,8881,6.34308e-05,119220891,0.851512
D.bocki,140010837,458103,1,8878,6.34094e-05,119229769,0.851575
D.bocki,140010837,317483,1,8877,6.34022e-05,119238646,0.851639
D.bocki,140010837,464548,1,8868,6.3338e-05,119247514,0.851702
D.bocki,140010837,462945,1,8867,6.33308e-05,119256381,0.851765
D.bocki,140010837,463437,1,8862,6.32951e-05,119265243,0.851829
D.bocki,140010837,457187,1,8860,6.32808e-05,119274103,0.851892
D.bocki,140010837,461201,1,8855,6.32451e-05,119282958,0.851955
D.bocki,140010837,456753,1,8854,6.3238e-05,119291812,0.852018
D.bocki,140010837,457750,1,8844,6.31665e-05,119300656,0.852082
D.bocki,140010837,89129,1,8833,6.3088e-05,119309489,0.852145
D.bocki,140010837,463386,1,8828,6.30523e-05,119318317,0.852208
D.bocki,140010837,461572,1,8823,6.30166e-05,119327140,0.852271
D.bocki,140010837,189827,1,8812,6.2938e-05,119335952,0.852334
D.bocki,140010837,459467,1,8808,6.29094e-05,119344760,0.852397
D.bocki,140010837,464753,1,8804,6.28808e-05,119353564,0.852459
D.bocki,140010837,456401,1,8803,6.28737e-05,119362367,0.852522
D.bocki,140010837,461488,1,8795,6.28166e-05,119371162,0.852585
D.bocki,140010837,460762,1,8784,6.2738e-05,119379946,0.852648
D.bocki,140010837,462670,1,8780,6.27094e-05,119388726,0.852711
D.bocki,140010837,440902,1,8769,6.26309e-05,119397495,0.852773
D.bocki,140010837,464705,1,8767,6.26166e-05,119406262,0.852836
D.bocki,140010837,457511,1,8759,6.25594e-05,119415021,0.852898
D.bocki,140010837,461326,1,8757,6.25452e-05,119423778,0.852961
D.bocki,140010837,465139,1,8753,6.25166e-05,119432531,0.853023
D.bocki,140010837,277669,1,8753,6.25166e-05,119441284,0.853086
D.bocki,140010837,456771,1,8746,6.24666e-05,119450030,0.853148
D.bocki,140010837,462084,1,8744,6.24523e-05,119458774,0.853211
D.bocki,140010837,464620,1,8735,6.2388e-05,119467509,0.853273
D.bocki,140010837,459558,1,8734,6.23809e-05,119476243,0.853336
D.bocki,140010837,462819,1,8729,6.23452e-05,119484972,0.853398
D.bocki,140010837,455893,1,8724,6.23095e-05,119493696,0.85346
D.bocki,140010837,464676,1,8723,6.23023e-05,119502419,0.853523
D.bocki,140010837,458699,1,8718,6.22666e-05,119511137,0.853585
D.bocki,140010837,458194,1,8717,6.22595e-05,119519854,0.853647
D.bocki,140010837,464113,1,8709,6.22023e-05,119528563,0.853709
D.bocki,140010837,42063,1,8706,6.21809e-05,119537269,0.853772
D.bocki,140010837,462294,1,8705,6.21738e-05,119545974,0.853834
D.bocki,140010837,464696,1,8701,6.21452e-05,119554675,0.853896
D.bocki,140010837,464295,1,8698,6.21238e-05,119563373,0.853958
D.bocki,140010837,459266,1,8698,6.21238e-05,119572071,0.85402
D.bocki,140010837,458043,1,8694,6.20952e-05,119580765,0.854082
D.bocki,140010837,404383,1,8693,6.20881e-05,119589458,0.854144
D.bocki,140010837,457089,1,8692,6.20809e-05,119598150,0.854206
D.bocki,140010837,451204,1,8684,6.20238e-05,119606834,0.854268
D.bocki,140010837,464445,1,8681,6.20023e-05,119615515,0.85433
D.bocki,140010837,457803,1,8664,6.18809e-05,119624179,0.854392
D.bocki,140010837,456829,1,8652,6.17952e-05,119632831,0.854454
D.bocki,140010837,168450,1,8652,6.17952e-05,119641483,0.854516
D.bocki,140010837,57543,1,8644,6.17381e-05,119650127,0.854578
D.bocki,140010837,462383,1,8643,6.17309e-05,119658770,0.854639
D.bocki,140010837,461045,1,8633,6.16595e-05,119667403,0.854701
D.bocki,140010837,456265,1,8624,6.15952e-05,119676027,0.854763
D.bocki,140010837,464344,1,8610,6.14952e-05,119684637,0.854824
D.bocki,140010837,459427,1,8609,6.14881e-05,119693246,0.854886
D.bocki,140010837,463340,1,8596,6.13952e-05,119701842,0.854947
D.bocki,140010837,459528,1,8587,6.1331e-05,119710429,0.855008
D.bocki,140010837,458837,1,8587,6.1331e-05,119719016,0.85507
D.bocki,140010837,464945,1,8582,6.12953e-05,119727598,0.855131
D.bocki,140010837,284427,1,8580,6.1281e-05,119736178,0.855192
D.bocki,140010837,465117,1,8566,6.1181e-05,119744744,0.855253
D.bocki,140010837,458282,1,8566,6.1181e-05,119753310,0.855315
D.bocki,140010837,461965,1,8563,6.11596e-05,119761873,0.855376
D.bocki,140010837,232251,1,8560,6.11381e-05,119770433,0.855437
D.bocki,140010837,462330,1,8553,6.10881e-05,119778986,0.855498
D.bocki,140010837,463800,1,8543,6.10167e-05,119787529,0.855559
D.bocki,140010837,458413,1,8538,6.0981e-05,119796067,0.85562
D.bocki,140010837,463407,1,8531,6.0931e-05,119804598,0.855681
D.bocki,140010837,456431,1,8525,6.08881e-05,119813123,0.855742
D.bocki,140010837,461973,1,8524,6.0881e-05,119821647,0.855803
D.bocki,140010837,455759,1,8522,6.08667e-05,119830169,0.855864
D.bocki,140010837,214898,1,8512,6.07953e-05,119838681,0.855924
D.bocki,140010837,458189,1,8497,6.06882e-05,119847178,0.855985
D.bocki,140010837,458698,1,8485,6.06025e-05,119855663,0.856046
D.bocki,140010837,464972,1,8483,6.05882e-05,119864146,0.856106
D.bocki,140010837,460674,1,8481,6.05739e-05,119872627,0.856167
D.bocki,140010837,455786,1,8479,6.05596e-05,119881106,0.856227
D.bocki,140010837,458657,1,8471,6.05025e-05,119889577,0.856288
D.bocki,140010837,92956,1,8466,6.04667e-05,119898043,0.856348
D.bocki,140010837,464182,1,8436,6.02525e-05,119906479,0.856409
D.bocki,140010837,463735,1,8435,6.02453e-05,119914914,0.856469
D.bocki,140010837,462639,1,8433,6.02311e-05,119923347,0.856529
D.bocki,140010837,464663,1,8428,6.01953e-05,119931775,0.856589
D.bocki,140010837,465105,1,8424,6.01668e-05,119940199,0.856649
D.bocki,140010837,460424,1,8418,6.01239e-05,119948617,0.85671
D.bocki,140010837,455795,1,8412,6.00811e-05,119957029,0.85677
D.bocki,140010837,461461,1,8406,6.00382e-05,119965435,0.85683
D.bocki,140010837,457701,1,8406,6.00382e-05,119973841,0.85689
D.bocki,140010837,458156,1,8402,6.00096e-05,119982243,0.85695
D.bocki,140010837,463713,1,8401,6.00025e-05,119990644,0.85701
D.bocki,140010837,459873,1,8391,5.99311e-05,119999035,0.85707
D.bocki,140010837,463076,1,8390,5.99239e-05,120007425,0.85713
D.bocki,140010837,459728,1,8379,5.98454e-05,120015804,0.857189
D.bocki,140010837,458395,1,8370,5.97811e-05,120024174,0.857249
D.bocki,140010837,457288,1,8366,5.97525e-05,120032540,0.857309
D.bocki,140010837,385953,1,8359,5.97025e-05,120040899,0.857369
D.bocki,140010837,463139,1,8357,5.96882e-05,120049256,0.857428
D.bocki,140010837,461753,1,8356,5.96811e-05,120057612,0.857488
D.bocki,140010837,445881,1,8353,5.96597e-05,120065965,0.857548
D.bocki,140010837,462869,1,8352,5.96525e-05,120074317,0.857607
D.bocki,140010837,458598,1,8344,5.95954e-05,120082661,0.857667
D.bocki,140010837,456021,1,8335,5.95311e-05,120090996,0.857726
D.bocki,140010837,463450,1,8329,5.94883e-05,120099325,0.857786
D.bocki,140010837,456529,1,8329,5.94883e-05,120107654,0.857845
D.bocki,140010837,462088,1,8322,5.94383e-05,120115976,0.857905
D.bocki,140010837,248277,1,8300,5.92811e-05,120124276,0.857964
D.bocki,140010837,464510,1,8293,5.92311e-05,120132569,0.858023
D.bocki,140010837,457999,1,8293,5.92311e-05,120140862,0.858083
D.bocki,140010837,463166,1,8284,5.91668e-05,120149146,0.858142
D.bocki,140010837,464109,1,8282,5.91526e-05,120157428,0.858201
D.bocki,140010837,463141,1,8280,5.91383e-05,120165708,0.85826
D.bocki,140010837,464967,1,8273,5.90883e-05,120173981,0.858319
D.bocki,140010837,457564,1,8265,5.90311e-05,120182246,0.858378
D.bocki,140010837,464306,1,8259,5.89883e-05,120190505,0.858437
D.bocki,140010837,464143,1,8258,5.89811e-05,120198763,0.858496
D.bocki,140010837,462461,1,8252,5.89383e-05,120207015,0.858555
D.bocki,140010837,83486,1,8240,5.88526e-05,120215255,0.858614
D.bocki,140010837,461117,1,8239,5.88454e-05,120223494,0.858673
D.bocki,140010837,462867,1,8238,5.88383e-05,120231732,0.858732
D.bocki,140010837,379343,1,8238,5.88383e-05,120239970,0.85879
D.bocki,140010837,460891,1,8237,5.88312e-05,120248207,0.858849
D.bocki,140010837,459335,1,8231,5.87883e-05,120256438,0.858908
D.bocki,140010837,464061,1,8218,5.86955e-05,120264656,0.858967
D.bocki,140010837,457209,1,8212,5.86526e-05,120272868,0.859025
D.bocki,140010837,458814,1,8203,5.85883e-05,120281071,0.859084
D.bocki,140010837,459209,1,8199,5.85598e-05,120289270,0.859143
D.bocki,140010837,465095,1,8197,5.85455e-05,120297467,0.859201
D.bocki,140010837,459296,1,8192,5.85098e-05,120305659,0.85926
D.bocki,140010837,464580,1,8183,5.84455e-05,120313842,0.859318
D.bocki,140010837,460641,1,8180,5.8424e-05,120322022,0.859376
D.bocki,140010837,462663,1,8179,5.84169e-05,120330201,0.859435
D.bocki,140010837,462755,1,8174,5.83812e-05,120338375,0.859493
D.bocki,140010837,462774,1,8161,5.82883e-05,120346536,0.859552
D.bocki,140010837,464068,1,8155,5.82455e-05,120354691,0.85961
D.bocki,140010837,458682,1,8150,5.82098e-05,120362841,0.859668
D.bocki,140010837,457310,1,8144,5.81669e-05,120370985,0.859726
D.bocki,140010837,455760,1,8142,5.81526e-05,120379127,0.859784
D.bocki,140010837,455804,1,8133,5.80884e-05,120387260,0.859842
D.bocki,140010837,459234,1,8130,5.80669e-05,120395390,0.859901
D.bocki,140010837,458656,1,8129,5.80598e-05,120403519,0.859959
D.bocki,140010837,438452,1,8126,5.80384e-05,120411645,0.860017
D.bocki,140010837,454731,1,8124,5.80241e-05,120419769,0.860075
D.bocki,140010837,455887,1,8120,5.79955e-05,120427889,0.860133
D.bocki,140010837,460824,1,8113,5.79455e-05,120436002,0.860191
D.bocki,140010837,29482,1,8108,5.79098e-05,120444110,0.860248
D.bocki,140010837,460315,1,8102,5.78669e-05,120452212,0.860306
D.bocki,140010837,461789,1,8101,5.78598e-05,120460313,0.860364
D.bocki,140010837,460852,1,8100,5.78527e-05,120468413,0.860422
D.bocki,140010837,28074,1,8099,5.78455e-05,120476512,0.86048
D.bocki,140010837,460446,1,8085,5.77455e-05,120484597,0.860538
D.bocki,140010837,262893,1,8085,5.77455e-05,120492682,0.860595
D.bocki,140010837,461429,1,8082,5.77241e-05,120500764,0.860653
D.bocki,140010837,460203,1,8079,5.77027e-05,120508843,0.860711
D.bocki,140010837,462396,1,8078,5.76955e-05,120516921,0.860769
D.bocki,140010837,360958,1,8074,5.7667e-05,120524995,0.860826
D.bocki,140010837,327563,1,8064,5.75955e-05,120533059,0.860884
D.bocki,140010837,462882,1,8061,5.75741e-05,120541120,0.860941
D.bocki,140010837,462241,1,8060,5.7567e-05,120549180,0.860999
D.bocki,140010837,461293,1,8057,5.75455e-05,120557237,0.861056
D.bocki,140010837,458402,1,8044,5.74527e-05,120565281,0.861114
D.bocki,140010837,464286,1,8042,5.74384e-05,120573323,0.861171
D.bocki,140010837,463254,1,8041,5.74313e-05,120581364,0.861229
D.bocki,140010837,456633,1,8031,5.73598e-05,120589395,0.861286
D.bocki,140010837,455763,1,8031,5.73598e-05,120597426,0.861344
D.bocki,140010837,464039,1,8028,5.73384e-05,120605454,0.861401
D.bocki,140010837,464737,1,8004,5.7167e-05,120613458,0.861458
D.bocki,140010837,455980,1,7998,5.71241e-05,120621456,0.861515
D.bocki,140010837,464937,1,7993,5.70884e-05,120629449,0.861572
D.bocki,140010837,464998,1,7990,5.7067e-05,120637439,0.861629
D.bocki,140010837,359421,1,7987,5.70456e-05,120645426,0.861686
D.bocki,140010837,463878,1,7986,5.70384e-05,120653412,0.861743
D.bocki,140010837,464515,1,7982,5.70099e-05,120661394,0.8618
D.bocki,140010837,464610,1,7978,5.69813e-05,120669372,0.861857
D.bocki,140010837,459038,1,7973,5.69456e-05,120677345,0.861914
D.bocki,140010837,463731,1,7972,5.69384e-05,120685317,0.861971
D.bocki,140010837,347000,1,7970,5.69242e-05,120693287,0.862028
D.bocki,140010837,458460,1,7967,5.69027e-05,120701254,0.862085
D.bocki,140010837,457155,1,7957,5.68313e-05,120709211,0.862142
D.bocki,140010837,464595,1,7950,5.67813e-05,120717161,0.862199
D.bocki,140010837,457478,1,7947,5.67599e-05,120725108,0.862255
D.bocki,140010837,175659,1,7944,5.67385e-05,120733052,0.862312
D.bocki,140010837,462047,1,7939,5.67028e-05,120740991,0.862369
D.bocki,140010837,464301,1,7930,5.66385e-05,120748921,0.862426
D.bocki,140010837,458173,1,7925,5.66028e-05,120756846,0.862482
D.bocki,140010837,458911,1,7921,5.65742e-05,120764767,0.862539
D.bocki,140010837,462871,1,7914,5.65242e-05,120772681,0.862595
D.bocki,140010837,462525,1,7907,5.64742e-05,120780588,0.862652
D.bocki,140010837,463860,1,7906,5.64671e-05,120788494,0.862708
D.bocki,140010837,463110,1,7902,5.64385e-05,120796396,0.862765
D.bocki,140010837,464421,1,7896,5.63956e-05,120804292,0.862821
D.bocki,140010837,458951,1,7885,5.63171e-05,120812177,0.862877
D.bocki,140010837,155573,1,7882,5.62956e-05,120820059,0.862934
D.bocki,140010837,465128,1,7879,5.62742e-05,120827938,0.86299
D.bocki,140010837,463049,1,7873,5.62314e-05,120835811,0.863046
D.bocki,140010837,456183,1,7867,5.61885e-05,120843678,0.863102
D.bocki,140010837,458766,1,7861,5.61457e-05,120851539,0.863158
D.bocki,140010837,464522,1,7854,5.60957e-05,120859393,0.863215
D.bocki,140010837,461332,1,7852,5.60814e-05,120867245,0.863271
D.bocki,140010837,462662,1,7821,5.586e-05,120875066,0.863327
D.bocki,140010837,216291,1,7811,5.57885e-05,120882877,0.863382
D.bocki,140010837,462223,1,7802,5.57243e-05,120890679,0.863438
D.bocki,140010837,400010,1,7799,5.57028e-05,120898478,0.863494
D.bocki,140010837,462443,1,7794,5.56671e-05,120906272,0.863549
D.bocki,140010837,460968,1,7794,5.56671e-05,120914066,0.863605
D.bocki,140010837,463123,1,7788,5.56243e-05,120921854,0.863661
D.bocki,140010837,456969,1,7779,5.556e-05,120929633,0.863716
D.bocki,140010837,461506,1,7768,5.54814e-05,120937401,0.863772
D.bocki,140010837,456786,1,7763,5.54457e-05,120945164,0.863827
D.bocki,140010837,464556,1,7755,5.53886e-05,120952919,0.863883
D.bocki,140010837,462249,1,7747,5.53314e-05,120960666,0.863938
D.bocki,140010837,459855,1,7740,5.52814e-05,120968406,0.863993
D.bocki,140010837,456208,1,7738,5.52672e-05,120976144,0.864048
D.bocki,140010837,464869,1,7733,5.52314e-05,120983877,0.864104
D.bocki,140010837,464564,1,7732,5.52243e-05,120991609,0.864159
D.bocki,140010837,456746,1,7722,5.51529e-05,120999331,0.864214
D.bocki,140010837,460517,1,7720,5.51386e-05,121007051,0.864269
D.bocki,140010837,458475,1,7717,5.51172e-05,121014768,0.864324
D.bocki,140010837,463796,1,7716,5.511e-05,121022484,0.864379
D.bocki,140010837,456191,1,7713,5.50886e-05,121030197,0.864434
D.bocki,140010837,461662,1,7705,5.50315e-05,121037902,0.86449
D.bocki,140010837,457116,1,7705,5.50315e-05,121045607,0.864545
D.bocki,140010837,456652,1,7705,5.50315e-05,121053312,0.8646
D.bocki,140010837,462483,1,7700,5.49957e-05,121061012,0.864655
D.bocki,140010837,459217,1,7685,5.48886e-05,121068697,0.864709
D.bocki,140010837,463466,1,7682,5.48672e-05,121076379,0.864764
D.bocki,140010837,458521,1,7678,5.48386e-05,121084057,0.864819
D.bocki,140010837,464495,1,7677,5.48315e-05,121091734,0.864874
D.bocki,140010837,462658,1,7672,5.47958e-05,121099406,0.864929
D.bocki,140010837,463426,1,7671,5.47886e-05,121107077,0.864984
D.bocki,140010837,457522,1,7670,5.47815e-05,121114747,0.865038
D.bocki,140010837,457142,1,7670,5.47815e-05,121122417,0.865093
D.bocki,140010837,245494,1,7669,5.47743e-05,121130086,0.865148
D.bocki,140010837,464919,1,7667,5.476e-05,121137753,0.865203
D.bocki,140010837,456138,1,7660,5.47101e-05,121145413,0.865257
D.bocki,140010837,464808,1,7659,5.47029e-05,121153072,0.865312
D.bocki,140010837,412710,1,7653,5.46601e-05,121160725,0.865367
D.bocki,140010837,456337,1,7652,5.46529e-05,121168377,0.865421
D.bocki,140010837,457739,1,7644,5.45958e-05,121176021,0.865476
D.bocki,140010837,463891,1,7641,5.45743e-05,121183662,0.865531
D.bocki,140010837,463602,1,7641,5.45743e-05,121191303,0.865585
D.bocki,140010837,456817,1,7641,5.45743e-05,121198944,0.86564
D.bocki,140010837,464402,1,7634,5.45244e-05,121206578,0.865694
D.bocki,140010837,430273,1,7632,5.45101e-05,121214210,0.865749
D.bocki,140010837,396266,1,7624,5.44529e-05,121221834,0.865803
D.bocki,140010837,450916,1,7623,5.44458e-05,121229457,0.865858
D.bocki,140010837,461428,1,7622,5.44386e-05,121237079,0.865912
D.bocki,140010837,457946,1,7621,5.44315e-05,121244700,0.865967
D.bocki,140010837,465006,1,7620,5.44244e-05,121252320,0.866021
D.bocki,140010837,465143,1,7617,5.44029e-05,121259937,0.866075
D.bocki,140010837,461417,1,7608,5.43387e-05,121267545,0.86613
D.bocki,140010837,459619,1,7604,5.43101e-05,121275149,0.866184
D.bocki,140010837,459227,1,7597,5.42601e-05,121282746,0.866238
D.bocki,140010837,457063,1,7595,5.42458e-05,121290341,0.866293
D.bocki,140010837,456082,1,7591,5.42172e-05,121297932,0.866347
D.bocki,140010837,464640,1,7590,5.42101e-05,121305522,0.866401
D.bocki,140010837,393009,1,7588,5.41958e-05,121313110,0.866455
D.bocki,140010837,456273,1,7574,5.40958e-05,121320684,0.866509
D.bocki,140010837,463187,1,7570,5.40672e-05,121328254,0.866563
D.bocki,140010837,458705,1,7565,5.40315e-05,121335819,0.866617
D.bocki,140010837,464024,1,7561,5.4003e-05,121343380,0.866671
D.bocki,140010837,460069,1,7561,5.4003e-05,121350941,0.866725
D.bocki,140010837,461358,1,7560,5.39958e-05,121358501,0.866779
D.bocki,140010837,464302,1,7551,5.39315e-05,121366052,0.866833
D.bocki,140010837,461140,1,7551,5.39315e-05,121373603,0.866887
D.bocki,140010837,463175,1,7547,5.3903e-05,121381150,0.866941
D.bocki,140010837,85980,1,7546,5.38958e-05,121388696,0.866995
D.bocki,140010837,464254,1,7544,5.38815e-05,121396240,0.867049
D.bocki,140010837,464882,1,7542,5.38673e-05,121403782,0.867103
D.bocki,140010837,463721,1,7539,5.38458e-05,121411321,0.867157
D.bocki,140010837,457751,1,7535,5.38173e-05,121418856,0.86721
D.bocki,140010837,114657,1,7529,5.37744e-05,121426385,0.867264
D.bocki,140010837,461816,1,7526,5.3753e-05,121433911,0.867318
D.bocki,140010837,464932,1,7524,5.37387e-05,121441435,0.867372
D.bocki,140010837,463349,1,7521,5.37173e-05,121448956,0.867425
D.bocki,140010837,461634,1,7512,5.3653e-05,121456468,0.867479
D.bocki,140010837,464268,1,7507,5.36173e-05,121463975,0.867533
D.bocki,140010837,459378,1,7499,5.35601e-05,121471474,0.867586
D.bocki,140010837,464858,1,7486,5.34673e-05,121478960,0.86764
D.bocki,140010837,460264,1,7477,5.3403e-05,121486437,0.867693
D.bocki,140010837,463452,1,7476,5.33959e-05,121493913,0.867746
D.bocki,140010837,457966,1,7465,5.33173e-05,121501378,0.8678
D.bocki,140010837,462516,1,7464,5.33102e-05,121508842,0.867853
D.bocki,140010837,463335,1,7460,5.32816e-05,121516302,0.867906
D.bocki,140010837,464746,1,7448,5.31959e-05,121523750,0.86796
D.bocki,140010837,458463,1,7447,5.31887e-05,121531197,0.868013
D.bocki,140010837,456190,1,7444,5.31673e-05,121538641,0.868066
D.bocki,140010837,281702,1,7442,5.3153e-05,121546083,0.868119
D.bocki,140010837,456361,1,7438,5.31245e-05,121553521,0.868172
D.bocki,140010837,461124,1,7432,5.30816e-05,121560953,0.868225
D.bocki,140010837,463942,1,7429,5.30602e-05,121568382,0.868278
D.bocki,140010837,460468,1,7425,5.30316e-05,121575807,0.868331
D.bocki,140010837,464430,1,7418,5.29816e-05,121583225,0.868384
D.bocki,140010837,323464,1,7411,5.29316e-05,121590636,0.868437
D.bocki,140010837,371318,1,7410,5.29245e-05,121598046,0.86849
D.bocki,140010837,464799,1,7399,5.28459e-05,121605445,0.868543
D.bocki,140010837,462270,1,7397,5.28316e-05,121612842,0.868596
D.bocki,140010837,464277,1,7388,5.27673e-05,121620230,0.868649
D.bocki,140010837,457689,1,7370,5.26388e-05,121627600,0.868701
D.bocki,140010837,463231,1,7369,5.26316e-05,121634969,0.868754
D.bocki,140010837,461784,1,7359,5.25602e-05,121642328,0.868807
D.bocki,140010837,460633,1,7359,5.25602e-05,121649687,0.868859
D.bocki,140010837,464289,1,7356,5.25388e-05,121657043,0.868912
D.bocki,140010837,461512,1,7347,5.24745e-05,121664390,0.868964
D.bocki,140010837,457680,1,7340,5.24245e-05,121671730,0.869017
D.bocki,140010837,463798,1,7338,5.24102e-05,121679068,0.869069
D.bocki,140010837,458015,1,7331,5.23602e-05,121686399,0.869121
D.bocki,140010837,464425,1,7325,5.23174e-05,121693724,0.869174
D.bocki,140010837,464700,1,7321,5.22888e-05,121701045,0.869226
D.bocki,140010837,461143,1,7320,5.22817e-05,121708365,0.869278
D.bocki,140010837,459707,1,7303,5.21602e-05,121715668,0.86933
D.bocki,140010837,458510,1,7302,5.21531e-05,121722970,0.869382
D.bocki,140010837,456823,1,7298,5.21245e-05,121730268,0.869435
D.bocki,140010837,463540,1,7297,5.21174e-05,121737565,0.869487
D.bocki,140010837,281373,1,7291,5.20745e-05,121744856,0.869539
D.bocki,140010837,456691,1,7289,5.20603e-05,121752145,0.869591
D.bocki,140010837,464257,1,7287,5.2046e-05,121759432,0.869643
D.bocki,140010837,463401,1,7284,5.20245e-05,121766716,0.869695
D.bocki,140010837,457700,1,7284,5.20245e-05,121774000,0.869747
D.bocki,140010837,464734,1,7282,5.20103e-05,121781282,0.869799
D.bocki,140010837,461930,1,7282,5.20103e-05,121788564,0.869851
D.bocki,140010837,461803,1,7275,5.19603e-05,121795839,0.869903
D.bocki,140010837,464708,1,7272,5.19388e-05,121803111,0.869955
D.bocki,140010837,277997,1,7266,5.1896e-05,121810377,0.870007
D.bocki,140010837,464633,1,7259,5.1846e-05,121817636,0.870059
D.bocki,140010837,83983,1,7252,5.1796e-05,121824888,0.87011
D.bocki,140010837,463210,1,7251,5.17888e-05,121832139,0.870162
D.bocki,140010837,132992,1,7247,5.17603e-05,121839386,0.870214
D.bocki,140010837,463749,1,7245,5.1746e-05,121846631,0.870266
D.bocki,140010837,464085,1,7243,5.17317e-05,121853874,0.870317
D.bocki,140010837,462912,1,7238,5.1696e-05,121861112,0.870369
D.bocki,140010837,462006,1,7236,5.16817e-05,121868348,0.870421
D.bocki,140010837,459508,1,7232,5.16531e-05,121875580,0.870472
D.bocki,140010837,464095,1,7227,5.16174e-05,121882807,0.870524
D.bocki,140010837,457977,1,7226,5.16103e-05,121890033,0.870576
D.bocki,140010837,465018,1,7220,5.15674e-05,121897253,0.870627
D.bocki,140010837,464842,1,7218,5.15532e-05,121904471,0.870679
D.bocki,140010837,458356,1,7216,5.15389e-05,121911687,0.87073
D.bocki,140010837,459540,1,7212,5.15103e-05,121918899,0.870782
D.bocki,140010837,458145,1,7207,5.14746e-05,121926106,0.870833
D.bocki,140010837,456306,1,7206,5.14674e-05,121933312,0.870885
D.bocki,140010837,458954,1,7200,5.14246e-05,121940512,0.870936
D.bocki,140010837,463694,1,7196,5.1396e-05,121947708,0.870988
D.bocki,140010837,461886,1,7195,5.13889e-05,121954903,0.871039
D.bocki,140010837,460563,1,7193,5.13746e-05,121962096,0.87109
D.bocki,140010837,465080,1,7188,5.13389e-05,121969284,0.871142
D.bocki,140010837,460558,1,7188,5.13389e-05,121976472,0.871193
D.bocki,140010837,458842,1,7188,5.13389e-05,121983660,0.871244
D.bocki,140010837,460543,1,7185,5.13175e-05,121990845,0.871296
D.bocki,140010837,460939,1,7181,5.12889e-05,121998026,0.871347
D.bocki,140010837,458150,1,7181,5.12889e-05,122005207,0.871398
D.bocki,140010837,464227,1,7179,5.12746e-05,122012386,0.87145
D.bocki,140010837,463535,1,7179,5.12746e-05,122019565,0.871501
D.bocki,140010837,464187,1,7175,5.1246e-05,122026740,0.871552
D.bocki,140010837,462160,1,7171,5.12175e-05,122033911,0.871603
D.bocki,140010837,456728,1,7171,5.12175e-05,122041082,0.871655
D.bocki,140010837,210538,1,7169,5.12032e-05,122048251,0.871706
D.bocki,140010837,463632,1,7165,5.11746e-05,122055416,0.871757
D.bocki,140010837,462894,1,7161,5.1146e-05,122062577,0.871808
D.bocki,140010837,458364,1,7159,5.11318e-05,122069736,0.871859
D.bocki,140010837,463649,1,7155,5.11032e-05,122076891,0.87191
D.bocki,140010837,463387,1,7150,5.10675e-05,122084041,0.871961
D.bocki,140010837,447703,1,7150,5.10675e-05,122091191,0.872012
D.bocki,140010837,465055,1,7148,5.10532e-05,122098339,0.872063
D.bocki,140010837,384451,1,7135,5.09603e-05,122105474,0.872114
D.bocki,140010837,463028,1,7121,5.08603e-05,122112595,0.872165
D.bocki,140010837,457995,1,7121,5.08603e-05,122119716,0.872216
D.bocki,140010837,464677,1,7114,5.08104e-05,122126830,0.872267
D.bocki,140010837,461635,1,7114,5.08104e-05,122133944,0.872318
D.bocki,140010837,212895,1,7112,5.07961e-05,122141056,0.872369
D.bocki,140010837,38331,1,7109,5.07746e-05,122148165,0.872419
D.bocki,140010837,459434,1,7105,5.07461e-05,122155270,0.87247
D.bocki,140010837,462948,1,7102,5.07246e-05,122162372,0.872521
D.bocki,140010837,247434,1,7100,5.07104e-05,122169472,0.872572
D.bocki,140010837,464767,1,7098,5.06961e-05,122176570,0.872622
D.bocki,140010837,462066,1,7094,5.06675e-05,122183664,0.872673
D.bocki,140010837,462876,1,7092,5.06532e-05,122190756,0.872724
D.bocki,140010837,458564,1,7076,5.05389e-05,122197832,0.872774
D.bocki,140010837,460311,1,7072,5.05104e-05,122204904,0.872825
D.bocki,140010837,465062,1,7070,5.04961e-05,122211974,0.872875
D.bocki,140010837,463097,1,7065,5.04604e-05,122219039,0.872926
D.bocki,140010837,149810,1,7064,5.04532e-05,122226103,0.872976
D.bocki,140010837,461132,1,7060,5.04247e-05,122233163,0.873026
D.bocki,140010837,455735,1,7056,5.03961e-05,122240219,0.873077
D.bocki,140010837,462920,1,7046,5.03247e-05,122247265,0.873127
D.bocki,140010837,463609,1,7042,5.02961e-05,122254307,0.873177
D.bocki,140010837,106010,1,7042,5.02961e-05,122261349,0.873228
D.bocki,140010837,458810,1,7030,5.02104e-05,122268379,0.873278
D.bocki,140010837,463935,1,7025,5.01747e-05,122275404,0.873328
D.bocki,140010837,462128,1,7024,5.01675e-05,122282428,0.873378
D.bocki,140010837,412168,1,7016,5.01104e-05,122289444,0.873428
D.bocki,140010837,464332,1,7005,5.00318e-05,122296449,0.873478
D.bocki,140010837,464361,1,7002,5.00104e-05,122303451,0.873528
D.bocki,140010837,464574,1,6999,4.9989e-05,122310450,0.873578
D.bocki,140010837,456233,1,6997,4.99747e-05,122317447,0.873628
D.bocki,140010837,457379,1,6989,4.99176e-05,122324436,0.873678
D.bocki,140010837,463101,1,6985,4.9889e-05,122331421,0.873728
D.bocki,140010837,407226,1,6984,4.98819e-05,122338405,0.873778
D.bocki,140010837,464468,1,6973,4.98033e-05,122345378,0.873828
D.bocki,140010837,460626,1,6964,4.9739e-05,122352342,0.873878
D.bocki,140010837,459596,1,6962,4.97247e-05,122359304,0.873927
D.bocki,140010837,458496,1,6960,4.97104e-05,122366264,0.873977
D.bocki,140010837,183073,1,6960,4.97104e-05,122373224,0.874027
D.bocki,140010837,462877,1,6950,4.9639e-05,122380174,0.874076
D.bocki,140010837,461851,1,6950,4.9639e-05,122387124,0.874126
D.bocki,140010837,459572,1,6950,4.9639e-05,122394074,0.874176
D.bocki,140010837,462263,1,6949,4.96319e-05,122401023,0.874225
D.bocki,140010837,457485,1,6948,4.96247e-05,122407971,0.874275
D.bocki,140010837,463933,1,6947,4.96176e-05,122414918,0.874325
D.bocki,140010837,458036,1,6947,4.96176e-05,122421865,0.874374
D.bocki,140010837,452266,1,6947,4.96176e-05,122428812,0.874424
D.bocki,140010837,464138,1,6942,4.95819e-05,122435754,0.874473
D.bocki,140010837,456469,1,6939,4.95604e-05,122442693,0.874523
D.bocki,140010837,459168,1,6938,4.95533e-05,122449631,0.874573
D.bocki,140010837,462616,1,6937,4.95462e-05,122456568,0.874622
D.bocki,140010837,460197,1,6937,4.95462e-05,122463505,0.874672
D.bocki,140010837,460475,1,6932,4.95105e-05,122470437,0.874721
D.bocki,140010837,459374,1,6921,4.94319e-05,122477358,0.874771
D.bocki,140010837,460430,1,6918,4.94105e-05,122484276,0.87482
D.bocki,140010837,456581,1,6918,4.94105e-05,122491194,0.874869
D.bocki,140010837,464329,1,6916,4.93962e-05,122498110,0.874919
D.bocki,140010837,457149,1,6913,4.93747e-05,122505023,0.874968
D.bocki,140010837,464745,1,6896,4.92533e-05,122511919,0.875017
D.bocki,140010837,75805,1,6892,4.92248e-05,122518811,0.875067
D.bocki,140010837,457378,1,6891,4.92176e-05,122525702,0.875116
D.bocki,140010837,464928,1,6885,4.91748e-05,122532587,0.875165
D.bocki,140010837,465083,1,6883,4.91605e-05,122539470,0.875214
D.bocki,140010837,463133,1,6882,4.91533e-05,122546352,0.875263
D.bocki,140010837,459647,1,6877,4.91176e-05,122553229,0.875312
D.bocki,140010837,458258,1,6876,4.91105e-05,122560105,0.875362
D.bocki,140010837,464671,1,6872,4.90819e-05,122566977,0.875411
D.bocki,140010837,458202,1,6858,4.89819e-05,122573835,0.87546
D.bocki,140010837,457722,1,6858,4.89819e-05,122580693,0.875509
D.bocki,140010837,462406,1,6847,4.89034e-05,122587540,0.875558
D.bocki,140010837,463029,1,6841,4.88605e-05,122594381,0.875606
D.bocki,140010837,464913,1,6838,4.88391e-05,122601219,0.875655
D.bocki,140010837,464008,1,6830,4.87819e-05,122608049,0.875704
D.bocki,140010837,461186,1,6830,4.87819e-05,122614879,0.875753
D.bocki,140010837,460953,1,6830,4.87819e-05,122621709,0.875802
D.bocki,140010837,456099,1,6829,4.87748e-05,122628538,0.87585
D.bocki,140010837,157188,1,6827,4.87605e-05,122635365,0.875899
D.bocki,140010837,463846,1,6823,4.87319e-05,122642188,0.875948
D.bocki,140010837,460546,1,6822,4.87248e-05,122649010,0.875997
D.bocki,140010837,458269,1,6822,4.87248e-05,122655832,0.876045
D.bocki,140010837,463816,1,6814,4.86677e-05,122662646,0.876094
D.bocki,140010837,457421,1,6809,4.86319e-05,122669455,0.876143
D.bocki,140010837,461403,1,6803,4.85891e-05,122676258,0.876191
D.bocki,140010837,457231,1,6797,4.85462e-05,122683055,0.87624
D.bocki,140010837,354665,1,6797,4.85462e-05,122689852,0.876288
D.bocki,140010837,456480,1,6795,4.8532e-05,122696647,0.876337
D.bocki,140010837,457525,1,6794,4.85248e-05,122703441,0.876385
D.bocki,140010837,463795,1,6792,4.85105e-05,122710233,0.876434
D.bocki,140010837,456511,1,6791,4.85034e-05,122717024,0.876482
D.bocki,140010837,464356,1,6786,4.84677e-05,122723810,0.876531
D.bocki,140010837,463482,1,6786,4.84677e-05,122730596,0.876579
D.bocki,140010837,359026,1,6785,4.84605e-05,122737381,0.876628
D.bocki,140010837,458117,1,6770,4.83534e-05,122744151,0.876676
D.bocki,140010837,457898,1,6755,4.82463e-05,122750906,0.876724
D.bocki,140010837,308290,1,6754,4.82391e-05,122757660,0.876773
D.bocki,140010837,464922,1,6750,4.82106e-05,122764410,0.876821
D.bocki,140010837,464710,1,6750,4.82106e-05,122771160,0.876869
D.bocki,140010837,463691,1,6749,4.82034e-05,122777909,0.876917
D.bocki,140010837,463267,1,6744,4.81677e-05,122784653,0.876965
D.bocki,140010837,160863,1,6743,4.81606e-05,122791396,0.877014
D.bocki,140010837,461519,1,6741,4.81463e-05,122798137,0.877062
D.bocki,140010837,462758,1,6729,4.80606e-05,122804866,0.87711
D.bocki,140010837,464768,1,6727,4.80463e-05,122811593,0.877158
D.bocki,140010837,461835,1,6724,4.80249e-05,122818317,0.877206
D.bocki,140010837,464164,1,6722,4.80106e-05,122825039,0.877254
D.bocki,140010837,451638,1,6719,4.79891e-05,122831758,0.877302
D.bocki,140010837,457299,1,6717,4.79749e-05,122838475,0.87735
D.bocki,140010837,464131,1,6711,4.7932e-05,122845186,0.877398
D.bocki,140010837,458948,1,6711,4.7932e-05,122851897,0.877446
D.bocki,140010837,463124,1,6708,4.79106e-05,122858605,0.877494
D.bocki,140010837,461633,1,6700,4.78534e-05,122865305,0.877541
D.bocki,140010837,462771,1,6692,4.77963e-05,122871997,0.877589
D.bocki,140010837,463770,1,6685,4.77463e-05,122878682,0.877637
D.bocki,140010837,458462,1,6685,4.77463e-05,122885367,0.877685
D.bocki,140010837,232429,1,6683,4.7732e-05,122892050,0.877732
D.bocki,140010837,387150,1,6671,4.76463e-05,122898721,0.87778
D.bocki,140010837,458264,1,6667,4.76177e-05,122905388,0.877828
D.bocki,140010837,420653,1,6663,4.75892e-05,122912051,0.877875
D.bocki,140010837,180018,1,6657,4.75463e-05,122918708,0.877923
D.bocki,140010837,463704,1,6650,4.74963e-05,122925358,0.87797
D.bocki,140010837,458201,1,6626,4.73249e-05,122931984,0.878018
D.bocki,140010837,463640,1,6623,4.73035e-05,122938607,0.878065
D.bocki,140010837,170545,1,6623,4.73035e-05,122945230,0.878112
D.bocki,140010837,465107,1,6620,4.72821e-05,122951850,0.87816
D.bocki,140010837,461131,1,6619,4.72749e-05,122958469,0.878207
D.bocki,140010837,462230,1,6608,4.71963e-05,122965077,0.878254
D.bocki,140010837,338557,1,6608,4.71963e-05,122971685,0.878301
D.bocki,140010837,465031,1,6606,4.71821e-05,122978291,0.878348
D.bocki,140010837,346906,1,6597,4.71178e-05,122984888,0.878395
D.bocki,140010837,230221,1,6588,4.70535e-05,122991476,0.878443
D.bocki,140010837,142295,1,6577,4.69749e-05,122998053,0.87849
D.bocki,140010837,460914,1,6574,4.69535e-05,123004627,0.878536
D.bocki,140010837,457385,1,6573,4.69464e-05,123011200,0.878583
D.bocki,140010837,306880,1,6571,4.69321e-05,123017771,0.87863
D.bocki,140010837,459035,1,6569,4.69178e-05,123024340,0.878677
D.bocki,140010837,459320,1,6567,4.69035e-05,123030907,0.878724
D.bocki,140010837,154314,1,6566,4.68964e-05,123037473,0.878771
D.bocki,140010837,458981,1,6565,4.68892e-05,123044038,0.878818
D.bocki,140010837,460668,1,6557,4.68321e-05,123050595,0.878865
D.bocki,140010837,464517,1,6547,4.67607e-05,123057142,0.878912
D.bocki,140010837,462032,1,6533,4.66607e-05,123063675,0.878958
D.bocki,140010837,455761,1,6520,4.65678e-05,123070195,0.879005
D.bocki,140010837,461147,1,6513,4.65178e-05,123076708,0.879051
D.bocki,140010837,453908,1,6509,4.64893e-05,123083217,0.879098
D.bocki,140010837,456339,1,6502,4.64393e-05,123089719,0.879144
D.bocki,140010837,464776,1,6499,4.64178e-05,123096218,0.879191
D.bocki,140010837,464236,1,6495,4.63893e-05,123102713,0.879237
D.bocki,140010837,457848,1,6493,4.6375e-05,123109206,0.879283
D.bocki,140010837,455925,1,6492,4.63678e-05,123115698,0.87933
D.bocki,140010837,465092,1,6491,4.63607e-05,123122189,0.879376
D.bocki,140010837,464636,1,6488,4.63393e-05,123128677,0.879422
D.bocki,140010837,54585,1,6480,4.62821e-05,123135157,0.879469
D.bocki,140010837,459520,1,6465,4.6175e-05,123141622,0.879515
D.bocki,140010837,459507,1,6462,4.61536e-05,123148084,0.879561
D.bocki,140010837,464320,1,6461,4.61464e-05,123154545,0.879607
D.bocki,140010837,463142,1,6457,4.61179e-05,123161002,0.879653
D.bocki,140010837,460959,1,6446,4.60393e-05,123167448,0.879699
D.bocki,140010837,465088,1,6440,4.59964e-05,123173888,0.879745
D.bocki,140010837,464639,1,6436,4.59679e-05,123180324,0.879791
D.bocki,140010837,456389,1,6434,4.59536e-05,123186758,0.879837
D.bocki,140010837,456148,1,6432,4.59393e-05,123193190,0.879883
D.bocki,140010837,458621,1,6425,4.58893e-05,123199615,0.879929
D.bocki,140010837,464845,1,6423,4.5875e-05,123206038,0.879975
D.bocki,140010837,464815,1,6419,4.58465e-05,123212457,0.880021
D.bocki,140010837,458812,1,6414,4.58107e-05,123218871,0.880067
D.bocki,140010837,464416,1,6412,4.57965e-05,123225283,0.880112
D.bocki,140010837,464486,1,6409,4.5775e-05,123231692,0.880158
D.bocki,140010837,464375,1,6408,4.57679e-05,123238100,0.880204
D.bocki,140010837,457754,1,6369,4.54893e-05,123244469,0.880249
D.bocki,140010837,460787,1,6368,4.54822e-05,123250837,0.880295
D.bocki,140010837,464780,1,6364,4.54536e-05,123257201,0.88034
D.bocki,140010837,461533,1,6361,4.54322e-05,123263562,0.880386
D.bocki,140010837,461453,1,6361,4.54322e-05,123269923,0.880431
D.bocki,140010837,455834,1,6361,4.54322e-05,123276284,0.880477
D.bocki,140010837,464343,1,6358,4.54108e-05,123282642,0.880522
D.bocki,140010837,464359,1,6354,4.53822e-05,123288996,0.880568
D.bocki,140010837,459798,1,6353,4.53751e-05,123295349,0.880613
D.bocki,140010837,461183,1,6347,4.53322e-05,123301696,0.880658
D.bocki,140010837,457382,1,6341,4.52894e-05,123308037,0.880704
D.bocki,140010837,464908,1,6336,4.52536e-05,123314373,0.880749
D.bocki,140010837,458369,1,6336,4.52536e-05,123320709,0.880794
D.bocki,140010837,456672,1,6335,4.52465e-05,123327044,0.880839
D.bocki,140010837,464398,1,6334,4.52394e-05,123333378,0.880885
D.bocki,140010837,458995,1,6332,4.52251e-05,123339710,0.88093
D.bocki,140010837,464365,1,6330,4.52108e-05,123346040,0.880975
D.bocki,140010837,204143,1,6324,4.51679e-05,123352364,0.88102
D.bocki,140010837,464554,1,6320,4.51394e-05,123358684,0.881065
D.bocki,140010837,326976,1,6317,4.51179e-05,123365001,0.88111
D.bocki,140010837,463806,1,6314,4.50965e-05,123371315,0.881155
D.bocki,140010837,462252,1,6314,4.50965e-05,123377629,0.881201
D.bocki,140010837,457186,1,6308,4.50537e-05,123383937,0.881246
D.bocki,140010837,464910,1,6306,4.50394e-05,123390243,0.881291
D.bocki,140010837,456936,1,6300,4.49965e-05,123396543,0.881336
D.bocki,140010837,463038,1,6297,4.49751e-05,123402840,0.881381
D.bocki,140010837,461084,1,6296,4.49679e-05,123409136,0.881426
D.bocki,140010837,463058,1,6294,4.49537e-05,123415430,0.881471
D.bocki,140010837,461928,1,6288,4.49108e-05,123421718,0.881515
D.bocki,140010837,414823,1,6281,4.48608e-05,123427999,0.88156
D.bocki,140010837,463685,1,6278,4.48394e-05,123434277,0.881605
D.bocki,140010837,464724,1,6275,4.4818e-05,123440552,0.88165
D.bocki,140010837,464818,1,6269,4.47751e-05,123446821,0.881695
D.bocki,140010837,457416,1,6267,4.47608e-05,123453088,0.88174
D.bocki,140010837,38005,1,6267,4.47608e-05,123459355,0.881784
D.bocki,140010837,320996,1,6267,4.47608e-05,123465622,0.881829
D.bocki,140010837,463381,1,6266,4.47537e-05,123471888,0.881874
D.bocki,140010837,456504,1,6261,4.4718e-05,123478149,0.881919
D.bocki,140010837,461885,1,6256,4.46823e-05,123484405,0.881963
D.bocki,140010837,456806,1,6254,4.4668e-05,123490659,0.882008
D.bocki,140010837,463470,1,6253,4.46608e-05,123496912,0.882053
D.bocki,140010837,461299,1,6248,4.46251e-05,123503160,0.882097
D.bocki,140010837,463714,1,6237,4.45466e-05,123509397,0.882142
D.bocki,140010837,463634,1,6231,4.45037e-05,123515628,0.882186
D.bocki,140010837,408929,1,6231,4.45037e-05,123521859,0.882231
D.bocki,140010837,464154,1,6229,4.44894e-05,123528088,0.882275
D.bocki,140010837,31063,1,6221,4.44323e-05,123534309,0.88232
D.bocki,140010837,86508,1,6212,4.4368e-05,123540521,0.882364
D.bocki,140010837,464665,1,6212,4.4368e-05,123546733,0.882408
D.bocki,140010837,462779,1,6212,4.4368e-05,123552945,0.882453
D.bocki,140010837,463412,1,6205,4.4318e-05,123559150,0.882497
D.bocki,140010837,463345,1,6197,4.42609e-05,123565347,0.882541
D.bocki,140010837,455816,1,6194,4.42394e-05,123571541,0.882586
D.bocki,140010837,464412,1,6191,4.4218e-05,123577732,0.88263
D.bocki,140010837,463506,1,6186,4.41823e-05,123583918,0.882674
D.bocki,140010837,459133,1,6176,4.41109e-05,123590094,0.882718
D.bocki,140010837,457864,1,6176,4.41109e-05,123596270,0.882762
D.bocki,140010837,457832,1,6174,4.40966e-05,123602444,0.882806
D.bocki,140010837,463984,1,6167,4.40466e-05,123608611,0.88285
D.bocki,140010837,463922,1,6166,4.40394e-05,123614777,0.882894
D.bocki,140010837,457065,1,6164,4.40252e-05,123620941,0.882938
D.bocki,140010837,465098,1,6163,4.4018e-05,123627104,0.882982
D.bocki,140010837,177352,1,6162,4.40109e-05,123633266,0.883026
D.bocki,140010837,459499,1,6161,4.40037e-05,123639427,0.88307
D.bocki,140010837,463627,1,6159,4.39895e-05,123645586,0.883114
D.bocki,140010837,464270,1,6154,4.39537e-05,123651740,0.883158
D.bocki,140010837,102786,1,6152,4.39395e-05,123657892,0.883202
D.bocki,140010837,457225,1,6148,4.39109e-05,123664040,0.883246
D.bocki,140010837,462085,1,6144,4.38823e-05,123670184,0.88329
D.bocki,140010837,457509,1,6130,4.37823e-05,123676314,0.883334
D.bocki,140010837,462951,1,6128,4.3768e-05,123682442,0.883378
D.bocki,140010837,461036,1,6127,4.37609e-05,123688569,0.883421
D.bocki,140010837,462745,1,6118,4.36966e-05,123694687,0.883465
D.bocki,140010837,299981,1,6116,4.36823e-05,123700803,0.883509
D.bocki,140010837,457940,1,6115,4.36752e-05,123706918,0.883552
D.bocki,140010837,202702,1,6108,4.36252e-05,123713026,0.883596
D.bocki,140010837,456704,1,6102,4.35823e-05,123719128,0.88364
D.bocki,140010837,460740,1,6093,4.35181e-05,123725221,0.883683
D.bocki,140010837,461730,1,6090,4.34966e-05,123731311,0.883727
D.bocki,140010837,459830,1,6090,4.34966e-05,123737401,0.88377
D.bocki,140010837,464203,1,6076,4.33966e-05,123743477,0.883814
D.bocki,140010837,460921,1,6074,4.33824e-05,123749551,0.883857
D.bocki,140010837,464111,1,6073,4.33752e-05,123755624,0.8839
D.bocki,140010837,458323,1,6073,4.33752e-05,123761697,0.883944
D.bocki,140010837,463039,1,6064,4.33109e-05,123767761,0.883987
D.bocki,140010837,464207,1,6050,4.32109e-05,123773811,0.88403
D.bocki,140010837,464214,1,6048,4.31967e-05,123779859,0.884073
D.bocki,140010837,460855,1,6048,4.31967e-05,123785907,0.884117
D.bocki,140010837,461324,1,6046,4.31824e-05,123791953,0.88416
D.bocki,140010837,464911,1,6042,4.31538e-05,123797995,0.884203
D.bocki,140010837,458886,1,6038,4.31252e-05,123804033,0.884246
D.bocki,140010837,458236,1,6038,4.31252e-05,123810071,0.884289
D.bocki,140010837,459931,1,6035,4.31038e-05,123816106,0.884332
D.bocki,140010837,459463,1,6035,4.31038e-05,123822141,0.884375
D.bocki,140010837,463821,1,6027,4.30467e-05,123828168,0.884418
D.bocki,140010837,461980,1,6026,4.30395e-05,123834194,0.884461
D.bocki,140010837,39231,1,6025,4.30324e-05,123840219,0.884505
D.bocki,140010837,464448,1,6023,4.30181e-05,123846242,0.884548
D.bocki,140010837,155190,1,6020,4.29967e-05,123852262,0.884591
D.bocki,140010837,463701,1,6018,4.29824e-05,123858280,0.884634
D.bocki,140010837,462798,1,6017,4.29752e-05,123864297,0.884676
D.bocki,140010837,464148,1,6016,4.29681e-05,123870313,0.884719
D.bocki,140010837,455976,1,6016,4.29681e-05,123876329,0.884762
D.bocki,140010837,462152,1,6014,4.29538e-05,123882343,0.884805
D.bocki,140010837,461972,1,6010,4.29252e-05,123888353,0.884848
D.bocki,140010837,462392,1,6009,4.29181e-05,123894362,0.884891
D.bocki,140010837,463708,1,6008,4.2911e-05,123900370,0.884934
D.bocki,140010837,460692,1,6004,4.28824e-05,123906374,0.884977
D.bocki,140010837,458691,1,6004,4.28824e-05,123912378,0.88502
D.bocki,140010837,464898,1,6000,4.28538e-05,123918378,0.885063
D.bocki,140010837,456296,1,5998,4.28395e-05,123924376,0.885106
D.bocki,140010837,464034,1,5997,4.28324e-05,123930373,0.885148
D.bocki,140010837,421806,1,5994,4.2811e-05,123936367,0.885191
D.bocki,140010837,464147,1,5987,4.2761e-05,123942354,0.885234
D.bocki,140010837,460958,1,5987,4.2761e-05,123948341,0.885277
D.bocki,140010837,326572,1,5987,4.2761e-05,123954328,0.88532
D.bocki,140010837,459360,1,5986,4.27538e-05,123960314,0.885362
D.bocki,140010837,464875,1,5984,4.27395e-05,123966298,0.885405
D.bocki,140010837,102404,1,5984,4.27395e-05,123972282,0.885448
D.bocki,140010837,463436,1,5978,4.26967e-05,123978260,0.88549
D.bocki,140010837,452631,1,5978,4.26967e-05,123984238,0.885533
D.bocki,140010837,180915,1,5977,4.26896e-05,123990215,0.885576
D.bocki,140010837,458465,1,5976,4.26824e-05,123996191,0.885619
D.bocki,140010837,458404,1,5975,4.26753e-05,124002166,0.885661
D.bocki,140010837,6664,1,5971,4.26467e-05,124008137,0.885704
D.bocki,140010837,463584,1,5970,4.26396e-05,124014107,0.885746
D.bocki,140010837,464961,1,5967,4.26181e-05,124020074,0.885789
D.bocki,140010837,456142,1,5966,4.2611e-05,124026040,0.885832
D.bocki,140010837,464748,1,5961,4.25753e-05,124032001,0.885874
D.bocki,140010837,10688,1,5961,4.25753e-05,124037962,0.885917
D.bocki,140010837,460141,1,5957,4.25467e-05,124043919,0.885959
D.bocki,140010837,460655,1,5953,4.25181e-05,124049872,0.886002
D.bocki,140010837,463771,1,5948,4.24824e-05,124055820,0.886044
D.bocki,140010837,461987,1,5943,4.24467e-05,124061763,0.886087
D.bocki,140010837,464087,1,5942,4.24396e-05,124067705,0.886129
D.bocki,140010837,462316,1,5942,4.24396e-05,124073647,0.886172
D.bocki,140010837,463362,1,5940,4.24253e-05,124079587,0.886214
D.bocki,140010837,457698,1,5938,4.2411e-05,124085525,0.886257
D.bocki,140010837,463702,1,5934,4.23824e-05,124091459,0.886299
D.bocki,140010837,336984,1,5933,4.23753e-05,124097392,0.886341
D.bocki,140010837,459246,1,5932,4.23681e-05,124103324,0.886384
D.bocki,140010837,462235,1,5931,4.2361e-05,124109255,0.886426
D.bocki,140010837,159253,1,5926,4.23253e-05,124115181,0.886468
D.bocki,140010837,463555,1,5921,4.22896e-05,124121102,0.886511
D.bocki,140010837,459904,1,5921,4.22896e-05,124127023,0.886553
D.bocki,140010837,465061,1,5920,4.22824e-05,124132943,0.886595
D.bocki,140010837,462873,1,5915,4.22467e-05,124138858,0.886637
D.bocki,140010837,464743,1,5913,4.22324e-05,124144771,0.88668
D.bocki,140010837,460459,1,5904,4.21682e-05,124150675,0.886722
D.bocki,140010837,464232,1,5894,4.20967e-05,124156569,0.886764
D.bocki,140010837,460383,1,5893,4.20896e-05,124162462,0.886806
D.bocki,140010837,462542,1,5889,4.2061e-05,124168351,0.886848
D.bocki,140010837,460310,1,5888,4.20539e-05,124174239,0.88689
D.bocki,140010837,463369,1,5882,4.2011e-05,124180121,0.886932
D.bocki,140010837,190074,1,5881,4.20039e-05,124186002,0.886974
D.bocki,140010837,102752,1,5856,4.18253e-05,124191858,0.887016
D.bocki,140010837,461600,1,5851,4.17896e-05,124197709,0.887058
D.bocki,140010837,464685,1,5849,4.17753e-05,124203558,0.8871
D.bocki,140010837,10659,1,5844,4.17396e-05,124209402,0.887141
D.bocki,140010837,42719,1,5832,4.16539e-05,124215234,0.887183
D.bocki,140010837,458570,1,5826,4.16111e-05,124221060,0.887225
D.bocki,140010837,461007,1,5820,4.15682e-05,124226880,0.887266
D.bocki,140010837,360618,1,5818,4.15539e-05,124232698,0.887308
D.bocki,140010837,456981,1,5812,4.15111e-05,124238510,0.887349
D.bocki,140010837,456832,1,5812,4.15111e-05,124244322,0.887391
D.bocki,140010837,460647,1,5806,4.14682e-05,124250128,0.887432
D.bocki,140010837,447624,1,5806,4.14682e-05,124255934,0.887474
D.bocki,140010837,463850,1,5799,4.14182e-05,124261733,0.887515
D.bocki,140010837,464499,1,5797,4.14039e-05,124267530,0.887557
D.bocki,140010837,461722,1,5795,4.13897e-05,124273325,0.887598
D.bocki,140010837,462520,1,5789,4.13468e-05,124279114,0.887639
D.bocki,140010837,460842,1,5789,4.13468e-05,124284903,0.887681
D.bocki,140010837,456149,1,5789,4.13468e-05,124290692,0.887722
D.bocki,140010837,458113,1,5787,4.13325e-05,124296479,0.887763
D.bocki,140010837,462572,1,5783,4.13039e-05,124302262,0.887805
D.bocki,140010837,457351,1,5782,4.12968e-05,124308044,0.887846
D.bocki,140010837,461235,1,5780,4.12825e-05,124313824,0.887887
D.bocki,140010837,464501,1,5771,4.12182e-05,124319595,0.887928
D.bocki,140010837,464381,1,5769,4.1204e-05,124325364,0.88797
D.bocki,140010837,463132,1,5768,4.11968e-05,124331132,0.888011
D.bocki,140010837,463419,1,5766,4.11825e-05,124336898,0.888052
D.bocki,140010837,462061,1,5766,4.11825e-05,124342664,0.888093
D.bocki,140010837,459815,1,5761,4.11468e-05,124348425,0.888134
D.bocki,140010837,456302,1,5760,4.11397e-05,124354185,0.888175
D.bocki,140010837,456940,1,5757,4.11182e-05,124359942,0.888217
D.bocki,140010837,456632,1,5756,4.11111e-05,124365698,0.888258
D.bocki,140010837,459802,1,5754,4.10968e-05,124371452,0.888299
D.bocki,140010837,462444,1,5749,4.10611e-05,124377201,0.88834
D.bocki,140010837,458374,1,5749,4.10611e-05,124382950,0.888381
D.bocki,140010837,457760,1,5747,4.10468e-05,124388697,0.888422
D.bocki,140010837,458362,1,5746,4.10397e-05,124394443,0.888463
D.bocki,140010837,464062,1,5745,4.10325e-05,124400188,0.888504
D.bocki,140010837,456291,1,5745,4.10325e-05,124405933,0.888545
D.bocki,140010837,459156,1,5742,4.10111e-05,124411675,0.888586
D.bocki,140010837,458727,1,5742,4.10111e-05,124417417,0.888627
D.bocki,140010837,456503,1,5741,4.1004e-05,124423158,0.888668
D.bocki,140010837,101318,1,5740,4.09968e-05,124428898,0.888709
D.bocki,140010837,458309,1,5738,4.09825e-05,124434636,0.88875
D.bocki,140010837,462609,1,5733,4.09468e-05,124440369,0.888791
D.bocki,140010837,463367,1,5731,4.09325e-05,124446100,0.888832
D.bocki,140010837,460260,1,5728,4.09111e-05,124451828,0.888873
D.bocki,140010837,460463,1,5726,4.08968e-05,124457554,0.888914
D.bocki,140010837,464606,1,5720,4.0854e-05,124463274,0.888955
D.bocki,140010837,460658,1,5720,4.0854e-05,124468994,0.888995
D.bocki,140010837,464854,1,5719,4.08468e-05,124474713,0.889036
D.bocki,140010837,463358,1,5715,4.08183e-05,124480428,0.889077
D.bocki,140010837,455957,1,5713,4.0804e-05,124486141,0.889118
D.bocki,140010837,456289,1,5705,4.07468e-05,124491846,0.889159
D.bocki,140010837,464180,1,5704,4.07397e-05,124497550,0.889199
D.bocki,140010837,456372,1,5703,4.07326e-05,124503253,0.88924
D.bocki,140010837,463673,1,5698,4.06968e-05,124508951,0.889281
D.bocki,140010837,433262,1,5687,4.06183e-05,124514638,0.889321
D.bocki,140010837,463111,1,5681,4.05754e-05,124520319,0.889362
D.bocki,140010837,452770,1,5681,4.05754e-05,124526000,0.889403
D.bocki,140010837,452346,1,5672,4.05111e-05,124531672,0.889443
D.bocki,140010837,463525,1,5671,4.0504e-05,124537343,0.889484
D.bocki,140010837,462469,1,5669,4.04897e-05,124543012,0.889524
D.bocki,140010837,457998,1,5668,4.04826e-05,124548680,0.889565
D.bocki,140010837,455728,1,5666,4.04683e-05,124554346,0.889605
D.bocki,140010837,464377,1,5657,4.0404e-05,124560003,0.889645
D.bocki,140010837,457461,1,5656,4.03969e-05,124565659,0.889686
D.bocki,140010837,460119,1,5652,4.03683e-05,124571311,0.889726
D.bocki,140010837,458736,1,5652,4.03683e-05,124576963,0.889767
D.bocki,140010837,459777,1,5651,4.03612e-05,124582614,0.889807
D.bocki,140010837,457165,1,5650,4.0354e-05,124588264,0.889847
D.bocki,140010837,464719,1,5647,4.03326e-05,124593911,0.889888
D.bocki,140010837,462635,1,5644,4.03112e-05,124599555,0.889928
D.bocki,140010837,461433,1,5644,4.03112e-05,124605199,0.889968
D.bocki,140010837,457161,1,5644,4.03112e-05,124610843,0.890009
D.bocki,140010837,459807,1,5643,4.0304e-05,124616486,0.890049
D.bocki,140010837,464489,1,5641,4.02897e-05,124622127,0.890089
D.bocki,140010837,465012,1,5640,4.02826e-05,124627767,0.890129
D.bocki,140010837,464054,1,5638,4.02683e-05,124633405,0.89017
D.bocki,140010837,456980,1,5633,4.02326e-05,124639038,0.89021
D.bocki,140010837,456962,1,5631,4.02183e-05,124644669,0.89025
D.bocki,140010837,463859,1,5627,4.01897e-05,124650296,0.89029
D.bocki,140010837,462939,1,5627,4.01897e-05,124655923,0.890331
D.bocki,140010837,459350,1,5618,4.01255e-05,124661541,0.890371
D.bocki,140010837,457707,1,5614,4.00969e-05,124667155,0.890411
D.bocki,140010837,456278,1,5613,4.00898e-05,124672768,0.890451
D.bocki,140010837,455807,1,5607,4.00469e-05,124678375,0.890491
D.bocki,140010837,465073,1,5606,4.00398e-05,124683981,0.890531
D.bocki,140010837,461259,1,5606,4.00398e-05,124689587,0.890571
D.bocki,140010837,456508,1,5603,4.00183e-05,124695190,0.890611
D.bocki,140010837,461661,1,5602,4.00112e-05,124700792,0.890651
D.bocki,140010837,456625,1,5601,4.0004e-05,124706393,0.890691
D.bocki,140010837,464881,1,5599,3.99898e-05,124711992,0.890731
D.bocki,140010837,464255,1,5594,3.99541e-05,124717586,0.890771
D.bocki,140010837,462510,1,5593,3.99469e-05,124723179,0.890811
D.bocki,140010837,459437,1,5588,3.99112e-05,124728767,0.890851
D.bocki,140010837,463317,1,5577,3.98326e-05,124734344,0.890891
D.bocki,140010837,451818,1,5572,3.97969e-05,124739916,0.89093
D.bocki,140010837,457329,1,5566,3.97541e-05,124745482,0.89097
D.bocki,140010837,464358,1,5563,3.97326e-05,124751045,0.89101
D.bocki,140010837,462947,1,5563,3.97326e-05,124756608,0.89105
D.bocki,140010837,457009,1,5562,3.97255e-05,124762170,0.891089
D.bocki,140010837,460816,1,5558,3.96969e-05,124767728,0.891129
D.bocki,140010837,463300,1,5557,3.96898e-05,124773285,0.891169
D.bocki,140010837,457846,1,5556,3.96826e-05,124778841,0.891208
D.bocki,140010837,461363,1,5555,3.96755e-05,124784396,0.891248
D.bocki,140010837,456634,1,5552,3.96541e-05,124789948,0.891288
D.bocki,140010837,457027,1,5548,3.96255e-05,124795496,0.891327
D.bocki,140010837,465014,1,5545,3.96041e-05,124801041,0.891367
D.bocki,140010837,457232,1,5537,3.95469e-05,124806578,0.891407
D.bocki,140010837,453634,1,5536,3.95398e-05,124812114,0.891446
D.bocki,140010837,456259,1,5533,3.95184e-05,124817647,0.891486
D.bocki,140010837,456514,1,5527,3.94755e-05,124823174,0.891525
D.bocki,140010837,463667,1,5522,3.94398e-05,124828696,0.891565
D.bocki,140010837,461100,1,5519,3.94184e-05,124834215,0.891604
D.bocki,140010837,461926,1,5509,3.9347e-05,124839724,0.891643
D.bocki,140010837,457813,1,5509,3.9347e-05,124845233,0.891683
D.bocki,140010837,455895,1,5503,3.93041e-05,124850736,0.891722
D.bocki,140010837,463913,1,5496,3.92541e-05,124856232,0.891761
D.bocki,140010837,462494,1,5495,3.9247e-05,124861727,0.8918
D.bocki,140010837,458048,1,5493,3.92327e-05,124867220,0.89184
D.bocki,140010837,323465,1,5493,3.92327e-05,124872713,0.891879
D.bocki,140010837,456473,1,5492,3.92255e-05,124878205,0.891918
D.bocki,140010837,464536,1,5491,3.92184e-05,124883696,0.891957
D.bocki,140010837,461300,1,5488,3.9197e-05,124889184,0.891997
D.bocki,140010837,458274,1,5485,3.91755e-05,124894669,0.892036
D.bocki,140010837,463329,1,5481,3.9147e-05,124900150,0.892075
D.bocki,140010837,459545,1,5480,3.91398e-05,124905630,0.892114
D.bocki,140010837,464065,1,5477,3.91184e-05,124911107,0.892153
D.bocki,140010837,457873,1,5471,3.90755e-05,124916578,0.892192
D.bocki,140010837,223510,1,5470,3.90684e-05,124922048,0.892231
D.bocki,140010837,462199,1,5467,3.9047e-05,124927515,0.89227
D.bocki,140010837,461043,1,5466,3.90398e-05,124932981,0.892309
D.bocki,140010837,464975,1,5464,3.90256e-05,124938445,0.892348
D.bocki,140010837,464773,1,5462,3.90113e-05,124943907,0.892387
D.bocki,140010837,464325,1,5459,3.89898e-05,124949366,0.892426
D.bocki,140010837,460734,1,5451,3.89327e-05,124954817,0.892465
D.bocki,140010837,462345,1,5447,3.89041e-05,124960264,0.892504
D.bocki,140010837,458437,1,5447,3.89041e-05,124965711,0.892543
D.bocki,140010837,463492,1,5437,3.88327e-05,124971148,0.892582
D.bocki,140010837,462954,1,5437,3.88327e-05,124976585,0.892621
D.bocki,140010837,461673,1,5437,3.88327e-05,124982022,0.89266
D.bocki,140010837,461622,1,5435,3.88184e-05,124987457,0.892698
D.bocki,140010837,461239,1,5433,3.88041e-05,124992890,0.892737
D.bocki,140010837,437264,1,5433,3.88041e-05,124998323,0.892776
D.bocki,140010837,462659,1,5432,3.8797e-05,125003755,0.892815
D.bocki,140010837,464296,1,5426,3.87541e-05,125009181,0.892854
D.bocki,140010837,463648,1,5425,3.8747e-05,125014606,0.892892
D.bocki,140010837,465119,1,5424,3.87399e-05,125020030,0.892931
D.bocki,140010837,75262,1,5423,3.87327e-05,125025453,0.89297
D.bocki,140010837,459088,1,5421,3.87184e-05,125030874,0.893009
D.bocki,140010837,456093,1,5416,3.86827e-05,125036290,0.893047
D.bocki,140010837,451852,1,5412,3.86542e-05,125041702,0.893086
D.bocki,140010837,202155,1,5409,3.86327e-05,125047111,0.893125
D.bocki,140010837,462739,1,5393,3.85184e-05,125052504,0.893163
D.bocki,140010837,455996,1,5392,3.85113e-05,125057896,0.893202
D.bocki,140010837,462386,1,5390,3.8497e-05,125063286,0.89324
D.bocki,140010837,460639,1,5390,3.8497e-05,125068676,0.893279
D.bocki,140010837,462110,1,5380,3.84256e-05,125074056,0.893317
D.bocki,140010837,351135,1,5378,3.84113e-05,125079434,0.893355
D.bocki,140010837,464909,1,5377,3.84042e-05,125084811,0.893394
D.bocki,140010837,407071,1,5374,3.83827e-05,125090185,0.893432
D.bocki,140010837,463819,1,5369,3.8347e-05,125095554,0.893471
D.bocki,140010837,463041,1,5368,3.83399e-05,125100922,0.893509
D.bocki,140010837,458499,1,5364,3.83113e-05,125106286,0.893547
D.bocki,140010837,457781,1,5360,3.82828e-05,125111646,0.893585
D.bocki,140010837,399767,1,5358,3.82685e-05,125117004,0.893624
D.bocki,140010837,464821,1,5353,3.82328e-05,125122357,0.893662
D.bocki,140010837,420299,1,5352,3.82256e-05,125127709,0.8937
D.bocki,140010837,464758,1,5348,3.8197e-05,125133057,0.893738
D.bocki,140010837,460308,1,5348,3.8197e-05,125138405,0.893777
D.bocki,140010837,464989,1,5347,3.81899e-05,125143752,0.893815
D.bocki,140010837,457104,1,5342,3.81542e-05,125149094,0.893853
D.bocki,140010837,462122,1,5340,3.81399e-05,125154434,0.893891
D.bocki,140010837,457337,1,5340,3.81399e-05,125159774,0.893929
D.bocki,140010837,463360,1,5337,3.81185e-05,125165111,0.893967
D.bocki,140010837,455888,1,5335,3.81042e-05,125170446,0.894005
D.bocki,140010837,148240,1,5332,3.80828e-05,125175778,0.894043
D.bocki,140010837,457568,1,5331,3.80756e-05,125181109,0.894082
D.bocki,140010837,461618,1,5330,3.80685e-05,125186439,0.89412
D.bocki,140010837,457992,1,5330,3.80685e-05,125191769,0.894158
D.bocki,140010837,464802,1,5326,3.80399e-05,125197095,0.894196
D.bocki,140010837,462297,1,5326,3.80399e-05,125202421,0.894234
D.bocki,140010837,459874,1,5326,3.80399e-05,125207747,0.894272
D.bocki,140010837,457793,1,5325,3.80328e-05,125213072,0.89431
D.bocki,140010837,458191,1,5323,3.80185e-05,125218395,0.894348
D.bocki,140010837,457492,1,5322,3.80113e-05,125223717,0.894386
D.bocki,140010837,464185,1,5320,3.79971e-05,125229037,0.894424
D.bocki,140010837,456791,1,5314,3.79542e-05,125234351,0.894462
D.bocki,140010837,464285,1,5312,3.79399e-05,125239663,0.8945
D.bocki,140010837,460419,1,5311,3.79328e-05,125244974,0.894538
D.bocki,140010837,464339,1,5308,3.79114e-05,125250282,0.894576
D.bocki,140010837,457218,1,5305,3.78899e-05,125255587,0.894614
D.bocki,140010837,460164,1,5304,3.78828e-05,125260891,0.894651
D.bocki,140010837,462213,1,5302,3.78685e-05,125266193,0.894689
D.bocki,140010837,463502,1,5297,3.78328e-05,125271490,0.894727
D.bocki,140010837,460211,1,5284,3.77399e-05,125276774,0.894765
D.bocki,140010837,457766,1,5282,3.77257e-05,125282056,0.894803
D.bocki,140010837,103609,1,5282,3.77257e-05,125287338,0.89484
D.bocki,140010837,464188,1,5273,3.76614e-05,125292611,0.894878
D.bocki,140010837,456281,1,5270,3.76399e-05,125297881,0.894916
D.bocki,140010837,462768,1,5268,3.76257e-05,125303149,0.894953
D.bocki,140010837,465121,1,5265,3.76042e-05,125308414,0.894991
D.bocki,140010837,459449,1,5265,3.76042e-05,125313679,0.895028
D.bocki,140010837,456683,1,5265,3.76042e-05,125318944,0.895066
D.bocki,140010837,455906,1,5262,3.75828e-05,125324206,0.895104
D.bocki,140010837,455943,1,5261,3.75757e-05,125329467,0.895141
D.bocki,140010837,457716,1,5260,3.75685e-05,125334727,0.895179
D.bocki,140010837,457208,1,5256,3.754e-05,125339983,0.895216
D.bocki,140010837,457878,1,5255,3.75328e-05,125345238,0.895254
D.bocki,140010837,462312,1,5254,3.75257e-05,125350492,0.895291
D.bocki,140010837,464949,1,5253,3.75185e-05,125355745,0.895329
D.bocki,140010837,462723,1,5251,3.75042e-05,125360996,0.895366
D.bocki,140010837,456242,1,5251,3.75042e-05,125366247,0.895404
D.bocki,140010837,464438,1,5245,3.74614e-05,125371492,0.895441
D.bocki,140010837,459930,1,5240,3.74257e-05,125376732,0.895479
D.bocki,140010837,457287,1,5237,3.74042e-05,125381969,0.895516
D.bocki,140010837,458655,1,5230,3.73543e-05,125387199,0.895554
D.bocki,140010837,450879,1,5227,3.73328e-05,125392426,0.895591
D.bocki,140010837,457645,1,5223,3.73043e-05,125397649,0.895628
D.bocki,140010837,461611,1,5222,3.72971e-05,125402871,0.895665
D.bocki,140010837,456501,1,5221,3.729e-05,125408092,0.895703
D.bocki,140010837,463966,1,5220,3.72828e-05,125413312,0.89574
D.bocki,140010837,464050,1,5218,3.72685e-05,125418530,0.895777
D.bocki,140010837,456089,1,5213,3.72328e-05,125423743,0.895815
D.bocki,140010837,462331,1,5212,3.72257e-05,125428955,0.895852
D.bocki,140010837,461899,1,5209,3.72043e-05,125434164,0.895889
D.bocki,140010837,461254,1,5206,3.71828e-05,125439370,0.895926
D.bocki,140010837,456840,1,5204,3.71686e-05,125444574,0.895963
D.bocki,140010837,456140,1,5204,3.71686e-05,125449778,0.896
D.bocki,140010837,459742,1,5199,3.71328e-05,125454977,0.896038
D.bocki,140010837,212149,1,5198,3.71257e-05,125460175,0.896075
D.bocki,140010837,461755,1,5197,3.71186e-05,125465372,0.896112
D.bocki,140010837,459696,1,5197,3.71186e-05,125470569,0.896149
D.bocki,140010837,463777,1,5195,3.71043e-05,125475764,0.896186
D.bocki,140010837,457181,1,5195,3.71043e-05,125480959,0.896223
D.bocki,140010837,462538,1,5193,3.709e-05,125486152,0.89626
D.bocki,140010837,463870,1,5192,3.70828e-05,125491344,0.896297
D.bocki,140010837,455705,1,5187,3.70471e-05,125496531,0.896334
D.bocki,140010837,458337,1,5186,3.704e-05,125501717,0.896371
D.bocki,140010837,461091,1,5185,3.70328e-05,125506902,0.896408
D.bocki,140010837,78550,1,5183,3.70186e-05,125512085,0.896446
D.bocki,140010837,463638,1,5182,3.70114e-05,125517267,0.896483
D.bocki,140010837,458153,1,5182,3.70114e-05,125522449,0.89652
D.bocki,140010837,456366,1,5180,3.69971e-05,125527629,0.896557
D.bocki,140010837,459297,1,5179,3.699e-05,125532808,0.896594
D.bocki,140010837,458543,1,5178,3.69829e-05,125537986,0.89663
D.bocki,140010837,456036,1,5178,3.69829e-05,125543164,0.896667
D.bocki,140010837,462744,1,5168,3.69114e-05,125548332,0.896704
D.bocki,140010837,280444,1,5164,3.68829e-05,125553496,0.896741
D.bocki,140010837,462874,1,5163,3.68757e-05,125558659,0.896778
D.bocki,140010837,458438,1,5162,3.68686e-05,125563821,0.896815
D.bocki,140010837,464044,1,5161,3.68614e-05,125568982,0.896852
D.bocki,140010837,456526,1,5157,3.68329e-05,125574139,0.896889
D.bocki,140010837,125061,1,5156,3.68257e-05,125579295,0.896926
D.bocki,140010837,464020,1,5155,3.68186e-05,125584450,0.896962
D.bocki,140010837,458575,1,5155,3.68186e-05,125589605,0.896999
D.bocki,140010837,463119,1,5152,3.67972e-05,125594757,0.897036
D.bocki,140010837,462970,1,5150,3.67829e-05,125599907,0.897073
D.bocki,140010837,460925,1,5150,3.67829e-05,125605057,0.89711
D.bocki,140010837,463955,1,5145,3.67472e-05,125610202,0.897146
D.bocki,140010837,463229,1,5141,3.67186e-05,125615343,0.897183
D.bocki,140010837,460453,1,5140,3.67114e-05,125620483,0.89722
D.bocki,140010837,459655,1,5136,3.66829e-05,125625619,0.897256
D.bocki,140010837,463493,1,5135,3.66757e-05,125630754,0.897293
D.bocki,140010837,459404,1,5135,3.66757e-05,125635889,0.89733
D.bocki,140010837,456711,1,5131,3.66472e-05,125641020,0.897366
D.bocki,140010837,460208,1,5130,3.664e-05,125646150,0.897403
D.bocki,140010837,152270,1,5129,3.66329e-05,125651279,0.89744
D.bocki,140010837,462761,1,5127,3.66186e-05,125656406,0.897476
D.bocki,140010837,458631,1,5126,3.66115e-05,125661532,0.897513
D.bocki,140010837,460707,1,5124,3.65972e-05,125666656,0.897549
D.bocki,140010837,464801,1,5123,3.659e-05,125671779,0.897586
D.bocki,140010837,459096,1,5117,3.65472e-05,125676896,0.897623
D.bocki,140010837,463137,1,5115,3.65329e-05,125682011,0.897659
D.bocki,140010837,128725,1,5115,3.65329e-05,125687126,0.897696
D.bocki,140010837,460627,1,5113,3.65186e-05,125692239,0.897732
D.bocki,140010837,464456,1,5112,3.65115e-05,125697351,0.897769
D.bocki,140010837,462713,1,5110,3.64972e-05,125702461,0.897805
D.bocki,140010837,461615,1,5106,3.64686e-05,125707567,0.897842
D.bocki,140010837,463912,1,5104,3.64543e-05,125712671,0.897878
D.bocki,140010837,122748,1,5104,3.64543e-05,125717775,0.897915
D.bocki,140010837,460809,1,5102,3.644e-05,125722877,0.897951
D.bocki,140010837,463516,1,5100,3.64258e-05,125727977,0.897987
D.bocki,140010837,457364,1,5100,3.64258e-05,125733077,0.898024
D.bocki,140010837,464953,1,5099,3.64186e-05,125738176,0.89806
D.bocki,140010837,459285,1,5098,3.64115e-05,125743274,0.898097
D.bocki,140010837,461156,1,5097,3.64043e-05,125748371,0.898133
D.bocki,140010837,461328,1,5096,3.63972e-05,125753467,0.89817
D.bocki,140010837,256241,1,5096,3.63972e-05,125758563,0.898206
D.bocki,140010837,461000,1,5094,3.63829e-05,125763657,0.898242
D.bocki,140010837,462966,1,5089,3.63472e-05,125768746,0.898279
D.bocki,140010837,458668,1,5088,3.634e-05,125773834,0.898315
D.bocki,140010837,461173,1,5086,3.63258e-05,125778920,0.898351
D.bocki,140010837,457345,1,5086,3.63258e-05,125784006,0.898388
D.bocki,140010837,464443,1,5084,3.63115e-05,125789090,0.898424
D.bocki,140010837,463989,1,5082,3.62972e-05,125794172,0.89846
D.bocki,140010837,461686,1,5082,3.62972e-05,125799254,0.898497
D.bocki,140010837,461389,1,5078,3.62686e-05,125804332,0.898533
D.bocki,140010837,464698,1,5077,3.62615e-05,125809409,0.898569
D.bocki,140010837,459771,1,5071,3.62186e-05,125814480,0.898605
D.bocki,140010837,458546,1,5070,3.62115e-05,125819550,0.898642
D.bocki,140010837,464820,1,5064,3.61686e-05,125824614,0.898678
D.bocki,140010837,464793,1,5059,3.61329e-05,125829673,0.898714
D.bocki,140010837,462272,1,5058,3.61258e-05,125834731,0.89875
D.bocki,140010837,457529,1,5058,3.61258e-05,125839789,0.898786
D.bocki,140010837,460898,1,5055,3.61043e-05,125844844,0.898822
D.bocki,140010837,457535,1,5052,3.60829e-05,125849896,0.898858
D.bocki,140010837,451310,1,5049,3.60615e-05,125854945,0.898894
D.bocki,140010837,462399,1,5048,3.60544e-05,125859993,0.89893
D.bocki,140010837,455826,1,5046,3.60401e-05,125865039,0.898966
D.bocki,140010837,458920,1,5043,3.60186e-05,125870082,0.899002
D.bocki,140010837,456544,1,5041,3.60044e-05,125875123,0.899038
D.bocki,140010837,333397,1,5040,3.59972e-05,125880163,0.899074
D.bocki,140010837,460716,1,5036,3.59686e-05,125885199,0.89911
D.bocki,140010837,457050,1,5034,3.59544e-05,125890233,0.899146
D.bocki,140010837,462075,1,5031,3.59329e-05,125895264,0.899182
D.bocki,140010837,22226,1,5030,3.59258e-05,125900294,0.899218
D.bocki,140010837,457982,1,5028,3.59115e-05,125905322,0.899254
D.bocki,140010837,464168,1,5026,3.58972e-05,125910348,0.89929
D.bocki,140010837,463740,1,5026,3.58972e-05,125915374,0.899326
D.bocki,140010837,459174,1,5026,3.58972e-05,125920400,0.899362
D.bocki,140010837,464409,1,5025,3.58901e-05,125925425,0.899398
D.bocki,140010837,458901,1,5025,3.58901e-05,125930450,0.899434
D.bocki,140010837,458365,1,5025,3.58901e-05,125935475,0.899469
D.bocki,140010837,460573,1,5015,3.58187e-05,125940490,0.899505
D.bocki,140010837,460541,1,5012,3.57972e-05,125945502,0.899541
D.bocki,140010837,459562,1,5010,3.57829e-05,125950512,0.899577
D.bocki,140010837,458640,1,5006,3.57544e-05,125955518,0.899613
D.bocki,140010837,462785,1,5005,3.57472e-05,125960523,0.899648
D.bocki,140010837,461210,1,5004,3.57401e-05,125965527,0.899684
D.bocki,140010837,145793,1,5002,3.57258e-05,125970529,0.89972
D.bocki,140010837,183636,1,4998,3.56972e-05,125975527,0.899756
D.bocki,140010837,456650,1,4997,3.56901e-05,125980524,0.899791
D.bocki,140010837,464957,1,4994,3.56687e-05,125985518,0.899827
D.bocki,140010837,459071,1,4994,3.56687e-05,125990512,0.899863
D.bocki,140010837,459525,1,4991,3.56472e-05,125995503,0.899898
D.bocki,140010837,222074,1,4987,3.56187e-05,126000490,0.899934
D.bocki,140010837,464010,1,4982,3.5583e-05,126005472,0.899969
D.bocki,140010837,21460,1,4978,3.55544e-05,126010450,0.900005
D.bocki,140010837,460771,1,4975,3.5533e-05,126015425,0.900041
D.bocki,140010837,464488,1,4973,3.55187e-05,126020398,0.900076
D.bocki,140010837,461295,1,4973,3.55187e-05,126025371,0.900112
D.bocki,140010837,199573,1,4968,3.5483e-05,126030339,0.900147
D.bocki,140010837,463827,1,4966,3.54687e-05,126035305,0.900182
D.bocki,140010837,460646,1,4966,3.54687e-05,126040271,0.900218
D.bocki,140010837,464590,1,4961,3.5433e-05,126045232,0.900253
D.bocki,140010837,463106,1,4960,3.54258e-05,126050192,0.900289
D.bocki,140010837,462501,1,4946,3.53258e-05,126055138,0.900324
D.bocki,140010837,458758,1,4944,3.53116e-05,126060082,0.900359
D.bocki,140010837,459911,1,4943,3.53044e-05,126065025,0.900395
D.bocki,140010837,460970,1,4939,3.52758e-05,126069964,0.90043
D.bocki,140010837,456917,1,4938,3.52687e-05,126074902,0.900465
D.bocki,140010837,397752,1,4937,3.52616e-05,126079839,0.900501
D.bocki,140010837,251186,1,4936,3.52544e-05,126084775,0.900536
D.bocki,140010837,458087,1,4935,3.52473e-05,126089710,0.900571
D.bocki,140010837,456828,1,4934,3.52401e-05,126094644,0.900606
D.bocki,140010837,347418,1,4933,3.5233e-05,126099577,0.900642
D.bocki,140010837,34350,1,4931,3.52187e-05,126104508,0.900677
D.bocki,140010837,461427,1,4929,3.52044e-05,126109437,0.900712
D.bocki,140010837,463825,1,4927,3.51901e-05,126114364,0.900747
D.bocki,140010837,458985,1,4926,3.5183e-05,126119290,0.900782
D.bocki,140010837,457903,1,4926,3.5183e-05,126124216,0.900818
D.bocki,140010837,328592,1,4923,3.51616e-05,126129139,0.900853
D.bocki,140010837,464851,1,4922,3.51544e-05,126134061,0.900888
D.bocki,140010837,459291,1,4922,3.51544e-05,126138983,0.900923
D.bocki,140010837,462142,1,4921,3.51473e-05,126143904,0.900958
D.bocki,140010837,462551,1,4918,3.51259e-05,126148822,0.900993
D.bocki,140010837,461272,1,4917,3.51187e-05,126153739,0.901028
D.bocki,140010837,87315,1,4912,3.5083e-05,126158651,0.901063
D.bocki,140010837,458108,1,4910,3.50687e-05,126163561,0.901099
D.bocki,140010837,456911,1,4902,3.50116e-05,126168463,0.901134
D.bocki,140010837,464576,1,4901,3.50044e-05,126173364,0.901169
D.bocki,140010837,460602,1,4900,3.49973e-05,126178264,0.901204
D.bocki,140010837,462251,1,4897,3.49759e-05,126183161,0.901239
D.bocki,140010837,459806,1,4897,3.49759e-05,126188058,0.901274
D.bocki,140010837,306368,1,4886,3.48973e-05,126192944,0.901308
D.bocki,140010837,458305,1,4885,3.48902e-05,126197829,0.901343
D.bocki,140010837,458921,1,4882,3.48687e-05,126202711,0.901378
D.bocki,140010837,458111,1,4881,3.48616e-05,126207592,0.901413
D.bocki,140010837,458660,1,4880,3.48544e-05,126212472,0.901448
D.bocki,140010837,459175,1,4877,3.4833e-05,126217349,0.901483
D.bocki,140010837,149549,1,4877,3.4833e-05,126222226,0.901518
D.bocki,140010837,298293,1,4874,3.48116e-05,126227100,0.901552
D.bocki,140010837,460174,1,4870,3.4783e-05,126231970,0.901587
D.bocki,140010837,459283,1,4870,3.4783e-05,126236840,0.901622
D.bocki,140010837,456921,1,4870,3.4783e-05,126241710,0.901657
D.bocki,140010837,464754,1,4869,3.47759e-05,126246579,0.901691
D.bocki,140010837,430305,1,4868,3.47687e-05,126251447,0.901726
D.bocki,140010837,461216,1,4867,3.47616e-05,126256314,0.901761
D.bocki,140010837,456708,1,4866,3.47545e-05,126261180,0.901796
D.bocki,140010837,246224,1,4863,3.4733e-05,126266043,0.90183
D.bocki,140010837,463831,1,4861,3.47187e-05,126270904,0.901865
D.bocki,140010837,457897,1,4859,3.47045e-05,126275763,0.9019
D.bocki,140010837,457599,1,4855,3.46759e-05,126280618,0.901935
D.bocki,140010837,459250,1,4852,3.46545e-05,126285470,0.901969
D.bocki,140010837,456997,1,4844,3.45973e-05,126290314,0.902004
D.bocki,140010837,456670,1,4840,3.45688e-05,126295154,0.902038
D.bocki,140010837,464393,1,4836,3.45402e-05,126299990,0.902073
D.bocki,140010837,459321,1,4832,3.45116e-05,126304822,0.902107
D.bocki,140010837,459764,1,4830,3.44973e-05,126309652,0.902142
D.bocki,140010837,464988,1,4828,3.4483e-05,126314480,0.902176
D.bocki,140010837,464459,1,4826,3.44688e-05,126319306,0.902211
D.bocki,140010837,328851,1,4824,3.44545e-05,126324130,0.902245
D.bocki,140010837,462479,1,4818,3.44116e-05,126328948,0.90228
D.bocki,140010837,462581,1,4817,3.44045e-05,126333765,0.902314
D.bocki,140010837,458102,1,4816,3.43973e-05,126338581,0.902349
D.bocki,140010837,456949,1,4816,3.43973e-05,126343397,0.902383
D.bocki,140010837,460738,1,4815,3.43902e-05,126348212,0.902417
D.bocki,140010837,456888,1,4810,3.43545e-05,126353022,0.902452
D.bocki,140010837,315760,1,4809,3.43473e-05,126357831,0.902486
D.bocki,140010837,464234,1,4808,3.43402e-05,126362639,0.90252
D.bocki,140010837,457095,1,4801,3.42902e-05,126367440,0.902555
D.bocki,140010837,214610,1,4793,3.42331e-05,126372233,0.902589
D.bocki,140010837,457494,1,4792,3.42259e-05,126377025,0.902623
D.bocki,140010837,456926,1,4790,3.42116e-05,126381815,0.902657
D.bocki,140010837,460575,1,4788,3.41974e-05,126386603,0.902692
D.bocki,140010837,321386,1,4787,3.41902e-05,126391390,0.902726
D.bocki,140010837,334195,1,4786,3.41831e-05,126396176,0.90276
D.bocki,140010837,146983,1,4781,3.41474e-05,126400957,0.902794
D.bocki,140010837,456968,1,4777,3.41188e-05,126405734,0.902828
D.bocki,140010837,463180,1,4775,3.41045e-05,126410509,0.902862
D.bocki,140010837,458370,1,4765,3.40331e-05,126415274,0.902896
D.bocki,140010837,459971,1,4764,3.40259e-05,126420038,0.90293
D.bocki,140010837,459007,1,4763,3.40188e-05,126424801,0.902964
D.bocki,140010837,463023,1,4762,3.40117e-05,126429563,0.902998
D.bocki,140010837,464160,1,4761,3.40045e-05,126434324,0.903032
D.bocki,140010837,463063,1,4761,3.40045e-05,126439085,0.903066
D.bocki,140010837,457261,1,4761,3.40045e-05,126443846,0.9031
D.bocki,140010837,464551,1,4759,3.39902e-05,126448605,0.903134
D.bocki,140010837,461581,1,4759,3.39902e-05,126453364,0.903168
D.bocki,140010837,462995,1,4754,3.39545e-05,126458118,0.903202
D.bocki,140010837,367900,1,4750,3.39259e-05,126462868,0.903236
D.bocki,140010837,464060,1,4748,3.39117e-05,126467616,0.90327
D.bocki,140010837,461587,1,4747,3.39045e-05,126472363,0.903304
D.bocki,140010837,378957,1,4746,3.38974e-05,126477109,0.903338
D.bocki,140010837,463011,1,4739,3.38474e-05,126481848,0.903372
D.bocki,140010837,458540,1,4738,3.38402e-05,126486586,0.903406
D.bocki,140010837,463947,1,4735,3.38188e-05,126491321,0.90344
D.bocki,140010837,457902,1,4732,3.37974e-05,126496053,0.903473
D.bocki,140010837,463359,1,4730,3.37831e-05,126500783,0.903507
D.bocki,140010837,441386,1,4729,3.3776e-05,126505512,0.903541
D.bocki,140010837,464418,1,4722,3.3726e-05,126510234,0.903575
D.bocki,140010837,458918,1,4722,3.3726e-05,126514956,0.903608
D.bocki,140010837,462911,1,4721,3.37188e-05,126519677,0.903642
D.bocki,140010837,124303,1,4714,3.36688e-05,126524391,0.903676
D.bocki,140010837,464300,1,4710,3.36403e-05,126529101,0.903709
D.bocki,140010837,464278,1,4710,3.36403e-05,126533811,0.903743
D.bocki,140010837,464906,1,4704,3.35974e-05,126538515,0.903777
D.bocki,140010837,457692,1,4703,3.35903e-05,126543218,0.90381
D.bocki,140010837,457554,1,4701,3.3576e-05,126547919,0.903844
D.bocki,140010837,464709,1,4690,3.34974e-05,126552609,0.903877
D.bocki,140010837,460487,1,4690,3.34974e-05,126557299,0.903911
D.bocki,140010837,456744,1,4687,3.3476e-05,126561986,0.903944
D.bocki,140010837,237145,1,4687,3.3476e-05,126566673,0.903978
D.bocki,140010837,464123,1,4683,3.34474e-05,126571356,0.904011
D.bocki,140010837,2170,1,4678,3.34117e-05,126576034,0.904045
D.bocki,140010837,457469,1,4676,3.33974e-05,126580710,0.904078
D.bocki,140010837,462318,1,4662,3.32974e-05,126585372,0.904111
D.bocki,140010837,459443,1,4662,3.32974e-05,126590034,0.904145
D.bocki,140010837,387910,1,4655,3.32474e-05,126594689,0.904178
D.bocki,140010837,462348,1,4652,3.3226e-05,126599341,0.904211
D.bocki,140010837,378425,1,4652,3.3226e-05,126603993,0.904244
D.bocki,140010837,463165,1,4649,3.32046e-05,126608642,0.904277
D.bocki,140010837,454534,1,4649,3.32046e-05,126613291,0.904311
D.bocki,140010837,364343,1,4649,3.32046e-05,126617940,0.904344
D.bocki,140010837,456205,1,4644,3.31689e-05,126622584,0.904377
D.bocki,140010837,461137,1,4643,3.31617e-05,126627227,0.90441
D.bocki,140010837,463739,1,4642,3.31546e-05,126631869,0.904443
D.bocki,140010837,460884,1,4641,3.31474e-05,126636510,0.904476
D.bocki,140010837,458884,1,4640,3.31403e-05,126641150,0.90451
D.bocki,140010837,457667,1,4639,3.31331e-05,126645789,0.904543
D.bocki,140010837,462087,1,4636,3.31117e-05,126650425,0.904576
D.bocki,140010837,461608,1,4636,3.31117e-05,126655061,0.904609
D.bocki,140010837,456897,1,4633,3.30903e-05,126659694,0.904642
D.bocki,140010837,283144,1,4622,3.30117e-05,126664316,0.904675
D.bocki,140010837,176342,1,4622,3.30117e-05,126668938,0.904708
D.bocki,140010837,463059,1,4618,3.29832e-05,126673556,0.904741
D.bocki,140010837,462090,1,4617,3.2976e-05,126678173,0.904774
D.bocki,140010837,461122,1,4616,3.29689e-05,126682789,0.904807
D.bocki,140010837,464964,1,4608,3.29117e-05,126687397,0.90484
D.bocki,140010837,461736,1,4607,3.29046e-05,126692004,0.904873
D.bocki,140010837,459955,1,4604,3.28832e-05,126696608,0.904906
D.bocki,140010837,458560,1,4602,3.28689e-05,126701210,0.904939
D.bocki,140010837,422547,1,4601,3.28617e-05,126705811,0.904971
D.bocki,140010837,458644,1,4600,3.28546e-05,126710411,0.905004
D.bocki,140010837,462709,1,4599,3.28475e-05,126715010,0.905037
D.bocki,140010837,457658,1,4599,3.28475e-05,126719609,0.90507
D.bocki,140010837,462417,1,4598,3.28403e-05,126724207,0.905103
D.bocki,140010837,461695,1,4597,3.28332e-05,126728804,0.905136
D.bocki,140010837,463885,1,4596,3.2826e-05,126733400,0.905169
D.bocki,140010837,460613,1,4590,3.27832e-05,126737990,0.905201
D.bocki,140010837,464597,1,4589,3.2776e-05,126742579,0.905234
D.bocki,140010837,464437,1,4584,3.27403e-05,126747163,0.905267
D.bocki,140010837,462086,1,4584,3.27403e-05,126751747,0.9053
D.bocki,140010837,464324,1,4572,3.26546e-05,126756319,0.905332
D.bocki,140010837,458973,1,4572,3.26546e-05,126760891,0.905365
D.bocki,140010837,462824,1,4571,3.26475e-05,126765462,0.905398
D.bocki,140010837,457892,1,4570,3.26403e-05,126770032,0.90543
D.bocki,140010837,464544,1,4566,3.26118e-05,126774598,0.905463
D.bocki,140010837,463836,1,4566,3.26118e-05,126779164,0.905495
D.bocki,140010837,462095,1,4561,3.2576e-05,126783725,0.905528
D.bocki,140010837,457984,1,4561,3.2576e-05,126788286,0.905561
D.bocki,140010837,462750,1,4557,3.25475e-05,126792843,0.905593
D.bocki,140010837,463996,1,4556,3.25403e-05,126797399,0.905626
D.bocki,140010837,463655,1,4553,3.25189e-05,126801952,0.905658
D.bocki,140010837,464785,1,4552,3.25118e-05,126806504,0.905691
D.bocki,140010837,459926,1,4547,3.24761e-05,126811051,0.905723
D.bocki,140010837,125770,1,4546,3.24689e-05,126815597,0.905756
D.bocki,140010837,458246,1,4539,3.24189e-05,126820136,0.905788
D.bocki,140010837,351615,1,4539,3.24189e-05,126824675,0.90582
D.bocki,140010837,458483,1,4538,3.24118e-05,126829213,0.905853
D.bocki,140010837,456044,1,4536,3.23975e-05,126833749,0.905885
D.bocki,140010837,459128,1,4534,3.23832e-05,126838283,0.905918
D.bocki,140010837,463732,1,4533,3.23761e-05,126842816,0.90595
D.bocki,140010837,451526,1,4533,3.23761e-05,126847349,0.905982
D.bocki,140010837,463501,1,4532,3.23689e-05,126851881,0.906015
D.bocki,140010837,461826,1,4526,3.23261e-05,126856407,0.906047
D.bocki,140010837,456188,1,4526,3.23261e-05,126860933,0.906079
D.bocki,140010837,458847,1,4522,3.22975e-05,126865455,0.906112
D.bocki,140010837,456440,1,4519,3.22761e-05,126869974,0.906144
D.bocki,140010837,324967,1,4519,3.22761e-05,126874493,0.906176
D.bocki,140010837,462008,1,4518,3.22689e-05,126879011,0.906209
D.bocki,140010837,458073,1,4517,3.22618e-05,126883528,0.906241
D.bocki,140010837,456004,1,4516,3.22546e-05,126888044,0.906273
D.bocki,140010837,461329,1,4514,3.22404e-05,126892558,0.906305
D.bocki,140010837,280064,1,4514,3.22404e-05,126897072,0.906338
D.bocki,140010837,460498,1,4512,3.22261e-05,126901584,0.90637
D.bocki,140010837,460072,1,4511,3.22189e-05,126906095,0.906402
D.bocki,140010837,464439,1,4510,3.22118e-05,126910605,0.906434
D.bocki,140010837,456995,1,4510,3.22118e-05,126915115,0.906466
D.bocki,140010837,455956,1,4508,3.21975e-05,126919623,0.906499
D.bocki,140010837,461371,1,4502,3.21547e-05,126924125,0.906531
D.bocki,140010837,460814,1,4501,3.21475e-05,126928626,0.906563
D.bocki,140010837,464874,1,4499,3.21332e-05,126933125,0.906595
D.bocki,140010837,455878,1,4499,3.21332e-05,126937624,0.906627
D.bocki,140010837,402247,1,4499,3.21332e-05,126942123,0.906659
D.bocki,140010837,464530,1,4493,3.20904e-05,126946616,0.906691
D.bocki,140010837,462565,1,4491,3.20761e-05,126951107,0.906723
D.bocki,140010837,458509,1,4491,3.20761e-05,126955598,0.906756
D.bocki,140010837,456209,1,4490,3.20689e-05,126960088,0.906788
D.bocki,140010837,375040,1,4490,3.20689e-05,126964578,0.90682
D.bocki,140010837,457466,1,4486,3.20404e-05,126969064,0.906852
D.bocki,140010837,463633,1,4479,3.19904e-05,126973543,0.906884
D.bocki,140010837,318883,1,4479,3.19904e-05,126978022,0.906916
D.bocki,140010837,461625,1,4478,3.19832e-05,126982500,0.906948
D.bocki,140010837,464132,1,4477,3.19761e-05,126986977,0.90698
D.bocki,140010837,459792,1,4476,3.1969e-05,126991453,0.907012
D.bocki,140010837,463034,1,4475,3.19618e-05,126995928,0.907044
D.bocki,140010837,461361,1,4474,3.19547e-05,127000402,0.907076
D.bocki,140010837,437340,1,4473,3.19475e-05,127004875,0.907107
D.bocki,140010837,462776,1,4471,3.19332e-05,127009346,0.907139
D.bocki,140010837,457271,1,4471,3.19332e-05,127013817,0.907171
D.bocki,140010837,87414,1,4469,3.1919e-05,127018286,0.907203
D.bocki,140010837,464047,1,4464,3.18832e-05,127022750,0.907235
D.bocki,140010837,460034,1,4464,3.18832e-05,127027214,0.907267
D.bocki,140010837,463416,1,4461,3.18618e-05,127031675,0.907299
D.bocki,140010837,463050,1,4460,3.18547e-05,127036135,0.907331
D.bocki,140010837,450998,1,4460,3.18547e-05,127040595,0.907363
D.bocki,140010837,458412,1,4445,3.17475e-05,127045040,0.907394
D.bocki,140010837,456077,1,4444,3.17404e-05,127049484,0.907426
D.bocki,140010837,463240,1,4443,3.17333e-05,127053927,0.907458
D.bocki,140010837,462343,1,4440,3.17118e-05,127058367,0.90749
D.bocki,140010837,459580,1,4440,3.17118e-05,127062807,0.907521
D.bocki,140010837,464058,1,4431,3.16476e-05,127067238,0.907553
D.bocki,140010837,463328,1,4431,3.16476e-05,127071669,0.907585
D.bocki,140010837,463213,1,4431,3.16476e-05,127076100,0.907616
D.bocki,140010837,460073,1,4429,3.16333e-05,127080529,0.907648
D.bocki,140010837,281212,1,4428,3.16261e-05,127084957,0.907679
D.bocki,140010837,462338,1,4427,3.1619e-05,127089384,0.907711
D.bocki,140010837,463614,1,4426,3.16118e-05,127093810,0.907743
D.bocki,140010837,462971,1,4426,3.16118e-05,127098236,0.907774
D.bocki,140010837,463892,1,4424,3.15976e-05,127102660,0.907806
D.bocki,140010837,462677,1,4424,3.15976e-05,127107084,0.907837
D.bocki,140010837,461473,1,4423,3.15904e-05,127111507,0.907869
D.bocki,140010837,117807,1,4423,3.15904e-05,127115930,0.907901
D.bocki,140010837,458116,1,4419,3.15618e-05,127120349,0.907932
D.bocki,140010837,209640,1,4417,3.15476e-05,127124766,0.907964
D.bocki,140010837,456681,1,4414,3.15261e-05,127129180,0.907995
D.bocki,140010837,464969,1,4413,3.1519e-05,127133593,0.908027
D.bocki,140010837,460417,1,4413,3.1519e-05,127138006,0.908058
D.bocki,140010837,461791,1,4412,3.15118e-05,127142418,0.90809
D.bocki,140010837,462245,1,4410,3.14976e-05,127146828,0.908121
D.bocki,140010837,458003,1,4410,3.14976e-05,127151238,0.908153
D.bocki,140010837,464118,1,4402,3.14404e-05,127155640,0.908184
D.bocki,140010837,458712,1,4402,3.14404e-05,127160042,0.908216
D.bocki,140010837,464805,1,4401,3.14333e-05,127164443,0.908247
D.bocki,140010837,462317,1,4395,3.13904e-05,127168838,0.908279
D.bocki,140010837,461777,1,4395,3.13904e-05,127173233,0.90831
D.bocki,140010837,463406,1,4393,3.13761e-05,127177626,0.908341
D.bocki,140010837,391065,1,4389,3.13476e-05,127182015,0.908373
D.bocki,140010837,463439,1,4387,3.13333e-05,127186402,0.908404
D.bocki,140010837,462002,1,4386,3.13261e-05,127190788,0.908435
D.bocki,140010837,110537,1,4384,3.13119e-05,127195172,0.908467
D.bocki,140010837,462449,1,4382,3.12976e-05,127199554,0.908498
D.bocki,140010837,460758,1,4381,3.12904e-05,127203935,0.908529
D.bocki,140010837,464315,1,4378,3.1269e-05,127208313,0.90856
D.bocki,140010837,459810,1,4376,3.12547e-05,127212689,0.908592
D.bocki,140010837,456206,1,4374,3.12404e-05,127217063,0.908623
D.bocki,140010837,464877,1,4371,3.1219e-05,127221434,0.908654
D.bocki,140010837,458075,1,4371,3.1219e-05,127225805,0.908685
D.bocki,140010837,208062,1,4370,3.12119e-05,127230175,0.908717
D.bocki,140010837,458986,1,4366,3.11833e-05,127234541,0.908748
D.bocki,140010837,456405,1,4362,3.11547e-05,127238903,0.908779
D.bocki,140010837,464069,1,4355,3.11047e-05,127243258,0.90881
D.bocki,140010837,459027,1,4350,3.1069e-05,127247608,0.908841
D.bocki,140010837,461048,1,4346,3.10405e-05,127251954,0.908872
D.bocki,140010837,461544,1,4345,3.10333e-05,127256299,0.908903
D.bocki,140010837,461562,1,4342,3.10119e-05,127260641,0.908934
D.bocki,140010837,458250,1,4341,3.10047e-05,127264982,0.908965
D.bocki,140010837,459138,1,4337,3.09762e-05,127269319,0.908996
D.bocki,140010837,459364,1,4336,3.0969e-05,127273655,0.909027
D.bocki,140010837,464592,1,4331,3.09333e-05,127277986,0.909058
D.bocki,140010837,465054,1,4326,3.08976e-05,127282312,0.909089
D.bocki,140010837,223036,1,4326,3.08976e-05,127286638,0.90912
D.bocki,140010837,461049,1,4322,3.0869e-05,127290960,0.909151
D.bocki,140010837,458271,1,4319,3.08476e-05,127295279,0.909182
D.bocki,140010837,462306,1,4314,3.08119e-05,127299593,0.909212
D.bocki,140010837,457493,1,4312,3.07976e-05,127303905,0.909243
D.bocki,140010837,463745,1,4311,3.07905e-05,127308216,0.909274
D.bocki,140010837,459893,1,4308,3.0769e-05,127312524,0.909305
D.bocki,140010837,325676,1,4304,3.07405e-05,127316828,0.909336
D.bocki,140010837,464742,1,4299,3.07048e-05,127321127,0.909366
D.bocki,140010837,459595,1,4298,3.06976e-05,127325425,0.909397
D.bocki,140010837,465104,1,4295,3.06762e-05,127329720,0.909428
D.bocki,140010837,463324,1,4294,3.06691e-05,127334014,0.909458
D.bocki,140010837,462172,1,4294,3.06691e-05,127338308,0.909489
D.bocki,140010837,387053,1,4293,3.06619e-05,127342601,0.90952
D.bocki,140010837,463070,1,4289,3.06333e-05,127346890,0.90955
D.bocki,140010837,464449,1,4287,3.06191e-05,127351177,0.909581
D.bocki,140010837,459793,1,4287,3.06191e-05,127355464,0.909611
D.bocki,140010837,464056,1,4284,3.05976e-05,127359748,0.909642
D.bocki,140010837,460327,1,4283,3.05905e-05,127364031,0.909673
D.bocki,140010837,461946,1,4282,3.05833e-05,127368313,0.909703
D.bocki,140010837,461573,1,4282,3.05833e-05,127372595,0.909734
D.bocki,140010837,465087,1,4279,3.05619e-05,127376874,0.909764
D.bocki,140010837,459048,1,4279,3.05619e-05,127381153,0.909795
D.bocki,140010837,456282,1,4279,3.05619e-05,127385432,0.909826
D.bocki,140010837,455717,1,4275,3.05334e-05,127389707,0.909856
D.bocki,140010837,465074,1,4273,3.05191e-05,127393980,0.909887
D.bocki,140010837,465002,1,4272,3.05119e-05,127398252,0.909917
D.bocki,140010837,461350,1,4272,3.05119e-05,127402524,0.909948
D.bocki,140010837,213120,1,4272,3.05119e-05,127406796,0.909978
D.bocki,140010837,459310,1,4271,3.05048e-05,127411067,0.910009
D.bocki,140010837,463013,1,4267,3.04762e-05,127415334,0.910039
D.bocki,140010837,456312,1,4266,3.04691e-05,127419600,0.91007
D.bocki,140010837,456457,1,4264,3.04548e-05,127423864,0.9101
D.bocki,140010837,449525,1,4257,3.04048e-05,127428121,0.91013
D.bocki,140010837,464316,1,4256,3.03976e-05,127432377,0.910161
D.bocki,140010837,461197,1,4256,3.03976e-05,127436633,0.910191
D.bocki,140010837,258745,1,4256,3.03976e-05,127440889,0.910222
D.bocki,140010837,457297,1,4255,3.03905e-05,127445144,0.910252
D.bocki,140010837,463790,1,4254,3.03834e-05,127449398,0.910282
D.bocki,140010837,464759,1,4253,3.03762e-05,127453651,0.910313
D.bocki,140010837,464899,1,4252,3.03691e-05,127457903,0.910343
D.bocki,140010837,461398,1,4249,3.03477e-05,127462152,0.910373
D.bocki,140010837,458908,1,4245,3.03191e-05,127466397,0.910404
D.bocki,140010837,464769,1,4240,3.02834e-05,127470637,0.910434
D.bocki,140010837,458185,1,4239,3.02762e-05,127474876,0.910464
D.bocki,140010837,456169,1,4239,3.02762e-05,127479115,0.910495
D.bocki,140010837,461404,1,4236,3.02548e-05,127483351,0.910525
D.bocki,140010837,460987,1,4234,3.02405e-05,127487585,0.910555
D.bocki,140010837,456971,1,4234,3.02405e-05,127491819,0.910585
D.bocki,140010837,464635,1,4230,3.02119e-05,127496049,0.910616
D.bocki,140010837,463574,1,4230,3.02119e-05,127500279,0.910646
D.bocki,140010837,457368,1,4230,3.02119e-05,127504509,0.910676
D.bocki,140010837,281524,1,4229,3.02048e-05,127508738,0.910706
D.bocki,140010837,464279,1,4228,3.01977e-05,127512966,0.910736
D.bocki,140010837,460485,1,4228,3.01977e-05,127517194,0.910767
D.bocki,140010837,457381,1,4228,3.01977e-05,127521422,0.910797
D.bocki,140010837,462289,1,4225,3.01762e-05,127525647,0.910827
D.bocki,140010837,281930,1,4223,3.0162e-05,127529870,0.910857
D.bocki,140010837,459515,1,4221,3.01477e-05,127534091,0.910887
D.bocki,140010837,458493,1,4221,3.01477e-05,127538312,0.910917
D.bocki,140010837,207815,1,4218,3.01262e-05,127542530,0.910948
D.bocki,140010837,456804,1,4217,3.01191e-05,127546747,0.910978
D.bocki,140010837,422510,1,4217,3.01191e-05,127550964,0.911008
D.bocki,140010837,463370,1,4216,3.0112e-05,127555180,0.911038
D.bocki,140010837,458328,1,4213,3.00905e-05,127559393,0.911068
D.bocki,140010837,109818,1,4211,3.00762e-05,127563604,0.911098
D.bocki,140010837,465020,1,4209,3.0062e-05,127567813,0.911128
D.bocki,140010837,21969,1,4209,3.0062e-05,127572022,0.911158
D.bocki,140010837,262607,1,4206,3.00405e-05,127576228,0.911188
D.bocki,140010837,458587,1,4202,3.0012e-05,127580430,0.911218
D.bocki,140010837,455998,1,4202,3.0012e-05,127584632,0.911248
D.bocki,140010837,456033,1,4201,3.00048e-05,127588833,0.911278
D.bocki,140010837,459091,1,4199,2.99905e-05,127593032,0.911308
D.bocki,140010837,459570,1,4197,2.99763e-05,127597229,0.911338
D.bocki,140010837,460931,1,4196,2.99691e-05,127601425,0.911368
D.bocki,140010837,460040,1,4192,2.99405e-05,127605617,0.911398
D.bocki,140010837,459439,1,4190,2.99263e-05,127609807,0.911428
D.bocki,140010837,462789,1,4189,2.99191e-05,127613996,0.911458
D.bocki,140010837,461074,1,4188,2.9912e-05,127618184,0.911488
D.bocki,140010837,464115,1,4185,2.98905e-05,127622369,0.911518
D.bocki,140010837,461838,1,4184,2.98834e-05,127626553,0.911548
D.bocki,140010837,459929,1,4184,2.98834e-05,127630737,0.911578
D.bocki,140010837,461543,1,4183,2.98763e-05,127634920,0.911607
D.bocki,140010837,455750,1,4182,2.98691e-05,127639102,0.911637
D.bocki,140010837,464771,1,4173,2.98048e-05,127643275,0.911667
D.bocki,140010837,460535,1,4169,2.97763e-05,127647444,0.911697
D.bocki,140010837,461103,1,4168,2.97691e-05,127651612,0.911727
D.bocki,140010837,221156,1,4167,2.9762e-05,127655779,0.911756
D.bocki,140010837,462268,1,4165,2.97477e-05,127659944,0.911786
D.bocki,140010837,461593,1,4164,2.97406e-05,127664108,0.911816
D.bocki,140010837,456038,1,4164,2.97406e-05,127668272,0.911846
D.bocki,140010837,460637,1,4163,2.97334e-05,127672435,0.911875
D.bocki,140010837,456410,1,4163,2.97334e-05,127676598,0.911905
D.bocki,140010837,459664,1,4162,2.97263e-05,127680760,0.911935
D.bocki,140010837,462067,1,4160,2.9712e-05,127684920,0.911965
D.bocki,140010837,457644,1,4159,2.97048e-05,127689079,0.911994
D.bocki,140010837,285368,1,4158,2.96977e-05,127693237,0.912024
D.bocki,140010837,464067,1,4156,2.96834e-05,127697393,0.912054
D.bocki,140010837,464452,1,4152,2.96548e-05,127701545,0.912083
D.bocki,140010837,462281,1,4152,2.96548e-05,127705697,0.912113
D.bocki,140010837,456139,1,4152,2.96548e-05,127709849,0.912143
D.bocki,140010837,460384,1,4151,2.96477e-05,127714000,0.912172
D.bocki,140010837,458046,1,4151,2.96477e-05,127718151,0.912202
D.bocki,140010837,458784,1,4148,2.96263e-05,127722299,0.912232
D.bocki,140010837,460724,1,4146,2.9612e-05,127726445,0.912261
D.bocki,140010837,460343,1,4146,2.9612e-05,127730591,0.912291
D.bocki,140010837,460732,1,4145,2.96049e-05,127734736,0.91232
D.bocki,140010837,461485,1,4137,2.95477e-05,127738873,0.91235
D.bocki,140010837,462853,1,4136,2.95406e-05,127743009,0.912379
D.bocki,140010837,459331,1,4133,2.95191e-05,127747142,0.912409
D.bocki,140010837,464481,1,4132,2.9512e-05,127751274,0.912438
D.bocki,140010837,462643,1,4132,2.9512e-05,127755406,0.912468
D.bocki,140010837,459542,1,4132,2.9512e-05,127759538,0.912497
D.bocki,140010837,460442,1,4131,2.95049e-05,127763669,0.912527
D.bocki,140010837,459475,1,4130,2.94977e-05,127767799,0.912556
D.bocki,140010837,457202,1,4129,2.94906e-05,127771928,0.912586
D.bocki,140010837,219468,1,4128,2.94834e-05,127776056,0.912615
D.bocki,140010837,461525,1,4127,2.94763e-05,127780183,0.912645
D.bocki,140010837,460804,1,4124,2.94549e-05,127784307,0.912674
D.bocki,140010837,464369,1,4123,2.94477e-05,127788430,0.912704
D.bocki,140010837,463485,1,4123,2.94477e-05,127792553,0.912733
D.bocki,140010837,459398,1,4123,2.94477e-05,127796676,0.912763
D.bocki,140010837,464283,1,4114,2.93834e-05,127800790,0.912792
D.bocki,140010837,460080,1,4114,2.93834e-05,127804904,0.912822
D.bocki,140010837,464683,1,4113,2.93763e-05,127809017,0.912851
D.bocki,140010837,462271,1,4110,2.93549e-05,127813127,0.91288
D.bocki,140010837,459058,1,4110,2.93549e-05,127817237,0.91291
D.bocki,140010837,462636,1,4105,2.93192e-05,127821342,0.912939
D.bocki,140010837,461783,1,4105,2.93192e-05,127825447,0.912968
D.bocki,140010837,135156,1,4105,2.93192e-05,127829552,0.912998
D.bocki,140010837,460872,1,4104,2.9312e-05,127833656,0.913027
D.bocki,140010837,462521,1,4103,2.93049e-05,127837759,0.913056
D.bocki,140010837,455785,1,4102,2.92977e-05,127841861,0.913085
D.bocki,140010837,456546,1,4099,2.92763e-05,127845960,0.913115
D.bocki,140010837,456334,1,4099,2.92763e-05,127850059,0.913144
D.bocki,140010837,460426,1,4095,2.92477e-05,127854154,0.913173
D.bocki,140010837,463122,1,4090,2.9212e-05,127858244,0.913202
D.bocki,140010837,461057,1,4090,2.9212e-05,127862334,0.913232
D.bocki,140010837,464428,1,4087,2.91906e-05,127866421,0.913261
D.bocki,140010837,190404,1,4086,2.91835e-05,127870507,0.91329
D.bocki,140010837,464031,1,4085,2.91763e-05,127874592,0.913319
D.bocki,140010837,458276,1,4084,2.91692e-05,127878676,0.913348
D.bocki,140010837,458974,1,4081,2.91477e-05,127882757,0.913378
D.bocki,140010837,457036,1,4079,2.91335e-05,127886836,0.913407
D.bocki,140010837,456906,1,4076,2.9112e-05,127890912,0.913436
D.bocki,140010837,462161,1,4074,2.90977e-05,127894986,0.913465
D.bocki,140010837,463728,1,4071,2.90763e-05,127899057,0.913494
D.bocki,140010837,463321,1,4069,2.9062e-05,127903126,0.913523
D.bocki,140010837,458983,1,4068,2.90549e-05,127907194,0.913552
D.bocki,140010837,455977,1,4067,2.90478e-05,127911261,0.913581
D.bocki,140010837,458852,1,4065,2.90335e-05,127915326,0.91361
D.bocki,140010837,455818,1,4060,2.89978e-05,127919386,0.913639
D.bocki,140010837,456543,1,4058,2.89835e-05,127923444,0.913668
D.bocki,140010837,464410,1,4057,2.89763e-05,127927501,0.913697
D.bocki,140010837,462892,1,4049,2.89192e-05,127931550,0.913726
D.bocki,140010837,463131,1,4045,2.88906e-05,127935595,0.913755
D.bocki,140010837,451155,1,4043,2.88763e-05,127939638,0.913784
D.bocki,140010837,460807,1,4041,2.88621e-05,127943679,0.913813
D.bocki,140010837,456763,1,4039,2.88478e-05,127947718,0.913842
D.bocki,140010837,391127,1,4037,2.88335e-05,127951755,0.91387
D.bocki,140010837,461902,1,4036,2.88263e-05,127955791,0.913899
D.bocki,140010837,458925,1,4036,2.88263e-05,127959827,0.913928
D.bocki,140010837,458446,1,4035,2.88192e-05,127963862,0.913957
D.bocki,140010837,464847,1,4033,2.88049e-05,127967895,0.913986
D.bocki,140010837,459870,1,4026,2.87549e-05,127971921,0.914014
D.bocki,140010837,461873,1,4023,2.87335e-05,127975944,0.914043
D.bocki,140010837,458917,1,4023,2.87335e-05,127979967,0.914072
D.bocki,140010837,464615,1,4020,2.87121e-05,127983987,0.914101
D.bocki,140010837,463002,1,4019,2.87049e-05,127988006,0.914129
D.bocki,140010837,461021,1,4018,2.86978e-05,127992024,0.914158
D.bocki,140010837,459726,1,4018,2.86978e-05,127996042,0.914187
D.bocki,140010837,460628,1,4015,2.86764e-05,128000057,0.914215
D.bocki,140010837,459036,1,4014,2.86692e-05,128004071,0.914244
D.bocki,140010837,461256,1,4013,2.86621e-05,128008084,0.914273
D.bocki,140010837,457045,1,4012,2.86549e-05,128012096,0.914301
D.bocki,140010837,463542,1,4010,2.86406e-05,128016106,0.91433
D.bocki,140010837,460478,1,4010,2.86406e-05,128020116,0.914359
D.bocki,140010837,457647,1,4010,2.86406e-05,128024126,0.914387
D.bocki,140010837,464982,1,4007,2.86192e-05,128028133,0.914416
D.bocki,140010837,458801,1,4000,2.85692e-05,128032133,0.914444
D.bocki,140010837,457635,1,4000,2.85692e-05,128036133,0.914473
D.bocki,140010837,463099,1,3998,2.85549e-05,128040131,0.914502
D.bocki,140010837,462752,1,3998,2.85549e-05,128044129,0.91453
D.bocki,140010837,271689,1,3998,2.85549e-05,128048127,0.914559
D.bocki,140010837,455982,1,3997,2.85478e-05,128052124,0.914587
D.bocki,140010837,456309,1,3995,2.85335e-05,128056119,0.914616
D.bocki,140010837,463016,1,3993,2.85192e-05,128060112,0.914644
D.bocki,140010837,461821,1,3993,2.85192e-05,128064105,0.914673
D.bocki,140010837,457135,1,3993,2.85192e-05,128068098,0.914701
D.bocki,140010837,462462,1,3990,2.84978e-05,128072088,0.91473
D.bocki,140010837,458603,1,3987,2.84764e-05,128076075,0.914758
D.bocki,140010837,457451,1,3987,2.84764e-05,128080062,0.914787
D.bocki,140010837,462473,1,3985,2.84621e-05,128084047,0.914815
D.bocki,140010837,456719,1,3985,2.84621e-05,128088032,0.914844
D.bocki,140010837,309447,1,3985,2.84621e-05,128092017,0.914872
D.bocki,140010837,455972,1,3984,2.84549e-05,128096001,0.914901
D.bocki,140010837,461653,1,3983,2.84478e-05,128099984,0.914929
D.bocki,140010837,461420,1,3983,2.84478e-05,128103967,0.914958
D.bocki,140010837,461540,1,3982,2.84407e-05,128107949,0.914986
D.bocki,140010837,458231,1,3982,2.84407e-05,128111931,0.915014
D.bocki,140010837,458939,1,3981,2.84335e-05,128115912,0.915043
D.bocki,140010837,462835,1,3979,2.84192e-05,128119891,0.915071
D.bocki,140010837,456199,1,3976,2.83978e-05,128123867,0.9151
D.bocki,140010837,462997,1,3971,2.83621e-05,128127838,0.915128
D.bocki,140010837,458618,1,3971,2.83621e-05,128131809,0.915156
D.bocki,140010837,463636,1,3966,2.83264e-05,128135775,0.915185
D.bocki,140010837,461909,1,3965,2.83192e-05,128139740,0.915213
D.bocki,140010837,458387,1,3962,2.82978e-05,128143702,0.915241
D.bocki,140010837,456418,1,3962,2.82978e-05,128147664,0.91527
D.bocki,140010837,459226,1,3960,2.82835e-05,128151624,0.915298
D.bocki,140010837,464588,1,3955,2.82478e-05,128155579,0.915326
D.bocki,140010837,464046,1,3955,2.82478e-05,128159534,0.915354
D.bocki,140010837,459935,1,3953,2.82335e-05,128163487,0.915383
D.bocki,140010837,464271,1,3952,2.82264e-05,128167439,0.915411
D.bocki,140010837,461675,1,3952,2.82264e-05,128171391,0.915439
D.bocki,140010837,463801,1,3951,2.82192e-05,128175342,0.915467
D.bocki,140010837,464173,1,3950,2.82121e-05,128179292,0.915496
D.bocki,140010837,456768,1,3950,2.82121e-05,128183242,0.915524
D.bocki,140010837,78057,1,3949,2.8205e-05,128187191,0.915552
D.bocki,140010837,456304,1,3946,2.81835e-05,128191137,0.91558
D.bocki,140010837,460449,1,3942,2.8155e-05,128195079,0.915608
D.bocki,140010837,458453,1,3940,2.81407e-05,128199019,0.915636
D.bocki,140010837,462387,1,3939,2.81335e-05,128202958,0.915665
D.bocki,140010837,461823,1,3939,2.81335e-05,128206897,0.915693
D.bocki,140010837,460380,1,3936,2.81121e-05,128210833,0.915721
D.bocki,140010837,458806,1,3936,2.81121e-05,128214769,0.915749
D.bocki,140010837,457214,1,3934,2.80978e-05,128218703,0.915777
D.bocki,140010837,460924,1,3931,2.80764e-05,128222634,0.915805
D.bocki,140010837,463242,1,3929,2.80621e-05,128226563,0.915833
D.bocki,140010837,462751,1,3928,2.8055e-05,128230491,0.915861
D.bocki,140010837,457798,1,3928,2.8055e-05,128234419,0.915889
D.bocki,140010837,66885,1,3926,2.80407e-05,128238345,0.915917
D.bocki,140010837,463458,1,3926,2.80407e-05,128242271,0.915945
D.bocki,140010837,5585,1,3925,2.80335e-05,128246196,0.915973
D.bocki,140010837,462130,1,3919,2.79907e-05,128250115,0.916001
D.bocki,140010837,459970,1,3919,2.79907e-05,128254034,0.916029
D.bocki,140010837,461230,1,3918,2.79835e-05,128257952,0.916057
D.bocki,140010837,457159,1,3916,2.79693e-05,128261868,0.916085
D.bocki,140010837,463040,1,3912,2.79407e-05,128265780,0.916113
D.bocki,140010837,460357,1,3911,2.79336e-05,128269691,0.916141
D.bocki,140010837,462949,1,3909,2.79193e-05,128273600,0.916169
D.bocki,140010837,456893,1,3903,2.78764e-05,128277503,0.916197
D.bocki,140010837,464829,1,3899,2.78478e-05,128281402,0.916225
D.bocki,140010837,97806,1,3896,2.78264e-05,128285298,0.916253
D.bocki,140010837,463138,1,3895,2.78193e-05,128289193,0.91628
D.bocki,140010837,456754,1,3895,2.78193e-05,128293088,0.916308
D.bocki,140010837,463590,1,3894,2.78121e-05,128296982,0.916336
D.bocki,140010837,439738,1,3892,2.77978e-05,128300874,0.916364
D.bocki,140010837,459472,1,3888,2.77693e-05,128304762,0.916392
D.bocki,140010837,453364,1,3886,2.7755e-05,128308648,0.916419
D.bocki,140010837,197960,1,3882,2.77264e-05,128312530,0.916447
D.bocki,140010837,461580,1,3879,2.7705e-05,128316409,0.916475
D.bocki,140010837,459307,1,3879,2.7705e-05,128320288,0.916503
D.bocki,140010837,456012,1,3879,2.7705e-05,128324167,0.91653
D.bocki,140010837,460865,1,3877,2.76907e-05,128328044,0.916558
D.bocki,140010837,458093,1,3877,2.76907e-05,128331921,0.916586
D.bocki,140010837,453063,1,3874,2.76693e-05,128335795,0.916613
D.bocki,140010837,456966,1,3870,2.76407e-05,128339665,0.916641
D.bocki,140010837,42718,1,3870,2.76407e-05,128343535,0.916669
D.bocki,140010837,461223,1,3869,2.76336e-05,128347404,0.916696
D.bocki,140010837,463432,1,3868,2.76264e-05,128351272,0.916724
D.bocki,140010837,25677,1,3867,2.76193e-05,128355139,0.916751
D.bocki,140010837,457856,1,3864,2.75979e-05,128359003,0.916779
D.bocki,140010837,42031,1,3862,2.75836e-05,128362865,0.916807
D.bocki,140010837,463529,1,3861,2.75764e-05,128366726,0.916834
D.bocki,140010837,458089,1,3861,2.75764e-05,128370587,0.916862
D.bocki,140010837,461380,1,3853,2.75193e-05,128374440,0.916889
D.bocki,140010837,463779,1,3851,2.7505e-05,128378291,0.916917
D.bocki,140010837,456403,1,3850,2.74979e-05,128382141,0.916944
D.bocki,140010837,456553,1,3848,2.74836e-05,128385989,0.916972
D.bocki,140010837,464052,1,3844,2.7455e-05,128389833,0.916999
D.bocki,140010837,461486,1,3839,2.74193e-05,128393672,0.917027
D.bocki,140010837,460595,1,3839,2.74193e-05,128397511,0.917054
D.bocki,140010837,457671,1,3839,2.74193e-05,128401350,0.917082
D.bocki,140010837,460296,1,3838,2.74122e-05,128405188,0.917109
D.bocki,140010837,461208,1,3837,2.7405e-05,128409025,0.917136
D.bocki,140010837,456876,1,3833,2.73765e-05,128412858,0.917164
D.bocki,140010837,462879,1,3831,2.73622e-05,128416689,0.917191
D.bocki,140010837,458287,1,3831,2.73622e-05,128420520,0.917218
D.bocki,140010837,464055,1,3830,2.7355e-05,128424350,0.917246
D.bocki,140010837,457217,1,3830,2.7355e-05,128428180,0.917273
D.bocki,140010837,463430,1,3827,2.73336e-05,128432007,0.9173
D.bocki,140010837,459739,1,3826,2.73265e-05,128435833,0.917328
D.bocki,140010837,464470,1,3825,2.73193e-05,128439658,0.917355
D.bocki,140010837,457234,1,3821,2.72907e-05,128443479,0.917382
D.bocki,140010837,259238,1,3818,2.72693e-05,128447297,0.91741
D.bocki,140010837,223677,1,3818,2.72693e-05,128451115,0.917437
D.bocki,140010837,461955,1,3816,2.7255e-05,128454931,0.917464
D.bocki,140010837,460999,1,3816,2.7255e-05,128458747,0.917491
D.bocki,140010837,451599,1,3813,2.72336e-05,128462560,0.917519
D.bocki,140010837,463678,1,3807,2.71908e-05,128466367,0.917546
D.bocki,140010837,276819,1,3805,2.71765e-05,128470172,0.917573
D.bocki,140010837,458096,1,3804,2.71693e-05,128473976,0.9176
D.bocki,140010837,462754,1,3799,2.71336e-05,128477775,0.917627
D.bocki,140010837,462900,1,3798,2.71265e-05,128481573,0.917654
D.bocki,140010837,458535,1,3798,2.71265e-05,128485371,0.917682
D.bocki,140010837,461527,1,3795,2.7105e-05,128489166,0.917709
D.bocki,140010837,461283,1,3792,2.70836e-05,128492958,0.917736
D.bocki,140010837,465024,1,3791,2.70765e-05,128496749,0.917763
D.bocki,140010837,462073,1,3791,2.70765e-05,128500540,0.91779
D.bocki,140010837,455836,1,3791,2.70765e-05,128504331,0.917817
D.bocki,140010837,98756,1,3789,2.70622e-05,128508120,0.917844
D.bocki,140010837,457394,1,3788,2.7055e-05,128511908,0.917871
D.bocki,140010837,460870,1,3785,2.70336e-05,128515693,0.917898
D.bocki,140010837,464541,1,3783,2.70193e-05,128519476,0.917925
D.bocki,140010837,459897,1,3782,2.70122e-05,128523258,0.917952
D.bocki,140010837,377239,1,3781,2.70051e-05,128527039,0.917979
D.bocki,140010837,457309,1,3779,2.69908e-05,128530818,0.918006
D.bocki,140010837,278881,1,3768,2.69122e-05,128534586,0.918033
D.bocki,140010837,159601,1,3768,2.69122e-05,128538354,0.91806
D.bocki,140010837,463108,1,3763,2.68765e-05,128542117,0.918087
D.bocki,140010837,386706,1,3762,2.68693e-05,128545879,0.918114
D.bocki,140010837,460749,1,3761,2.68622e-05,128549640,0.918141
D.bocki,140010837,385477,1,3761,2.68622e-05,128553401,0.918168
D.bocki,140010837,461051,1,3759,2.68479e-05,128557160,0.918194
D.bocki,140010837,460372,1,3759,2.68479e-05,128560919,0.918221
D.bocki,140010837,464334,1,3758,2.68408e-05,128564677,0.918248
D.bocki,140010837,460714,1,3755,2.68194e-05,128568432,0.918275
D.bocki,140010837,463462,1,3753,2.68051e-05,128572185,0.918302
D.bocki,140010837,463697,1,3752,2.67979e-05,128575937,0.918328
D.bocki,140010837,456688,1,3752,2.67979e-05,128579689,0.918355
D.bocki,140010837,458086,1,3749,2.67765e-05,128583438,0.918382
D.bocki,140010837,456565,1,3749,2.67765e-05,128587187,0.918409
D.bocki,140010837,457064,1,3747,2.67622e-05,128590934,0.918436
D.bocki,140010837,461597,1,3746,2.67551e-05,128594680,0.918462
D.bocki,140010837,459787,1,3745,2.67479e-05,128598425,0.918489
D.bocki,140010837,464840,1,3742,2.67265e-05,128602167,0.918516
D.bocki,140010837,461236,1,3741,2.67194e-05,128605908,0.918543
D.bocki,140010837,459534,1,3741,2.67194e-05,128609649,0.918569
D.bocki,140010837,458367,1,3741,2.67194e-05,128613390,0.918596
D.bocki,140010837,456835,1,3740,2.67122e-05,128617130,0.918623
D.bocki,140010837,459221,1,3738,2.66979e-05,128620868,0.918649
D.bocki,140010837,464565,1,3733,2.66622e-05,128624601,0.918676
D.bocki,140010837,457295,1,3733,2.66622e-05,128628334,0.918703
D.bocki,140010837,457362,1,3729,2.66337e-05,128632063,0.918729
D.bocki,140010837,462812,1,3728,2.66265e-05,128635791,0.918756
D.bocki,140010837,463481,1,3725,2.66051e-05,128639516,0.918783
D.bocki,140010837,459633,1,3722,2.65837e-05,128643238,0.918809
D.bocki,140010837,460280,1,3720,2.65694e-05,128646958,0.918836
D.bocki,140010837,464546,1,3717,2.65479e-05,128650675,0.918862
D.bocki,140010837,460482,1,3716,2.65408e-05,128654391,0.918889
D.bocki,140010837,403657,1,3716,2.65408e-05,128658107,0.918915
D.bocki,140010837,47822,1,3715,2.65337e-05,128661822,0.918942
D.bocki,140010837,463987,1,3713,2.65194e-05,128665535,0.918968
D.bocki,140010837,458943,1,3713,2.65194e-05,128669248,0.918995
D.bocki,140010837,460721,1,3712,2.65122e-05,128672960,0.919021
D.bocki,140010837,460532,1,3712,2.65122e-05,128676672,0.919048
D.bocki,140010837,457974,1,3711,2.65051e-05,128680383,0.919074
D.bocki,140010837,459395,1,3709,2.64908e-05,128684092,0.919101
D.bocki,140010837,460843,1,3705,2.64622e-05,128687797,0.919127
D.bocki,140010837,456323,1,3704,2.64551e-05,128691501,0.919154
D.bocki,140010837,456202,1,3703,2.6448e-05,128695204,0.91918
D.bocki,140010837,458193,1,3697,2.64051e-05,128698901,0.919207
D.bocki,140010837,459407,1,3687,2.63337e-05,128702588,0.919233
D.bocki,140010837,457166,1,3686,2.63265e-05,128706274,0.919259
D.bocki,140010837,460690,1,3685,2.63194e-05,128709959,0.919286
D.bocki,140010837,457669,1,3685,2.63194e-05,128713644,0.919312
D.bocki,140010837,194394,1,3683,2.63051e-05,128717327,0.919338
D.bocki,140010837,457474,1,3679,2.62765e-05,128721006,0.919365
D.bocki,140010837,460778,1,3676,2.62551e-05,128724682,0.919391
D.bocki,140010837,456422,1,3675,2.6248e-05,128728357,0.919417
D.bocki,140010837,456079,1,3672,2.62265e-05,128732029,0.919443
D.bocki,140010837,457366,1,3671,2.62194e-05,128735700,0.91947
D.bocki,140010837,458307,1,3667,2.61908e-05,128739367,0.919496
D.bocki,140010837,457830,1,3664,2.61694e-05,128743031,0.919522
D.bocki,140010837,458146,1,3663,2.61623e-05,128746694,0.919548
D.bocki,140010837,458017,1,3657,2.61194e-05,128750351,0.919574
D.bocki,140010837,463288,1,3656,2.61123e-05,128754007,0.9196
D.bocki,140010837,456490,1,3655,2.61051e-05,128757662,0.919626
D.bocki,140010837,457011,1,3651,2.60766e-05,128761313,0.919652
D.bocki,140010837,452554,1,3650,2.60694e-05,128764963,0.919679
D.bocki,140010837,459703,1,3646,2.60408e-05,128768609,0.919705
D.bocki,140010837,461630,1,3644,2.60266e-05,128772253,0.919731
D.bocki,140010837,456086,1,3641,2.60051e-05,128775894,0.919757
D.bocki,140010837,457975,1,3639,2.59908e-05,128779533,0.919783
D.bocki,140010837,456837,1,3639,2.59908e-05,128783172,0.919809
D.bocki,140010837,455949,1,3638,2.59837e-05,128786810,0.919835
D.bocki,140010837,458862,1,3634,2.59551e-05,128790444,0.919861
D.bocki,140010837,457553,1,3633,2.5948e-05,128794077,0.919886
D.bocki,140010837,465082,1,3632,2.59408e-05,128797709,0.919912
D.bocki,140010837,458746,1,3630,2.59266e-05,128801339,0.919938
D.bocki,140010837,456846,1,3625,2.58909e-05,128804964,0.919964
D.bocki,140010837,462410,1,3624,2.58837e-05,128808588,0.91999
D.bocki,140010837,462117,1,3623,2.58766e-05,128812211,0.920016
D.bocki,140010837,462848,1,3621,2.58623e-05,128815832,0.920042
D.bocki,140010837,462207,1,3621,2.58623e-05,128819453,0.920068
D.bocki,140010837,460616,1,3618,2.58409e-05,128823071,0.920094
D.bocki,140010837,459418,1,3617,2.58337e-05,128826688,0.920119
D.bocki,140010837,438555,1,3617,2.58337e-05,128830305,0.920145
D.bocki,140010837,463682,1,3613,2.58051e-05,128833918,0.920171
D.bocki,140010837,462721,1,3613,2.58051e-05,128837531,0.920197
D.bocki,140010837,457963,1,3612,2.5798e-05,128841143,0.920223
D.bocki,140010837,456252,1,3609,2.57766e-05,128844752,0.920248
D.bocki,140010837,460457,1,3608,2.57694e-05,128848360,0.920274
D.bocki,140010837,461437,1,3606,2.57551e-05,128851966,0.9203
D.bocki,140010837,457246,1,3605,2.5748e-05,128855571,0.920326
D.bocki,140010837,458988,1,3603,2.57337e-05,128859174,0.920351
D.bocki,140010837,292032,1,3603,2.57337e-05,128862777,0.920377
D.bocki,140010837,463645,1,3599,2.57052e-05,128866376,0.920403
D.bocki,140010837,383774,1,3598,2.5698e-05,128869974,0.920429
D.bocki,140010837,457882,1,3592,2.56552e-05,128873566,0.920454
D.bocki,140010837,463043,1,3591,2.5648e-05,128877157,0.92048
D.bocki,140010837,461307,1,3585,2.56052e-05,128880742,0.920505
D.bocki,140010837,464404,1,3582,2.55837e-05,128884324,0.920531
D.bocki,140010837,460406,1,3582,2.55837e-05,128887906,0.920557
D.bocki,140010837,461744,1,3580,2.55694e-05,128891486,0.920582
D.bocki,140010837,462946,1,3577,2.5548e-05,128895063,0.920608
D.bocki,140010837,456894,1,3577,2.5548e-05,128898640,0.920633
D.bocki,140010837,458001,1,3576,2.55409e-05,128902216,0.920659
D.bocki,140010837,455910,1,3574,2.55266e-05,128905790,0.920684
D.bocki,140010837,463766,1,3568,2.54837e-05,128909358,0.92071
D.bocki,140010837,462045,1,3568,2.54837e-05,128912926,0.920735
D.bocki,140010837,463060,1,3567,2.54766e-05,128916493,0.920761
D.bocki,140010837,422355,1,3560,2.54266e-05,128920053,0.920786
D.bocki,140010837,460594,1,3558,2.54123e-05,128923611,0.920812
D.bocki,140010837,455963,1,3556,2.5398e-05,128927167,0.920837
D.bocki,140010837,464649,1,3555,2.53909e-05,128930722,0.920862
D.bocki,140010837,456617,1,3555,2.53909e-05,128934277,0.920888
D.bocki,140010837,464429,1,3554,2.53837e-05,128937831,0.920913
D.bocki,140010837,459704,1,3553,2.53766e-05,128941384,0.920939
D.bocki,140010837,457171,1,3549,2.5348e-05,128944933,0.920964
D.bocki,140010837,462292,1,3544,2.53123e-05,128948477,0.920989
D.bocki,140010837,462305,1,3542,2.5298e-05,128952019,0.921015
D.bocki,140010837,462165,1,3540,2.52838e-05,128955559,0.92104
D.bocki,140010837,13165,1,3538,2.52695e-05,128959097,0.921065
D.bocki,140010837,463448,1,3535,2.5248e-05,128962632,0.92109
D.bocki,140010837,442546,1,3535,2.5248e-05,128966167,0.921116
D.bocki,140010837,464312,1,3534,2.52409e-05,128969701,0.921141
D.bocki,140010837,461961,1,3534,2.52409e-05,128973235,0.921166
D.bocki,140010837,64605,1,3532,2.52266e-05,128976767,0.921191
D.bocki,140010837,457617,1,3531,2.52195e-05,128980298,0.921217
D.bocki,140010837,457433,1,3529,2.52052e-05,128983827,0.921242
D.bocki,140010837,457784,1,3528,2.5198e-05,128987355,0.921267
D.bocki,140010837,456133,1,3527,2.51909e-05,128990882,0.921292
D.bocki,140010837,462201,1,3524,2.51695e-05,128994406,0.921317
D.bocki,140010837,457338,1,3524,2.51695e-05,128997930,0.921342
D.bocki,140010837,456024,1,3519,2.51338e-05,129001449,0.921368
D.bocki,140010837,455869,1,3518,2.51266e-05,129004967,0.921393
D.bocki,140010837,459801,1,3515,2.51052e-05,129008482,0.921418
D.bocki,140010837,464809,1,3511,2.50766e-05,129011993,0.921443
D.bocki,140010837,456856,1,3509,2.50623e-05,129015502,0.921468
D.bocki,140010837,456849,1,3509,2.50623e-05,129019011,0.921493
D.bocki,140010837,104319,1,3509,2.50623e-05,129022520,0.921518
D.bocki,140010837,460345,1,3504,2.50266e-05,129026024,0.921543
D.bocki,140010837,458871,1,3504,2.50266e-05,129029528,0.921568
D.bocki,140010837,465001,1,3501,2.50052e-05,129033029,0.921593
D.bocki,140010837,459511,1,3501,2.50052e-05,129036530,0.921618
D.bocki,140010837,457558,1,3501,2.50052e-05,129040031,0.921643
D.bocki,140010837,456034,1,3498,2.49838e-05,129043529,0.921668
D.bocki,140010837,456903,1,3497,2.49766e-05,129047026,0.921693
D.bocki,140010837,457944,1,3496,2.49695e-05,129050522,0.921718
D.bocki,140010837,457134,1,3496,2.49695e-05,129054018,0.921743
D.bocki,140010837,460307,1,3495,2.49624e-05,129057513,0.921768
D.bocki,140010837,456479,1,3494,2.49552e-05,129061007,0.921793
D.bocki,140010837,461287,1,3492,2.49409e-05,129064499,0.921818
D.bocki,140010837,457346,1,3492,2.49409e-05,129067991,0.921843
D.bocki,140010837,463789,1,3491,2.49338e-05,129071482,0.921868
D.bocki,140010837,463435,1,3491,2.49338e-05,129074973,0.921893
D.bocki,140010837,52712,1,3488,2.49124e-05,129078461,0.921918
D.bocki,140010837,114565,1,3487,2.49052e-05,129081948,0.921943
D.bocki,140010837,460600,1,3486,2.48981e-05,129085434,0.921967
D.bocki,140010837,462279,1,3485,2.48909e-05,129088919,0.921992
D.bocki,140010837,463310,1,3482,2.48695e-05,129092401,0.922017
D.bocki,140010837,461532,1,3481,2.48624e-05,129095882,0.922042
D.bocki,140010837,460369,1,3481,2.48624e-05,129099363,0.922067
D.bocki,140010837,217953,1,3480,2.48552e-05,129102843,0.922092
D.bocki,140010837,297581,1,3476,2.48266e-05,129106319,0.922117
D.bocki,140010837,457040,1,3475,2.48195e-05,129109794,0.922141
D.bocki,140010837,455997,1,3474,2.48124e-05,129113268,0.922166
D.bocki,140010837,458647,1,3473,2.48052e-05,129116741,0.922191
D.bocki,140010837,459578,1,3471,2.47909e-05,129120212,0.922216
D.bocki,140010837,461651,1,3465,2.47481e-05,129123677,0.922241
D.bocki,140010837,460746,1,3462,2.47267e-05,129127139,0.922265
D.bocki,140010837,464220,1,3459,2.47052e-05,129130598,0.92229
D.bocki,140010837,463117,1,3459,2.47052e-05,129134057,0.922315
D.bocki,140010837,452335,1,3459,2.47052e-05,129137516,0.922339
D.bocki,140010837,463223,1,3458,2.46981e-05,129140974,0.922364
D.bocki,140010837,464962,1,3447,2.46195e-05,129144421,0.922389
D.bocki,140010837,455837,1,3444,2.45981e-05,129147865,0.922413
D.bocki,140010837,462132,1,3443,2.4591e-05,129151308,0.922438
D.bocki,140010837,462038,1,3441,2.45767e-05,129154749,0.922463
D.bocki,140010837,460489,1,3438,2.45552e-05,129158187,0.922487
D.bocki,140010837,458854,1,3438,2.45552e-05,129161625,0.922512
D.bocki,140010837,456043,1,3438,2.45552e-05,129165063,0.922536
D.bocki,140010837,459506,1,3437,2.45481e-05,129168500,0.922561
D.bocki,140010837,461642,1,3434,2.45267e-05,129171934,0.922585
D.bocki,140010837,463527,1,3432,2.45124e-05,129175366,0.92261
D.bocki,140010837,461870,1,3432,2.45124e-05,129178798,0.922634
D.bocki,140010837,456523,1,3432,2.45124e-05,129182230,0.922659
D.bocki,140010837,461360,1,3425,2.44624e-05,129185655,0.922683
D.bocki,140010837,452076,1,3425,2.44624e-05,129189080,0.922708
D.bocki,140010837,463215,1,3423,2.44481e-05,129192503,0.922732
D.bocki,140010837,432949,1,3422,2.4441e-05,129195925,0.922757
D.bocki,140010837,463015,1,3420,2.44267e-05,129199345,0.922781
D.bocki,140010837,459819,1,3420,2.44267e-05,129202765,0.922805
D.bocki,140010837,188007,1,3415,2.4391e-05,129206180,0.92283
D.bocki,140010837,459884,1,3412,2.43695e-05,129209592,0.922854
D.bocki,140010837,41903,1,3412,2.43695e-05,129213004,0.922879
D.bocki,140010837,459287,1,3410,2.43553e-05,129216414,0.922903
D.bocki,140010837,456143,1,3410,2.43553e-05,129219824,0.922927
D.bocki,140010837,460753,1,3408,2.4341e-05,129223232,0.922952
D.bocki,140010837,460949,1,3407,2.43338e-05,129226639,0.922976
D.bocki,140010837,460789,1,3406,2.43267e-05,129230045,0.923
D.bocki,140010837,464853,1,3405,2.43195e-05,129233450,0.923025
D.bocki,140010837,455805,1,3405,2.43195e-05,129236855,0.923049
D.bocki,140010837,460618,1,3404,2.43124e-05,129240259,0.923073
D.bocki,140010837,457046,1,3404,2.43124e-05,129243663,0.923098
D.bocki,140010837,456217,1,3402,2.42981e-05,129247065,0.923122
D.bocki,140010837,457886,1,3401,2.4291e-05,129250466,0.923146
D.bocki,140010837,456409,1,3401,2.4291e-05,129253867,0.92317
D.bocki,140010837,455954,1,3401,2.4291e-05,129257268,0.923195
D.bocki,140010837,462794,1,3398,2.42695e-05,129260666,0.923219
D.bocki,140010837,457033,1,3396,2.42553e-05,129264062,0.923243
D.bocki,140010837,456155,1,3395,2.42481e-05,129267457,0.923268
D.bocki,140010837,462115,1,3393,2.42338e-05,129270850,0.923292
D.bocki,140010837,460493,1,3393,2.42338e-05,129274243,0.923316
D.bocki,140010837,422608,1,3390,2.42124e-05,129277633,0.92334
D.bocki,140010837,461044,1,3387,2.4191e-05,129281020,0.923364
D.bocki,140010837,457029,1,3385,2.41767e-05,129284405,0.923389
D.bocki,140010837,459079,1,3384,2.41696e-05,129287789,0.923413
D.bocki,140010837,322941,1,3384,2.41696e-05,129291173,0.923437
D.bocki,140010837,463311,1,3383,2.41624e-05,129294556,0.923461
D.bocki,140010837,462314,1,3382,2.41553e-05,129297938,0.923485
D.bocki,140010837,462648,1,3376,2.41124e-05,129301314,0.923509
D.bocki,140010837,462351,1,3376,2.41124e-05,129304690,0.923533
D.bocki,140010837,458300,1,3376,2.41124e-05,129308066,0.923558
D.bocki,140010837,462135,1,3373,2.4091e-05,129311439,0.923582
D.bocki,140010837,459373,1,3372,2.40839e-05,129314811,0.923606
D.bocki,140010837,461004,1,3370,2.40696e-05,129318181,0.92363
D.bocki,140010837,462248,1,3369,2.40624e-05,129321550,0.923654
D.bocki,140010837,37251,1,3369,2.40624e-05,129324919,0.923678
D.bocki,140010837,457510,1,3364,2.40267e-05,129328283,0.923702
D.bocki,140010837,461782,1,3363,2.40196e-05,129331646,0.923726
D.bocki,140010837,457197,1,3363,2.40196e-05,129335009,0.92375
D.bocki,140010837,456678,1,3363,2.40196e-05,129338372,0.923774
D.bocki,140010837,67223,1,3362,2.40124e-05,129341734,0.923798
D.bocki,140010837,459733,1,3362,2.40124e-05,129345096,0.923822
D.bocki,140010837,456430,1,3362,2.40124e-05,129348458,0.923846
D.bocki,140010837,464990,1,3361,2.40053e-05,129351819,0.92387
D.bocki,140010837,464225,1,3351,2.39339e-05,129355170,0.923894
D.bocki,140010837,461966,1,3348,2.39124e-05,129358518,0.923918
D.bocki,140010837,462697,1,3336,2.38267e-05,129361854,0.923942
D.bocki,140010837,458583,1,3336,2.38267e-05,129365190,0.923966
D.bocki,140010837,460373,1,3335,2.38196e-05,129368525,0.923989
D.bocki,140010837,461801,1,3334,2.38124e-05,129371859,0.924013
D.bocki,140010837,460104,1,3333,2.38053e-05,129375192,0.924037
D.bocki,140010837,457752,1,3330,2.37839e-05,129378522,0.924061
D.bocki,140010837,458623,1,3326,2.37553e-05,129381848,0.924085
D.bocki,140010837,456721,1,3326,2.37553e-05,129385174,0.924108
D.bocki,140010837,463339,1,3325,2.37482e-05,129388499,0.924132
D.bocki,140010837,463295,1,3319,2.37053e-05,129391818,0.924156
D.bocki,140010837,456922,1,3319,2.37053e-05,129395137,0.924179
D.bocki,140010837,456467,1,3318,2.36982e-05,129398455,0.924203
D.bocki,140010837,456127,1,3318,2.36982e-05,129401773,0.924227
D.bocki,140010837,408754,1,3314,2.36696e-05,129405087,0.924251
D.bocki,140010837,460467,1,3309,2.36339e-05,129408396,0.924274
D.bocki,140010837,452377,1,3309,2.36339e-05,129411705,0.924298
D.bocki,140010837,464226,1,3307,2.36196e-05,129415012,0.924321
D.bocki,140010837,336432,1,3307,2.36196e-05,129418319,0.924345
D.bocki,140010837,463232,1,3306,2.36125e-05,129421625,0.924369
D.bocki,140010837,461528,1,3305,2.36053e-05,129424930,0.924392
D.bocki,140010837,152893,1,3305,2.36053e-05,129428235,0.924416
D.bocki,140010837,457639,1,3303,2.3591e-05,129431538,0.924439
D.bocki,140010837,460448,1,3299,2.35625e-05,129434837,0.924463
D.bocki,140010837,462007,1,3298,2.35553e-05,129438135,0.924487
D.bocki,140010837,460689,1,3298,2.35553e-05,129441433,0.92451
D.bocki,140010837,459408,1,3298,2.35553e-05,129444731,0.924534
D.bocki,140010837,462183,1,3296,2.3541e-05,129448027,0.924557
D.bocki,140010837,322796,1,3293,2.35196e-05,129451320,0.924581
D.bocki,140010837,317595,1,3292,2.35125e-05,129454612,0.924604
D.bocki,140010837,464379,1,3291,2.35053e-05,129457903,0.924628
D.bocki,140010837,461837,1,3291,2.35053e-05,129461194,0.924651
D.bocki,140010837,456509,1,3289,2.3491e-05,129464483,0.924675
D.bocki,140010837,26694,1,3289,2.3491e-05,129467772,0.924698
D.bocki,140010837,462349,1,3288,2.34839e-05,129471060,0.924722
D.bocki,140010837,462734,1,3287,2.34768e-05,129474347,0.924745
D.bocki,140010837,375528,1,3285,2.34625e-05,129477632,0.924769
D.bocki,140010837,457570,1,3284,2.34553e-05,129480916,0.924792
D.bocki,140010837,457713,1,3281,2.34339e-05,129484197,0.924816
D.bocki,140010837,456130,1,3281,2.34339e-05,129487478,0.924839
D.bocki,140010837,456874,1,3280,2.34268e-05,129490758,0.924862
D.bocki,140010837,461072,1,3278,2.34125e-05,129494036,0.924886
D.bocki,140010837,456552,1,3278,2.34125e-05,129497314,0.924909
D.bocki,140010837,458577,1,3277,2.34053e-05,129500591,0.924933
D.bocki,140010837,375384,1,3277,2.34053e-05,129503868,0.924956
D.bocki,140010837,458090,1,3275,2.3391e-05,129507143,0.924979
D.bocki,140010837,420886,1,3275,2.3391e-05,129510418,0.925003
D.bocki,140010837,458461,1,3269,2.33482e-05,129513687,0.925026
D.bocki,140010837,455718,1,3269,2.33482e-05,129516956,0.92505
D.bocki,140010837,464240,1,3268,2.33411e-05,129520224,0.925073
D.bocki,140010837,462265,1,3268,2.33411e-05,129523492,0.925096
D.bocki,140010837,458605,1,3268,2.33411e-05,129526760,0.92512
D.bocki,140010837,456393,1,3268,2.33411e-05,129530028,0.925143
D.bocki,140010837,461646,1,3265,2.33196e-05,129533293,0.925166
D.bocki,140010837,461171,1,3265,2.33196e-05,129536558,0.92519
D.bocki,140010837,462680,1,3263,2.33053e-05,129539821,0.925213
D.bocki,140010837,461233,1,3263,2.33053e-05,129543084,0.925236
D.bocki,140010837,458701,1,3263,2.33053e-05,129546347,0.925259
D.bocki,140010837,461454,1,3261,2.32911e-05,129549608,0.925283
D.bocki,140010837,460140,1,3260,2.32839e-05,129552868,0.925306
D.bocki,140010837,464446,1,3259,2.32768e-05,129556127,0.925329
D.bocki,140010837,455843,1,3259,2.32768e-05,129559386,0.925353
D.bocki,140010837,456664,1,3252,2.32268e-05,129562638,0.925376
D.bocki,140010837,462557,1,3251,2.32196e-05,129565889,0.925399
D.bocki,140010837,458418,1,3251,2.32196e-05,129569140,0.925422
D.bocki,140010837,458550,1,3249,2.32053e-05,129572389,0.925445
D.bocki,140010837,322125,1,3249,2.32053e-05,129575638,0.925469
D.bocki,140010837,461338,1,3246,2.31839e-05,129578884,0.925492
D.bocki,140010837,223000,1,3246,2.31839e-05,129582130,0.925515
D.bocki,140010837,461802,1,3245,2.31768e-05,129585375,0.925538
D.bocki,140010837,457910,1,3244,2.31696e-05,129588619,0.925561
D.bocki,140010837,463971,1,3241,2.31482e-05,129591860,0.925584
D.bocki,140010837,458184,1,3241,2.31482e-05,129595101,0.925608
D.bocki,140010837,458092,1,3241,2.31482e-05,129598342,0.925631
D.bocki,140010837,463522,1,3238,2.31268e-05,129601580,0.925654
D.bocki,140010837,459322,1,3236,2.31125e-05,129604816,0.925677
D.bocki,140010837,25678,1,3230,2.30696e-05,129608046,0.9257
D.bocki,140010837,462167,1,3228,2.30554e-05,129611274,0.925723
D.bocki,140010837,463500,1,3226,2.30411e-05,129614500,0.925746
D.bocki,140010837,338149,1,3226,2.30411e-05,129617726,0.925769
D.bocki,140010837,1645,1,3225,2.30339e-05,129620951,0.925792
D.bocki,140010837,170852,1,3223,2.30196e-05,129624174,0.925815
D.bocki,140010837,462231,1,3220,2.29982e-05,129627394,0.925838
D.bocki,140010837,457804,1,3219,2.29911e-05,129630613,0.925861
D.bocki,140010837,458056,1,3217,2.29768e-05,129633830,0.925884
D.bocki,140010837,455947,1,3217,2.29768e-05,129637047,0.925907
D.bocki,140010837,462645,1,3214,2.29554e-05,129640261,0.92593
D.bocki,140010837,457367,1,3212,2.29411e-05,129643473,0.925953
D.bocki,140010837,218190,1,3210,2.29268e-05,129646683,0.925976
D.bocki,140010837,461209,1,3205,2.28911e-05,129649888,0.925999
D.bocki,140010837,463225,1,3204,2.28839e-05,129653092,0.926022
D.bocki,140010837,462941,1,3203,2.28768e-05,129656295,0.926045
D.bocki,140010837,456785,1,3203,2.28768e-05,129659498,0.926068
D.bocki,140010837,462807,1,3199,2.28482e-05,129662697,0.92609
D.bocki,140010837,455952,1,3199,2.28482e-05,129665896,0.926113
D.bocki,140010837,457968,1,3198,2.28411e-05,129669094,0.926136
D.bocki,140010837,356286,1,3198,2.28411e-05,129672292,0.926159
D.bocki,140010837,460158,1,3197,2.28339e-05,129675489,0.926182
D.bocki,140010837,464175,1,3195,2.28197e-05,129678684,0.926205
D.bocki,140010837,456124,1,3195,2.28197e-05,129681879,0.926227
D.bocki,140010837,462433,1,3191,2.27911e-05,129685070,0.92625
D.bocki,140010837,458167,1,3191,2.27911e-05,129688261,0.926273
D.bocki,140010837,210910,1,3191,2.27911e-05,129691452,0.926296
D.bocki,140010837,170138,1,3190,2.2784e-05,129694642,0.926319
D.bocki,140010837,460851,1,3189,2.27768e-05,129697831,0.926341
D.bocki,140010837,460339,1,3188,2.27697e-05,129701019,0.926364
D.bocki,140010837,458781,1,3187,2.27625e-05,129704206,0.926387
D.bocki,140010837,459192,1,3183,2.2734e-05,129707389,0.92641
D.bocki,140010837,459827,1,3176,2.2684e-05,129710565,0.926432
D.bocki,140010837,458053,1,3176,2.2684e-05,129713741,0.926455
D.bocki,140010837,457484,1,3175,2.26768e-05,129716916,0.926478
D.bocki,140010837,462193,1,3174,2.26697e-05,129720090,0.9265
D.bocki,140010837,463464,1,3173,2.26625e-05,129723263,0.926523
D.bocki,140010837,460671,1,3173,2.26625e-05,129726436,0.926546
D.bocki,140010837,463626,1,3169,2.2634e-05,129729605,0.926568
D.bocki,140010837,456902,1,3164,2.25983e-05,129732769,0.926591
D.bocki,140010837,459890,1,3163,2.25911e-05,129735932,0.926614
D.bocki,140010837,463080,1,3162,2.2584e-05,129739094,0.926636
D.bocki,140010837,458803,1,3161,2.25768e-05,129742255,0.926659
D.bocki,140010837,132167,1,3158,2.25554e-05,129745413,0.926681
D.bocki,140010837,457876,1,3157,2.25483e-05,129748570,0.926704
D.bocki,140010837,452197,1,3152,2.25125e-05,129751722,0.926726
D.bocki,140010837,204756,1,3152,2.25125e-05,129754874,0.926749
D.bocki,140010837,457677,1,3149,2.24911e-05,129758023,0.926771
D.bocki,140010837,457528,1,3147,2.24768e-05,129761170,0.926794
D.bocki,140010837,463338,1,3146,2.24697e-05,129764316,0.926816
D.bocki,140010837,463322,1,3145,2.24625e-05,129767461,0.926839
D.bocki,140010837,447817,1,3143,2.24483e-05,129770604,0.926861
D.bocki,140010837,127745,1,3142,2.24411e-05,129773746,0.926884
D.bocki,140010837,462719,1,3141,2.2434e-05,129776887,0.926906
D.bocki,140010837,460882,1,3141,2.2434e-05,129780028,0.926928
D.bocki,140010837,461399,1,3140,2.24268e-05,129783168,0.926951
D.bocki,140010837,456855,1,3140,2.24268e-05,129786308,0.926973
D.bocki,140010837,457811,1,3139,2.24197e-05,129789447,0.926996
D.bocki,140010837,458955,1,3136,2.23983e-05,129792583,0.927018
D.bocki,140010837,458584,1,3135,2.23911e-05,129795718,0.927041
D.bocki,140010837,411164,1,3134,2.2384e-05,129798852,0.927063
D.bocki,140010837,461121,1,3133,2.23768e-05,129801985,0.927085
D.bocki,140010837,460227,1,3133,2.23768e-05,129805118,0.927108
D.bocki,140010837,464213,1,3127,2.2334e-05,129808245,0.92713
D.bocki,140010837,463071,1,3127,2.2334e-05,129811372,0.927152
D.bocki,140010837,461028,1,3127,2.2334e-05,129814499,0.927175
D.bocki,140010837,456116,1,3123,2.23054e-05,129817622,0.927197
D.bocki,140010837,461113,1,3119,2.22768e-05,129820741,0.927219
D.bocki,140010837,56350,1,3118,2.22697e-05,129823859,0.927242
D.bocki,140010837,457228,1,3118,2.22697e-05,129826977,0.927264
D.bocki,140010837,461174,1,3116,2.22554e-05,129830093,0.927286
D.bocki,140010837,455899,1,3114,2.22411e-05,129833207,0.927308
D.bocki,140010837,464905,1,3113,2.2234e-05,129836320,0.927331
D.bocki,140010837,460341,1,3113,2.2234e-05,129839433,0.927353
D.bocki,140010837,457475,1,3112,2.22269e-05,129842545,0.927375
D.bocki,140010837,460938,1,3111,2.22197e-05,129845656,0.927397
D.bocki,140010837,200875,1,3111,2.22197e-05,129848767,0.927419
D.bocki,140010837,462282,1,3110,2.22126e-05,129851877,0.927442
D.bocki,140010837,456527,1,3110,2.22126e-05,129854987,0.927464
D.bocki,140010837,457093,1,3109,2.22054e-05,129858096,0.927486
D.bocki,140010837,462407,1,3108,2.21983e-05,129861204,0.927508
D.bocki,140010837,465085,1,3106,2.2184e-05,129864310,0.92753
D.bocki,140010837,463539,1,3104,2.21697e-05,129867414,0.927553
D.bocki,140010837,462998,1,3104,2.21697e-05,129870518,0.927575
D.bocki,140010837,2047,1,3103,2.21626e-05,129873621,0.927597
D.bocki,140010837,396077,1,3100,2.21411e-05,129876721,0.927619
D.bocki,140010837,457731,1,3099,2.2134e-05,129879820,0.927641
D.bocki,140010837,461198,1,3097,2.21197e-05,129882917,0.927663
D.bocki,140010837,216511,1,3097,2.21197e-05,129886014,0.927685
D.bocki,140010837,459680,1,3096,2.21126e-05,129889110,0.927708
D.bocki,140010837,462787,1,3095,2.21054e-05,129892205,0.92773
D.bocki,140010837,462404,1,3094,2.20983e-05,129895299,0.927752
D.bocki,140010837,459691,1,3092,2.2084e-05,129898391,0.927774
D.bocki,140010837,457454,1,3092,2.2084e-05,129901483,0.927796
D.bocki,140010837,456180,1,3091,2.20769e-05,129904574,0.927818
D.bocki,140010837,456144,1,3091,2.20769e-05,129907665,0.92784
D.bocki,140010837,455898,1,3091,2.20769e-05,129910756,0.927862
D.bocki,140010837,458308,1,3090,2.20697e-05,129913846,0.927884
D.bocki,140010837,456662,1,3090,2.20697e-05,129916936,0.927906
D.bocki,140010837,455721,1,3089,2.20626e-05,129920025,0.927928
D.bocki,140010837,458052,1,3088,2.20554e-05,129923113,0.92795
D.bocki,140010837,460052,1,3087,2.20483e-05,129926200,0.927972
D.bocki,140010837,457904,1,3087,2.20483e-05,129929287,0.927995
D.bocki,140010837,389933,1,3084,2.20269e-05,129932371,0.928017
D.bocki,140010837,459785,1,3083,2.20197e-05,129935454,0.928039
D.bocki,140010837,402466,1,3083,2.20197e-05,129938537,0.928061
D.bocki,140010837,459111,1,3082,2.20126e-05,129941619,0.928083
D.bocki,140010837,456660,1,3082,2.20126e-05,129944701,0.928105
D.bocki,140010837,462897,1,3080,2.19983e-05,129947781,0.928127
D.bocki,140010837,456879,1,3080,2.19983e-05,129950861,0.928149
D.bocki,140010837,458430,1,3079,2.19912e-05,129953940,0.928171
D.bocki,140010837,455729,1,3079,2.19912e-05,129957019,0.928193
D.bocki,140010837,192904,1,3077,2.19769e-05,129960096,0.928215
D.bocki,140010837,459947,1,3074,2.19554e-05,129963170,0.928237
D.bocki,140010837,459748,1,3074,2.19554e-05,129966244,0.928258
D.bocki,140010837,459393,1,3073,2.19483e-05,129969317,0.92828
D.bocki,140010837,458440,1,3072,2.19412e-05,129972389,0.928302
D.bocki,140010837,457498,1,3072,2.19412e-05,129975461,0.928324
D.bocki,140010837,462247,1,3071,2.1934e-05,129978532,0.928346
D.bocki,140010837,461456,1,3071,2.1934e-05,129981603,0.928368
D.bocki,140010837,457240,1,3071,2.1934e-05,129984674,0.92839
D.bocki,140010837,460880,1,3069,2.19197e-05,129987743,0.928412
D.bocki,140010837,462041,1,3068,2.19126e-05,129990811,0.928434
D.bocki,140010837,285999,1,3068,2.19126e-05,129993879,0.928456
D.bocki,140010837,462800,1,3065,2.18912e-05,129996944,0.928478
D.bocki,140010837,457210,1,3062,2.18697e-05,130000006,0.9285
D.bocki,140010837,461386,1,3056,2.18269e-05,130003062,0.928521
D.bocki,140010837,462182,1,3055,2.18197e-05,130006117,0.928543
D.bocki,140010837,459259,1,3055,2.18197e-05,130009172,0.928565
D.bocki,140010837,423718,1,3054,2.18126e-05,130012226,0.928587
D.bocki,140010837,280211,1,3054,2.18126e-05,130015280,0.928609
D.bocki,140010837,461224,1,3046,2.17555e-05,130018326,0.92863
D.bocki,140010837,459231,1,3046,2.17555e-05,130021372,0.928652
D.bocki,140010837,463143,1,3045,2.17483e-05,130024417,0.928674
D.bocki,140010837,459492,1,3040,2.17126e-05,130027457,0.928696
D.bocki,140010837,461636,1,3039,2.17055e-05,130030496,0.928717
D.bocki,140010837,461232,1,3038,2.16983e-05,130033534,0.928739
D.bocki,140010837,456756,1,3038,2.16983e-05,130036572,0.928761
D.bocki,140010837,459555,1,3036,2.1684e-05,130039608,0.928782
D.bocki,140010837,80548,1,3033,2.16626e-05,130042641,0.928804
D.bocki,140010837,47336,1,3031,2.16483e-05,130045672,0.928826
D.bocki,140010837,461187,1,3031,2.16483e-05,130048703,0.928847
D.bocki,140010837,460623,1,3031,2.16483e-05,130051734,0.928869
D.bocki,140010837,458977,1,3030,2.16412e-05,130054764,0.928891
D.bocki,140010837,462823,1,3029,2.1634e-05,130057793,0.928912
D.bocki,140010837,463048,1,3026,2.16126e-05,130060819,0.928934
D.bocki,140010837,463548,1,3025,2.16055e-05,130063844,0.928956
D.bocki,140010837,440038,1,3025,2.16055e-05,130066869,0.928977
D.bocki,140010837,457323,1,3022,2.1584e-05,130069891,0.928999
D.bocki,140010837,461938,1,3020,2.15698e-05,130072911,0.92902
D.bocki,140010837,457042,1,3020,2.15698e-05,130075931,0.929042
D.bocki,140010837,455817,1,3020,2.15698e-05,130078951,0.929063
D.bocki,140010837,458207,1,3017,2.15483e-05,130081968,0.929085
D.bocki,140010837,460138,1,3016,2.15412e-05,130084984,0.929107
D.bocki,140010837,456261,1,3014,2.15269e-05,130087998,0.929128
D.bocki,140010837,461563,1,3013,2.15198e-05,130091011,0.92915
D.bocki,140010837,458809,1,3013,2.15198e-05,130094024,0.929171
D.bocki,140010837,462127,1,3010,2.14983e-05,130097034,0.929193
D.bocki,140010837,463763,1,3009,2.14912e-05,130100043,0.929214
D.bocki,140010837,462915,1,3008,2.14841e-05,130103051,0.929236
D.bocki,140010837,462402,1,3008,2.14841e-05,130106059,0.929257
D.bocki,140010837,457259,1,3008,2.14841e-05,130109067,0.929279
D.bocki,140010837,456736,1,3008,2.14841e-05,130112075,0.9293
D.bocki,140010837,462627,1,3006,2.14698e-05,130115081,0.929321
D.bocki,140010837,300830,1,3006,2.14698e-05,130118087,0.929343
D.bocki,140010837,459012,1,3004,2.14555e-05,130121091,0.929364
D.bocki,140010837,460763,1,3003,2.14483e-05,130124094,0.929386
D.bocki,140010837,462014,1,2999,2.14198e-05,130127093,0.929407
D.bocki,140010837,463538,1,2997,2.14055e-05,130130090,0.929429
D.bocki,140010837,462058,1,2997,2.14055e-05,130133087,0.92945
D.bocki,140010837,253151,1,2996,2.13983e-05,130136083,0.929472
D.bocki,140010837,461508,1,2995,2.13912e-05,130139078,0.929493
D.bocki,140010837,460010,1,2993,2.13769e-05,130142071,0.929514
D.bocki,140010837,462477,1,2992,2.13698e-05,130145063,0.929536
D.bocki,140010837,456571,1,2987,2.13341e-05,130148050,0.929557
D.bocki,140010837,456275,1,2987,2.13341e-05,130151037,0.929578
D.bocki,140010837,463931,1,2986,2.13269e-05,130154023,0.9296
D.bocki,140010837,459750,1,2984,2.13126e-05,130157007,0.929621
D.bocki,140010837,262636,1,2984,2.13126e-05,130159991,0.929642
D.bocki,140010837,460971,1,2983,2.13055e-05,130162974,0.929664
D.bocki,140010837,463298,1,2982,2.12984e-05,130165956,0.929685
D.bocki,140010837,461672,1,2982,2.12984e-05,130168938,0.929706
D.bocki,140010837,459706,1,2982,2.12984e-05,130171920,0.929727
D.bocki,140010837,462599,1,2979,2.12769e-05,130174899,0.929749
D.bocki,140010837,456341,1,2979,2.12769e-05,130177878,0.92977
D.bocki,140010837,463140,1,2975,2.12484e-05,130180853,0.929791
D.bocki,140010837,456491,1,2973,2.12341e-05,130183826,0.929812
D.bocki,140010837,462470,1,2972,2.12269e-05,130186798,0.929834
D.bocki,140010837,460890,1,2972,2.12269e-05,130189770,0.929855
D.bocki,140010837,458029,1,2970,2.12126e-05,130192740,0.929876
D.bocki,140010837,93048,1,2969,2.12055e-05,130195709,0.929897
D.bocki,140010837,452256,1,2969,2.12055e-05,130198678,0.929919
D.bocki,140010837,456520,1,2967,2.11912e-05,130201645,0.92994
D.bocki,140010837,144640,1,2967,2.11912e-05,130204612,0.929961
D.bocki,140010837,182321,1,2965,2.11769e-05,130207577,0.929982
D.bocki,140010837,457314,1,2964,2.11698e-05,130210541,0.930003
D.bocki,140010837,463092,1,2963,2.11626e-05,130213504,0.930024
D.bocki,140010837,324480,1,2963,2.11626e-05,130216467,0.930046
D.bocki,140010837,463252,1,2962,2.11555e-05,130219429,0.930067
D.bocki,140010837,459095,1,2961,2.11484e-05,130222390,0.930088
D.bocki,140010837,456521,1,2961,2.11484e-05,130225351,0.930109
D.bocki,140010837,458121,1,2957,2.11198e-05,130228308,0.93013
D.bocki,140010837,460825,1,2955,2.11055e-05,130231263,0.930151
D.bocki,140010837,459113,1,2955,2.11055e-05,130234218,0.930172
D.bocki,140010837,462783,1,2954,2.10984e-05,130237172,0.930194
D.bocki,140010837,461866,1,2954,2.10984e-05,130240126,0.930215
D.bocki,140010837,457449,1,2952,2.10841e-05,130243078,0.930236
D.bocki,140010837,460854,1,2951,2.10769e-05,130246029,0.930257
D.bocki,140010837,462194,1,2950,2.10698e-05,130248979,0.930278
D.bocki,140010837,456454,1,2950,2.10698e-05,130251929,0.930299
D.bocki,140010837,460112,1,2948,2.10555e-05,130254877,0.93032
D.bocki,140010837,456524,1,2947,2.10484e-05,130257824,0.930341
D.bocki,140010837,457120,1,2945,2.10341e-05,130260769,0.930362
D.bocki,140010837,459986,1,2944,2.10269e-05,130263713,0.930383
D.bocki,140010837,457753,1,2942,2.10127e-05,130266655,0.930404
D.bocki,140010837,458858,1,2941,2.10055e-05,130269596,0.930425
D.bocki,140010837,461207,1,2940,2.09984e-05,130272536,0.930446
D.bocki,140010837,457928,1,2939,2.09912e-05,130275475,0.930467
D.bocki,140010837,460808,1,2938,2.09841e-05,130278413,0.930488
D.bocki,140010837,456167,1,2938,2.09841e-05,130281351,0.930509
D.bocki,140010837,458830,1,2937,2.09769e-05,130284288,0.93053
D.bocki,140010837,222717,1,2937,2.09769e-05,130287225,0.930551
D.bocki,140010837,461242,1,2936,2.09698e-05,130290161,0.930572
D.bocki,140010837,456345,1,2933,2.09484e-05,130293094,0.930593
D.bocki,140010837,459995,1,2932,2.09412e-05,130296026,0.930614
D.bocki,140010837,460403,1,2929,2.09198e-05,130298955,0.930635
D.bocki,140010837,457586,1,2929,2.09198e-05,130301884,0.930656
D.bocki,140010837,457201,1,2929,2.09198e-05,130304813,0.930677
D.bocki,140010837,463957,1,2928,2.09127e-05,130307741,0.930698
D.bocki,140010837,460504,1,2926,2.08984e-05,130310667,0.930718
D.bocki,140010837,458000,1,2925,2.08912e-05,130313592,0.930739
D.bocki,140010837,462012,1,2923,2.0877e-05,130316515,0.93076
D.bocki,140010837,103837,1,2922,2.08698e-05,130319437,0.930781
D.bocki,140010837,462553,1,2920,2.08555e-05,130322357,0.930802
D.bocki,140010837,456579,1,2919,2.08484e-05,130325276,0.930823
D.bocki,140010837,460248,1,2918,2.08412e-05,130328194,0.930844
D.bocki,140010837,456292,1,2916,2.0827e-05,130331110,0.930864
D.bocki,140010837,458070,1,2912,2.07984e-05,130334022,0.930885
D.bocki,140010837,455970,1,2912,2.07984e-05,130336934,0.930906
D.bocki,140010837,463756,1,2911,2.07912e-05,130339845,0.930927
D.bocki,140010837,456356,1,2910,2.07841e-05,130342755,0.930948
D.bocki,140010837,454595,1,2910,2.07841e-05,130345665,0.930968
D.bocki,140010837,151235,1,2910,2.07841e-05,130348575,0.930989
D.bocki,140010837,458720,1,2907,2.07627e-05,130351482,0.93101
D.bocki,140010837,456702,1,2907,2.07627e-05,130354389,0.931031
D.bocki,140010837,34940,1,2907,2.07627e-05,130357296,0.931051
D.bocki,140010837,463327,1,2905,2.07484e-05,130360201,0.931072
D.bocki,140010837,462442,1,2904,2.07413e-05,130363105,0.931093
D.bocki,140010837,463434,1,2903,2.07341e-05,130366008,0.931114
D.bocki,140010837,455971,1,2903,2.07341e-05,130368911,0.931134
D.bocki,140010837,218050,1,2903,2.07341e-05,130371814,0.931155
D.bocki,140010837,460302,1,2901,2.07198e-05,130374715,0.931176
D.bocki,140010837,455857,1,2900,2.07127e-05,130377615,0.931197
D.bocki,140010837,457935,1,2898,2.06984e-05,130380513,0.931217
D.bocki,140010837,461162,1,2897,2.06913e-05,130383410,0.931238
D.bocki,140010837,461108,1,2893,2.06627e-05,130386303,0.931259
D.bocki,140010837,456316,1,2893,2.06627e-05,130389196,0.931279
D.bocki,140010837,458894,1,2892,2.06555e-05,130392088,0.9313
D.bocki,140010837,459848,1,2891,2.06484e-05,130394979,0.931321
D.bocki,140010837,459436,1,2891,2.06484e-05,130397870,0.931341
D.bocki,140010837,458779,1,2890,2.06413e-05,130400760,0.931362
D.bocki,140010837,459912,1,2889,2.06341e-05,130403649,0.931383
D.bocki,140010837,460067,1,2886,2.06127e-05,130406535,0.931403
D.bocki,140010837,457640,1,2885,2.06055e-05,130409420,0.931424
D.bocki,140010837,457582,1,2884,2.05984e-05,130412304,0.931444
D.bocki,140010837,462985,1,2882,2.05841e-05,130415186,0.931465
D.bocki,140010837,460661,1,2880,2.05698e-05,130418066,0.931486
D.bocki,140010837,461681,1,2879,2.05627e-05,130420945,0.931506
D.bocki,140010837,367932,1,2879,2.05627e-05,130423824,0.931527
D.bocki,140010837,460325,1,2878,2.05556e-05,130426702,0.931547
D.bocki,140010837,461423,1,2877,2.05484e-05,130429579,0.931568
D.bocki,140010837,459683,1,2877,2.05484e-05,130432456,0.931588
D.bocki,140010837,455791,1,2877,2.05484e-05,130435333,0.931609
D.bocki,140010837,460607,1,2875,2.05341e-05,130438208,0.931629
D.bocki,140010837,464612,1,2874,2.0527e-05,130441082,0.93165
D.bocki,140010837,456750,1,2874,2.0527e-05,130443956,0.93167
D.bocki,140010837,460392,1,2873,2.05198e-05,130446829,0.931691
D.bocki,140010837,457375,1,2873,2.05198e-05,130449702,0.931711
D.bocki,140010837,455739,1,2871,2.05056e-05,130452573,0.931732
D.bocki,140010837,356254,1,2871,2.05056e-05,130455444,0.931752
D.bocki,140010837,464252,1,2869,2.04913e-05,130458313,0.931773
D.bocki,140010837,460853,1,2869,2.04913e-05,130461182,0.931793
D.bocki,140010837,458133,1,2869,2.04913e-05,130464051,0.931814
D.bocki,140010837,459814,1,2868,2.04841e-05,130466919,0.931834
D.bocki,140010837,318857,1,2868,2.04841e-05,130469787,0.931855
D.bocki,140010837,463151,1,2867,2.0477e-05,130472654,0.931875
D.bocki,140010837,455897,1,2867,2.0477e-05,130475521,0.931896
D.bocki,140010837,457411,1,2866,2.04698e-05,130478387,0.931916
D.bocki,140010837,458902,1,2865,2.04627e-05,130481252,0.931937
D.bocki,140010837,452137,1,2865,2.04627e-05,130484117,0.931957
D.bocki,140010837,270564,1,2865,2.04627e-05,130486982,0.931978
D.bocki,140010837,460548,1,2864,2.04556e-05,130489846,0.931998
D.bocki,140010837,148423,1,2864,2.04556e-05,130492710,0.932019
D.bocki,140010837,460821,1,2863,2.04484e-05,130495573,0.932039
D.bocki,140010837,458298,1,2863,2.04484e-05,130498436,0.93206
D.bocki,140010837,456818,1,2862,2.04413e-05,130501298,0.93208
D.bocki,140010837,462188,1,2859,2.04198e-05,130504157,0.9321
D.bocki,140010837,457775,1,2856,2.03984e-05,130507013,0.932121
D.bocki,140010837,462684,1,2853,2.0377e-05,130509866,0.932141
D.bocki,140010837,311556,1,2853,2.0377e-05,130512719,0.932162
D.bocki,140010837,462463,1,2849,2.03484e-05,130515568,0.932182
D.bocki,140010837,13167,1,2849,2.03484e-05,130518417,0.932202
D.bocki,140010837,458853,1,2846,2.0327e-05,130521263,0.932223
D.bocki,140010837,460481,1,2844,2.03127e-05,130524107,0.932243
D.bocki,140010837,367618,1,2842,2.02984e-05,130526949,0.932263
D.bocki,140010837,460121,1,2841,2.02913e-05,130529790,0.932283
D.bocki,140010837,234045,1,2840,2.02841e-05,130532630,0.932304
D.bocki,140010837,462822,1,2839,2.0277e-05,130535469,0.932324
D.bocki,140010837,250663,1,2839,2.0277e-05,130538308,0.932344
D.bocki,140010837,459487,1,2837,2.02627e-05,130541145,0.932365
D.bocki,140010837,457041,1,2837,2.02627e-05,130543982,0.932385
D.bocki,140010837,462845,1,2836,2.02556e-05,130546818,0.932405
D.bocki,140010837,462618,1,2832,2.0227e-05,130549650,0.932425
D.bocki,140010837,456891,1,2830,2.02127e-05,130552480,0.932446
D.bocki,140010837,463841,1,2826,2.01842e-05,130555306,0.932466
D.bocki,140010837,459597,1,2826,2.01842e-05,130558132,0.932486
D.bocki,140010837,458002,1,2826,2.01842e-05,130560958,0.932506
D.bocki,140010837,457549,1,2826,2.01842e-05,130563784,0.932526
D.bocki,140010837,460176,1,2825,2.0177e-05,130566609,0.932546
D.bocki,140010837,158945,1,2825,2.0177e-05,130569434,0.932567
D.bocki,140010837,461774,1,2824,2.01699e-05,130572258,0.932587
D.bocki,140010837,456003,1,2824,2.01699e-05,130575082,0.932607
D.bocki,140010837,456375,1,2818,2.0127e-05,130577900,0.932627
D.bocki,140010837,456789,1,2817,2.01199e-05,130580717,0.932647
D.bocki,140010837,458790,1,2816,2.01127e-05,130583533,0.932667
D.bocki,140010837,87314,1,2815,2.01056e-05,130586348,0.932687
D.bocki,140010837,461515,1,2813,2.00913e-05,130589161,0.932708
D.bocki,140010837,462278,1,2811,2.0077e-05,130591972,0.932728
D.bocki,140010837,458956,1,2810,2.00699e-05,130594782,0.932748
D.bocki,140010837,463427,1,2808,2.00556e-05,130597590,0.932768
D.bocki,140010837,462063,1,2807,2.00484e-05,130600397,0.932788
D.bocki,140010837,457427,1,2807,2.00484e-05,130603204,0.932808
D.bocki,140010837,260037,1,2802,2.00127e-05,130606006,0.932828
D.bocki,140010837,462004,1,2801,2.00056e-05,130608807,0.932848
D.bocki,140010837,451654,1,2801,2.00056e-05,130611608,0.932868
D.bocki,140010837,462732,1,2798,1.99842e-05,130614406,0.932888
D.bocki,140010837,461867,1,2796,1.99699e-05,130617202,0.932908
D.bocki,140010837,457780,1,2796,1.99699e-05,130619998,0.932928
D.bocki,140010837,460926,1,2795,1.99627e-05,130622793,0.932948
D.bocki,140010837,457301,1,2794,1.99556e-05,130625587,0.932968
D.bocki,140010837,459256,1,2792,1.99413e-05,130628379,0.932988
D.bocki,140010837,463830,1,2791,1.99342e-05,130631170,0.933008
D.bocki,140010837,460590,1,2790,1.9927e-05,130633960,0.933027
D.bocki,140010837,456992,1,2790,1.9927e-05,130636750,0.933047
D.bocki,140010837,262155,1,2789,1.99199e-05,130639539,0.933067
D.bocki,140010837,458468,1,2787,1.99056e-05,130642326,0.933087
D.bocki,140010837,461800,1,2786,1.98985e-05,130645112,0.933107
D.bocki,140010837,453441,1,2786,1.98985e-05,130647898,0.933127
D.bocki,140010837,462243,1,2782,1.98699e-05,130650680,0.933147
D.bocki,140010837,462033,1,2782,1.98699e-05,130653462,0.933167
D.bocki,140010837,434646,1,2782,1.98699e-05,130656244,0.933187
D.bocki,140010837,460303,1,2781,1.98627e-05,130659025,0.933207
D.bocki,140010837,460088,1,2778,1.98413e-05,130661803,0.933226
D.bocki,140010837,392190,1,2778,1.98413e-05,130664581,0.933246
D.bocki,140010837,457534,1,2776,1.9827e-05,130667357,0.933266
D.bocki,140010837,456189,1,2776,1.9827e-05,130670133,0.933286
D.bocki,140010837,460533,1,2775,1.98199e-05,130672908,0.933306
D.bocki,140010837,461364,1,2773,1.98056e-05,130675681,0.933325
D.bocki,140010837,458281,1,2773,1.98056e-05,130678454,0.933345
D.bocki,140010837,456301,1,2769,1.9777e-05,130681223,0.933365
D.bocki,140010837,462653,1,2765,1.97485e-05,130683988,0.933385
D.bocki,140010837,458703,1,2765,1.97485e-05,130686753,0.933405
D.bocki,140010837,463927,1,2764,1.97413e-05,130689517,0.933424
D.bocki,140010837,131034,1,2764,1.97413e-05,130692281,0.933444
D.bocki,140010837,458769,1,2763,1.97342e-05,130695044,0.933464
D.bocki,140010837,455751,1,2763,1.97342e-05,130697807,0.933484
D.bocki,140010837,460715,1,2762,1.9727e-05,130700569,0.933503
D.bocki,140010837,462815,1,2761,1.97199e-05,130703330,0.933523
D.bocki,140010837,461842,1,2761,1.97199e-05,130706091,0.933543
D.bocki,140010837,457023,1,2761,1.97199e-05,130708852,0.933562
D.bocki,140010837,458119,1,2760,1.97128e-05,130711612,0.933582
D.bocki,140010837,463562,1,2759,1.97056e-05,130714371,0.933602
D.bocki,140010837,461959,1,2759,1.97056e-05,130717130,0.933622
D.bocki,140010837,457614,1,2759,1.97056e-05,130719889,0.933641
D.bocki,140010837,457496,1,2758,1.96985e-05,130722647,0.933661
D.bocki,140010837,456173,1,2758,1.96985e-05,130725405,0.933681
D.bocki,140010837,461166,1,2755,1.9677e-05,130728160,0.9337
D.bocki,140010837,456950,1,2753,1.96628e-05,130730913,0.93372
D.bocki,140010837,463105,1,2752,1.96556e-05,130733665,0.93374
D.bocki,140010837,463291,1,2751,1.96485e-05,130736416,0.933759
D.bocki,140010837,456373,1,2751,1.96485e-05,130739167,0.933779
D.bocki,140010837,457748,1,2750,1.96413e-05,130741917,0.933799
D.bocki,140010837,456114,1,2750,1.96413e-05,130744667,0.933818
D.bocki,140010837,461872,1,2749,1.96342e-05,130747416,0.933838
D.bocki,140010837,407130,1,2749,1.96342e-05,130750165,0.933857
D.bocki,140010837,461853,1,2748,1.96271e-05,130752913,0.933877
D.bocki,140010837,456298,1,2745,1.96056e-05,130755658,0.933897
D.bocki,140010837,461788,1,2744,1.95985e-05,130758402,0.933916
D.bocki,140010837,458721,1,2744,1.95985e-05,130761146,0.933936
D.bocki,140010837,451105,1,2744,1.95985e-05,130763890,0.933955
D.bocki,140010837,461694,1,2743,1.95913e-05,130766633,0.933975
D.bocki,140010837,458338,1,2742,1.95842e-05,130769375,0.933995
D.bocki,140010837,463205,1,2740,1.95699e-05,130772115,0.934014
D.bocki,140010837,460894,1,2738,1.95556e-05,130774853,0.934034
D.bocki,140010837,459040,1,2738,1.95556e-05,130777591,0.934053
D.bocki,140010837,302741,1,2738,1.95556e-05,130780329,0.934073
D.bocki,140010837,463736,1,2735,1.95342e-05,130783064,0.934092
D.bocki,140010837,459076,1,2734,1.95271e-05,130785798,0.934112
D.bocki,140010837,459430,1,2733,1.95199e-05,130788531,0.934131
D.bocki,140010837,459548,1,2732,1.95128e-05,130791263,0.934151
D.bocki,140010837,459264,1,2731,1.95056e-05,130793994,0.934171
D.bocki,140010837,459850,1,2730,1.94985e-05,130796724,0.93419
D.bocki,140010837,455714,1,2730,1.94985e-05,130799454,0.934209
D.bocki,140010837,458130,1,2729,1.94913e-05,130802183,0.934229
D.bocki,140010837,455988,1,2728,1.94842e-05,130804911,0.934248
D.bocki,140010837,462806,1,2725,1.94628e-05,130807636,0.934268
D.bocki,140010837,458351,1,2724,1.94556e-05,130810360,0.934287
D.bocki,140010837,459204,1,2722,1.94414e-05,130813082,0.934307
D.bocki,140010837,461884,1,2721,1.94342e-05,130815803,0.934326
D.bocki,140010837,460554,1,2720,1.94271e-05,130818523,0.934346
D.bocki,140010837,459228,1,2719,1.94199e-05,130821242,0.934365
D.bocki,140010837,160053,1,2719,1.94199e-05,130823961,0.934385
D.bocki,140010837,459791,1,2718,1.94128e-05,130826679,0.934404
D.bocki,140010837,459466,1,2718,1.94128e-05,130829397,0.934423
D.bocki,140010837,456164,1,2718,1.94128e-05,130832115,0.934443
D.bocki,140010837,251841,1,2718,1.94128e-05,130834833,0.934462
D.bocki,140010837,462992,1,2715,1.93914e-05,130837548,0.934482
D.bocki,140010837,462149,1,2715,1.93914e-05,130840263,0.934501
D.bocki,140010837,462568,1,2714,1.93842e-05,130842977,0.93452
D.bocki,140010837,461751,1,2712,1.93699e-05,130845689,0.93454
D.bocki,140010837,462441,1,2710,1.93556e-05,130848399,0.934559
D.bocki,140010837,460005,1,2710,1.93556e-05,130851109,0.934578
D.bocki,140010837,12080,1,2709,1.93485e-05,130853818,0.934598
D.bocki,140010837,93433,1,2707,1.93342e-05,130856525,0.934617
D.bocki,140010837,463346,1,2707,1.93342e-05,130859232,0.934636
D.bocki,140010837,462156,1,2706,1.93271e-05,130861938,0.934656
D.bocki,140010837,460631,1,2706,1.93271e-05,130864644,0.934675
D.bocki,140010837,458945,1,2706,1.93271e-05,130867350,0.934694
D.bocki,140010837,461163,1,2703,1.93056e-05,130870053,0.934714
D.bocki,140010837,460306,1,2703,1.93056e-05,130872756,0.934733
D.bocki,140010837,458754,1,2703,1.93056e-05,130875459,0.934752
D.bocki,140010837,457526,1,2701,1.92914e-05,130878160,0.934772
D.bocki,140010837,456212,1,2700,1.92842e-05,130880860,0.934791
D.bocki,140010837,462661,1,2697,1.92628e-05,130883557,0.93481
D.bocki,140010837,163440,1,2697,1.92628e-05,130886254,0.934829
D.bocki,140010837,462031,1,2695,1.92485e-05,130888949,0.934849
D.bocki,140010837,460178,1,2695,1.92485e-05,130891644,0.934868
D.bocki,140010837,457573,1,2695,1.92485e-05,130894339,0.934887
D.bocki,140010837,456097,1,2694,1.92414e-05,130897033,0.934906
D.bocki,140010837,461518,1,2693,1.92342e-05,130899726,0.934926
D.bocki,140010837,460184,1,2693,1.92342e-05,130902419,0.934945
D.bocki,140010837,333664,1,2693,1.92342e-05,130905112,0.934964
D.bocki,140010837,460831,1,2691,1.92199e-05,130907803,0.934983
D.bocki,140010837,457965,1,2691,1.92199e-05,130910494,0.935003
D.bocki,140010837,456240,1,2690,1.92128e-05,130913184,0.935022
D.bocki,140010837,463253,1,2689,1.92057e-05,130915873,0.935041
D.bocki,140010837,458665,1,2689,1.92057e-05,130918562,0.93506
D.bocki,140010837,455828,1,2689,1.92057e-05,130921251,0.935079
D.bocki,140010837,461393,1,2686,1.91842e-05,130923937,0.935099
D.bocki,140010837,463169,1,2685,1.91771e-05,130926622,0.935118
D.bocki,140010837,362186,1,2685,1.91771e-05,130929307,0.935137
D.bocki,140010837,459087,1,2684,1.91699e-05,130931991,0.935156
D.bocki,140010837,457244,1,2684,1.91699e-05,130934675,0.935175
D.bocki,140010837,456854,1,2684,1.91699e-05,130937359,0.935194
D.bocki,140010837,84765,1,2683,1.91628e-05,130940042,0.935214
D.bocki,140010837,460945,1,2682,1.91557e-05,130942724,0.935233
D.bocki,140010837,458861,1,2681,1.91485e-05,130945405,0.935252
D.bocki,140010837,461029,1,2679,1.91342e-05,130948084,0.935271
D.bocki,140010837,459178,1,2677,1.91199e-05,130950761,0.93529
D.bocki,140010837,458058,1,2677,1.91199e-05,130953438,0.935309
D.bocki,140010837,457972,1,2676,1.91128e-05,130956114,0.935328
D.bocki,140010837,457465,1,2674,1.90985e-05,130958788,0.935348
D.bocki,140010837,464642,1,2673,1.90914e-05,130961461,0.935367
D.bocki,140010837,458747,1,2673,1.90914e-05,130964134,0.935386
D.bocki,140010837,457000,1,2672,1.90842e-05,130966806,0.935405
D.bocki,140010837,129466,1,2672,1.90842e-05,130969478,0.935424
D.bocki,140010837,458768,1,2669,1.90628e-05,130972147,0.935443
D.bocki,140010837,459711,1,2665,1.90342e-05,130974812,0.935462
D.bocki,140010837,456362,1,2665,1.90342e-05,130977477,0.935481
D.bocki,140010837,462619,1,2662,1.90128e-05,130980139,0.9355
D.bocki,140010837,460319,1,2662,1.90128e-05,130982801,0.935519
D.bocki,140010837,456280,1,2661,1.90057e-05,130985462,0.935538
D.bocki,140010837,461841,1,2658,1.89842e-05,130988120,0.935557
D.bocki,140010837,462197,1,2657,1.89771e-05,130990777,0.935576
D.bocki,140010837,390653,1,2657,1.89771e-05,130993434,0.935595
D.bocki,140010837,462854,1,2656,1.897e-05,130996090,0.935614
D.bocki,140010837,457772,1,2655,1.89628e-05,130998745,0.935633
D.bocki,140010837,243445,1,2655,1.89628e-05,131001400,0.935652
D.bocki,140010837,456661,1,2653,1.89485e-05,131004053,0.935671
D.bocki,140010837,463518,1,2651,1.89342e-05,131006704,0.93569
D.bocki,140010837,463201,1,2650,1.89271e-05,131009354,0.935709
D.bocki,140010837,461940,1,2650,1.89271e-05,131012004,0.935728
D.bocki,140010837,457206,1,2649,1.892e-05,131014653,0.935747
D.bocki,140010837,457260,1,2648,1.89128e-05,131017301,0.935765
D.bocki,140010837,458947,1,2645,1.88914e-05,131019946,0.935784
D.bocki,140010837,458643,1,2644,1.88843e-05,131022590,0.935803
D.bocki,140010837,461881,1,2639,1.88485e-05,131025229,0.935822
D.bocki,140010837,458040,1,2639,1.88485e-05,131027868,0.935841
D.bocki,140010837,458883,1,2638,1.88414e-05,131030506,0.93586
D.bocki,140010837,457303,1,2638,1.88414e-05,131033144,0.935879
D.bocki,140010837,463128,1,2634,1.88128e-05,131035778,0.935897
D.bocki,140010837,456147,1,2634,1.88128e-05,131038412,0.935916
D.bocki,140010837,461448,1,2633,1.88057e-05,131041045,0.935935
D.bocki,140010837,459247,1,2633,1.88057e-05,131043678,0.935954
D.bocki,140010837,458330,1,2632,1.87985e-05,131046310,0.935973
D.bocki,140010837,456328,1,2632,1.87985e-05,131048942,0.935991
D.bocki,140010837,460472,1,2631,1.87914e-05,131051573,0.93601
D.bocki,140010837,457913,1,2631,1.87914e-05,131054204,0.936029
D.bocki,140010837,457513,1,2631,1.87914e-05,131056835,0.936048
D.bocki,140010837,460234,1,2630,1.87843e-05,131059465,0.936067
D.bocki,140010837,10216,1,2630,1.87843e-05,131062095,0.936085
D.bocki,140010837,459776,1,2629,1.87771e-05,131064724,0.936104
D.bocki,140010837,457167,1,2629,1.87771e-05,131067353,0.936123
D.bocki,140010837,460379,1,2628,1.877e-05,131069981,0.936142
D.bocki,140010837,197099,1,2625,1.87485e-05,131072606,0.93616
D.bocki,140010837,463292,1,2624,1.87414e-05,131075230,0.936179
D.bocki,140010837,457404,1,2623,1.87343e-05,131077853,0.936198
D.bocki,140010837,232847,1,2623,1.87343e-05,131080476,0.936217
D.bocki,140010837,461719,1,2622,1.87271e-05,131083098,0.936235
D.bocki,140010837,456738,1,2622,1.87271e-05,131085720,0.936254
D.bocki,140010837,86509,1,2621,1.872e-05,131088341,0.936273
D.bocki,140010837,463236,1,2619,1.87057e-05,131090960,0.936292
D.bocki,140010837,460473,1,2619,1.87057e-05,131093579,0.93631
D.bocki,140010837,459630,1,2619,1.87057e-05,131096198,0.936329
D.bocki,140010837,456231,1,2618,1.86986e-05,131098816,0.936348
D.bocki,140010837,462336,1,2617,1.86914e-05,131101433,0.936366
D.bocki,140010837,462512,1,2616,1.86843e-05,131104049,0.936385
D.bocki,140010837,460791,1,2616,1.86843e-05,131106665,0.936404
D.bocki,140010837,460127,1,2614,1.867e-05,131109279,0.936422
D.bocki,140010837,451757,1,2614,1.867e-05,131111893,0.936441
D.bocki,140010837,461385,1,2613,1.86628e-05,131114506,0.93646
D.bocki,140010837,460060,1,2612,1.86557e-05,131117118,0.936478
D.bocki,140010837,456022,1,2612,1.86557e-05,131119730,0.936497
D.bocki,140010837,460790,1,2611,1.86486e-05,131122341,0.936516
D.bocki,140010837,455915,1,2608,1.86271e-05,131124949,0.936534
D.bocki,140010837,461868,1,2604,1.85986e-05,131127553,0.936553
D.bocki,140010837,348350,1,2604,1.85986e-05,131130157,0.936571
D.bocki,140010837,230448,1,2603,1.85914e-05,131132760,0.93659
D.bocki,140010837,458685,1,2602,1.85843e-05,131135362,0.936609
D.bocki,140010837,416402,1,2602,1.85843e-05,131137964,0.936627
D.bocki,140010837,456583,1,2601,1.85771e-05,131140565,0.936646
D.bocki,140010837,228790,1,2601,1.85771e-05,131143166,0.936664
D.bocki,140010837,462675,1,2600,1.857e-05,131145766,0.936683
D.bocki,140010837,208428,1,2598,1.85557e-05,131148364,0.936702
D.bocki,140010837,459312,1,2595,1.85343e-05,131150959,0.93672
D.bocki,140010837,457333,1,2595,1.85343e-05,131153554,0.936739
D.bocki,140010837,462965,1,2594,1.85271e-05,131156148,0.936757
D.bocki,140010837,456578,1,2594,1.85271e-05,131158742,0.936776
D.bocki,140010837,457961,1,2593,1.852e-05,131161335,0.936794
D.bocki,140010837,457204,1,2592,1.85129e-05,131163927,0.936813
D.bocki,140010837,463528,1,2586,1.847e-05,131166513,0.936831
D.bocki,140010837,459356,1,2586,1.847e-05,131169099,0.93685
D.bocki,140010837,461692,1,2583,1.84486e-05,131171682,0.936868
D.bocki,140010837,462480,1,2581,1.84343e-05,131174263,0.936886
D.bocki,140010837,461932,1,2581,1.84343e-05,131176844,0.936905
D.bocki,140010837,456182,1,2580,1.84271e-05,131179424,0.936923
D.bocki,140010837,462862,1,2577,1.84057e-05,131182001,0.936942
D.bocki,140010837,457012,1,2577,1.84057e-05,131184578,0.93696
D.bocki,140010837,461237,1,2576,1.83986e-05,131187154,0.936979
D.bocki,140010837,457579,1,2575,1.83914e-05,131189729,0.936997
D.bocki,140010837,457178,1,2575,1.83914e-05,131192304,0.937015
D.bocki,140010837,460793,1,2573,1.83771e-05,131194877,0.937034
D.bocki,140010837,458435,1,2571,1.83629e-05,131197448,0.937052
D.bocki,140010837,460556,1,2570,1.83557e-05,131200018,0.93707
D.bocki,140010837,456717,1,2570,1.83557e-05,131202588,0.937089
D.bocki,140010837,456629,1,2570,1.83557e-05,131205158,0.937107
D.bocki,140010837,461086,1,2569,1.83486e-05,131207727,0.937126
D.bocki,140010837,456974,1,2569,1.83486e-05,131210296,0.937144
D.bocki,140010837,427647,1,2569,1.83486e-05,131212865,0.937162
D.bocki,140010837,29600,1,2569,1.83486e-05,131215434,0.937181
D.bocki,140010837,462102,1,2567,1.83343e-05,131218001,0.937199
D.bocki,140010837,459311,1,2567,1.83343e-05,131220568,0.937217
D.bocki,140010837,458555,1,2567,1.83343e-05,131223135,0.937236
D.bocki,140010837,456363,1,2567,1.83343e-05,131225702,0.937254
D.bocki,140010837,258099,1,2567,1.83343e-05,131228269,0.937272
D.bocki,140010837,462766,1,2566,1.83272e-05,131230835,0.937291
D.bocki,140010837,459286,1,2566,1.83272e-05,131233401,0.937309
D.bocki,140010837,459347,1,2565,1.832e-05,131235966,0.937327
D.bocki,140010837,417373,1,2565,1.832e-05,131238531,0.937346
D.bocki,140010837,457304,1,2564,1.83129e-05,131241095,0.937364
D.bocki,140010837,463181,1,2562,1.82986e-05,131243657,0.937382
D.bocki,140010837,458373,1,2562,1.82986e-05,131246219,0.9374
D.bocki,140010837,460584,1,2560,1.82843e-05,131248779,0.937419
D.bocki,140010837,257970,1,2560,1.82843e-05,131251339,0.937437
D.bocki,140010837,457838,1,2558,1.827e-05,131253897,0.937455
D.bocki,140010837,459616,1,2557,1.82629e-05,131256454,0.937474
D.bocki,140010837,457818,1,2556,1.82557e-05,131259010,0.937492
D.bocki,140010837,461620,1,2555,1.82486e-05,131261565,0.93751
D.bocki,140010837,459820,1,2552,1.82272e-05,131264117,0.937528
D.bocki,140010837,461963,1,2550,1.82129e-05,131266667,0.937546
D.bocki,140010837,464838,1,2549,1.82057e-05,131269216,0.937565
D.bocki,140010837,460295,1,2548,1.81986e-05,131271764,0.937583
D.bocki,140010837,463543,1,2546,1.81843e-05,131274310,0.937601
D.bocki,140010837,463854,1,2545,1.81772e-05,131276855,0.937619
D.bocki,140010837,460077,1,2545,1.81772e-05,131279400,0.937637
D.bocki,140010837,457420,1,2545,1.81772e-05,131281945,0.937656
D.bocki,140010837,455852,1,2545,1.81772e-05,131284490,0.937674
D.bocki,140010837,461123,1,2543,1.81629e-05,131287033,0.937692
D.bocki,140010837,461855,1,2539,1.81343e-05,131289572,0.93771
D.bocki,140010837,461711,1,2538,1.81272e-05,131292110,0.937728
D.bocki,140010837,462792,1,2536,1.81129e-05,131294646,0.937746
D.bocki,140010837,463549,1,2535,1.81057e-05,131297181,0.937764
D.bocki,140010837,456105,1,2535,1.81057e-05,131299716,0.937783
D.bocki,140010837,19771,1,2533,1.80915e-05,131302249,0.937801
D.bocki,140010837,455821,1,2532,1.80843e-05,131304781,0.937819
D.bocki,140010837,462600,1,2531,1.80772e-05,131307312,0.937837
D.bocki,140010837,461943,1,2530,1.807e-05,131309842,0.937855
D.bocki,140010837,456106,1,2528,1.80557e-05,131312370,0.937873
D.bocki,140010837,455782,1,2527,1.80486e-05,131314897,0.937891
D.bocki,140010837,257134,1,2527,1.80486e-05,131317424,0.937909
D.bocki,140010837,462996,1,2526,1.80415e-05,131319950,0.937927
D.bocki,140010837,461805,1,2526,1.80415e-05,131322476,0.937945
D.bocki,140010837,461431,1,2526,1.80415e-05,131325002,0.937963
D.bocki,140010837,460886,1,2525,1.80343e-05,131327527,0.937981
D.bocki,140010837,460429,1,2525,1.80343e-05,131330052,0.937999
D.bocki,140010837,463447,1,2524,1.80272e-05,131332576,0.938017
D.bocki,140010837,456600,1,2524,1.80272e-05,131335100,0.938035
D.bocki,140010837,462424,1,2523,1.802e-05,131337623,0.938053
D.bocki,140010837,127704,1,2523,1.802e-05,131340146,0.938071
D.bocki,140010837,464176,1,2518,1.79843e-05,131342664,0.938089
D.bocki,140010837,463653,1,2518,1.79843e-05,131345182,0.938107
D.bocki,140010837,462397,1,2518,1.79843e-05,131347700,0.938125
D.bocki,140010837,461139,1,2517,1.79772e-05,131350217,0.938143
D.bocki,140010837,459417,1,2517,1.79772e-05,131352734,0.938161
D.bocki,140010837,460355,1,2516,1.797e-05,131355250,0.938179
D.bocki,140010837,457620,1,2515,1.79629e-05,131357765,0.938197
D.bocki,140010837,464258,1,2514,1.79558e-05,131360279,0.938215
D.bocki,140010837,461390,1,2512,1.79415e-05,131362791,0.938233
D.bocki,140010837,463009,1,2510,1.79272e-05,131365301,0.938251
D.bocki,140010837,461238,1,2510,1.79272e-05,131367811,0.938269
D.bocki,140010837,460153,1,2508,1.79129e-05,131370319,0.938287
D.bocki,140010837,461286,1,2507,1.79058e-05,131372826,0.938305
D.bocki,140010837,461046,1,2507,1.79058e-05,131375333,0.938323
D.bocki,140010837,456979,1,2507,1.79058e-05,131377840,0.938341
D.bocki,140010837,461910,1,2506,1.78986e-05,131380346,0.938358
D.bocki,140010837,461271,1,2505,1.78915e-05,131382851,0.938376
D.bocki,140010837,459210,1,2505,1.78915e-05,131385356,0.938394
D.bocki,140010837,458594,1,2505,1.78915e-05,131387861,0.938412
D.bocki,140010837,456624,1,2505,1.78915e-05,131390366,0.93843
D.bocki,140010837,463193,1,2504,1.78843e-05,131392870,0.938448
D.bocki,140010837,463025,1,2503,1.78772e-05,131395373,0.938466
D.bocki,140010837,190821,1,2503,1.78772e-05,131397876,0.938484
D.bocki,140010837,460245,1,2501,1.78629e-05,131400377,0.938501
D.bocki,140010837,458151,1,2498,1.78415e-05,131402875,0.938519
D.bocki,140010837,456313,1,2497,1.78343e-05,131405372,0.938537
D.bocki,140010837,460580,1,2496,1.78272e-05,131407868,0.938555
D.bocki,140010837,456644,1,2495,1.782e-05,131410363,0.938573
D.bocki,140010837,462631,1,2494,1.78129e-05,131412857,0.938591
D.bocki,140010837,458060,1,2494,1.78129e-05,131415351,0.938608
D.bocki,140010837,457111,1,2491,1.77915e-05,131417842,0.938626
D.bocki,140010837,265315,1,2491,1.77915e-05,131420333,0.938644
D.bocki,140010837,462574,1,2490,1.77843e-05,131422823,0.938662
D.bocki,140010837,461501,1,2488,1.77701e-05,131425311,0.93868
D.bocki,140010837,457330,1,2487,1.77629e-05,131427798,0.938697
D.bocki,140010837,138748,1,2487,1.77629e-05,131430285,0.938715
D.bocki,140010837,457870,1,2486,1.77558e-05,131432771,0.938733
D.bocki,140010837,459326,1,2484,1.77415e-05,131435255,0.938751
D.bocki,140010837,458451,1,2484,1.77415e-05,131437739,0.938768
D.bocki,140010837,456382,1,2484,1.77415e-05,131440223,0.938786
D.bocki,140010837,450970,1,2484,1.77415e-05,131442707,0.938804
D.bocki,140010837,456712,1,2481,1.77201e-05,131445188,0.938822
D.bocki,140010837,455823,1,2481,1.77201e-05,131447669,0.938839
D.bocki,140010837,459319,1,2479,1.77058e-05,131450148,0.938857
D.bocki,140010837,463026,1,2477,1.76915e-05,131452625,0.938875
D.bocki,140010837,455749,1,2475,1.76772e-05,131455100,0.938892
D.bocki,140010837,463251,1,2472,1.76558e-05,131457572,0.93891
D.bocki,140010837,461704,1,2472,1.76558e-05,131460044,0.938928
D.bocki,140010837,462603,1,2471,1.76486e-05,131462515,0.938945
D.bocki,140010837,460604,1,2469,1.76343e-05,131464984,0.938963
D.bocki,140010837,459554,1,2469,1.76343e-05,131467453,0.938981
D.bocki,140010837,458929,1,2469,1.76343e-05,131469922,0.938998
D.bocki,140010837,458774,1,2469,1.76343e-05,131472391,0.939016
D.bocki,140010837,462802,1,2468,1.76272e-05,131474859,0.939033
D.bocki,140010837,459833,1,2468,1.76272e-05,131477327,0.939051
D.bocki,140010837,457916,1,2468,1.76272e-05,131479795,0.939069
D.bocki,140010837,307947,1,2466,1.76129e-05,131482261,0.939086
D.bocki,140010837,460182,1,2465,1.76058e-05,131484726,0.939104
D.bocki,140010837,458882,1,2464,1.75986e-05,131487190,0.939122
D.bocki,140010837,459121,1,2462,1.75844e-05,131489652,0.939139
D.bocki,140010837,456385,1,2462,1.75844e-05,131492114,0.939157
D.bocki,140010837,463889,1,2460,1.75701e-05,131494574,0.939174
D.bocki,140010837,458651,1,2460,1.75701e-05,131497034,0.939192
D.bocki,140010837,86386,1,2459,1.75629e-05,131499493,0.939209
D.bocki,140010837,459615,1,2457,1.75486e-05,131501950,0.939227
D.bocki,140010837,458793,1,2457,1.75486e-05,131504407,0.939244
D.bocki,140010837,457311,1,2455,1.75344e-05,131506862,0.939262
D.bocki,140010837,458765,1,2454,1.75272e-05,131509316,0.93928
D.bocki,140010837,193398,1,2454,1.75272e-05,131511770,0.939297
D.bocki,140010837,461818,1,2453,1.75201e-05,131514223,0.939315
D.bocki,140010837,460433,1,2453,1.75201e-05,131516676,0.939332
D.bocki,140010837,460378,1,2452,1.75129e-05,131519128,0.93935
D.bocki,140010837,456635,1,2452,1.75129e-05,131521580,0.939367
D.bocki,140010837,437094,1,2452,1.75129e-05,131524032,0.939385
D.bocki,140010837,459153,1,2451,1.75058e-05,131526483,0.939402
D.bocki,140010837,458565,1,2451,1.75058e-05,131528934,0.93942
D.bocki,140010837,460694,1,2448,1.74844e-05,131531382,0.939437
D.bocki,140010837,460150,1,2448,1.74844e-05,131533830,0.939455
D.bocki,140010837,457450,1,2448,1.74844e-05,131536278,0.939472
D.bocki,140010837,462125,1,2446,1.74701e-05,131538724,0.93949
D.bocki,140010837,464954,1,2442,1.74415e-05,131541166,0.939507
D.bocki,140010837,461344,1,2442,1.74415e-05,131543608,0.939524
D.bocki,140010837,275257,1,2442,1.74415e-05,131546050,0.939542
D.bocki,140010837,459606,1,2441,1.74344e-05,131548491,0.939559
D.bocki,140010837,461798,1,2439,1.74201e-05,131550930,0.939577
D.bocki,140010837,353083,1,2438,1.74129e-05,131553368,0.939594
D.bocki,140010837,459753,1,2437,1.74058e-05,131555805,0.939612
D.bocki,140010837,462363,1,2435,1.73915e-05,131558240,0.939629
D.bocki,140010837,458425,1,2434,1.73844e-05,131560674,0.939646
D.bocki,140010837,458206,1,2434,1.73844e-05,131563108,0.939664
D.bocki,140010837,458112,1,2432,1.73701e-05,131565540,0.939681
D.bocki,140010837,96860,1,2431,1.73629e-05,131567971,0.939698
D.bocki,140010837,65188,1,2430,1.73558e-05,131570401,0.939716
D.bocki,140010837,457881,1,2428,1.73415e-05,131572829,0.939733
D.bocki,140010837,460402,1,2427,1.73344e-05,131575256,0.939751
D.bocki,140010837,457148,1,2427,1.73344e-05,131577683,0.939768
D.bocki,140010837,461616,1,2426,1.73272e-05,131580109,0.939785
D.bocki,140010837,461558,1,2425,1.73201e-05,131582534,0.939802
D.bocki,140010837,359515,1,2425,1.73201e-05,131584959,0.93982
D.bocki,140010837,46927,1,2423,1.73058e-05,131587382,0.939837
D.bocki,140010837,463075,1,2423,1.73058e-05,131589805,0.939854
D.bocki,140010837,456279,1,2423,1.73058e-05,131592228,0.939872
D.bocki,140010837,239519,1,2422,1.72987e-05,131594650,0.939889
D.bocki,140010837,463410,1,2421,1.72915e-05,131597071,0.939906
D.bocki,140010837,461840,1,2420,1.72844e-05,131599491,0.939924
D.bocki,140010837,462498,1,2417,1.72629e-05,131601908,0.939941
D.bocki,140010837,457997,1,2415,1.72487e-05,131604323,0.939958
D.bocki,140010837,457242,1,2415,1.72487e-05,131606738,0.939975
D.bocki,140010837,457220,1,2411,1.72201e-05,131609149,0.939993
D.bocki,140010837,224675,1,2411,1.72201e-05,131611560,0.94001
D.bocki,140010837,456168,1,2408,1.71987e-05,131613968,0.940027
D.bocki,140010837,456136,1,2408,1.71987e-05,131616376,0.940044
D.bocki,140010837,395859,1,2408,1.71987e-05,131618784,0.940061
D.bocki,140010837,459130,1,2407,1.71915e-05,131621191,0.940079
D.bocki,140010837,403919,1,2407,1.71915e-05,131623598,0.940096
D.bocki,140010837,310411,1,2407,1.71915e-05,131626005,0.940113
D.bocki,140010837,462917,1,2406,1.71844e-05,131628411,0.94013
D.bocki,140010837,457361,1,2405,1.71772e-05,131630816,0.940147
D.bocki,140010837,456056,1,2405,1.71772e-05,131633221,0.940165
D.bocki,140010837,459503,1,2404,1.71701e-05,131635625,0.940182
D.bocki,140010837,456157,1,2404,1.71701e-05,131638029,0.940199
D.bocki,140010837,461628,1,2403,1.7163e-05,131640432,0.940216
D.bocki,140010837,461008,1,2402,1.71558e-05,131642834,0.940233
D.bocki,140010837,457661,1,2402,1.71558e-05,131645236,0.94025
D.bocki,140010837,461106,1,2401,1.71487e-05,131647637,0.940267
D.bocki,140010837,458051,1,2399,1.71344e-05,131650036,0.940285
D.bocki,140010837,459222,1,2396,1.7113e-05,131652432,0.940302
D.bocki,140010837,459959,1,2393,1.70915e-05,131654825,0.940319
D.bocki,140010837,462267,1,2392,1.70844e-05,131657217,0.940336
D.bocki,140010837,461362,1,2392,1.70844e-05,131659609,0.940353
D.bocki,140010837,460036,1,2392,1.70844e-05,131662001,0.94037
D.bocki,140010837,458063,1,2390,1.70701e-05,131664391,0.940387
D.bocki,140010837,462727,1,2389,1.7063e-05,131666780,0.940404
D.bocki,140010837,458477,1,2388,1.70558e-05,131669168,0.940421
D.bocki,140010837,457762,1,2388,1.70558e-05,131671556,0.940438
D.bocki,140010837,390329,1,2386,1.70415e-05,131673942,0.940455
D.bocki,140010837,221912,1,2386,1.70415e-05,131676328,0.940472
D.bocki,140010837,459624,1,2381,1.70058e-05,131678709,0.940489
D.bocki,140010837,457565,1,2381,1.70058e-05,131681090,0.940506
D.bocki,140010837,459073,1,2378,1.69844e-05,131683468,0.940523
D.bocki,140010837,460838,1,2377,1.69773e-05,131685845,0.94054
D.bocki,140010837,457809,1,2377,1.69773e-05,131688222,0.940557
D.bocki,140010837,461654,1,2374,1.69558e-05,131690596,0.940574
D.bocki,140010837,461368,1,2374,1.69558e-05,131692970,0.940591
D.bocki,140010837,463158,1,2373,1.69487e-05,131695343,0.940608
D.bocki,140010837,461609,1,2373,1.69487e-05,131697716,0.940625
D.bocki,140010837,454458,1,2372,1.69415e-05,131700088,0.940642
D.bocki,140010837,97719,1,2369,1.69201e-05,131702457,0.940659
D.bocki,140010837,461012,1,2369,1.69201e-05,131704826,0.940676
D.bocki,140010837,457269,1,2369,1.69201e-05,131707195,0.940693
D.bocki,140010837,456808,1,2369,1.69201e-05,131709564,0.94071
D.bocki,140010837,462300,1,2368,1.6913e-05,131711932,0.940727
D.bocki,140010837,460305,1,2367,1.69058e-05,131714299,0.940744
D.bocki,140010837,457628,1,2366,1.68987e-05,131716665,0.94076
D.bocki,140010837,456834,1,2363,1.68773e-05,131719028,0.940777
D.bocki,140010837,462395,1,2360,1.68558e-05,131721388,0.940794
D.bocki,140010837,455736,1,2359,1.68487e-05,131723747,0.940811
D.bocki,140010837,460393,1,2358,1.68416e-05,131726105,0.940828
D.bocki,140010837,459432,1,2358,1.68416e-05,131728463,0.940845
D.bocki,140010837,457215,1,2358,1.68416e-05,131730821,0.940862
D.bocki,140010837,205129,1,2357,1.68344e-05,131733178,0.940878
D.bocki,140010837,461401,1,2356,1.68273e-05,131735534,0.940895
D.bocki,140010837,456701,1,2356,1.68273e-05,131737890,0.940912
D.bocki,140010837,458380,1,2355,1.68201e-05,131740245,0.940929
D.bocki,140010837,462524,1,2354,1.6813e-05,131742599,0.940946
D.bocki,140010837,463547,1,2352,1.67987e-05,131744951,0.940963
D.bocki,140010837,460458,1,2352,1.67987e-05,131747303,0.940979
D.bocki,140010837,461557,1,2351,1.67916e-05,131749654,0.940996
D.bocki,140010837,458730,1,2349,1.67773e-05,131752003,0.941013
D.bocki,140010837,187398,1,2349,1.67773e-05,131754352,0.94103
D.bocki,140010837,173868,1,2349,1.67773e-05,131756701,0.941046
D.bocki,140010837,456429,1,2347,1.6763e-05,131759048,0.941063
D.bocki,140010837,457370,1,2346,1.67558e-05,131761394,0.94108
D.bocki,140010837,101483,1,2346,1.67558e-05,131763740,0.941097
D.bocki,140010837,457682,1,2345,1.67487e-05,131766085,0.941113
D.bocki,140010837,456623,1,2345,1.67487e-05,131768430,0.94113
D.bocki,140010837,461974,1,2344,1.67416e-05,131770774,0.941147
D.bocki,140010837,455941,1,2342,1.67273e-05,131773116,0.941164
D.bocki,140010837,462747,1,2341,1.67201e-05,131775457,0.94118
D.bocki,140010837,459414,1,2341,1.67201e-05,131777798,0.941197
D.bocki,140010837,458100,1,2341,1.67201e-05,131780139,0.941214
D.bocki,140010837,456722,1,2341,1.67201e-05,131782480,0.941231
D.bocki,140010837,456384,1,2341,1.67201e-05,131784821,0.941247
D.bocki,140010837,463262,1,2340,1.6713e-05,131787161,0.941264
D.bocki,140010837,456253,1,2340,1.6713e-05,131789501,0.941281
D.bocki,140010837,455801,1,2340,1.6713e-05,131791841,0.941297
D.bocki,140010837,455822,1,2338,1.66987e-05,131794179,0.941314
D.bocki,140010837,461808,1,2336,1.66844e-05,131796515,0.941331
D.bocki,140010837,459357,1,2336,1.66844e-05,131798851,0.941347
D.bocki,140010837,456732,1,2336,1.66844e-05,131801187,0.941364
D.bocki,140010837,455814,1,2335,1.66773e-05,131803522,0.941381
D.bocki,140010837,462114,1,2334,1.66701e-05,131805856,0.941398
D.bocki,140010837,461591,1,2334,1.66701e-05,131808190,0.941414
D.bocki,140010837,458843,1,2333,1.6663e-05,131810523,0.941431
D.bocki,140010837,53811,1,2329,1.66344e-05,131812852,0.941447
D.bocki,140010837,460199,1,2328,1.66273e-05,131815180,0.941464
D.bocki,140010837,456268,1,2328,1.66273e-05,131817508,0.941481
D.bocki,140010837,132067,1,2328,1.66273e-05,131819836,0.941497
D.bocki,140010837,458168,1,2327,1.66201e-05,131822163,0.941514
D.bocki,140010837,457693,1,2327,1.66201e-05,131824490,0.941531
D.bocki,140010837,456958,1,2327,1.66201e-05,131826817,0.941547
D.bocki,140010837,253120,1,2327,1.66201e-05,131829144,0.941564
D.bocki,140010837,246850,1,2327,1.66201e-05,131831471,0.94158
D.bocki,140010837,456641,1,2326,1.6613e-05,131833797,0.941597
D.bocki,140010837,457512,1,2325,1.66059e-05,131836122,0.941614
D.bocki,140010837,459486,1,2323,1.65916e-05,131838445,0.94163
D.bocki,140010837,456588,1,2320,1.65701e-05,131840765,0.941647
D.bocki,140010837,462437,1,2319,1.6563e-05,131843084,0.941663
D.bocki,140010837,462099,1,2319,1.6563e-05,131845403,0.94168
D.bocki,140010837,460974,1,2319,1.6563e-05,131847722,0.941697
D.bocki,140010837,460609,1,2318,1.65559e-05,131850040,0.941713
D.bocki,140010837,460166,1,2317,1.65487e-05,131852357,0.94173
D.bocki,140010837,461507,1,2315,1.65344e-05,131854672,0.941746
D.bocki,140010837,462232,1,2314,1.65273e-05,131856986,0.941763
D.bocki,140010837,462089,1,2314,1.65273e-05,131859300,0.941779
D.bocki,140010837,456388,1,2314,1.65273e-05,131861614,0.941796
D.bocki,140010837,456186,1,2312,1.6513e-05,131863926,0.941812
D.bocki,140010837,462163,1,2311,1.65059e-05,131866237,0.941829
D.bocki,140010837,461451,1,2311,1.65059e-05,131868548,0.941845
D.bocki,140010837,459211,1,2311,1.65059e-05,131870859,0.941862
D.bocki,140010837,460175,1,2310,1.64987e-05,131873169,0.941878
D.bocki,140010837,458844,1,2308,1.64844e-05,131875477,0.941895
D.bocki,140010837,458796,1,2308,1.64844e-05,131877785,0.941911
D.bocki,140010837,462896,1,2307,1.64773e-05,131880092,0.941928
D.bocki,140010837,457084,1,2307,1.64773e-05,131882399,0.941944
D.bocki,140010837,454097,1,2306,1.64702e-05,131884705,0.941961
D.bocki,140010837,461877,1,2305,1.6463e-05,131887010,0.941977
D.bocki,140010837,459866,1,2305,1.6463e-05,131889315,0.941994
D.bocki,140010837,457262,1,2305,1.6463e-05,131891620,0.94201
D.bocki,140010837,461110,1,2302,1.64416e-05,131893922,0.942027
D.bocki,140010837,460109,1,2302,1.64416e-05,131896224,0.942043
D.bocki,140010837,456850,1,2302,1.64416e-05,131898526,0.942059
D.bocki,140010837,459678,1,2301,1.64344e-05,131900827,0.942076
D.bocki,140010837,462158,1,2300,1.64273e-05,131903127,0.942092
D.bocki,140010837,283794,1,2300,1.64273e-05,131905427,0.942109
D.bocki,140010837,459817,1,2298,1.6413e-05,131907725,0.942125
D.bocki,140010837,324155,1,2297,1.64059e-05,131910022,0.942142
D.bocki,140010837,462583,1,2296,1.63987e-05,131912318,0.942158
D.bocki,140010837,458455,1,2296,1.63987e-05,131914614,0.942174
D.bocki,140010837,266409,1,2295,1.63916e-05,131916909,0.942191
D.bocki,140010837,456833,1,2294,1.63844e-05,131919203,0.942207
D.bocki,140010837,457280,1,2293,1.63773e-05,131921496,0.942223
D.bocki,140010837,456549,1,2293,1.63773e-05,131923789,0.94224
D.bocki,140010837,458648,1,2292,1.63702e-05,131926081,0.942256
D.bocki,140010837,457924,1,2292,1.63702e-05,131928373,0.942273
D.bocki,140010837,268557,1,2292,1.63702e-05,131930665,0.942289
D.bocki,140010837,458432,1,2291,1.6363e-05,131932956,0.942305
D.bocki,140010837,460409,1,2289,1.63487e-05,131935245,0.942322
D.bocki,140010837,459155,1,2289,1.63487e-05,131937534,0.942338
D.bocki,140010837,458912,1,2289,1.63487e-05,131939823,0.942354
D.bocki,140010837,456059,1,2289,1.63487e-05,131942112,0.942371
D.bocki,140010837,462394,1,2286,1.63273e-05,131944398,0.942387
D.bocki,140010837,459412,1,2285,1.63202e-05,131946683,0.942403
D.bocki,140010837,462453,1,2282,1.62987e-05,131948965,0.94242
D.bocki,140010837,461327,1,2282,1.62987e-05,131951247,0.942436
D.bocki,140010837,456590,1,2282,1.62987e-05,131953529,0.942452
D.bocki,140010837,462409,1,2280,1.62845e-05,131955809,0.942469
D.bocki,140010837,457007,1,2275,1.62487e-05,131958084,0.942485
D.bocki,140010837,234192,1,2275,1.62487e-05,131960359,0.942501
D.bocki,140010837,457774,1,2274,1.62416e-05,131962633,0.942517
D.bocki,140010837,403977,1,2274,1.62416e-05,131964907,0.942534
D.bocki,140010837,456707,1,2271,1.62202e-05,131967178,0.94255
D.bocki,140010837,461891,1,2270,1.6213e-05,131969448,0.942566
D.bocki,140010837,28298,1,2269,1.62059e-05,131971717,0.942582
D.bocki,140010837,462491,1,2267,1.61916e-05,131973984,0.942598
D.bocki,140010837,461689,1,2267,1.61916e-05,131976251,0.942615
D.bocki,140010837,457254,1,2267,1.61916e-05,131978518,0.942631
D.bocki,140010837,462015,1,2266,1.61845e-05,131980784,0.942647
D.bocki,140010837,461150,1,2266,1.61845e-05,131983050,0.942663
D.bocki,140010837,456015,1,2265,1.61773e-05,131985315,0.942679
D.bocki,140010837,274247,1,2265,1.61773e-05,131987580,0.942695
D.bocki,140010837,461605,1,2264,1.61702e-05,131989844,0.942712
D.bocki,140010837,459026,1,2263,1.6163e-05,131992107,0.942728
D.bocki,140010837,458022,1,2263,1.6163e-05,131994370,0.942744
D.bocki,140010837,463191,1,2260,1.61416e-05,131996630,0.94276
D.bocki,140010837,460835,1,2260,1.61416e-05,131998890,0.942776
D.bocki,140010837,457871,1,2259,1.61345e-05,132001149,0.942792
D.bocki,140010837,461483,1,2258,1.61273e-05,132003407,0.942808
D.bocki,140010837,359011,1,2258,1.61273e-05,132005665,0.942825
D.bocki,140010837,461546,1,2255,1.61059e-05,132007920,0.942841
D.bocki,140010837,460859,1,2255,1.61059e-05,132010175,0.942857
D.bocki,140010837,354878,1,2255,1.61059e-05,132012430,0.942873
D.bocki,140010837,461879,1,2254,1.60988e-05,132014684,0.942889
D.bocki,140010837,56448,1,2253,1.60916e-05,132016937,0.942905
D.bocki,140010837,462797,1,2253,1.60916e-05,132019190,0.942921
D.bocki,140010837,461460,1,2252,1.60845e-05,132021442,0.942937
D.bocki,140010837,458288,1,2251,1.60773e-05,132023693,0.942953
D.bocki,140010837,463554,1,2249,1.6063e-05,132025942,0.942969
D.bocki,140010837,280742,1,2249,1.6063e-05,132028191,0.942986
D.bocki,140010837,460496,1,2248,1.60559e-05,132030439,0.943002
D.bocki,140010837,457320,1,2248,1.60559e-05,132032687,0.943018
D.bocki,140010837,458606,1,2247,1.60488e-05,132034934,0.943034
D.bocki,140010837,457548,1,2245,1.60345e-05,132037179,0.94305
D.bocki,140010837,456805,1,2245,1.60345e-05,132039424,0.943066
D.bocki,140010837,459169,1,2244,1.60273e-05,132041668,0.943082
D.bocki,140010837,456762,1,2244,1.60273e-05,132043912,0.943098
D.bocki,140010837,458261,1,2243,1.60202e-05,132046155,0.943114
D.bocki,140010837,459010,1,2242,1.6013e-05,132048397,0.94313
D.bocki,140010837,458134,1,2240,1.59988e-05,132050637,0.943146
D.bocki,140010837,458188,1,2239,1.59916e-05,132052876,0.943162
D.bocki,140010837,457950,1,2239,1.59916e-05,132055115,0.943178
D.bocki,140010837,456072,1,2239,1.59916e-05,132057354,0.943194
D.bocki,140010837,460157,1,2238,1.59845e-05,132059592,0.94321
D.bocki,140010837,457502,1,2238,1.59845e-05,132061830,0.943226
D.bocki,140010837,456380,1,2238,1.59845e-05,132064068,0.943242
D.bocki,140010837,456054,1,2237,1.59773e-05,132066305,0.943258
D.bocki,140010837,462365,1,2235,1.59631e-05,132068540,0.943274
D.bocki,140010837,459170,1,2234,1.59559e-05,132070774,0.94329
D.bocki,140010837,462561,1,2232,1.59416e-05,132073006,0.943306
D.bocki,140010837,292469,1,2232,1.59416e-05,132075238,0.943322
D.bocki,140010837,462936,1,2230,1.59273e-05,132077468,0.943337
D.bocki,140010837,460669,1,2230,1.59273e-05,132079698,0.943353
D.bocki,140010837,460030,1,2230,1.59273e-05,132081928,0.943369
D.bocki,140010837,458815,1,2230,1.59273e-05,132084158,0.943385
D.bocki,140010837,463385,1,2229,1.59202e-05,132086387,0.943401
D.bocki,140010837,459604,1,2229,1.59202e-05,132088616,0.943417
D.bocki,140010837,459527,1,2227,1.59059e-05,132090843,0.943433
D.bocki,140010837,1619,1,2221,1.58631e-05,132093064,0.943449
D.bocki,140010837,462953,1,2220,1.58559e-05,132095284,0.943465
D.bocki,140010837,462972,1,2218,1.58416e-05,132097502,0.943481
D.bocki,140010837,460830,1,2218,1.58416e-05,132099720,0.943496
D.bocki,140010837,461847,1,2217,1.58345e-05,132101937,0.943512
D.bocki,140010837,460932,1,2217,1.58345e-05,132104154,0.943528
D.bocki,140010837,458888,1,2216,1.58273e-05,132106370,0.943544
D.bocki,140010837,71599,1,2212,1.57988e-05,132108582,0.94356
D.bocki,140010837,461202,1,2212,1.57988e-05,132110794,0.943575
D.bocki,140010837,458934,1,2212,1.57988e-05,132113006,0.943591
D.bocki,140010837,462767,1,2210,1.57845e-05,132115216,0.943607
D.bocki,140010837,458484,1,2210,1.57845e-05,132117426,0.943623
D.bocki,140010837,457945,1,2210,1.57845e-05,132119636,0.943639
D.bocki,140010837,461887,1,2209,1.57774e-05,132121845,0.943654
D.bocki,140010837,461193,1,2209,1.57774e-05,132124054,0.94367
D.bocki,140010837,459208,1,2209,1.57774e-05,132126263,0.943686
D.bocki,140010837,457909,1,2209,1.57774e-05,132128472,0.943702
D.bocki,140010837,396334,1,2209,1.57774e-05,132130681,0.943718
D.bocki,140010837,456230,1,2207,1.57631e-05,132132888,0.943733
D.bocki,140010837,458431,1,2206,1.57559e-05,132135094,0.943749
D.bocki,140010837,461843,1,2205,1.57488e-05,132137299,0.943765
D.bocki,140010837,463475,1,2203,1.57345e-05,132139502,0.943781
D.bocki,140010837,458139,1,2203,1.57345e-05,132141705,0.943796
D.bocki,140010837,458859,1,2202,1.57274e-05,132143907,0.943812
D.bocki,140010837,176534,1,2202,1.57274e-05,132146109,0.943828
D.bocki,140010837,461184,1,2199,1.57059e-05,132148308,0.943843
D.bocki,140010837,459512,1,2199,1.57059e-05,132150507,0.943859
D.bocki,140010837,455772,1,2199,1.57059e-05,132152706,0.943875
D.bocki,140010837,458649,1,2197,1.56916e-05,132154903,0.943891
D.bocki,140010837,421058,1,2196,1.56845e-05,132157099,0.943906
D.bocki,140010837,460207,1,2194,1.56702e-05,132159293,0.943922
D.bocki,140010837,458363,1,2194,1.56702e-05,132161487,0.943938
D.bocki,140010837,457190,1,2194,1.56702e-05,132163681,0.943953
D.bocki,140010837,62563,1,2192,1.56559e-05,132165873,0.943969
D.bocki,140010837,462333,1,2192,1.56559e-05,132168065,0.943985
D.bocki,140010837,452436,1,2192,1.56559e-05,132170257,0.944
D.bocki,140010837,463220,1,2191,1.56488e-05,132172448,0.944016
D.bocki,140010837,456359,1,2186,1.56131e-05,132174634,0.944031
D.bocki,140010837,397010,1,2186,1.56131e-05,132176820,0.944047
D.bocki,140010837,458232,1,2185,1.56059e-05,132179005,0.944063
D.bocki,140010837,460873,1,2184,1.55988e-05,132181189,0.944078
D.bocki,140010837,461340,1,2183,1.55917e-05,132183372,0.944094
D.bocki,140010837,455832,1,2183,1.55917e-05,132185555,0.944109
D.bocki,140010837,346485,1,2182,1.55845e-05,132187737,0.944125
D.bocki,140010837,461298,1,2181,1.55774e-05,132189918,0.944141
D.bocki,140010837,458938,1,2181,1.55774e-05,132192099,0.944156
D.bocki,140010837,457604,1,2178,1.55559e-05,132194277,0.944172
D.bocki,140010837,95376,1,2177,1.55488e-05,132196454,0.944187
D.bocki,140010837,456115,1,2177,1.55488e-05,132198631,0.944203
D.bocki,140010837,460571,1,2176,1.55417e-05,132200807,0.944218
D.bocki,140010837,459735,1,2175,1.55345e-05,132202982,0.944234
D.bocki,140010837,458857,1,2175,1.55345e-05,132205157,0.944249
D.bocki,140010837,252312,1,2173,1.55202e-05,132207330,0.944265
D.bocki,140010837,460525,1,2172,1.55131e-05,132209502,0.94428
D.bocki,140010837,460857,1,2171,1.55059e-05,132211673,0.944296
D.bocki,140010837,459239,1,2171,1.55059e-05,132213844,0.944312
D.bocki,140010837,459805,1,2170,1.54988e-05,132216014,0.944327
D.bocki,140010837,459584,1,2170,1.54988e-05,132218184,0.944343
D.bocki,140010837,459399,1,2168,1.54845e-05,132220352,0.944358
D.bocki,140010837,458923,1,2166,1.54702e-05,132222518,0.944373
D.bocki,140010837,458044,1,2166,1.54702e-05,132224684,0.944389
D.bocki,140010837,459869,1,2165,1.54631e-05,132226849,0.944404
D.bocki,140010837,350833,1,2165,1.54631e-05,132229014,0.94442
D.bocki,140010837,27433,1,2164,1.54559e-05,132231178,0.944435
D.bocki,140010837,459154,1,2162,1.54417e-05,132233340,0.944451
D.bocki,140010837,458485,1,2162,1.54417e-05,132235502,0.944466
D.bocki,140010837,460420,1,2160,1.54274e-05,132237662,0.944482
D.bocki,140010837,456682,1,2160,1.54274e-05,132239822,0.944497
D.bocki,140010837,460802,1,2159,1.54202e-05,132241981,0.944512
D.bocki,140010837,456727,1,2159,1.54202e-05,132244140,0.944528
D.bocki,140010837,458212,1,2158,1.54131e-05,132246298,0.944543
D.bocki,140010837,459552,1,2157,1.5406e-05,132248455,0.944559
D.bocki,140010837,462001,1,2156,1.53988e-05,132250611,0.944574
D.bocki,140010837,457087,1,2156,1.53988e-05,132252767,0.94459
D.bocki,140010837,458802,1,2155,1.53917e-05,132254922,0.944605
D.bocki,140010837,456742,1,2155,1.53917e-05,132257077,0.94462
D.bocki,140010837,458653,1,2154,1.53845e-05,132259231,0.944636
D.bocki,140010837,457274,1,2154,1.53845e-05,132261385,0.944651
D.bocki,140010837,456223,1,2154,1.53845e-05,132263539,0.944666
D.bocki,140010837,221064,1,2154,1.53845e-05,132265693,0.944682
D.bocki,140010837,459323,1,2152,1.53702e-05,132267845,0.944697
D.bocki,140010837,458283,1,2151,1.53631e-05,132269996,0.944713
D.bocki,140010837,460966,1,2149,1.53488e-05,132272145,0.944728
D.bocki,140010837,460900,1,2149,1.53488e-05,132274294,0.944743
D.bocki,140010837,460500,1,2149,1.53488e-05,132276443,0.944759
D.bocki,140010837,456807,1,2149,1.53488e-05,132278592,0.944774
D.bocki,140010837,459086,1,2148,1.53417e-05,132280740,0.944789
D.bocki,140010837,362394,1,2148,1.53417e-05,132282888,0.944805
D.bocki,140010837,462360,1,2147,1.53345e-05,132285035,0.94482
D.bocki,140010837,462307,1,2146,1.53274e-05,132287181,0.944835
D.bocki,140010837,420950,1,2146,1.53274e-05,132289327,0.944851
D.bocki,140010837,454468,1,2145,1.53202e-05,132291472,0.944866
D.bocki,140010837,458704,1,2144,1.53131e-05,132293616,0.944881
D.bocki,140010837,456462,1,2144,1.53131e-05,132295760,0.944897
D.bocki,140010837,455922,1,2144,1.53131e-05,132297904,0.944912
D.bocki,140010837,459954,1,2143,1.5306e-05,132300047,0.944927
D.bocki,140010837,460253,1,2142,1.52988e-05,132302189,0.944942
D.bocki,140010837,458346,1,2142,1.52988e-05,132304331,0.944958
D.bocki,140010837,463156,1,2141,1.52917e-05,132306472,0.944973
D.bocki,140010837,459041,1,2141,1.52917e-05,132308613,0.944988
D.bocki,140010837,462157,1,2140,1.52845e-05,132310753,0.945004
D.bocki,140010837,460977,1,2140,1.52845e-05,132312893,0.945019
D.bocki,140010837,248200,1,2140,1.52845e-05,132315033,0.945034
D.bocki,140010837,458863,1,2138,1.52702e-05,132317171,0.945049
D.bocki,140010837,458081,1,2138,1.52702e-05,132319309,0.945065
D.bocki,140010837,461089,1,2137,1.52631e-05,132321446,0.94508
D.bocki,140010837,461752,1,2136,1.5256e-05,132323582,0.945095
D.bocki,140010837,461746,1,2136,1.5256e-05,132325718,0.945111
D.bocki,140010837,456597,1,2136,1.5256e-05,132327854,0.945126
D.bocki,140010837,458875,1,2135,1.52488e-05,132329989,0.945141
D.bocki,140010837,456793,1,2134,1.52417e-05,132332123,0.945156
D.bocki,140010837,459992,1,2133,1.52345e-05,132334256,0.945172
D.bocki,140010837,457547,1,2131,1.52203e-05,132336387,0.945187
D.bocki,140010837,461817,1,2130,1.52131e-05,132338517,0.945202
D.bocki,140010837,459975,1,2130,1.52131e-05,132340647,0.945217
D.bocki,140010837,458890,1,2128,1.51988e-05,132342775,0.945232
D.bocki,140010837,457432,1,2128,1.51988e-05,132344903,0.945248
D.bocki,140010837,462036,1,2126,1.51845e-05,132347029,0.945263
D.bocki,140010837,135239,1,2126,1.51845e-05,132349155,0.945278
D.bocki,140010837,459894,1,2124,1.51703e-05,132351279,0.945293
D.bocki,140010837,463468,1,2123,1.51631e-05,132353402,0.945308
D.bocki,140010837,463083,1,2123,1.51631e-05,132355525,0.945323
D.bocki,140010837,461831,1,2123,1.51631e-05,132357648,0.945339
D.bocki,140010837,459757,1,2123,1.51631e-05,132359771,0.945354
D.bocki,140010837,462906,1,2122,1.5156e-05,132361893,0.945369
D.bocki,140010837,460643,1,2121,1.51488e-05,132364014,0.945384
D.bocki,140010837,460084,1,2121,1.51488e-05,132366135,0.945399
D.bocki,140010837,464215,1,2120,1.51417e-05,132368255,0.945414
D.bocki,140010837,462475,1,2120,1.51417e-05,132370375,0.945429
D.bocki,140010837,460632,1,2120,1.51417e-05,132372495,0.945445
D.bocki,140010837,459906,1,2120,1.51417e-05,132374615,0.94546
D.bocki,140010837,462530,1,2119,1.51345e-05,132376734,0.945475
D.bocki,140010837,457817,1,2119,1.51345e-05,132378853,0.94549
D.bocki,140010837,457634,1,2117,1.51203e-05,132380970,0.945505
D.bocki,140010837,462493,1,2115,1.5106e-05,132383085,0.94552
D.bocki,140010837,459878,1,2115,1.5106e-05,132385200,0.945535
D.bocki,140010837,459521,1,2115,1.5106e-05,132387315,0.94555
D.bocki,140010837,463164,1,2112,1.50845e-05,132389427,0.945566
D.bocki,140010837,462562,1,2112,1.50845e-05,132391539,0.945581
D.bocki,140010837,461720,1,2110,1.50703e-05,132393649,0.945596
D.bocki,140010837,460583,1,2110,1.50703e-05,132395759,0.945611
D.bocki,140010837,461875,1,2109,1.50631e-05,132397868,0.945626
D.bocki,140010837,458311,1,2109,1.50631e-05,132399977,0.945641
D.bocki,140010837,456989,1,2108,1.5056e-05,132402085,0.945656
D.bocki,140010837,182431,1,2108,1.5056e-05,132404193,0.945671
D.bocki,140010837,459648,1,2104,1.50274e-05,132406297,0.945686
D.bocki,140010837,461424,1,2103,1.50203e-05,132408400,0.945701
D.bocki,140010837,458317,1,2103,1.50203e-05,132410503,0.945716
D.bocki,140010837,458160,1,2103,1.50203e-05,132412606,0.945731
D.bocki,140010837,458028,1,2100,1.49988e-05,132414706,0.945746
D.bocki,140010837,456120,1,2100,1.49988e-05,132416806,0.945761
D.bocki,140010837,212744,1,2100,1.49988e-05,132418906,0.945776
D.bocki,140010837,96932,1,2099,1.49917e-05,132421005,0.945791
D.bocki,140010837,463530,1,2099,1.49917e-05,132423104,0.945806
D.bocki,140010837,459745,1,2099,1.49917e-05,132425203,0.945821
D.bocki,140010837,459605,1,2099,1.49917e-05,132427302,0.945836
D.bocki,140010837,454525,1,2099,1.49917e-05,132429401,0.945851
D.bocki,140010837,459460,1,2097,1.49774e-05,132431498,0.945866
D.bocki,140010837,457092,1,2094,1.4956e-05,132433592,0.945881
D.bocki,140010837,406974,1,2094,1.4956e-05,132435686,0.945896
D.bocki,140010837,457915,1,2093,1.49488e-05,132437779,0.945911
D.bocki,140010837,462184,1,2092,1.49417e-05,132439871,0.945926
D.bocki,140010837,458405,1,2092,1.49417e-05,132441963,0.945941
D.bocki,140010837,461133,1,2091,1.49346e-05,132444054,0.945956
D.bocki,140010837,456595,1,2091,1.49346e-05,132446145,0.945971
D.bocki,140010837,456224,1,2091,1.49346e-05,132448236,0.945986
D.bocki,140010837,420807,1,2086,1.48988e-05,132450322,0.946001
D.bocki,140010837,459936,1,2085,1.48917e-05,132452407,0.946015
D.bocki,140010837,462963,1,2084,1.48846e-05,132454491,0.94603
D.bocki,140010837,452032,1,2084,1.48846e-05,132456575,0.946045
D.bocki,140010837,462145,1,2083,1.48774e-05,132458658,0.94606
D.bocki,140010837,457866,1,2083,1.48774e-05,132460741,0.946075
D.bocki,140010837,455744,1,2083,1.48774e-05,132462824,0.94609
D.bocki,140010837,379595,1,2083,1.48774e-05,132464907,0.946105
D.bocki,140010837,462544,1,2082,1.48703e-05,132466989,0.94612
D.bocki,140010837,254956,1,2081,1.48631e-05,132469070,0.946134
D.bocki,140010837,457481,1,2080,1.4856e-05,132471150,0.946149
D.bocki,140010837,462018,1,2079,1.48489e-05,132473229,0.946164
D.bocki,140010837,461026,1,2079,1.48489e-05,132475308,0.946179
D.bocki,140010837,456636,1,2079,1.48489e-05,132477387,0.946194
D.bocki,140010837,460027,1,2077,1.48346e-05,132479464,0.946209
D.bocki,140010837,459651,1,2077,1.48346e-05,132481541,0.946223
D.bocki,140010837,455851,1,2076,1.48274e-05,132483617,0.946238
D.bocki,140010837,463365,1,2075,1.48203e-05,132485692,0.946253
D.bocki,140010837,460093,1,2074,1.48131e-05,132487766,0.946268
D.bocki,140010837,399268,1,2074,1.48131e-05,132489840,0.946283
D.bocki,140010837,462060,1,2072,1.47989e-05,132491912,0.946298
D.bocki,140010837,457973,1,2072,1.47989e-05,132493984,0.946312
D.bocki,140010837,456084,1,2070,1.47846e-05,132496054,0.946327
D.bocki,140010837,40874,1,2070,1.47846e-05,132498124,0.946342
D.bocki,140010837,462666,1,2069,1.47774e-05,132500193,0.946357
D.bocki,140010837,461586,1,2069,1.47774e-05,132502262,0.946371
D.bocki,140010837,462390,1,2068,1.47703e-05,132504330,0.946386
D.bocki,140010837,462866,1,2067,1.47631e-05,132506397,0.946401
D.bocki,140010837,460803,1,2067,1.47631e-05,132508464,0.946416
D.bocki,140010837,459490,1,2065,1.47489e-05,132510529,0.946431
D.bocki,140010837,456487,1,2065,1.47489e-05,132512594,0.946445
D.bocki,140010837,354759,1,2065,1.47489e-05,132514659,0.94646
D.bocki,140010837,294527,1,2064,1.47417e-05,132516723,0.946475
D.bocki,140010837,461896,1,2063,1.47346e-05,132518786,0.946489
D.bocki,140010837,460483,1,2063,1.47346e-05,132520849,0.946504
D.bocki,140010837,459553,1,2063,1.47346e-05,132522912,0.946519
D.bocki,140010837,386332,1,2063,1.47346e-05,132524975,0.946534
D.bocki,140010837,457144,1,2062,1.47274e-05,132527037,0.946548
D.bocki,140010837,12125,1,2062,1.47274e-05,132529099,0.946563
D.bocki,140010837,458277,1,2061,1.47203e-05,132531160,0.946578
D.bocki,140010837,455726,1,2061,1.47203e-05,132533221,0.946593
D.bocki,140010837,463537,1,2060,1.47131e-05,132535281,0.946607
D.bocki,140010837,456562,1,2060,1.47131e-05,132537341,0.946622
D.bocki,140010837,456810,1,2059,1.4706e-05,132539400,0.946637
D.bocki,140010837,461594,1,2057,1.46917e-05,132541457,0.946651
D.bocki,140010837,144490,1,2057,1.46917e-05,132543514,0.946666
D.bocki,140010837,181113,1,2055,1.46774e-05,132545569,0.946681
D.bocki,140010837,460012,1,2054,1.46703e-05,132547623,0.946695
D.bocki,140010837,463266,1,2053,1.46632e-05,132549676,0.94671
D.bocki,140010837,462217,1,2052,1.4656e-05,132551728,0.946725
D.bocki,140010837,462430,1,2051,1.46489e-05,132553779,0.946739
D.bocki,140010837,459469,1,2051,1.46489e-05,132555830,0.946754
D.bocki,140010837,458312,1,2051,1.46489e-05,132557881,0.946769
D.bocki,140010837,462334,1,2048,1.46274e-05,132559929,0.946783
D.bocki,140010837,456264,1,2048,1.46274e-05,132561977,0.946798
D.bocki,140010837,461258,1,2047,1.46203e-05,132564024,0.946813
D.bocki,140010837,462335,1,2045,1.4606e-05,132566069,0.946827
D.bocki,140010837,462753,1,2043,1.45917e-05,132568112,0.946842
D.bocki,140010837,457391,1,2043,1.45917e-05,132570155,0.946856
D.bocki,140010837,461617,1,2042,1.45846e-05,132572197,0.946871
D.bocki,140010837,460190,1,2042,1.45846e-05,132574239,0.946886
D.bocki,140010837,458824,1,2042,1.45846e-05,132576281,0.9469
D.bocki,140010837,461211,1,2041,1.45774e-05,132578322,0.946915
D.bocki,140010837,457380,1,2041,1.45774e-05,132580363,0.946929
D.bocki,140010837,456935,1,2041,1.45774e-05,132582404,0.946944
D.bocki,140010837,458532,1,2039,1.45632e-05,132584443,0.946958
D.bocki,140010837,457729,1,2039,1.45632e-05,132586482,0.946973
D.bocki,140010837,461203,1,2038,1.4556e-05,132588520,0.946988
D.bocki,140010837,462389,1,2036,1.45417e-05,132590556,0.947002
D.bocki,140010837,461775,1,2035,1.45346e-05,132592591,0.947017
D.bocki,140010837,461643,1,2035,1.45346e-05,132594626,0.947031
D.bocki,140010837,459697,1,2035,1.45346e-05,132596661,0.947046
D.bocki,140010837,463505,1,2034,1.45274e-05,132598695,0.94706
D.bocki,140010837,459685,1,2034,1.45274e-05,132600729,0.947075
D.bocki,140010837,456868,1,2034,1.45274e-05,132602763,0.947089
D.bocki,140010837,456002,1,2034,1.45274e-05,132604797,0.947104
D.bocki,140010837,457778,1,2032,1.45132e-05,132606829,0.947118
D.bocki,140010837,461756,1,2030,1.44989e-05,132608859,0.947133
D.bocki,140010837,177786,1,2030,1.44989e-05,132610889,0.947147
D.bocki,140010837,463390,1,2029,1.44917e-05,132612918,0.947162
D.bocki,140010837,2313,1,2028,1.44846e-05,132614946,0.947176
D.bocki,140010837,461335,1,2027,1.44775e-05,132616973,0.947191
D.bocki,140010837,460963,1,2027,1.44775e-05,132619000,0.947205
D.bocki,140010837,460293,1,2027,1.44775e-05,132621027,0.94722
D.bocki,140010837,458891,1,2026,1.44703e-05,132623053,0.947234
D.bocki,140010837,456220,1,2026,1.44703e-05,132625079,0.947249
D.bocki,140010837,459943,1,2025,1.44632e-05,132627104,0.947263
D.bocki,140010837,456023,1,2024,1.4456e-05,132629128,0.947278
D.bocki,140010837,105536,1,2024,1.4456e-05,132631152,0.947292
D.bocki,140010837,460569,1,2023,1.44489e-05,132633175,0.947306
D.bocki,140010837,457278,1,2023,1.44489e-05,132635198,0.947321
D.bocki,140010837,462436,1,2022,1.44417e-05,132637220,0.947335
D.bocki,140010837,452738,1,2021,1.44346e-05,132639241,0.94735
D.bocki,140010837,315268,1,2021,1.44346e-05,132641262,0.947364
D.bocki,140010837,457758,1,2020,1.44275e-05,132643282,0.947379
D.bocki,140010837,457679,1,2020,1.44275e-05,132645302,0.947393
D.bocki,140010837,456165,1,2020,1.44275e-05,132647322,0.947408
D.bocki,140010837,459965,1,2019,1.44203e-05,132649341,0.947422
D.bocki,140010837,459176,1,2019,1.44203e-05,132651360,0.947436
D.bocki,140010837,462216,1,2018,1.44132e-05,132653378,0.947451
D.bocki,140010837,459824,1,2018,1.44132e-05,132655396,0.947465
D.bocki,140010837,457895,1,2018,1.44132e-05,132657414,0.94748
D.bocki,140010837,457276,1,2018,1.44132e-05,132659432,0.947494
D.bocki,140010837,456860,1,2018,1.44132e-05,132661450,0.947508
D.bocki,140010837,456653,1,2018,1.44132e-05,132663468,0.947523
D.bocki,140010837,224509,1,2016,1.43989e-05,132665484,0.947537
D.bocki,140010837,459708,1,2015,1.43917e-05,132667499,0.947552
D.bocki,140010837,452160,1,2013,1.43775e-05,132669512,0.947566
D.bocki,140010837,456350,1,2012,1.43703e-05,132671524,0.94758
D.bocki,140010837,307773,1,2012,1.43703e-05,132673536,0.947595
D.bocki,140010837,460651,1,2011,1.43632e-05,132675547,0.947609
D.bocki,140010837,458447,1,2010,1.4356e-05,132677557,0.947623
D.bocki,140010837,462570,1,2009,1.43489e-05,132679566,0.947638
D.bocki,140010837,459020,1,2009,1.43489e-05,132681575,0.947652
D.bocki,140010837,459268,1,2008,1.43417e-05,132683583,0.947667
D.bocki,140010837,456666,1,2007,1.43346e-05,132685590,0.947681
D.bocki,140010837,462784,1,2006,1.43275e-05,132687596,0.947695
D.bocki,140010837,460976,1,2006,1.43275e-05,132689602,0.94771
D.bocki,140010837,460268,1,2006,1.43275e-05,132691608,0.947724
D.bocki,140010837,327245,1,2006,1.43275e-05,132693614,0.947738
D.bocki,140010837,456000,1,2003,1.4306e-05,132695617,0.947752
D.bocki,140010837,461468,1,2001,1.42918e-05,132697618,0.947767
D.bocki,140010837,310309,1,2001,1.42918e-05,132699619,0.947781
D.bocki,140010837,456058,1,2000,1.42846e-05,132701619,0.947795
D.bocki,140010837,460537,1,1999,1.42775e-05,132703618,0.94781
D.bocki,140010837,131432,1,1998,1.42703e-05,132705616,0.947824
D.bocki,140010837,461839,1,1997,1.42632e-05,132707613,0.947838
D.bocki,140010837,461169,1,1997,1.42632e-05,132709610,0.947852
D.bocki,140010837,460219,1,1997,1.42632e-05,132711607,0.947867
D.bocki,140010837,455986,1,1997,1.42632e-05,132713604,0.947881
D.bocki,140010837,409833,1,1996,1.4256e-05,132715600,0.947895
D.bocki,140010837,457207,1,1995,1.42489e-05,132717595,0.947909
D.bocki,140010837,460603,1,1994,1.42418e-05,132719589,0.947924
D.bocki,140010837,450904,1,1994,1.42418e-05,132721583,0.947938
D.bocki,140010837,456867,1,1993,1.42346e-05,132723576,0.947952
D.bocki,140010837,52907,1,1990,1.42132e-05,132725566,0.947966
D.bocki,140010837,458085,1,1990,1.42132e-05,132727556,0.947981
D.bocki,140010837,457925,1,1990,1.42132e-05,132729546,0.947995
D.bocki,140010837,462112,1,1987,1.41918e-05,132731533,0.948009
D.bocki,140010837,459617,1,1985,1.41775e-05,132733518,0.948023
D.bocki,140010837,457230,1,1985,1.41775e-05,132735503,0.948037
D.bocki,140010837,462459,1,1984,1.41703e-05,132737487,0.948052
D.bocki,140010837,8699,1,1983,1.41632e-05,132739470,0.948066
D.bocki,140010837,458877,1,1982,1.4156e-05,132741452,0.94808
D.bocki,140010837,456656,1,1982,1.4156e-05,132743434,0.948094
D.bocki,140010837,463523,1,1981,1.41489e-05,132745415,0.948108
D.bocki,140010837,457227,1,1981,1.41489e-05,132747396,0.948122
D.bocki,140010837,462040,1,1980,1.41418e-05,132749376,0.948136
D.bocki,140010837,457571,1,1980,1.41418e-05,132751356,0.948151
D.bocki,140010837,457799,1,1978,1.41275e-05,132753334,0.948165
D.bocki,140010837,459003,1,1976,1.41132e-05,132755310,0.948179
D.bocki,140010837,458055,1,1976,1.41132e-05,132757286,0.948193
D.bocki,140010837,456496,1,1975,1.41061e-05,132759261,0.948207
D.bocki,140010837,461685,1,1974,1.40989e-05,132761235,0.948221
D.bocki,140010837,399254,1,1974,1.40989e-05,132763209,0.948235
D.bocki,140010837,459438,1,1971,1.40775e-05,132765180,0.948249
D.bocki,140010837,458734,1,1970,1.40703e-05,132767150,0.948263
D.bocki,140010837,458602,1,1964,1.40275e-05,132769114,0.948277
D.bocki,140010837,455861,1,1964,1.40275e-05,132771078,0.948291
D.bocki,140010837,451608,1,1964,1.40275e-05,132773042,0.948305
D.bocki,140010837,462926,1,1963,1.40203e-05,132775005,0.948319
D.bocki,140010837,126205,1,1963,1.40203e-05,132776968,0.948334
D.bocki,140010837,458187,1,1962,1.40132e-05,132778930,0.948348
D.bocki,140010837,457424,1,1962,1.40132e-05,132780892,0.948362
D.bocki,140010837,463219,1,1961,1.40061e-05,132782853,0.948376
D.bocki,140010837,459114,1,1961,1.40061e-05,132784814,0.94839
D.bocki,140010837,455987,1,1960,1.39989e-05,132786774,0.948404
D.bocki,140010837,461845,1,1959,1.39918e-05,132788733,0.948418
D.bocki,140010837,460024,1,1959,1.39918e-05,132790692,0.948432
D.bocki,140010837,461027,1,1958,1.39846e-05,132792650,0.948446
D.bocki,140010837,458868,1,1958,1.39846e-05,132794608,0.948459
D.bocki,140010837,458175,1,1958,1.39846e-05,132796566,0.948473
D.bocki,140010837,458345,1,1956,1.39703e-05,132798522,0.948487
D.bocki,140010837,456919,1,1956,1.39703e-05,132800478,0.948501
D.bocki,140010837,462935,1,1955,1.39632e-05,132802433,0.948515
D.bocki,140010837,461076,1,1954,1.39561e-05,132804387,0.948529
D.bocki,140010837,461334,1,1953,1.39489e-05,132806340,0.948543
D.bocki,140010837,460388,1,1953,1.39489e-05,132808293,0.948557
D.bocki,140010837,457589,1,1953,1.39489e-05,132810246,0.948571
D.bocki,140010837,459510,1,1952,1.39418e-05,132812198,0.948585
D.bocki,140010837,459547,1,1951,1.39346e-05,132814149,0.948599
D.bocki,140010837,9723,1,1950,1.39275e-05,132816099,0.948613
D.bocki,140010837,458163,1,1950,1.39275e-05,132818049,0.948627
D.bocki,140010837,457399,1,1949,1.39204e-05,132819998,0.948641
D.bocki,140010837,460385,1,1948,1.39132e-05,132821946,0.948655
D.bocki,140010837,458230,1,1948,1.39132e-05,132823894,0.948669
D.bocki,140010837,462683,1,1947,1.39061e-05,132825841,0.948683
D.bocki,140010837,462552,1,1947,1.39061e-05,132827788,0.948696
D.bocki,140010837,455842,1,1947,1.39061e-05,132829735,0.94871
D.bocki,140010837,30733,1,1946,1.38989e-05,132831681,0.948724
D.bocki,140010837,456250,1,1945,1.38918e-05,132833626,0.948738
D.bocki,140010837,462641,1,1944,1.38846e-05,132835570,0.948752
D.bocki,140010837,344392,1,1943,1.38775e-05,132837513,0.948766
D.bocki,140010837,90885,1,1942,1.38704e-05,132839455,0.94878
D.bocki,140010837,463463,1,1942,1.38704e-05,132841397,0.948794
D.bocki,140010837,244301,1,1942,1.38704e-05,132843339,0.948808
D.bocki,140010837,458433,1,1940,1.38561e-05,132845279,0.948821
D.bocki,140010837,460368,1,1939,1.38489e-05,132847218,0.948835
D.bocki,140010837,461721,1,1938,1.38418e-05,132849156,0.948849
D.bocki,140010837,460944,1,1938,1.38418e-05,132851094,0.948863
D.bocki,140010837,185154,1,1937,1.38346e-05,132853031,0.948877
D.bocki,140010837,459614,1,1936,1.38275e-05,132854967,0.948891
D.bocki,140010837,337364,1,1936,1.38275e-05,132856903,0.948904
D.bocki,140010837,461489,1,1934,1.38132e-05,132858837,0.948918
D.bocki,140010837,456475,1,1934,1.38132e-05,132860771,0.948932
D.bocki,140010837,455911,1,1933,1.38061e-05,132862704,0.948946
D.bocki,140010837,277500,1,1933,1.38061e-05,132864637,0.94896
D.bocki,140010837,458335,1,1932,1.37989e-05,132866569,0.948973
D.bocki,140010837,457352,1,1932,1.37989e-05,132868501,0.948987
D.bocki,140010837,457068,1,1932,1.37989e-05,132870433,0.949001
D.bocki,140010837,453420,1,1932,1.37989e-05,132872365,0.949015
D.bocki,140010837,460136,1,1931,1.37918e-05,132874296,0.949029
D.bocki,140010837,126602,1,1931,1.37918e-05,132876227,0.949042
D.bocki,140010837,72408,1,1928,1.37704e-05,132878155,0.949056
D.bocki,140010837,463351,1,1926,1.37561e-05,132880081,0.94907
D.bocki,140010837,458352,1,1926,1.37561e-05,132882007,0.949084
D.bocki,140010837,459812,1,1925,1.37489e-05,132883932,0.949097
D.bocki,140010837,459523,1,1925,1.37489e-05,132885857,0.949111
D.bocki,140010837,458619,1,1924,1.37418e-05,132887781,0.949125
D.bocki,140010837,463271,1,1923,1.37347e-05,132889704,0.949139
D.bocki,140010837,460565,1,1923,1.37347e-05,132891627,0.949152
D.bocki,140010837,460038,1,1923,1.37347e-05,132893550,0.949166
D.bocki,140010837,455850,1,1923,1.37347e-05,132895473,0.94918
D.bocki,140010837,455776,1,1923,1.37347e-05,132897396,0.949194
D.bocki,140010837,369795,1,1923,1.37347e-05,132899319,0.949207
D.bocki,140010837,204405,1,1923,1.37347e-05,132901242,0.949221
D.bocki,140010837,460195,1,1922,1.37275e-05,132903164,0.949235
D.bocki,140010837,457409,1,1922,1.37275e-05,132905086,0.949249
D.bocki,140010837,460103,1,1921,1.37204e-05,132907007,0.949262
D.bocki,140010837,463197,1,1920,1.37132e-05,132908927,0.949276
D.bocki,140010837,459212,1,1920,1.37132e-05,132910847,0.94929
D.bocki,140010837,455935,1,1919,1.37061e-05,132912766,0.949303
D.bocki,140010837,460706,1,1918,1.36989e-05,132914684,0.949317
D.bocki,140010837,458892,1,1918,1.36989e-05,132916602,0.949331
D.bocki,140010837,456593,1,1917,1.36918e-05,132918519,0.949345
D.bocki,140010837,453231,1,1916,1.36847e-05,132920435,0.949358
D.bocki,140010837,462932,1,1915,1.36775e-05,132922350,0.949372
D.bocki,140010837,462887,1,1915,1.36775e-05,132924265,0.949386
D.bocki,140010837,460159,1,1914,1.36704e-05,132926179,0.949399
D.bocki,140010837,457055,1,1914,1.36704e-05,132928093,0.949413
D.bocki,140010837,463082,1,1912,1.36561e-05,132930005,0.949427
D.bocki,140010837,460116,1,1912,1.36561e-05,132931917,0.94944
D.bocki,140010837,463168,1,1909,1.36347e-05,132933826,0.949454
D.bocki,140010837,462037,1,1909,1.36347e-05,132935735,0.949467
D.bocki,140010837,457867,1,1909,1.36347e-05,132937644,0.949481
D.bocki,140010837,461167,1,1908,1.36275e-05,132939552,0.949495
D.bocki,140010837,460677,1,1908,1.36275e-05,132941460,0.949508
D.bocki,140010837,301324,1,1908,1.36275e-05,132943368,0.949522
D.bocki,140010837,459394,1,1907,1.36204e-05,132945275,0.949536
D.bocki,140010837,461339,1,1906,1.36132e-05,132947181,0.949549
D.bocki,140010837,460629,1,1905,1.36061e-05,132949086,0.949563
D.bocki,140010837,273856,1,1905,1.36061e-05,132950991,0.949576
D.bocki,140010837,458664,1,1904,1.35989e-05,132952895,0.94959
D.bocki,140010837,458950,1,1903,1.35918e-05,132954798,0.949604
D.bocki,140010837,456745,1,1903,1.35918e-05,132956701,0.949617
D.bocki,140010837,455953,1,1902,1.35847e-05,132958603,0.949631
D.bocki,140010837,126479,1,1902,1.35847e-05,132960505,0.949644
D.bocki,140010837,463521,1,1901,1.35775e-05,132962406,0.949658
D.bocki,140010837,460161,1,1901,1.35775e-05,132964307,0.949672
D.bocki,140010837,457684,1,1900,1.35704e-05,132966207,0.949685
D.bocki,140010837,96631,1,1899,1.35632e-05,132968106,0.949699
D.bocki,140010837,459054,1,1897,1.3549e-05,132970003,0.949712
D.bocki,140010837,457489,1,1897,1.3549e-05,132971900,0.949726
D.bocki,140010837,461154,1,1896,1.35418e-05,132973796,0.949739
D.bocki,140010837,462071,1,1895,1.35347e-05,132975691,0.949753
D.bocki,140010837,457192,1,1895,1.35347e-05,132977586,0.949766
D.bocki,140010837,435253,1,1895,1.35347e-05,132979481,0.94978
D.bocki,140010837,246950,1,1895,1.35347e-05,132981376,0.949793
D.bocki,140010837,235207,1,1894,1.35275e-05,132983270,0.949807
D.bocki,140010837,457455,1,1893,1.35204e-05,132985163,0.94982
D.bocki,140010837,455767,1,1892,1.35132e-05,132987055,0.949834
D.bocki,140010837,134434,1,1892,1.35132e-05,132988947,0.949848
D.bocki,140010837,461498,1,1891,1.35061e-05,132990838,0.949861
D.bocki,140010837,460664,1,1891,1.35061e-05,132992729,0.949875
D.bocki,140010837,459498,1,1891,1.35061e-05,132994620,0.949888
D.bocki,140010837,455815,1,1891,1.35061e-05,132996511,0.949902
D.bocki,140010837,462601,1,1889,1.34918e-05,132998400,0.949915
D.bocki,140010837,461794,1,1889,1.34918e-05,133000289,0.949929
D.bocki,140010837,459009,1,1888,1.34847e-05,133002177,0.949942
D.bocki,140010837,458893,1,1888,1.34847e-05,133004065,0.949956
D.bocki,140010837,245587,1,1887,1.34775e-05,133005952,0.949969
D.bocki,140010837,460670,1,1886,1.34704e-05,133007838,0.949982
D.bocki,140010837,455865,1,1884,1.34561e-05,133009722,0.949996
D.bocki,140010837,458999,1,1883,1.3449e-05,133011605,0.950009
D.bocki,140010837,458719,1,1883,1.3449e-05,133013488,0.950023
D.bocki,140010837,456085,1,1882,1.34418e-05,133015370,0.950036
D.bocki,140010837,460680,1,1881,1.34347e-05,133017251,0.95005
D.bocki,140010837,456327,1,1880,1.34275e-05,133019131,0.950063
D.bocki,140010837,239067,1,1880,1.34275e-05,133021011,0.950077
D.bocki,140010837,461671,1,1878,1.34132e-05,133022889,0.95009
D.bocki,140010837,456540,1,1877,1.34061e-05,133024766,0.950103
D.bocki,140010837,182656,1,1877,1.34061e-05,133026643,0.950117
D.bocki,140010837,460259,1,1876,1.3399e-05,133028519,0.95013
D.bocki,140010837,459110,1,1873,1.33775e-05,133030392,0.950144
D.bocki,140010837,456007,1,1873,1.33775e-05,133032265,0.950157
D.bocki,140010837,120489,1,1873,1.33775e-05,133034138,0.95017
D.bocki,140010837,462518,1,1872,1.33704e-05,133036010,0.950184
D.bocki,140010837,456035,1,1872,1.33704e-05,133037882,0.950197
D.bocki,140010837,463343,1,1871,1.33633e-05,133039753,0.95021
D.bocki,140010837,459353,1,1871,1.33633e-05,133041624,0.950224
D.bocki,140010837,458348,1,1871,1.33633e-05,133043495,0.950237
D.bocki,140010837,462457,1,1870,1.33561e-05,133045365,0.95025
D.bocki,140010837,375318,1,1870,1.33561e-05,133047235,0.950264
D.bocki,140010837,224399,1,1870,1.33561e-05,133049105,0.950277
D.bocki,140010837,458714,1,1869,1.3349e-05,133050974,0.950291
D.bocki,140010837,461101,1,1868,1.33418e-05,133052842,0.950304
D.bocki,140010837,461342,1,1867,1.33347e-05,133054709,0.950317
D.bocki,140010837,457150,1,1867,1.33347e-05,133056576,0.950331
D.bocki,140010837,456752,1,1867,1.33347e-05,133058443,0.950344
D.bocki,140010837,338721,1,1867,1.33347e-05,133060310,0.950357
D.bocki,140010837,222637,1,1867,1.33347e-05,133062177,0.950371
D.bocki,140010837,458637,1,1866,1.33275e-05,133064043,0.950384
D.bocki,140010837,463556,1,1865,1.33204e-05,133065908,0.950397
D.bocki,140010837,453606,1,1865,1.33204e-05,133067773,0.950411
D.bocki,140010837,456920,1,1864,1.33133e-05,133069637,0.950424
D.bocki,140010837,463285,1,1863,1.33061e-05,133071500,0.950437
D.bocki,140010837,457030,1,1863,1.33061e-05,133073363,0.95045
D.bocki,140010837,118243,1,1863,1.33061e-05,133075226,0.950464
D.bocki,140010837,460585,1,1862,1.3299e-05,133077088,0.950477
D.bocki,140010837,459709,1,1862,1.3299e-05,133078950,0.95049
D.bocki,140010837,455884,1,1862,1.3299e-05,133080812,0.950504
D.bocki,140010837,462638,1,1860,1.32847e-05,133082672,0.950517
D.bocki,140010837,457590,1,1860,1.32847e-05,133084532,0.95053
D.bocki,140010837,458671,1,1858,1.32704e-05,133086390,0.950543
D.bocki,140010837,458514,1,1858,1.32704e-05,133088248,0.950557
D.bocki,140010837,457195,1,1856,1.32561e-05,133090104,0.95057
D.bocki,140010837,456924,1,1856,1.32561e-05,133091960,0.950583
D.bocki,140010837,462803,1,1854,1.32418e-05,133093814,0.950597
D.bocki,140010837,462488,1,1853,1.32347e-05,133095667,0.95061
D.bocki,140010837,457552,1,1853,1.32347e-05,133097520,0.950623
D.bocki,140010837,201979,1,1853,1.32347e-05,133099373,0.950636
D.bocki,140010837,462210,1,1852,1.32275e-05,133101225,0.950649
D.bocki,140010837,462150,1,1852,1.32275e-05,133103077,0.950663
D.bocki,140010837,459461,1,1852,1.32275e-05,133104929,0.950676
D.bocki,140010837,459424,1,1852,1.32275e-05,133106781,0.950689
D.bocki,140010837,457300,1,1852,1.32275e-05,133108633,0.950702
D.bocki,140010837,452458,1,1852,1.32275e-05,133110485,0.950716
D.bocki,140010837,297990,1,1851,1.32204e-05,133112336,0.950729
D.bocki,140010837,462091,1,1850,1.32133e-05,133114186,0.950742
D.bocki,140010837,459526,1,1850,1.32133e-05,133116036,0.950755
D.bocki,140010837,457070,1,1850,1.32133e-05,133117886,0.950768
D.bocki,140010837,461301,1,1849,1.32061e-05,133119735,0.950782
D.bocki,140010837,458913,1,1849,1.32061e-05,133121584,0.950795
D.bocki,140010837,210737,1,1848,1.3199e-05,133123432,0.950808
D.bocki,140010837,461994,1,1847,1.31918e-05,133125279,0.950821
D.bocki,140010837,458214,1,1846,1.31847e-05,133127125,0.950834
D.bocki,140010837,241291,1,1845,1.31776e-05,133128970,0.950848
D.bocki,140010837,456470,1,1844,1.31704e-05,133130814,0.950861
D.bocki,140010837,455985,1,1843,1.31633e-05,133132657,0.950874
D.bocki,140010837,462388,1,1842,1.31561e-05,133134499,0.950887
D.bocki,140010837,462140,1,1842,1.31561e-05,133136341,0.9509
D.bocki,140010837,460776,1,1841,1.3149e-05,133138182,0.950913
D.bocki,140010837,459416,1,1841,1.3149e-05,133140023,0.950927
D.bocki,140010837,461434,1,1840,1.31418e-05,133141863,0.95094
D.bocki,140010837,462284,1,1839,1.31347e-05,133143702,0.950953
D.bocki,140010837,456770,1,1839,1.31347e-05,133145541,0.950966
D.bocki,140010837,456584,1,1838,1.31276e-05,133147379,0.950979
D.bocki,140010837,454854,1,1838,1.31276e-05,133149217,0.950992
D.bocki,140010837,198877,1,1838,1.31276e-05,133151055,0.951005
D.bocki,140010837,462980,1,1837,1.31204e-05,133152892,0.951018
D.bocki,140010837,460820,1,1836,1.31133e-05,133154728,0.951032
D.bocki,140010837,456129,1,1835,1.31061e-05,133156563,0.951045
D.bocki,140010837,456128,1,1835,1.31061e-05,133158398,0.951058
D.bocki,140010837,455806,1,1834,1.3099e-05,133160232,0.951071
D.bocki,140010837,450859,1,1832,1.30847e-05,133162064,0.951084
D.bocki,140010837,462105,1,1831,1.30776e-05,133163895,0.951097
D.bocki,140010837,458147,1,1831,1.30776e-05,133165726,0.95111
D.bocki,140010837,458517,1,1830,1.30704e-05,133167556,0.951123
D.bocki,140010837,461785,1,1829,1.30633e-05,133169385,0.951136
D.bocki,140010837,460988,1,1828,1.30561e-05,133171213,0.951149
D.bocki,140010837,18413,1,1828,1.30561e-05,133173041,0.951162
D.bocki,140010837,456156,1,1827,1.3049e-05,133174868,0.951175
D.bocki,140010837,459327,1,1826,1.30418e-05,133176694,0.951188
D.bocki,140010837,462720,1,1825,1.30347e-05,133178519,0.951202
D.bocki,140010837,461148,1,1825,1.30347e-05,133180344,0.951215
D.bocki,140010837,461971,1,1824,1.30276e-05,133182168,0.951228
D.bocki,140010837,455872,1,1824,1.30276e-05,133183992,0.951241
D.bocki,140010837,39561,1,1824,1.30276e-05,133185816,0.951254
D.bocki,140010837,458419,1,1822,1.30133e-05,133187638,0.951267
D.bocki,140010837,460412,1,1821,1.30061e-05,133189459,0.95128
D.bocki,140010837,425886,1,1821,1.30061e-05,133191280,0.951293
D.bocki,140010837,272504,1,1821,1.30061e-05,133193101,0.951306
D.bocki,140010837,460524,1,1820,1.2999e-05,133194921,0.951319
D.bocki,140010837,461366,1,1819,1.29919e-05,133196740,0.951332
D.bocki,140010837,461292,1,1819,1.29919e-05,133198559,0.951345
D.bocki,140010837,460231,1,1819,1.29919e-05,133200378,0.951358
D.bocki,140010837,457540,1,1819,1.29919e-05,133202197,0.951371
D.bocki,140010837,457286,1,1819,1.29919e-05,133204016,0.951384
D.bocki,140010837,453726,1,1819,1.29919e-05,133205835,0.951397
D.bocki,140010837,350933,1,1818,1.29847e-05,133207653,0.95141
D.bocki,140010837,462302,1,1817,1.29776e-05,133209470,0.951423
D.bocki,140010837,149299,1,1817,1.29776e-05,133211287,0.951436
D.bocki,140010837,459799,1,1816,1.29704e-05,133213103,0.951449
D.bocki,140010837,305698,1,1816,1.29704e-05,133214919,0.951461
D.bocki,140010837,462486,1,1814,1.29561e-05,133216733,0.951474
D.bocki,140010837,461526,1,1814,1.29561e-05,133218547,0.951487
D.bocki,140010837,457241,1,1814,1.29561e-05,133220361,0.9515
D.bocki,140010837,456788,1,1814,1.29561e-05,133222175,0.951513
D.bocki,140010837,431941,1,1814,1.29561e-05,133223989,0.951526
D.bocki,140010837,456477,1,1813,1.2949e-05,133225802,0.951539
D.bocki,140010837,462224,1,1811,1.29347e-05,133227613,0.951552
D.bocki,140010837,458488,1,1811,1.29347e-05,133229424,0.951565
D.bocki,140010837,95614,1,1809,1.29204e-05,133231233,0.951578
D.bocki,140010837,457580,1,1808,1.29133e-05,133233041,0.951591
D.bocki,140010837,457071,1,1808,1.29133e-05,133234849,0.951604
D.bocki,140010837,199462,1,1808,1.29133e-05,133236657,0.951617
D.bocki,140010837,461467,1,1807,1.29061e-05,133238464,0.95163
D.bocki,140010837,460813,1,1807,1.29061e-05,133240271,0.951643
D.bocki,140010837,458713,1,1807,1.29061e-05,133242078,0.951655
D.bocki,140010837,457524,1,1807,1.29061e-05,133243885,0.951668
D.bocki,140010837,462554,1,1806,1.2899e-05,133245691,0.951681
D.bocki,140010837,459529,1,1806,1.2899e-05,133247497,0.951694
D.bocki,140010837,456141,1,1806,1.2899e-05,133249303,0.951707
D.bocki,140010837,458690,1,1805,1.28919e-05,133251108,0.95172
D.bocki,140010837,461005,1,1804,1.28847e-05,133252912,0.951733
D.bocki,140010837,458799,1,1804,1.28847e-05,133254716,0.951746
D.bocki,140010837,456175,1,1804,1.28847e-05,133256520,0.951759
D.bocki,140010837,461570,1,1803,1.28776e-05,133258323,0.951771
D.bocki,140010837,460997,1,1799,1.2849e-05,133260122,0.951784
D.bocki,140010837,460387,1,1799,1.2849e-05,133261921,0.951797
D.bocki,140010837,456288,1,1798,1.28419e-05,133263719,0.95181
D.bocki,140010837,452842,1,1798,1.28419e-05,133265517,0.951823
D.bocki,140010837,301766,1,1798,1.28419e-05,133267315,0.951836
D.bocki,140010837,151412,1,1798,1.28419e-05,133269113,0.951849
D.bocki,140010837,461064,1,1797,1.28347e-05,133270910,0.951861
D.bocki,140010837,462474,1,1795,1.28204e-05,133272705,0.951874
D.bocki,140010837,461099,1,1795,1.28204e-05,133274500,0.951887
D.bocki,140010837,457285,1,1795,1.28204e-05,133276295,0.9519
D.bocki,140010837,405779,1,1794,1.28133e-05,133278089,0.951913
D.bocki,140010837,463461,1,1793,1.28062e-05,133279882,0.951925
D.bocki,140010837,460615,1,1790,1.27847e-05,133281672,0.951938
D.bocki,140010837,457097,1,1790,1.27847e-05,133283462,0.951951
D.bocki,140010837,456841,1,1790,1.27847e-05,133285252,0.951964
D.bocki,140010837,463567,1,1787,1.27633e-05,133287039,0.951977
D.bocki,140010837,463347,1,1787,1.27633e-05,133288826,0.951989
D.bocki,140010837,460452,1,1787,1.27633e-05,133290613,0.952002
D.bocki,140010837,457336,1,1787,1.27633e-05,133292400,0.952015
D.bocki,140010837,461146,1,1786,1.27562e-05,133294186,0.952028
D.bocki,140010837,456297,1,1785,1.2749e-05,133295971,0.95204
D.bocki,140010837,458466,1,1784,1.27419e-05,133297755,0.952053
D.bocki,140010837,433840,1,1784,1.27419e-05,133299539,0.952066
D.bocki,140010837,458907,1,1783,1.27347e-05,133301322,0.952079
D.bocki,140010837,457545,1,1782,1.27276e-05,133303104,0.952091
D.bocki,140010837,456154,1,1780,1.27133e-05,133304884,0.952104
D.bocki,140010837,461388,1,1779,1.27062e-05,133306663,0.952117
D.bocki,140010837,459218,1,1779,1.27062e-05,133308442,0.952129
D.bocki,140010837,165077,1,1779,1.27062e-05,133310221,0.952142
D.bocki,140010837,457257,1,1778,1.2699e-05,133311999,0.952155
D.bocki,140010837,456078,1,1778,1.2699e-05,133313777,0.952168
D.bocki,140010837,459191,1,1774,1.26704e-05,133315551,0.95218
D.bocki,140010837,456870,1,1771,1.2649e-05,133317322,0.952193
D.bocki,140010837,69920,1,1769,1.26347e-05,133319091,0.952206
D.bocki,140010837,460947,1,1769,1.26347e-05,133320860,0.952218
D.bocki,140010837,460688,1,1768,1.26276e-05,133322628,0.952231
D.bocki,140010837,460342,1,1768,1.26276e-05,133324396,0.952243
D.bocki,140010837,459385,1,1768,1.26276e-05,133326164,0.952256
D.bocki,140010837,459816,1,1767,1.26205e-05,133327931,0.952269
D.bocki,140010837,457625,1,1767,1.26205e-05,133329698,0.952281
D.bocki,140010837,460765,1,1766,1.26133e-05,133331464,0.952294
D.bocki,140010837,456982,1,1766,1.26133e-05,133333230,0.952306
D.bocki,140010837,456107,1,1766,1.26133e-05,133334996,0.952319
D.bocki,140010837,455875,1,1766,1.26133e-05,133336762,0.952332
D.bocki,140010837,266330,1,1766,1.26133e-05,133338528,0.952344
D.bocki,140010837,462596,1,1765,1.26062e-05,133340293,0.952357
D.bocki,140010837,457988,1,1765,1.26062e-05,133342058,0.95237
D.bocki,140010837,463245,1,1764,1.2599e-05,133343822,0.952382
D.bocki,140010837,455788,1,1764,1.2599e-05,133345586,0.952395
D.bocki,140010837,91910,1,1762,1.25847e-05,133347348,0.952407
D.bocki,140010837,462136,1,1762,1.25847e-05,133349110,0.95242
D.bocki,140010837,459446,1,1762,1.25847e-05,133350872,0.952433
D.bocki,140010837,463453,1,1761,1.25776e-05,133352633,0.952445
D.bocki,140010837,460941,1,1761,1.25776e-05,133354394,0.952458
D.bocki,140010837,456108,1,1761,1.25776e-05,133356155,0.95247
D.bocki,140010837,456655,1,1760,1.25705e-05,133357915,0.952483
D.bocki,140010837,456952,1,1759,1.25633e-05,133359674,0.952495
D.bocki,140010837,257357,1,1758,1.25562e-05,133361432,0.952508
D.bocki,140010837,109249,1,1758,1.25562e-05,133363190,0.95252
D.bocki,140010837,461024,1,1757,1.2549e-05,133364947,0.952533
D.bocki,140010837,456852,1,1756,1.25419e-05,133366703,0.952546
D.bocki,140010837,460142,1,1755,1.25347e-05,133368458,0.952558
D.bocki,140010837,458659,1,1755,1.25347e-05,133370213,0.952571
D.bocki,140010837,458177,1,1755,1.25347e-05,133371968,0.952583
D.bocki,140010837,456967,1,1755,1.25347e-05,133373723,0.952596
D.bocki,140010837,461809,1,1753,1.25205e-05,133375476,0.952608
D.bocki,140010837,460015,1,1751,1.25062e-05,133377227,0.952621
D.bocki,140010837,460781,1,1750,1.2499e-05,133378977,0.952633
D.bocki,140010837,463102,1,1749,1.24919e-05,133380726,0.952646
D.bocki,140010837,72910,1,1747,1.24776e-05,133382473,0.952658
D.bocki,140010837,458162,1,1747,1.24776e-05,133384220,0.952671
D.bocki,140010837,457712,1,1747,1.24776e-05,133385967,0.952683
D.bocki,140010837,456172,1,1747,1.24776e-05,133387714,0.952696
D.bocki,140010837,462425,1,1745,1.24633e-05,133389459,0.952708
D.bocki,140010837,462166,1,1745,1.24633e-05,133391204,0.952721
D.bocki,140010837,459380,1,1745,1.24633e-05,133392949,0.952733
D.bocki,140010837,458750,1,1745,1.24633e-05,133394694,0.952745
D.bocki,140010837,456582,1,1745,1.24633e-05,133396439,0.952758
D.bocki,140010837,456453,1,1745,1.24633e-05,133398184,0.95277
D.bocki,140010837,455993,1,1745,1.24633e-05,133399929,0.952783
D.bocki,140010837,379778,1,1745,1.24633e-05,133401674,0.952795
D.bocki,140010837,461760,1,1744,1.24562e-05,133403418,0.952808
D.bocki,140010837,457819,1,1743,1.2449e-05,133405161,0.95282
D.bocki,140010837,455762,1,1743,1.2449e-05,133406904,0.952833
D.bocki,140010837,450641,1,1743,1.2449e-05,133408647,0.952845
D.bocki,140010837,30475,1,1743,1.2449e-05,133410390,0.952858
D.bocki,140010837,339081,1,1742,1.24419e-05,133412132,0.95287
D.bocki,140010837,456317,1,1741,1.24348e-05,133413873,0.952882
D.bocki,140010837,456166,1,1741,1.24348e-05,133415614,0.952895
D.bocki,140010837,343158,1,1740,1.24276e-05,133417354,0.952907
D.bocki,140010837,458639,1,1739,1.24205e-05,133419093,0.95292
D.bocki,140010837,398724,1,1739,1.24205e-05,133420832,0.952932
D.bocki,140010837,463157,1,1738,1.24133e-05,133422570,0.952945
D.bocki,140010837,456848,1,1738,1.24133e-05,133424308,0.952957
D.bocki,140010837,460267,1,1737,1.24062e-05,133426045,0.952969
D.bocki,140010837,457031,1,1737,1.24062e-05,133427782,0.952982
D.bocki,140010837,456474,1,1737,1.24062e-05,133429519,0.952994
D.bocki,140010837,459861,1,1736,1.2399e-05,133431255,0.953007
D.bocki,140010837,461464,1,1734,1.23848e-05,133432989,0.953019
D.bocki,140010837,456062,1,1734,1.23848e-05,133434723,0.953031
D.bocki,140010837,460877,1,1733,1.23776e-05,133436456,0.953044
D.bocki,140010837,462539,1,1732,1.23705e-05,133438188,0.953056
D.bocki,140010837,456686,1,1732,1.23705e-05,133439920,0.953069
D.bocki,140010837,323718,1,1732,1.23705e-05,133441652,0.953081
D.bocki,140010837,457480,1,1727,1.23348e-05,133443379,0.953093
D.bocki,140010837,456743,1,1727,1.23348e-05,133445106,0.953106
D.bocki,140010837,462825,1,1726,1.23276e-05,133446832,0.953118
D.bocki,140010837,460239,1,1725,1.23205e-05,133448557,0.95313
D.bocki,140010837,462855,1,1724,1.23133e-05,133450281,0.953143
D.bocki,140010837,460083,1,1724,1.23133e-05,133452005,0.953155
D.bocki,140010837,460828,1,1723,1.23062e-05,133453728,0.953167
D.bocki,140010837,160230,1,1721,1.22919e-05,133455449,0.953179
D.bocki,140010837,456464,1,1719,1.22776e-05,133457168,0.953192
D.bocki,140010837,456349,1,1719,1.22776e-05,133458887,0.953204
D.bocki,140010837,461394,1,1717,1.22633e-05,133460604,0.953216
D.bocki,140010837,460318,1,1717,1.22633e-05,133462321,0.953229
D.bocki,140010837,461313,1,1716,1.22562e-05,133464037,0.953241
D.bocki,140010837,302059,1,1716,1.22562e-05,133465753,0.953253
D.bocki,140010837,456353,1,1715,1.22491e-05,133467468,0.953265
D.bocki,140010837,119823,1,1715,1.22491e-05,133469183,0.953278
D.bocki,140010837,89003,1,1714,1.22419e-05,133470897,0.95329
D.bocki,140010837,461680,1,1714,1.22419e-05,133472611,0.953302
D.bocki,140010837,461395,1,1713,1.22348e-05,133474324,0.953314
D.bocki,140010837,460501,1,1713,1.22348e-05,133476037,0.953326
D.bocki,140010837,456171,1,1713,1.22348e-05,133477750,0.953339
D.bocki,140010837,387145,1,1713,1.22348e-05,133479463,0.953351
D.bocki,140010837,460744,1,1710,1.22133e-05,133481173,0.953363
D.bocki,140010837,456912,1,1710,1.22133e-05,133482883,0.953375
D.bocki,140010837,31793,1,1710,1.22133e-05,133484593,0.953388
D.bocki,140010837,463536,1,1709,1.22062e-05,133486302,0.9534
D.bocki,140010837,463152,1,1709,1.22062e-05,133488011,0.953412
D.bocki,140010837,457341,1,1707,1.21919e-05,133489718,0.953424
D.bocki,140010837,457981,1,1706,1.21848e-05,133491424,0.953436
D.bocki,140010837,461083,1,1705,1.21776e-05,133493129,0.953449
D.bocki,140010837,460730,1,1702,1.21562e-05,133494831,0.953461
D.bocki,140010837,264177,1,1702,1.21562e-05,133496533,0.953473
D.bocki,140010837,462296,1,1701,1.21491e-05,133498234,0.953485
D.bocki,140010837,459278,1,1700,1.21419e-05,133499934,0.953497
D.bocki,140010837,458887,1,1699,1.21348e-05,133501633,0.953509
D.bocki,140010837,458821,1,1698,1.21276e-05,133503331,0.953521
D.bocki,140010837,462414,1,1697,1.21205e-05,133505028,0.953534
D.bocki,140010837,457521,1,1697,1.21205e-05,133506725,0.953546
D.bocki,140010837,459949,1,1696,1.21133e-05,133508421,0.953558
D.bocki,140010837,457377,1,1696,1.21133e-05,133510117,0.95357
D.bocki,140010837,35336,1,1696,1.21133e-05,133511813,0.953582
D.bocki,140010837,459219,1,1695,1.21062e-05,133513508,0.953594
D.bocki,140010837,456198,1,1694,1.20991e-05,133515202,0.953606
D.bocki,140010837,459029,1,1688,1.20562e-05,133516890,0.953618
D.bocki,140010837,443363,1,1687,1.20491e-05,133518577,0.95363
D.bocki,140010837,459907,1,1686,1.20419e-05,133520263,0.953642
D.bocki,140010837,453061,1,1684,1.20276e-05,133521947,0.953654
D.bocki,140010837,458680,1,1683,1.20205e-05,133523630,0.953666
D.bocki,140010837,460238,1,1681,1.20062e-05,133525311,0.953678
D.bocki,140010837,457326,1,1681,1.20062e-05,133526992,0.95369
D.bocki,140010837,456073,1,1681,1.20062e-05,133528673,0.953702
D.bocki,140010837,459273,1,1679,1.19919e-05,133530352,0.953714
D.bocki,140010837,259265,1,1679,1.19919e-05,133532031,0.953726
D.bocki,140010837,460869,1,1678,1.19848e-05,133533709,0.953738
D.bocki,140010837,237998,1,1678,1.19848e-05,133535387,0.95375
D.bocki,140010837,463284,1,1677,1.19776e-05,133537064,0.953762
D.bocki,140010837,460601,1,1677,1.19776e-05,133538741,0.953774
D.bocki,140010837,461522,1,1676,1.19705e-05,133540417,0.953786
D.bocki,140010837,462371,1,1675,1.19634e-05,133542092,0.953798
D.bocki,140010837,462119,1,1675,1.19634e-05,133543767,0.95381
D.bocki,140010837,459084,1,1675,1.19634e-05,133545442,0.953822
D.bocki,140010837,457822,1,1675,1.19634e-05,133547117,0.953834
D.bocki,140010837,455781,1,1675,1.19634e-05,133548792,0.953846
D.bocki,140010837,461316,1,1674,1.19562e-05,133550466,0.953858
D.bocki,140010837,456258,1,1674,1.19562e-05,133552140,0.95387
D.bocki,140010837,458381,1,1673,1.19491e-05,133553813,0.953882
D.bocki,140010837,457967,1,1673,1.19491e-05,133555486,0.953894
D.bocki,140010837,457557,1,1673,1.19491e-05,133557159,0.953906
D.bocki,140010837,397380,1,1672,1.19419e-05,133558831,0.953918
D.bocki,140010837,462919,1,1671,1.19348e-05,133560502,0.95393
D.bocki,140010837,462604,1,1671,1.19348e-05,133562173,0.953942
D.bocki,140010837,458519,1,1671,1.19348e-05,133563844,0.953954
D.bocki,140010837,458047,1,1671,1.19348e-05,133565515,0.953966
D.bocki,140010837,461006,1,1670,1.19276e-05,133567185,0.953977
D.bocki,140010837,459101,1,1669,1.19205e-05,133568854,0.953989
D.bocki,140010837,460502,1,1668,1.19134e-05,133570522,0.954001
D.bocki,140010837,66891,1,1666,1.18991e-05,133572188,0.954013
D.bocki,140010837,62780,1,1666,1.18991e-05,133573854,0.954025
D.bocki,140010837,461087,1,1666,1.18991e-05,133575520,0.954037
D.bocki,140010837,461773,1,1664,1.18848e-05,133577184,0.954049
D.bocki,140010837,458544,1,1664,1.18848e-05,133578848,0.954061
D.bocki,140010837,173605,1,1664,1.18848e-05,133580512,0.954073
D.bocki,140010837,456799,1,1663,1.18777e-05,133582175,0.954085
D.bocki,140010837,461942,1,1662,1.18705e-05,133583837,0.954096
D.bocki,140010837,458610,1,1662,1.18705e-05,133585499,0.954108
D.bocki,140010837,457250,1,1662,1.18705e-05,133587161,0.95412
D.bocki,140010837,228636,1,1662,1.18705e-05,133588823,0.954132
D.bocki,140010837,458725,1,1661,1.18634e-05,133590484,0.954144
D.bocki,140010837,462496,1,1660,1.18562e-05,133592144,0.954156
D.bocki,140010837,172097,1,1660,1.18562e-05,133593804,0.954168
D.bocki,140010837,458942,1,1659,1.18491e-05,133595463,0.954179
D.bocki,140010837,460009,1,1657,1.18348e-05,133597120,0.954191
D.bocki,140010837,457656,1,1656,1.18277e-05,133598776,0.954203
D.bocki,140010837,461979,1,1655,1.18205e-05,133600431,0.954215
D.bocki,140010837,461513,1,1655,1.18205e-05,133602086,0.954227
D.bocki,140010837,460356,1,1655,1.18205e-05,133603741,0.954239
D.bocki,140010837,457730,1,1655,1.18205e-05,133605396,0.95425
D.bocki,140010837,73480,1,1654,1.18134e-05,133607050,0.954262
D.bocki,140010837,460499,1,1654,1.18134e-05,133608704,0.954274
D.bocki,140010837,462074,1,1653,1.18062e-05,133610357,0.954286
D.bocki,140010837,461383,1,1653,1.18062e-05,133612010,0.954298
D.bocki,140010837,460270,1,1653,1.18062e-05,133613663,0.954309
D.bocki,140010837,356010,1,1653,1.18062e-05,133615316,0.954321
D.bocki,140010837,341999,1,1653,1.18062e-05,133616969,0.954333
D.bocki,140010837,58720,1,1652,1.17991e-05,133618621,0.954345
D.bocki,140010837,417402,1,1652,1.17991e-05,133620273,0.954357
D.bocki,140010837,28154,1,1652,1.17991e-05,133621925,0.954368
D.bocki,140010837,119456,1,1652,1.17991e-05,133623577,0.95438
D.bocki,140010837,460021,1,1651,1.17919e-05,133625228,0.954392
D.bocki,140010837,459872,1,1651,1.17919e-05,133626879,0.954404
D.bocki,140010837,458993,1,1651,1.17919e-05,133628530,0.954416
D.bocki,140010837,457676,1,1651,1.17919e-05,133630181,0.954427
D.bocki,140010837,457576,1,1651,1.17919e-05,133631832,0.954439
D.bocki,140010837,461280,1,1649,1.17777e-05,133633481,0.954451
D.bocki,140010837,458707,1,1649,1.17777e-05,133635130,0.954463
D.bocki,140010837,462814,1,1648,1.17705e-05,133636778,0.954475
D.bocki,140010837,458010,1,1648,1.17705e-05,133638426,0.954486
D.bocki,140010837,457721,1,1648,1.17705e-05,133640074,0.954498
D.bocki,140010837,461094,1,1647,1.17634e-05,133641721,0.95451
D.bocki,140010837,202392,1,1645,1.17491e-05,133643366,0.954522
D.bocki,140010837,460130,1,1644,1.17419e-05,133645010,0.954533
D.bocki,140010837,456050,1,1642,1.17277e-05,133646652,0.954545
D.bocki,140010837,451612,1,1642,1.17277e-05,133648294,0.954557
D.bocki,140010837,34574,1,1641,1.17205e-05,133649935,0.954569
D.bocki,140010837,461408,1,1639,1.17062e-05,133651574,0.95458
D.bocki,140010837,462153,1,1637,1.1692e-05,133653211,0.954592
D.bocki,140010837,456726,1,1637,1.1692e-05,133654848,0.954604
D.bocki,140010837,461702,1,1636,1.16848e-05,133656484,0.954615
D.bocki,140010837,461889,1,1635,1.16777e-05,133658119,0.954627
D.bocki,140010837,458272,1,1635,1.16777e-05,133659754,0.954639
D.bocki,140010837,456813,1,1633,1.16634e-05,133661387,0.95465
D.bocki,140010837,456438,1,1633,1.16634e-05,133663020,0.954662
D.bocki,140010837,457275,1,1630,1.1642e-05,133664650,0.954674
D.bocki,140010837,457078,1,1630,1.1642e-05,133666280,0.954685
D.bocki,140010837,274205,1,1630,1.1642e-05,133667910,0.954697
D.bocki,140010837,462254,1,1629,1.16348e-05,133669539,0.954709
D.bocki,140010837,461950,1,1629,1.16348e-05,133671168,0.95472
D.bocki,140010837,450903,1,1628,1.16277e-05,133672796,0.954732
D.bocki,140010837,462669,1,1626,1.16134e-05,133674422,0.954743
D.bocki,140010837,462617,1,1626,1.16134e-05,133676048,0.954755
D.bocki,140010837,457403,1,1626,1.16134e-05,133677674,0.954767
D.bocki,140010837,456720,1,1626,1.16134e-05,133679300,0.954778
D.bocki,140010837,279906,1,1626,1.16134e-05,133680926,0.95479
D.bocki,140010837,146601,1,1626,1.16134e-05,133682552,0.954801
D.bocki,140010837,461018,1,1625,1.16062e-05,133684177,0.954813
D.bocki,140010837,320237,1,1625,1.16062e-05,133685802,0.954825
D.bocki,140010837,440450,1,1624,1.15991e-05,133687426,0.954836
D.bocki,140010837,360664,1,1624,1.15991e-05,133689050,0.954848
D.bocki,140010837,461598,1,1623,1.1592e-05,133690673,0.954859
D.bocki,140010837,248390,1,1623,1.1592e-05,133692296,0.954871
D.bocki,140010837,459428,1,1622,1.15848e-05,133693918,0.954883
D.bocki,140010837,116414,1,1621,1.15777e-05,133695539,0.954894
D.bocki,140010837,52357,1,1620,1.15705e-05,133697159,0.954906
D.bocki,140010837,460470,1,1619,1.15634e-05,133698778,0.954917
D.bocki,140010837,463563,1,1618,1.15562e-05,133700396,0.954929
D.bocki,140010837,462566,1,1618,1.15562e-05,133702014,0.95494
D.bocki,140010837,286981,1,1618,1.15562e-05,133703632,0.954952
D.bocki,140010837,241671,1,1618,1.15562e-05,133705250,0.954964
D.bocki,140010837,459117,1,1617,1.15491e-05,133706867,0.954975
D.bocki,140010837,455827,1,1617,1.15491e-05,133708484,0.954987
D.bocki,140010837,155282,1,1617,1.15491e-05,133710101,0.954998
D.bocki,140010837,461766,1,1616,1.1542e-05,133711717,0.95501
D.bocki,140010837,459892,1,1616,1.1542e-05,133713333,0.955021
D.bocki,140010837,458965,1,1615,1.15348e-05,133714948,0.955033
D.bocki,140010837,326967,1,1615,1.15348e-05,133716563,0.955044
D.bocki,140010837,108250,1,1615,1.15348e-05,133718178,0.955056
D.bocki,140010837,4660,1,1614,1.15277e-05,133719792,0.955067
D.bocki,140010837,462527,1,1614,1.15277e-05,133721406,0.955079
D.bocki,140010837,461435,1,1614,1.15277e-05,133723020,0.95509
D.bocki,140010837,452440,1,1614,1.15277e-05,133724634,0.955102
D.bocki,140010837,197213,1,1613,1.15205e-05,133726247,0.955114
D.bocki,140010837,401275,1,1612,1.15134e-05,133727859,0.955125
D.bocki,140010837,460928,1,1611,1.15063e-05,133729470,0.955137
D.bocki,140010837,457500,1,1610,1.14991e-05,133731080,0.955148
D.bocki,140010837,457198,1,1610,1.14991e-05,133732690,0.95516
D.bocki,140010837,461129,1,1608,1.14848e-05,133734298,0.955171
D.bocki,140010837,457889,1,1608,1.14848e-05,133735906,0.955183
D.bocki,140010837,462412,1,1606,1.14705e-05,133737512,0.955194
D.bocki,140010837,459468,1,1606,1.14705e-05,133739118,0.955205
D.bocki,140010837,456723,1,1606,1.14705e-05,133740724,0.955217
D.bocki,140010837,460436,1,1605,1.14634e-05,133742329,0.955228
D.bocki,140010837,459334,1,1605,1.14634e-05,133743934,0.95524
D.bocki,140010837,127322,1,1604,1.14563e-05,133745538,0.955251
D.bocki,140010837,459612,1,1603,1.14491e-05,133747141,0.955263
D.bocki,140010837,458949,1,1603,1.14491e-05,133748744,0.955274
D.bocki,140010837,459333,1,1602,1.1442e-05,133750346,0.955286
D.bocki,140010837,456990,1,1602,1.1442e-05,133751948,0.955297
D.bocki,140010837,453136,1,1602,1.1442e-05,133753550,0.955309
D.bocki,140010837,198103,1,1602,1.1442e-05,133755152,0.95532
D.bocki,140010837,461700,1,1601,1.14348e-05,133756753,0.955331
D.bocki,140010837,157776,1,1601,1.14348e-05,133758354,0.955343
D.bocki,140010837,72058,1,1599,1.14205e-05,133759953,0.955354
D.bocki,140010837,63518,1,1599,1.14205e-05,133761552,0.955366
D.bocki,140010837,457646,1,1599,1.14205e-05,133763151,0.955377
D.bocki,140010837,311468,1,1599,1.14205e-05,133764750,0.955389
D.bocki,140010837,462649,1,1598,1.14134e-05,133766348,0.9554
D.bocki,140010837,459713,1,1598,1.14134e-05,133767946,0.955411
D.bocki,140010837,456822,1,1598,1.14134e-05,133769544,0.955423
D.bocki,140010837,456819,1,1597,1.14063e-05,133771141,0.955434
D.bocki,140010837,271063,1,1597,1.14063e-05,133772738,0.955446
D.bocki,140010837,253793,1,1597,1.14063e-05,133774335,0.955457
D.bocki,140010837,187072,1,1597,1.14063e-05,133775932,0.955468
D.bocki,140010837,56349,1,1596,1.13991e-05,133777528,0.95548
D.bocki,140010837,459543,1,1595,1.1392e-05,133779123,0.955491
D.bocki,140010837,456985,1,1595,1.1392e-05,133780718,0.955503
D.bocki,140010837,402174,1,1594,1.13848e-05,133782312,0.955514
D.bocki,140010837,2820,1,1594,1.13848e-05,133783906,0.955525
D.bocki,140010837,233888,1,1594,1.13848e-05,133785500,0.955537
D.bocki,140010837,67702,1,1593,1.13777e-05,133787093,0.955548
D.bocki,140010837,458684,1,1593,1.13777e-05,133788686,0.95556
D.bocki,140010837,457039,1,1592,1.13705e-05,133790278,0.955571
D.bocki,140010837,371837,1,1591,1.13634e-05,133791869,0.955582
D.bocki,140010837,461066,1,1588,1.1342e-05,133793457,0.955594
D.bocki,140010837,383689,1,1587,1.13348e-05,133795044,0.955605
D.bocki,140010837,181170,1,1587,1.13348e-05,133796631,0.955616
D.bocki,140010837,79954,1,1585,1.13206e-05,133798216,0.955628
D.bocki,140010837,50468,1,1585,1.13206e-05,133799801,0.955639
D.bocki,140010837,334722,1,1585,1.13206e-05,133801386,0.95565
D.bocki,140010837,318547,1,1585,1.13206e-05,133802971,0.955662
D.bocki,140010837,458303,1,1584,1.13134e-05,133804555,0.955673
D.bocki,140010837,457387,1,1584,1.13134e-05,133806139,0.955684
D.bocki,140010837,456826,1,1584,1.13134e-05,133807723,0.955695
D.bocki,140010837,460374,1,1583,1.13063e-05,133809306,0.955707
D.bocki,140010837,456821,1,1583,1.13063e-05,133810889,0.955718
D.bocki,140010837,404443,1,1582,1.12991e-05,133812471,0.955729
D.bocki,140010837,457851,1,1581,1.1292e-05,133814052,0.955741
D.bocki,140010837,460205,1,1580,1.12848e-05,133815632,0.955752
D.bocki,140010837,459391,1,1580,1.12848e-05,133817212,0.955763
D.bocki,140010837,458604,1,1580,1.12848e-05,133818792,0.955775
D.bocki,140010837,457853,1,1580,1.12848e-05,133820372,0.955786
D.bocki,140010837,456398,1,1579,1.12777e-05,133821951,0.955797
D.bocki,140010837,454558,1,1579,1.12777e-05,133823530,0.955808
D.bocki,140010837,458148,1,1578,1.12706e-05,133825108,0.95582
D.bocki,140010837,458025,1,1577,1.12634e-05,133826685,0.955831
D.bocki,140010837,460332,1,1576,1.12563e-05,133828261,0.955842
D.bocki,140010837,375690,1,1576,1.12563e-05,133829837,0.955853
D.bocki,140010837,458054,1,1575,1.12491e-05,133831412,0.955865
D.bocki,140010837,356730,1,1575,1.12491e-05,133832987,0.955876
D.bocki,140010837,456627,1,1573,1.12348e-05,133834560,0.955887
D.bocki,140010837,143261,1,1573,1.12348e-05,133836133,0.955898
D.bocki,140010837,455920,1,1572,1.12277e-05,133837705,0.95591
D.bocki,140010837,459251,1,1571,1.12206e-05,133839276,0.955921
D.bocki,140010837,457317,1,1571,1.12206e-05,133840847,0.955932
D.bocki,140010837,456918,1,1571,1.12206e-05,133842418,0.955943
D.bocki,140010837,460620,1,1570,1.12134e-05,133843988,0.955954
D.bocki,140010837,457425,1,1568,1.11991e-05,133845556,0.955966
D.bocki,140010837,459293,1,1567,1.1192e-05,133847123,0.955977
D.bocki,140010837,461829,1,1566,1.11848e-05,133848689,0.955988
D.bocki,140010837,459681,1,1566,1.11848e-05,133850255,0.955999
D.bocki,140010837,459672,1,1565,1.11777e-05,133851820,0.95601
D.bocki,140010837,456563,1,1565,1.11777e-05,133853385,0.956022
D.bocki,140010837,162039,1,1564,1.11706e-05,133854949,0.956033
D.bocki,140010837,461741,1,1563,1.11634e-05,133856512,0.956044
D.bocki,140010837,460129,1,1563,1.11634e-05,133858075,0.956055
D.bocki,140010837,459255,1,1562,1.11563e-05,133859637,0.956066
D.bocki,140010837,458197,1,1562,1.11563e-05,133861199,0.956077
D.bocki,140010837,224926,1,1562,1.11563e-05,133862761,0.956089
D.bocki,140010837,462177,1,1560,1.1142e-05,133864321,0.9561
D.bocki,140010837,461536,1,1560,1.1142e-05,133865881,0.956111
D.bocki,140010837,460784,1,1560,1.1142e-05,133867441,0.956122
D.bocki,140010837,456276,1,1560,1.1142e-05,133869001,0.956133
D.bocki,140010837,453387,1,1560,1.1142e-05,133870561,0.956144
D.bocki,140010837,461194,1,1559,1.11349e-05,133872120,0.956155
D.bocki,140010837,457213,1,1559,1.11349e-05,133873679,0.956167
D.bocki,140010837,460059,1,1556,1.11134e-05,133875235,0.956178
D.bocki,140010837,455967,1,1556,1.11134e-05,133876791,0.956189
D.bocki,140010837,458941,1,1555,1.11063e-05,133878346,0.9562
D.bocki,140010837,211292,1,1555,1.11063e-05,133879901,0.956211
D.bocki,140010837,108406,1,1555,1.11063e-05,133881456,0.956222
D.bocki,140010837,463274,1,1553,1.1092e-05,133883009,0.956233
D.bocki,140010837,457106,1,1553,1.1092e-05,133884562,0.956244
D.bocki,140010837,24142,1,1553,1.1092e-05,133886115,0.956255
D.bocki,140010837,305203,1,1549,1.10634e-05,133887664,0.956266
D.bocki,140010837,458505,1,1548,1.10563e-05,133889212,0.956277
D.bocki,140010837,458018,1,1548,1.10563e-05,133890760,0.956289
D.bocki,140010837,179188,1,1546,1.1042e-05,133892306,0.9563
D.bocki,140010837,458122,1,1545,1.10349e-05,133893851,0.956311
D.bocki,140010837,456923,1,1545,1.10349e-05,133895396,0.956322
D.bocki,140010837,144681,1,1545,1.10349e-05,133896941,0.956333
D.bocki,140010837,461757,1,1544,1.10277e-05,133898485,0.956344
D.bocki,140010837,459494,1,1544,1.10277e-05,133900029,0.956355
D.bocki,140010837,459162,1,1543,1.10206e-05,133901572,0.956366
D.bocki,140010837,458064,1,1543,1.10206e-05,133903115,0.956377
D.bocki,140010837,458417,1,1542,1.10134e-05,133904657,0.956388
D.bocki,140010837,457650,1,1542,1.10134e-05,133906199,0.956399
D.bocki,140010837,461496,1,1541,1.10063e-05,133907740,0.95641
D.bocki,140010837,460969,1,1541,1.10063e-05,133909281,0.956421
D.bocki,140010837,20271,1,1540,1.09991e-05,133910821,0.956432
D.bocki,140010837,460965,1,1538,1.09849e-05,133912359,0.956443
D.bocki,140010837,395288,1,1537,1.09777e-05,133913896,0.956454
D.bocki,140010837,458350,1,1536,1.09706e-05,133915432,0.956465
D.bocki,140010837,463258,1,1535,1.09634e-05,133916967,0.956476
D.bocki,140010837,462250,1,1535,1.09634e-05,133918502,0.956487
D.bocki,140010837,460317,1,1535,1.09634e-05,133920037,0.956498
D.bocki,140010837,459590,1,1535,1.09634e-05,133921572,0.956509
D.bocki,140010837,457844,1,1535,1.09634e-05,133923107,0.95652
D.bocki,140010837,361291,1,1535,1.09634e-05,133924642,0.956531
D.bocki,140010837,151544,1,1535,1.09634e-05,133926177,0.956542
D.bocki,140010837,459581,1,1534,1.09563e-05,133927711,0.956552
D.bocki,140010837,82341,1,1533,1.09492e-05,133929244,0.956563
D.bocki,140010837,459188,1,1533,1.09492e-05,133930777,0.956574
D.bocki,140010837,450303,1,1533,1.09492e-05,133932310,0.956585
D.bocki,140010837,257843,1,1531,1.09349e-05,133933841,0.956596
D.bocki,140010837,106494,1,1531,1.09349e-05,133935372,0.956607
D.bocki,140010837,72931,1,1530,1.09277e-05,133936902,0.956618
D.bocki,140010837,458238,1,1529,1.09206e-05,133938431,0.956629
D.bocki,140010837,459304,1,1528,1.09134e-05,133939959,0.95664
D.bocki,140010837,458896,1,1527,1.09063e-05,133941486,0.956651
D.bocki,140010837,462185,1,1526,1.08992e-05,133943012,0.956662
D.bocki,140010837,460017,1,1526,1.08992e-05,133944538,0.956673
D.bocki,140010837,461418,1,1525,1.0892e-05,133946063,0.956684
D.bocki,140010837,457715,1,1525,1.0892e-05,133947588,0.956694
D.bocki,140010837,456687,1,1524,1.08849e-05,133949112,0.956705
D.bocki,140010837,458600,1,1523,1.08777e-05,133950635,0.956716
D.bocki,140010837,462872,1,1522,1.08706e-05,133952157,0.956727
D.bocki,140010837,460145,1,1522,1.08706e-05,133953679,0.956738
D.bocki,140010837,462576,1,1521,1.08634e-05,133955200,0.956749
D.bocki,140010837,457164,1,1521,1.08634e-05,133956721,0.95676
D.bocki,140010837,461652,1,1520,1.08563e-05,133958241,0.956771
D.bocki,140010837,461346,1,1520,1.08563e-05,133959761,0.956781
D.bocki,140010837,459282,1,1520,1.08563e-05,133961281,0.956792
D.bocki,140010837,457638,1,1520,1.08563e-05,133962801,0.956803
D.bocki,140010837,456735,1,1520,1.08563e-05,133964321,0.956814
D.bocki,140010837,461345,1,1519,1.08492e-05,133965840,0.956825
D.bocki,140010837,458344,1,1519,1.08492e-05,133967359,0.956836
D.bocki,140010837,461493,1,1518,1.0842e-05,133968877,0.956846
D.bocki,140010837,460709,1,1518,1.0842e-05,133970395,0.956857
D.bocki,140010837,233369,1,1517,1.08349e-05,133971912,0.956868
D.bocki,140010837,223055,1,1517,1.08349e-05,133973429,0.956879
D.bocki,140010837,455775,1,1516,1.08277e-05,133974945,0.95689
D.bocki,140010837,274010,1,1516,1.08277e-05,133976461,0.956901
D.bocki,140010837,460334,1,1514,1.08134e-05,133977975,0.956911
D.bocki,140010837,442317,1,1514,1.08134e-05,133979489,0.956922
D.bocki,140010837,143637,1,1514,1.08134e-05,133981003,0.956933
D.bocki,140010837,459474,1,1513,1.08063e-05,133982516,0.956944
D.bocki,140010837,458679,1,1513,1.08063e-05,133984029,0.956955
D.bocki,140010837,461126,1,1512,1.07992e-05,133985541,0.956966
D.bocki,140010837,459243,1,1512,1.07992e-05,133987053,0.956976
D.bocki,140010837,127146,1,1512,1.07992e-05,133988565,0.956987
D.bocki,140010837,458702,1,1511,1.0792e-05,133990076,0.956998
D.bocki,140010837,457795,1,1511,1.0792e-05,133991587,0.957009
D.bocki,140010837,454309,1,1511,1.0792e-05,133993098,0.957019
D.bocki,140010837,448882,1,1511,1.0792e-05,133994609,0.95703
D.bocki,140010837,12703,1,1511,1.0792e-05,133996120,0.957041
D.bocki,140010837,459299,1,1510,1.07849e-05,133997630,0.957052
D.bocki,140010837,343022,1,1509,1.07777e-05,133999139,0.957063
D.bocki,140010837,462246,1,1508,1.07706e-05,134000647,0.957073
D.bocki,140010837,461524,1,1506,1.07563e-05,134002153,0.957084
D.bocki,140010837,461407,1,1505,1.07492e-05,134003658,0.957095
D.bocki,140010837,299951,1,1504,1.0742e-05,134005162,0.957106
D.bocki,140010837,455727,1,1501,1.07206e-05,134006663,0.957116
D.bocki,140010837,457072,1,1499,1.07063e-05,134008162,0.957127
D.bocki,140010837,460728,1,1498,1.06992e-05,134009660,0.957138
D.bocki,140010837,459107,1,1498,1.06992e-05,134011158,0.957148
D.bocki,140010837,456207,1,1498,1.06992e-05,134012656,0.957159
D.bocki,140010837,461020,1,1497,1.0692e-05,134014153,0.95717
D.bocki,140010837,457531,1,1497,1.0692e-05,134015650,0.957181
D.bocki,140010837,171975,1,1497,1.0692e-05,134017147,0.957191
D.bocki,140010837,458397,1,1496,1.06849e-05,134018643,0.957202
D.bocki,140010837,460909,1,1494,1.06706e-05,134020137,0.957213
D.bocki,140010837,460187,1,1494,1.06706e-05,134021631,0.957223
D.bocki,140010837,350542,1,1494,1.06706e-05,134023125,0.957234
D.bocki,140010837,383773,1,1493,1.06635e-05,134024618,0.957245
D.bocki,140010837,457980,1,1492,1.06563e-05,134026110,0.957255
D.bocki,140010837,456239,1,1490,1.0642e-05,134027600,0.957266
D.bocki,140010837,214249,1,1490,1.0642e-05,134029090,0.957277
D.bocki,140010837,462205,1,1489,1.06349e-05,134030579,0.957287
D.bocki,140010837,447246,1,1489,1.06349e-05,134032068,0.957298
D.bocki,140010837,452666,1,1487,1.06206e-05,134033555,0.957308
D.bocki,140010837,133402,1,1487,1.06206e-05,134035042,0.957319
D.bocki,140010837,458856,1,1486,1.06135e-05,134036528,0.95733
D.bocki,140010837,341175,1,1486,1.06135e-05,134038014,0.95734
D.bocki,140010837,73481,1,1485,1.06063e-05,134039499,0.957351
D.bocki,140010837,459272,1,1482,1.05849e-05,134040981,0.957361
D.bocki,140010837,458088,1,1482,1.05849e-05,134042463,0.957372
D.bocki,140010837,104577,1,1482,1.05849e-05,134043945,0.957383
D.bocki,140010837,95751,1,1481,1.05778e-05,134045426,0.957393
D.bocki,140010837,460125,1,1480,1.05706e-05,134046906,0.957404
D.bocki,140010837,390588,1,1477,1.05492e-05,134048383,0.957414
D.bocki,140010837,462497,1,1476,1.0542e-05,134049859,0.957425
D.bocki,140010837,221898,1,1476,1.0542e-05,134051335,0.957435
D.bocki,140010837,461438,1,1475,1.05349e-05,134052810,0.957446
D.bocki,140010837,9331,1,1474,1.05278e-05,134054284,0.957456
D.bocki,140010837,460106,1,1474,1.05278e-05,134055758,0.957467
D.bocki,140010837,456668,1,1473,1.05206e-05,134057231,0.957478
D.bocki,140010837,458905,1,1471,1.05063e-05,134058702,0.957488
D.bocki,140010837,308892,1,1471,1.05063e-05,134060173,0.957499
D.bocki,140010837,274289,1,1469,1.0492e-05,134061642,0.957509
D.bocki,140010837,461060,1,1468,1.04849e-05,134063110,0.95752
D.bocki,140010837,451736,1,1468,1.04849e-05,134064578,0.95753
D.bocki,140010837,457052,1,1467,1.04778e-05,134066045,0.95754
D.bocki,140010837,394613,1,1466,1.04706e-05,134067511,0.957551
D.bocki,140010837,463315,1,1463,1.04492e-05,134068974,0.957561
D.bocki,140010837,459422,1,1462,1.0442e-05,134070436,0.957572
D.bocki,140010837,12243,1,1462,1.0442e-05,134071898,0.957582
D.bocki,140010837,456993,1,1461,1.04349e-05,134073359,0.957593
D.bocki,140010837,456910,1,1461,1.04349e-05,134074820,0.957603
D.bocki,140010837,142188,1,1460,1.04278e-05,134076280,0.957614
D.bocki,140010837,460113,1,1459,1.04206e-05,134077739,0.957624
D.bocki,140010837,456853,1,1459,1.04206e-05,134079198,0.957634
D.bocki,140010837,460233,1,1458,1.04135e-05,134080656,0.957645
D.bocki,140010837,458820,1,1457,1.04063e-05,134082113,0.957655
D.bocki,140010837,457987,1,1457,1.04063e-05,134083570,0.957666
D.bocki,140010837,461257,1,1456,1.03992e-05,134085026,0.957676
D.bocki,140010837,457249,1,1456,1.03992e-05,134086482,0.957686
D.bocki,140010837,463006,1,1455,1.03921e-05,134087937,0.957697
D.bocki,140010837,460299,1,1455,1.03921e-05,134089392,0.957707
D.bocki,140010837,459157,1,1455,1.03921e-05,134090847,0.957718
D.bocki,140010837,235334,1,1454,1.03849e-05,134092301,0.957728
D.bocki,140010837,458118,1,1453,1.03778e-05,134093754,0.957738
D.bocki,140010837,457814,1,1453,1.03778e-05,134095207,0.957749
D.bocki,140010837,12341,1,1453,1.03778e-05,134096660,0.957759
D.bocki,140010837,53296,1,1452,1.03706e-05,134098112,0.95777
D.bocki,140010837,462226,1,1451,1.03635e-05,134099563,0.95778
D.bocki,140010837,457872,1,1450,1.03563e-05,134101013,0.95779
D.bocki,140010837,460735,1,1449,1.03492e-05,134102462,0.957801
D.bocki,140010837,451944,1,1449,1.03492e-05,134103911,0.957811
D.bocki,140010837,420528,1,1449,1.03492e-05,134105360,0.957821
D.bocki,140010837,460286,1,1447,1.03349e-05,134106807,0.957832
D.bocki,140010837,238948,1,1447,1.03349e-05,134108254,0.957842
D.bocki,140010837,462134,1,1446,1.03278e-05,134109700,0.957852
D.bocki,140010837,221393,1,1446,1.03278e-05,134111146,0.957863
D.bocki,140010837,459235,1,1445,1.03206e-05,134112591,0.957873
D.bocki,140010837,457594,1,1445,1.03206e-05,134114036,0.957883
D.bocki,140010837,461374,1,1444,1.03135e-05,134115480,0.957894
D.bocki,140010837,461772,1,1443,1.03063e-05,134116923,0.957904
D.bocki,140010837,32858,1,1443,1.03063e-05,134118366,0.957914
D.bocki,140010837,233147,1,1443,1.03063e-05,134119809,0.957924
D.bocki,140010837,462072,1,1441,1.02921e-05,134121250,0.957935
D.bocki,140010837,462170,1,1440,1.02849e-05,134122690,0.957945
D.bocki,140010837,456087,1,1440,1.02849e-05,134124130,0.957955
D.bocki,140010837,455733,1,1440,1.02849e-05,134125570,0.957966
D.bocki,140010837,27900,1,1439,1.02778e-05,134127009,0.957976
D.bocki,140010837,460043,1,1438,1.02706e-05,134128447,0.957986
D.bocki,140010837,457457,1,1438,1.02706e-05,134129885,0.957996
D.bocki,140010837,68252,1,1435,1.02492e-05,134131320,0.958007
D.bocki,140010837,429522,1,1435,1.02492e-05,134132755,0.958017
D.bocki,140010837,462584,1,1434,1.02421e-05,134134189,0.958027
D.bocki,140010837,461682,1,1434,1.02421e-05,134135623,0.958037
D.bocki,140010837,461221,1,1433,1.02349e-05,134137056,0.958048
D.bocki,140010837,458062,1,1433,1.02349e-05,134138489,0.958058
D.bocki,140010837,460032,1,1430,1.02135e-05,134139919,0.958068
D.bocki,140010837,407387,1,1430,1.02135e-05,134141349,0.958078
D.bocki,140010837,460263,1,1429,1.02064e-05,134142778,0.958089
D.bocki,140010837,457006,1,1429,1.02064e-05,134144207,0.958099
D.bocki,140010837,455981,1,1429,1.02064e-05,134145636,0.958109
D.bocki,140010837,455948,1,1429,1.02064e-05,134147065,0.958119
D.bocki,140010837,460451,1,1428,1.01992e-05,134148493,0.958129
D.bocki,140010837,275978,1,1428,1.01992e-05,134149921,0.95814
D.bocki,140010837,463198,1,1427,1.01921e-05,134151348,0.95815
D.bocki,140010837,454674,1,1427,1.01921e-05,134152775,0.95816
D.bocki,140010837,32277,1,1427,1.01921e-05,134154202,0.95817
D.bocki,140010837,247940,1,1427,1.01921e-05,134155629,0.95818
D.bocki,140010837,462076,1,1426,1.01849e-05,134157055,0.958191
D.bocki,140010837,23985,1,1426,1.01849e-05,134158481,0.958201
D.bocki,140010837,462042,1,1425,1.01778e-05,134159906,0.958211
D.bocki,140010837,429982,1,1425,1.01778e-05,134161331,0.958221
D.bocki,140010837,461037,1,1424,1.01706e-05,134162755,0.958231
D.bocki,140010837,459346,1,1424,1.01706e-05,134164179,0.958241
D.bocki,140010837,362486,1,1424,1.01706e-05,134165603,0.958252
D.bocki,140010837,92617,1,1423,1.01635e-05,134167026,0.958262
D.bocki,140010837,171744,1,1423,1.01635e-05,134168449,0.958272
D.bocki,140010837,462454,1,1422,1.01564e-05,134169871,0.958282
D.bocki,140010837,101610,1,1420,1.01421e-05,134171291,0.958292
D.bocki,140010837,123491,1,1419,1.01349e-05,134172710,0.958302
D.bocki,140010837,460246,1,1418,1.01278e-05,134174128,0.958312
D.bocki,140010837,460653,1,1417,1.01206e-05,134175545,0.958323
D.bocki,140010837,459067,1,1415,1.01064e-05,134176960,0.958333
D.bocki,140010837,244914,1,1415,1.01064e-05,134178375,0.958343
D.bocki,140010837,457747,1,1414,1.00992e-05,134179789,0.958353
D.bocki,140010837,454491,1,1414,1.00992e-05,134181203,0.958363
D.bocki,140010837,456820,1,1413,1.00921e-05,134182616,0.958373
D.bocki,140010837,236982,1,1413,1.00921e-05,134184029,0.958383
D.bocki,140010837,458208,1,1412,1.00849e-05,134185441,0.958393
D.bocki,140010837,375507,1,1412,1.00849e-05,134186853,0.958403
D.bocki,140010837,9400,1,1411,1.00778e-05,134188264,0.958413
D.bocki,140010837,460686,1,1411,1.00778e-05,134189675,0.958423
D.bocki,140010837,462384,1,1410,1.00706e-05,134191085,0.958434
D.bocki,140010837,459784,1,1409,1.00635e-05,134192494,0.958444
D.bocki,140010837,459574,1,1409,1.00635e-05,134193903,0.958454
D.bocki,140010837,456324,1,1409,1.00635e-05,134195312,0.958464
D.bocki,140010837,462769,1,1408,1.00564e-05,134196720,0.958474
D.bocki,140010837,313935,1,1408,1.00564e-05,134198128,0.958484
D.bocki,140010837,237814,1,1408,1.00564e-05,134199536,0.958494
D.bocki,140010837,255655,1,1407,1.00492e-05,134200943,0.958504
D.bocki,140010837,69632,1,1406,1.00421e-05,134202349,0.958514
D.bocki,140010837,459759,1,1406,1.00421e-05,134203755,0.958524
D.bocki,140010837,458578,1,1406,1.00421e-05,134205161,0.958534
D.bocki,140010837,253241,1,1406,1.00421e-05,134206567,0.958544
D.bocki,140010837,460739,1,1404,1.00278e-05,134207971,0.958554
D.bocki,140010837,463356,1,1403,1.00207e-05,134209374,0.958564
D.bocki,140010837,459518,1,1403,1.00207e-05,134210777,0.958574
D.bocki,140010837,462164,1,1402,1.00135e-05,134212179,0.958584
D.bocki,140010837,395984,1,1402,1.00135e-05,134213581,0.958594
D.bocki,140010837,332734,1,1402,1.00135e-05,134214983,0.958604
D.bocki,140010837,181330,1,1402,1.00135e-05,134216385,0.958614
D.bocki,140010837,7515,1,1401,1.00064e-05,134217786,0.958624
D.bocki,140010837,70746,1,1400,9.99923e-06,134219186,0.958634
D.bocki,140010837,454732,1,1400,9.99923e-06,134220586,0.958644
D.bocki,140010837,34011,1,1400,9.99923e-06,134221986,0.958654
D.bocki,140010837,457859,1,1399,9.99208e-06,134223385,0.958664
D.bocki,140010837,457734,1,1398,9.98494e-06,134224783,0.958674
D.bocki,140010837,457219,1,1398,9.98494e-06,134226181,0.958684
D.bocki,140010837,456100,1,1398,9.98494e-06,134227579,0.958694
D.bocki,140010837,136731,1,1398,9.98494e-06,134228977,0.958704
D.bocki,140010837,34747,1,1397,9.9778e-06,134230374,0.958714
D.bocki,140010837,456333,1,1396,9.97066e-06,134231770,0.958724
D.bocki,140010837,460520,1,1395,9.96351e-06,134233165,0.958734
D.bocki,140010837,462280,1,1393,9.94923e-06,134234558,0.958744
D.bocki,140010837,433791,1,1393,9.94923e-06,134235951,0.958754
D.bocki,140010837,357206,1,1393,9.94923e-06,134237344,0.958764
D.bocki,140010837,277842,1,1393,9.94923e-06,134238737,0.958774
D.bocki,140010837,459896,1,1392,9.94209e-06,134240129,0.958784
D.bocki,140010837,459431,1,1392,9.94209e-06,134241521,0.958794
D.bocki,140010837,459941,1,1390,9.9278e-06,134242911,0.958804
D.bocki,140010837,328348,1,1390,9.9278e-06,134244301,0.958814
D.bocki,140010837,458196,1,1389,9.92066e-06,134245690,0.958824
D.bocki,140010837,456547,1,1387,9.90638e-06,134247077,0.958833
D.bocki,140010837,304082,1,1387,9.90638e-06,134248464,0.958843
D.bocki,140010837,461920,1,1386,9.89923e-06,134249850,0.958853
D.bocki,140010837,458251,1,1386,9.89923e-06,134251236,0.958863
D.bocki,140010837,459628,1,1385,9.89209e-06,134252621,0.958873
D.bocki,140010837,297674,1,1385,9.89209e-06,134254006,0.958883
D.bocki,140010837,276742,1,1385,9.89209e-06,134255391,0.958893
D.bocki,140010837,173045,1,1385,9.89209e-06,134256776,0.958903
D.bocki,140010837,459922,1,1384,9.88495e-06,134258160,0.958913
D.bocki,140010837,459402,1,1384,9.88495e-06,134259544,0.958923
D.bocki,140010837,307838,1,1384,9.88495e-06,134260928,0.958932
D.bocki,140010837,462482,1,1383,9.87781e-06,134262311,0.958942
D.bocki,140010837,458523,1,1382,9.87066e-06,134263693,0.958952
D.bocki,140010837,417093,1,1382,9.87066e-06,134265075,0.958962
D.bocki,140010837,279733,1,1382,9.87066e-06,134266457,0.958972
D.bocki,140010837,144191,1,1381,9.86352e-06,134267838,0.958982
D.bocki,140010837,458524,1,1380,9.85638e-06,134269218,0.958992
D.bocki,140010837,456448,1,1380,9.85638e-06,134270598,0.959001
D.bocki,140010837,61749,1,1379,9.84924e-06,134271977,0.959011
D.bocki,140010837,460312,1,1379,9.84924e-06,134273356,0.959021
D.bocki,140010837,194616,1,1379,9.84924e-06,134274735,0.959031
D.bocki,140010837,459840,1,1378,9.8421e-06,134276113,0.959041
D.bocki,140010837,295214,1,1375,9.82067e-06,134277488,0.959051
D.bocki,140010837,280980,1,1375,9.82067e-06,134278863,0.95906
D.bocki,140010837,144680,1,1375,9.82067e-06,134280238,0.95907
D.bocki,140010837,462622,1,1374,9.81353e-06,134281612,0.95908
D.bocki,140010837,3173,1,1373,9.80638e-06,134282985,0.95909
D.bocki,140010837,227039,1,1373,9.80638e-06,134284358,0.9591
D.bocki,140010837,264318,1,1372,9.79924e-06,134285730,0.95911
D.bocki,140010837,455860,1,1370,9.78496e-06,134287100,0.959119
D.bocki,140010837,353741,1,1370,9.78496e-06,134288470,0.959129
D.bocki,140010837,460929,1,1367,9.76353e-06,134289837,0.959139
D.bocki,140010837,459918,1,1367,9.76353e-06,134291204,0.959149
D.bocki,140010837,47059,1,1366,9.75639e-06,134292570,0.959158
D.bocki,140010837,462116,1,1366,9.75639e-06,134293936,0.959168
D.bocki,140010837,394828,1,1365,9.74925e-06,134295301,0.959178
D.bocki,140010837,77354,1,1364,9.7421e-06,134296665,0.959188
D.bocki,140010837,459730,1,1363,9.73496e-06,134298028,0.959197
D.bocki,140010837,456694,1,1362,9.72782e-06,134299390,0.959207
D.bocki,140010837,372232,1,1362,9.72782e-06,134300752,0.959217
D.bocki,140010837,368296,1,1362,9.72782e-06,134302114,0.959227
D.bocki,140010837,99819,1,1361,9.72068e-06,134303475,0.959236
D.bocki,140010837,462481,1,1361,9.72068e-06,134304836,0.959246
D.bocki,140010837,461297,1,1361,9.72068e-06,134306197,0.959256
D.bocki,140010837,460411,1,1360,9.71353e-06,134307557,0.959265
D.bocki,140010837,456126,1,1360,9.71353e-06,134308917,0.959275
D.bocki,140010837,458242,1,1359,9.70639e-06,134310276,0.959285
D.bocki,140010837,463172,1,1358,9.69925e-06,134311634,0.959295
D.bocki,140010837,461750,1,1358,9.69925e-06,134312992,0.959304
D.bocki,140010837,232196,1,1356,9.68496e-06,134314348,0.959314
D.bocki,140010837,458403,1,1355,9.67782e-06,134315703,0.959324
D.bocki,140010837,458132,1,1355,9.67782e-06,134317058,0.959333
D.bocki,140010837,457515,1,1354,9.67068e-06,134318412,0.959343
D.bocki,140010837,37453,1,1354,9.67068e-06,134319766,0.959353
D.bocki,140010837,299364,1,1354,9.67068e-06,134321120,0.959362
D.bocki,140010837,92212,1,1353,9.66354e-06,134322473,0.959372
D.bocki,140010837,457574,1,1353,9.66354e-06,134323826,0.959382
D.bocki,140010837,96354,1,1352,9.6564e-06,134325178,0.959391
D.bocki,140010837,206589,1,1352,9.6564e-06,134326530,0.959401
D.bocki,140010837,312865,1,1351,9.64925e-06,134327881,0.959411
D.bocki,140010837,461135,1,1350,9.64211e-06,134329231,0.95942
D.bocki,140010837,453268,1,1349,9.63497e-06,134330580,0.95943
D.bocki,140010837,461626,1,1348,9.62783e-06,134331928,0.95944
D.bocki,140010837,378244,1,1347,9.62068e-06,134333275,0.959449
D.bocki,140010837,36842,1,1347,9.62068e-06,134334622,0.959459
D.bocki,140010837,104223,1,1347,9.62068e-06,134335969,0.959468
D.bocki,140010837,80661,1,1346,9.61354e-06,134337315,0.959478
D.bocki,140010837,172712,1,1346,9.61354e-06,134338661,0.959488
D.bocki,140010837,80735,1,1345,9.6064e-06,134340006,0.959497
D.bocki,140010837,461387,1,1345,9.6064e-06,134341351,0.959507
D.bocki,140010837,404500,1,1345,9.6064e-06,134342696,0.959516
D.bocki,140010837,306964,1,1345,9.6064e-06,134344041,0.959526
D.bocki,140010837,167674,1,1345,9.6064e-06,134345386,0.959536
D.bocki,140010837,277620,1,1344,9.59926e-06,134346730,0.959545
D.bocki,140010837,165886,1,1344,9.59926e-06,134348074,0.959555
D.bocki,140010837,2346,1,1342,9.58497e-06,134349416,0.959564
D.bocki,140010837,60364,1,1341,9.57783e-06,134350757,0.959574
D.bocki,140010837,459964,1,1341,9.57783e-06,134352098,0.959584
D.bocki,140010837,460895,1,1338,9.5564e-06,134353436,0.959593
D.bocki,140010837,455783,1,1335,9.53498e-06,134354771,0.959603
D.bocki,140010837,274204,1,1335,9.53498e-06,134356106,0.959612
D.bocki,140010837,457615,1,1333,9.52069e-06,134357439,0.959622
D.bocki,140010837,286267,1,1333,9.52069e-06,134358772,0.959631
D.bocki,140010837,459063,1,1332,9.51355e-06,134360104,0.959641
D.bocki,140010837,199592,1,1332,9.51355e-06,134361436,0.95965
D.bocki,140010837,372114,1,1331,9.50641e-06,134362767,0.95966
D.bocki,140010837,82671,1,1329,9.49212e-06,134364096,0.959669
D.bocki,140010837,460946,1,1329,9.49212e-06,134365425,0.959679
D.bocki,140010837,456755,1,1328,9.48498e-06,134366753,0.959688
D.bocki,140010837,462976,1,1327,9.47784e-06,134368080,0.959698
D.bocki,140010837,458922,1,1326,9.4707e-06,134369406,0.959707
D.bocki,140010837,391866,1,1325,9.46355e-06,134370731,0.959717
D.bocki,140010837,365034,1,1325,9.46355e-06,134372056,0.959726
D.bocki,140010837,41344,1,1323,9.44927e-06,134373379,0.959736
D.bocki,140010837,198502,1,1323,9.44927e-06,134374702,0.959745
D.bocki,140010837,291521,1,1322,9.44213e-06,134376024,0.959754
D.bocki,140010837,459493,1,1321,9.43498e-06,134377345,0.959764
D.bocki,140010837,38105,1,1321,9.43498e-06,134378666,0.959773
D.bocki,140010837,26960,1,1321,9.43498e-06,134379987,0.959783
D.bocki,140010837,327078,1,1320,9.42784e-06,134381307,0.959792
D.bocki,140010837,451671,1,1318,9.41356e-06,134382625,0.959802
D.bocki,140010837,457653,1,1317,9.40641e-06,134383942,0.959811
D.bocki,140010837,370275,1,1317,9.40641e-06,134385259,0.95982
D.bocki,140010837,462420,1,1315,9.39213e-06,134386574,0.95983
D.bocki,140010837,226734,1,1311,9.36356e-06,134387885,0.959839
D.bocki,140010837,126478,1,1311,9.36356e-06,134389196,0.959849
D.bocki,140010837,461015,1,1309,9.34928e-06,134390505,0.959858
D.bocki,140010837,201551,1,1309,9.34928e-06,134391814,0.959867
D.bocki,140010837,222923,1,1307,9.33499e-06,134393121,0.959877
D.bocki,140010837,456654,1,1306,9.32785e-06,134394427,0.959886
D.bocki,140010837,173170,1,1305,9.32071e-06,134395732,0.959895
D.bocki,140010837,461747,1,1304,9.31356e-06,134397036,0.959905
D.bocki,140010837,311870,1,1303,9.30642e-06,134398339,0.959914
D.bocki,140010837,185936,1,1303,9.30642e-06,134399642,0.959923
D.bocki,140010837,6665,1,1302,9.29928e-06,134400944,0.959932
D.bocki,140010837,459914,1,1302,9.29928e-06,134402246,0.959942
D.bocki,140010837,423633,1,1302,9.29928e-06,134403548,0.959951
D.bocki,140010837,230196,1,1302,9.29928e-06,134404850,0.95996
D.bocki,140010837,458731,1,1301,9.29214e-06,134406151,0.95997
D.bocki,140010837,425765,1,1301,9.29214e-06,134407452,0.959979
D.bocki,140010837,460636,1,1300,9.285e-06,134408752,0.959988
D.bocki,140010837,312674,1,1299,9.27785e-06,134410051,0.959997
D.bocki,140010837,310592,1,1298,9.27071e-06,134411349,0.960007
D.bocki,140010837,456643,1,1297,9.26357e-06,134412646,0.960016
D.bocki,140010837,169379,1,1297,9.26357e-06,134413943,0.960025
D.bocki,140010837,461806,1,1296,9.25643e-06,134415239,0.960035
D.bocki,140010837,455955,1,1296,9.25643e-06,134416535,0.960044
D.bocki,140010837,247276,1,1295,9.24928e-06,134417830,0.960053
D.bocki,140010837,104162,1,1295,9.24928e-06,134419125,0.960062
D.bocki,140010837,462536,1,1293,9.235e-06,134420418,0.960072
D.bocki,140010837,462206,1,1293,9.235e-06,134421711,0.960081
D.bocki,140010837,231940,1,1293,9.235e-06,134423004,0.96009
D.bocki,140010837,17734,1,1293,9.235e-06,134424297,0.960099
D.bocki,140010837,461658,1,1292,9.22786e-06,134425589,0.960108
D.bocki,140010837,394396,1,1292,9.22786e-06,134426881,0.960118
D.bocki,140010837,252543,1,1292,9.22786e-06,134428173,0.960127
D.bocki,140010837,7712,1,1291,9.22071e-06,134429464,0.960136
D.bocki,140010837,456293,1,1291,9.22071e-06,134430755,0.960145
D.bocki,140010837,254538,1,1291,9.22071e-06,134432046,0.960155
D.bocki,140010837,459030,1,1290,9.21357e-06,134433336,0.960164
D.bocki,140010837,319479,1,1290,9.21357e-06,134434626,0.960173
D.bocki,140010837,282196,1,1290,9.21357e-06,134435916,0.960182
D.bocki,140010837,463161,1,1289,9.20643e-06,134437205,0.960191
D.bocki,140010837,78585,1,1288,9.19929e-06,134438493,0.960201
D.bocki,140010837,460679,1,1288,9.19929e-06,134439781,0.96021
D.bocki,140010837,459292,1,1288,9.19929e-06,134441069,0.960219
D.bocki,140010837,427010,1,1288,9.19929e-06,134442357,0.960228
D.bocki,140010837,172268,1,1288,9.19929e-06,134443645,0.960237
D.bocki,140010837,461923,1,1287,9.19215e-06,134444932,0.960247
D.bocki,140010837,462696,1,1286,9.185e-06,134446218,0.960256
D.bocki,140010837,66600,1,1285,9.17786e-06,134447503,0.960265
D.bocki,140010837,454488,1,1285,9.17786e-06,134448788,0.960274
D.bocki,140010837,433229,1,1285,9.17786e-06,134450073,0.960283
D.bocki,140010837,319223,1,1285,9.17786e-06,134451358,0.960293
D.bocki,140010837,124813,1,1285,9.17786e-06,134452643,0.960302
D.bocki,140010837,217553,1,1284,9.17072e-06,134453927,0.960311
D.bocki,140010837,190106,1,1283,9.16358e-06,134455210,0.96032
D.bocki,140010837,88157,1,1279,9.13501e-06,134456489,0.960329
D.bocki,140010837,322091,1,1279,9.13501e-06,134457768,0.960338
D.bocki,140010837,93574,1,1278,9.12786e-06,134459046,0.960347
D.bocki,140010837,182608,1,1278,9.12786e-06,134460324,0.960357
D.bocki,140010837,61903,1,1277,9.12072e-06,134461601,0.960366
D.bocki,140010837,193228,1,1276,9.11358e-06,134462877,0.960375
D.bocki,140010837,459203,1,1275,9.10644e-06,134464152,0.960384
D.bocki,140010837,328266,1,1275,9.10644e-06,134465427,0.960393
D.bocki,140010837,455880,1,1274,9.0993e-06,134466701,0.960402
D.bocki,140010837,361489,1,1273,9.09215e-06,134467974,0.960411
D.bocki,140010837,116924,1,1273,9.09215e-06,134469247,0.96042
D.bocki,140010837,102711,1,1273,9.09215e-06,134470520,0.960429
D.bocki,140010837,329484,1,1271,9.07787e-06,134471791,0.960438
D.bocki,140010837,462372,1,1270,9.07073e-06,134473061,0.960448
D.bocki,140010837,459338,1,1269,9.06358e-06,134474330,0.960457
D.bocki,140010837,461589,1,1268,9.05644e-06,134475598,0.960466
D.bocki,140010837,185070,1,1268,9.05644e-06,134476866,0.960475
D.bocki,140010837,294560,1,1267,9.0493e-06,134478133,0.960484
D.bocki,140010837,462233,1,1264,9.02787e-06,134479397,0.960493
D.bocki,140010837,149116,1,1264,9.02787e-06,134480661,0.960502
D.bocki,140010837,443675,1,1262,9.01359e-06,134481923,0.960511
D.bocki,140010837,264086,1,1262,9.01359e-06,134483185,0.96052
D.bocki,140010837,161854,1,1262,9.01359e-06,134484447,0.960529
D.bocki,140010837,461357,1,1261,9.00645e-06,134485708,0.960538
D.bocki,140010837,459129,1,1261,9.00645e-06,134486969,0.960547
D.bocki,140010837,147262,1,1258,8.98502e-06,134488227,0.960556
D.bocki,140010837,173629,1,1257,8.97788e-06,134489484,0.960565
D.bocki,140010837,349785,1,1255,8.96359e-06,134490739,0.960574
D.bocki,140010837,269800,1,1255,8.96359e-06,134491994,0.960583
D.bocki,140010837,459551,1,1254,8.95645e-06,134493248,0.960592
D.bocki,140010837,443497,1,1254,8.95645e-06,134494502,0.960601
D.bocki,140010837,41150,1,1254,8.95645e-06,134495756,0.96061
D.bocki,140010837,255341,1,1254,8.95645e-06,134497010,0.960619
D.bocki,140010837,169088,1,1254,8.95645e-06,134498264,0.960628
D.bocki,140010837,457032,1,1253,8.94931e-06,134499517,0.960636
D.bocki,140010837,181200,1,1253,8.94931e-06,134500770,0.960645
D.bocki,140010837,463299,1,1250,8.92788e-06,134502020,0.960654
D.bocki,140010837,461055,1,1250,8.92788e-06,134503270,0.960663
D.bocki,140010837,441758,1,1250,8.92788e-06,134504520,0.960672
D.bocki,140010837,253434,1,1250,8.92788e-06,134505770,0.960681
D.bocki,140010837,111765,1,1250,8.92788e-06,134507020,0.96069
D.bocki,140010837,407231,1,1249,8.92074e-06,134508269,0.960699
D.bocki,140010837,246372,1,1249,8.92074e-06,134509518,0.960708
D.bocki,140010837,9791,1,1248,8.9136e-06,134510766,0.960717
D.bocki,140010837,456575,1,1248,8.9136e-06,134512014,0.960726
D.bocki,140010837,335058,1,1247,8.90645e-06,134513261,0.960735
D.bocki,140010837,31458,1,1247,8.90645e-06,134514508,0.960744
D.bocki,140010837,239137,1,1247,8.90645e-06,134515755,0.960752
D.bocki,140010837,461240,1,1246,8.89931e-06,134517001,0.960761
D.bocki,140010837,457664,1,1246,8.89931e-06,134518247,0.96077
D.bocki,140010837,221913,1,1245,8.89217e-06,134519492,0.960779
D.bocki,140010837,460078,1,1243,8.87788e-06,134520735,0.960788
D.bocki,140010837,316865,1,1242,8.87074e-06,134521977,0.960797
D.bocki,140010837,113359,1,1242,8.87074e-06,134523219,0.960806
D.bocki,140010837,459718,1,1241,8.8636e-06,134524460,0.960815
D.bocki,140010837,140929,1,1240,8.85646e-06,134525700,0.960823
D.bocki,140010837,456532,1,1239,8.84931e-06,134526939,0.960832
D.bocki,140010837,31511,1,1239,8.84931e-06,134528178,0.960841
D.bocki,140010837,457212,1,1238,8.84217e-06,134529416,0.96085
D.bocki,140010837,381295,1,1238,8.84217e-06,134530654,0.960859
D.bocki,140010837,298265,1,1238,8.84217e-06,134531892,0.960868
D.bocki,140010837,458378,1,1236,8.82789e-06,134533128,0.960877
D.bocki,140010837,283179,1,1236,8.82789e-06,134534364,0.960885
D.bocki,140010837,461933,1,1235,8.82075e-06,134535599,0.960894
D.bocki,140010837,282571,1,1235,8.82075e-06,134536834,0.960903
D.bocki,140010837,5414,1,1234,8.8136e-06,134538068,0.960912
D.bocki,140010837,462610,1,1234,8.8136e-06,134539302,0.960921
D.bocki,140010837,459737,1,1233,8.80646e-06,134540535,0.960929
D.bocki,140010837,77164,1,1232,8.79932e-06,134541767,0.960938
D.bocki,140010837,427814,1,1232,8.79932e-06,134542999,0.960947
D.bocki,140010837,198839,1,1232,8.79932e-06,134544231,0.960956
D.bocki,140010837,430360,1,1231,8.79218e-06,134545462,0.960965
D.bocki,140010837,393870,1,1231,8.79218e-06,134546693,0.960973
D.bocki,140010837,31889,1,1231,8.79218e-06,134547924,0.960982
D.bocki,140010837,216630,1,1230,8.78503e-06,134549154,0.960991
D.bocki,140010837,46495,1,1229,8.77789e-06,134550383,0.961
D.bocki,140010837,460994,1,1229,8.77789e-06,134551612,0.961009
D.bocki,140010837,456792,1,1229,8.77789e-06,134552841,0.961017
D.bocki,140010837,433796,1,1229,8.77789e-06,134554070,0.961026
D.bocki,140010837,275362,1,1229,8.77789e-06,134555299,0.961035
D.bocki,140010837,132434,1,1229,8.77789e-06,134556528,0.961044
D.bocki,140010837,462647,1,1227,8.76361e-06,134557755,0.961052
D.bocki,140010837,457145,1,1226,8.75647e-06,134558981,0.961061
D.bocki,140010837,221126,1,1225,8.74932e-06,134560206,0.96107
D.bocki,140010837,191540,1,1225,8.74932e-06,134561431,0.961079
D.bocki,140010837,153018,1,1224,8.74218e-06,134562655,0.961087
D.bocki,140010837,304563,1,1223,8.73504e-06,134563878,0.961096
D.bocki,140010837,168600,1,1223,8.73504e-06,134565101,0.961105
D.bocki,140010837,460362,1,1221,8.72075e-06,134566322,0.961114
D.bocki,140010837,150870,1,1221,8.72075e-06,134567543,0.961122
D.bocki,140010837,5186,1,1218,8.69933e-06,134568761,0.961131
D.bocki,140010837,390260,1,1217,8.69218e-06,134569978,0.96114
D.bocki,140010837,280882,1,1217,8.69218e-06,134571195,0.961148
D.bocki,140010837,195814,1,1217,8.69218e-06,134572412,0.961157
D.bocki,140010837,155003,1,1217,8.69218e-06,134573629,0.961166
D.bocki,140010837,24347,1,1216,8.68504e-06,134574845,0.961174
D.bocki,140010837,209772,1,1216,8.68504e-06,134576061,0.961183
D.bocki,140010837,202452,1,1216,8.68504e-06,134577277,0.961192
D.bocki,140010837,461178,1,1215,8.6779e-06,134578492,0.961201
D.bocki,140010837,334086,1,1215,8.6779e-06,134579707,0.961209
D.bocki,140010837,221411,1,1214,8.67076e-06,134580921,0.961218
D.bocki,140010837,451102,1,1213,8.66362e-06,134582134,0.961227
D.bocki,140010837,439448,1,1213,8.66362e-06,134583347,0.961235
D.bocki,140010837,395717,1,1212,8.65647e-06,134584559,0.961244
D.bocki,140010837,202518,1,1212,8.65647e-06,134585771,0.961253
D.bocki,140010837,127649,1,1212,8.65647e-06,134586983,0.961261
D.bocki,140010837,454156,1,1211,8.64933e-06,134588194,0.96127
D.bocki,140010837,455796,1,1210,8.64219e-06,134589404,0.961278
D.bocki,140010837,87782,1,1209,8.63505e-06,134590613,0.961287
D.bocki,140010837,250681,1,1209,8.63505e-06,134591822,0.961296
D.bocki,140010837,16062,1,1209,8.63505e-06,134593031,0.961304
D.bocki,140010837,157493,1,1209,8.63505e-06,134594240,0.961313
D.bocki,140010837,159350,1,1208,8.6279e-06,134595448,0.961322
D.bocki,140010837,125662,1,1208,8.6279e-06,134596656,0.96133
D.bocki,140010837,371127,1,1207,8.62076e-06,134597863,0.961339
D.bocki,140010837,24925,1,1206,8.61362e-06,134599069,0.961348
D.bocki,140010837,87149,1,1205,8.60648e-06,134600274,0.961356
D.bocki,140010837,196564,1,1205,8.60648e-06,134601479,0.961365
D.bocki,140010837,459883,1,1204,8.59933e-06,134602683,0.961373
D.bocki,140010837,458074,1,1204,8.59933e-06,134603887,0.961382
D.bocki,140010837,290965,1,1204,8.59933e-06,134605091,0.961391
D.bocki,140010837,318949,1,1203,8.59219e-06,134606294,0.961399
D.bocki,140010837,36427,1,1202,8.58505e-06,134607496,0.961408
D.bocki,140010837,358441,1,1202,8.58505e-06,134608698,0.961416
D.bocki,140010837,62976,1,1201,8.57791e-06,134609899,0.961425
D.bocki,140010837,316066,1,1200,8.57077e-06,134611099,0.961433
D.bocki,140010837,458280,1,1199,8.56362e-06,134612298,0.961442
D.bocki,140010837,44929,1,1197,8.54934e-06,134613495,0.961451
D.bocki,140010837,242295,1,1197,8.54934e-06,134614692,0.961459
D.bocki,140010837,17737,1,1197,8.54934e-06,134615889,0.961468
D.bocki,140010837,451742,1,1196,8.5422e-06,134617085,0.961476
D.bocki,140010837,245303,1,1196,8.5422e-06,134618281,0.961485
D.bocki,140010837,448239,1,1195,8.53505e-06,134619476,0.961493
D.bocki,140010837,312895,1,1195,8.53505e-06,134620671,0.961502
D.bocki,140010837,126973,1,1195,8.53505e-06,134621866,0.96151
D.bocki,140010837,459358,1,1194,8.52791e-06,134623060,0.961519
D.bocki,140010837,87936,1,1193,8.52077e-06,134624253,0.961527
D.bocki,140010837,73604,1,1193,8.52077e-06,134625446,0.961536
D.bocki,140010837,454614,1,1193,8.52077e-06,134626639,0.961544
D.bocki,140010837,452861,1,1193,8.52077e-06,134627832,0.961553
D.bocki,140010837,53524,1,1192,8.51363e-06,134629024,0.961561
D.bocki,140010837,460836,1,1192,8.51363e-06,134630216,0.96157
D.bocki,140010837,457160,1,1192,8.51363e-06,134631408,0.961578
D.bocki,140010837,82339,1,1190,8.49934e-06,134632598,0.961587
D.bocki,140010837,430120,1,1190,8.49934e-06,134633788,0.961595
D.bocki,140010837,346824,1,1190,8.49934e-06,134634978,0.961604
D.bocki,140010837,459458,1,1189,8.4922e-06,134636167,0.961612
D.bocki,140010837,30474,1,1188,8.48506e-06,134637355,0.961621
D.bocki,140010837,48389,1,1187,8.47792e-06,134638542,0.961629
D.bocki,140010837,93077,1,1186,8.47077e-06,134639728,0.961638
D.bocki,140010837,155824,1,1186,8.47077e-06,134640914,0.961646
D.bocki,140010837,107469,1,1185,8.46363e-06,134642099,0.961655
D.bocki,140010837,463030,1,1183,8.44935e-06,134643282,0.961663
D.bocki,140010837,145445,1,1183,8.44935e-06,134644465,0.961672
D.bocki,140010837,88853,1,1182,8.4422e-06,134645647,0.96168
D.bocki,140010837,85074,1,1182,8.4422e-06,134646829,0.961689
D.bocki,140010837,113623,1,1182,8.4422e-06,134648011,0.961697
D.bocki,140010837,62535,1,1181,8.43506e-06,134649192,0.961705
D.bocki,140010837,461077,1,1180,8.42792e-06,134650372,0.961714
D.bocki,140010837,449835,1,1180,8.42792e-06,134651552,0.961722
D.bocki,140010837,335504,1,1180,8.42792e-06,134652732,0.961731
D.bocki,140010837,461908,1,1178,8.41363e-06,134653910,0.961739
D.bocki,140010837,99457,1,1177,8.40649e-06,134655087,0.961748
D.bocki,140010837,461555,1,1177,8.40649e-06,134656264,0.961756
D.bocki,140010837,362181,1,1177,8.40649e-06,134657441,0.961764
D.bocki,140010837,330050,1,1177,8.40649e-06,134658618,0.961773
D.bocki,140010837,323640,1,1177,8.40649e-06,134659795,0.961781
D.bocki,140010837,170454,1,1177,8.40649e-06,134660972,0.96179
D.bocki,140010837,263428,1,1176,8.39935e-06,134662148,0.961798
D.bocki,140010837,100473,1,1176,8.39935e-06,134663324,0.961806
D.bocki,140010837,460693,1,1175,8.39221e-06,134664499,0.961815
D.bocki,140010837,436097,1,1175,8.39221e-06,134665674,0.961823
D.bocki,140010837,460864,1,1174,8.38507e-06,134666848,0.961832
D.bocki,140010837,432494,1,1174,8.38507e-06,134668022,0.96184
D.bocki,140010837,34243,1,1174,8.38507e-06,134669196,0.961848
D.bocki,140010837,458932,1,1173,8.37792e-06,134670369,0.961857
D.bocki,140010837,183424,1,1172,8.37078e-06,134671541,0.961865
D.bocki,140010837,45057,1,1171,8.36364e-06,134672712,0.961873
D.bocki,140010837,259410,1,1171,8.36364e-06,134673883,0.961882
D.bocki,140010837,394207,1,1170,8.3565e-06,134675053,0.96189
D.bocki,140010837,28304,1,1170,8.3565e-06,134676223,0.961899
D.bocki,140010837,365260,1,1168,8.34221e-06,134677391,0.961907
D.bocki,140010837,452617,1,1166,8.32793e-06,134678557,0.961915
D.bocki,140010837,316505,1,1166,8.32793e-06,134679723,0.961924
D.bocki,140010837,111444,1,1165,8.32078e-06,134680888,0.961932
D.bocki,140010837,45318,1,1164,8.31364e-06,134682052,0.96194
D.bocki,140010837,452415,1,1164,8.31364e-06,134683216,0.961949
D.bocki,140010837,327573,1,1164,8.31364e-06,134684380,0.961957
D.bocki,140010837,115852,1,1163,8.3065e-06,134685543,0.961965
D.bocki,140010837,420450,1,1162,8.29936e-06,134686705,0.961973
D.bocki,140010837,23222,1,1157,8.26365e-06,134687862,0.961982
D.bocki,140010837,226512,1,1156,8.2565e-06,134689018,0.96199
D.bocki,140010837,107919,1,1156,8.2565e-06,134690174,0.961998
D.bocki,140010837,107518,1,1156,8.2565e-06,134691330,0.962006
D.bocki,140010837,431729,1,1154,8.24222e-06,134692484,0.962015
D.bocki,140010837,413220,1,1152,8.22793e-06,134693636,0.962023
D.bocki,140010837,373002,1,1151,8.22079e-06,134694787,0.962031
D.bocki,140010837,367559,1,1151,8.22079e-06,134695938,0.962039
D.bocki,140010837,67665,1,1150,8.21365e-06,134697088,0.962048
D.bocki,140010837,452835,1,1150,8.21365e-06,134698238,0.962056
D.bocki,140010837,378243,1,1149,8.20651e-06,134699387,0.962064
D.bocki,140010837,340917,1,1149,8.20651e-06,134700536,0.962072
D.bocki,140010837,337126,1,1149,8.20651e-06,134701685,0.96208
D.bocki,140010837,216722,1,1149,8.20651e-06,134702834,0.962089
D.bocki,140010837,424618,1,1148,8.19937e-06,134703982,0.962097
D.bocki,140010837,240952,1,1147,8.19222e-06,134705129,0.962105
D.bocki,140010837,117678,1,1147,8.19222e-06,134706276,0.962113
D.bocki,140010837,96499,1,1146,8.18508e-06,134707422,0.962121
D.bocki,140010837,452621,1,1146,8.18508e-06,134708568,0.96213
D.bocki,140010837,136193,1,1146,8.18508e-06,134709714,0.962138
D.bocki,140010837,10121,1,1146,8.18508e-06,134710860,0.962146
D.bocki,140010837,66715,1,1145,8.17794e-06,134712005,0.962154
D.bocki,140010837,196433,1,1145,8.17794e-06,134713150,0.962162
D.bocki,140010837,131352,1,1145,8.17794e-06,134714295,0.96217
D.bocki,140010837,184940,1,1144,8.1708e-06,134715439,0.962179
D.bocki,140010837,127422,1,1144,8.1708e-06,134716583,0.962187
D.bocki,140010837,406038,1,1143,8.16365e-06,134717726,0.962195
D.bocki,140010837,385139,1,1143,8.16365e-06,134718869,0.962203
D.bocki,140010837,456396,1,1142,8.15651e-06,134720011,0.962211
D.bocki,140010837,401216,1,1141,8.14937e-06,134721152,0.962219
D.bocki,140010837,188161,1,1140,8.14223e-06,134722292,0.962228
D.bocki,140010837,53000,1,1139,8.13508e-06,134723431,0.962236
D.bocki,140010837,193022,1,1139,8.13508e-06,134724570,0.962244
D.bocki,140010837,288914,1,1138,8.12794e-06,134725708,0.962252
D.bocki,140010837,27214,1,1137,8.1208e-06,134726845,0.96226
D.bocki,140010837,162716,1,1137,8.1208e-06,134727982,0.962268
D.bocki,140010837,354243,1,1136,8.11366e-06,134729118,0.962276
D.bocki,140010837,268258,1,1136,8.11366e-06,134730254,0.962284
D.bocki,140010837,371927,1,1135,8.10652e-06,134731389,0.962293
D.bocki,140010837,363459,1,1133,8.09223e-06,134732522,0.962301
D.bocki,140010837,411068,1,1131,8.07795e-06,134733653,0.962309
D.bocki,140010837,338625,1,1131,8.07795e-06,134734784,0.962317
D.bocki,140010837,274661,1,1131,8.07795e-06,134735915,0.962325
D.bocki,140010837,125055,1,1129,8.06366e-06,134737044,0.962333
D.bocki,140010837,394725,1,1128,8.05652e-06,134738172,0.962341
D.bocki,140010837,131013,1,1128,8.05652e-06,134739300,0.962349
D.bocki,140010837,130913,1,1128,8.05652e-06,134740428,0.962357
D.bocki,140010837,312736,1,1127,8.04938e-06,134741555,0.962365
D.bocki,140010837,311369,1,1127,8.04938e-06,134742682,0.962373
D.bocki,140010837,145214,1,1126,8.04223e-06,134743808,0.962381
D.bocki,140010837,452212,1,1125,8.03509e-06,134744933,0.962389
D.bocki,140010837,186680,1,1125,8.03509e-06,134746058,0.962397
D.bocki,140010837,409745,1,1124,8.02795e-06,134747182,0.962405
D.bocki,140010837,207863,1,1124,8.02795e-06,134748306,0.962413
D.bocki,140010837,13484,1,1124,8.02795e-06,134749430,0.962421
D.bocki,140010837,454449,1,1123,8.02081e-06,134750553,0.962429
D.bocki,140010837,203150,1,1123,8.02081e-06,134751676,0.962437
D.bocki,140010837,185019,1,1123,8.02081e-06,134752799,0.962445
D.bocki,140010837,235171,1,1122,8.01367e-06,134753921,0.962454
D.bocki,140010837,453452,1,1119,7.99224e-06,134755040,0.962461
D.bocki,140010837,62684,1,1118,7.9851e-06,134756158,0.962469
D.bocki,140010837,258446,1,1115,7.96367e-06,134757273,0.962477
D.bocki,140010837,198658,1,1115,7.96367e-06,134758388,0.962485
D.bocki,140010837,96026,1,1114,7.95653e-06,134759502,0.962493
D.bocki,140010837,255599,1,1114,7.95653e-06,134760616,0.962501
D.bocki,140010837,341453,1,1113,7.94938e-06,134761729,0.962509
D.bocki,140010837,242570,1,1113,7.94938e-06,134762842,0.962517
D.bocki,140010837,201467,1,1113,7.94938e-06,134763955,0.962525
D.bocki,140010837,46680,1,1112,7.94224e-06,134765067,0.962533
D.bocki,140010837,452695,1,1112,7.94224e-06,134766179,0.962541
D.bocki,140010837,355295,1,1112,7.94224e-06,134767291,0.962549
D.bocki,140010837,453555,1,1111,7.9351e-06,134768402,0.962557
D.bocki,140010837,218842,1,1111,7.9351e-06,134769513,0.962565
D.bocki,140010837,69515,1,1110,7.92796e-06,134770623,0.962573
D.bocki,140010837,162399,1,1110,7.92796e-06,134771733,0.962581
D.bocki,140010837,212209,1,1109,7.92082e-06,134772842,0.962589
D.bocki,140010837,445657,1,1108,7.91367e-06,134773950,0.962597
D.bocki,140010837,301895,1,1108,7.91367e-06,134775058,0.962604
D.bocki,140010837,201553,1,1108,7.91367e-06,134776166,0.962612
D.bocki,140010837,400950,1,1106,7.89939e-06,134777272,0.96262
D.bocki,140010837,244963,1,1106,7.89939e-06,134778378,0.962628
D.bocki,140010837,180644,1,1105,7.89225e-06,134779483,0.962636
D.bocki,140010837,270296,1,1103,7.87796e-06,134780586,0.962644
D.bocki,140010837,307283,1,1102,7.87082e-06,134781688,0.962652
D.bocki,140010837,393402,1,1101,7.86368e-06,134782789,0.96266
D.bocki,140010837,102343,1,1101,7.86368e-06,134783890,0.962668
D.bocki,140010837,461500,1,1098,7.84225e-06,134784988,0.962675
D.bocki,140010837,160266,1,1098,7.84225e-06,134786086,0.962683
D.bocki,140010837,392352,1,1097,7.83511e-06,134787183,0.962691
D.bocki,140010837,71490,1,1096,7.82797e-06,134788279,0.962699
D.bocki,140010837,452865,1,1095,7.82082e-06,134789374,0.962707
D.bocki,140010837,254247,1,1095,7.82082e-06,134790469,0.962715
D.bocki,140010837,92135,1,1094,7.81368e-06,134791563,0.962722
D.bocki,140010837,224955,1,1094,7.81368e-06,134792657,0.96273
D.bocki,140010837,144519,1,1094,7.81368e-06,134793751,0.962738
D.bocki,140010837,13213,1,1094,7.81368e-06,134794845,0.962746
D.bocki,140010837,165481,1,1093,7.80654e-06,134795938,0.962754
D.bocki,140010837,126749,1,1093,7.80654e-06,134797031,0.962761
D.bocki,140010837,323435,1,1092,7.7994e-06,134798123,0.962769
D.bocki,140010837,451815,1,1091,7.79225e-06,134799214,0.962777
D.bocki,140010837,366998,1,1091,7.79225e-06,134800305,0.962785
D.bocki,140010837,252709,1,1091,7.79225e-06,134801396,0.962793
D.bocki,140010837,54845,1,1089,7.77797e-06,134802485,0.9628
D.bocki,140010837,451838,1,1087,7.76368e-06,134803572,0.962808
D.bocki,140010837,150445,1,1087,7.76368e-06,134804659,0.962816
D.bocki,140010837,451189,1,1084,7.74226e-06,134805743,0.962824
D.bocki,140010837,274084,1,1084,7.74226e-06,134806827,0.962831
D.bocki,140010837,140982,1,1083,7.73512e-06,134807910,0.962839
D.bocki,140010837,187580,1,1082,7.72797e-06,134808992,0.962847
D.bocki,140010837,53207,1,1081,7.72083e-06,134810073,0.962855
D.bocki,140010837,4283,1,1081,7.72083e-06,134811154,0.962862
D.bocki,140010837,300077,1,1080,7.71369e-06,134812234,0.96287
D.bocki,140010837,359445,1,1079,7.70655e-06,134813313,0.962878
D.bocki,140010837,345442,1,1079,7.70655e-06,134814392,0.962885
D.bocki,140010837,247938,1,1078,7.6994e-06,134815470,0.962893
D.bocki,140010837,405601,1,1077,7.69226e-06,134816547,0.962901
D.bocki,140010837,218162,1,1077,7.69226e-06,134817624,0.962908
D.bocki,140010837,161616,1,1077,7.69226e-06,134818701,0.962916
D.bocki,140010837,319204,1,1076,7.68512e-06,134819777,0.962924
D.bocki,140010837,387606,1,1075,7.67798e-06,134820852,0.962932
D.bocki,140010837,146409,1,1075,7.67798e-06,134821927,0.962939
D.bocki,140010837,206704,1,1074,7.67083e-06,134823001,0.962947
D.bocki,140010837,452656,1,1073,7.66369e-06,134824074,0.962955
D.bocki,140010837,251535,1,1073,7.66369e-06,134825147,0.962962
D.bocki,140010837,77399,1,1072,7.65655e-06,134826219,0.96297
D.bocki,140010837,294861,1,1072,7.65655e-06,134827291,0.962978
D.bocki,140010837,247411,1,1072,7.65655e-06,134828363,0.962985
D.bocki,140010837,171974,1,1071,7.64941e-06,134829434,0.962993
D.bocki,140010837,141487,1,1071,7.64941e-06,134830505,0.963
D.bocki,140010837,131353,1,1070,7.64227e-06,134831575,0.963008
D.bocki,140010837,31028,1,1069,7.63512e-06,134832644,0.963016
D.bocki,140010837,117624,1,1068,7.62798e-06,134833712,0.963023
D.bocki,140010837,86667,1,1066,7.6137e-06,134834778,0.963031
D.bocki,140010837,322465,1,1066,7.6137e-06,134835844,0.963039
D.bocki,140010837,449217,1,1065,7.60655e-06,134836909,0.963046
D.bocki,140010837,157919,1,1065,7.60655e-06,134837974,0.963054
D.bocki,140010837,452860,1,1064,7.59941e-06,134839038,0.963061
D.bocki,140010837,453252,1,1062,7.58513e-06,134840100,0.963069
D.bocki,140010837,42560,1,1061,7.57798e-06,134841161,0.963077
D.bocki,140010837,216393,1,1061,7.57798e-06,134842222,0.963084
D.bocki,140010837,79650,1,1060,7.57084e-06,134843282,0.963092
D.bocki,140010837,398432,1,1060,7.57084e-06,134844342,0.963099
D.bocki,140010837,285554,1,1060,7.57084e-06,134845402,0.963107
D.bocki,140010837,271659,1,1060,7.57084e-06,134846462,0.963114
D.bocki,140010837,398710,1,1058,7.55656e-06,134847520,0.963122
D.bocki,140010837,270707,1,1057,7.54942e-06,134848577,0.96313
D.bocki,140010837,246807,1,1057,7.54942e-06,134849634,0.963137
D.bocki,140010837,280314,1,1056,7.54227e-06,134850690,0.963145
D.bocki,140010837,255798,1,1056,7.54227e-06,134851746,0.963152
D.bocki,140010837,192331,1,1056,7.54227e-06,134852802,0.96316
D.bocki,140010837,332163,1,1055,7.53513e-06,134853857,0.963167
D.bocki,140010837,186382,1,1053,7.52085e-06,134854910,0.963175
D.bocki,140010837,315392,1,1051,7.50656e-06,134855961,0.963182
D.bocki,140010837,8875,1,1050,7.49942e-06,134857011,0.96319
D.bocki,140010837,301042,1,1050,7.49942e-06,134858061,0.963197
D.bocki,140010837,219115,1,1050,7.49942e-06,134859111,0.963205
D.bocki,140010837,72056,1,1049,7.49228e-06,134860160,0.963212
D.bocki,140010837,447910,1,1049,7.49228e-06,134861209,0.96322
D.bocki,140010837,291894,1,1049,7.49228e-06,134862258,0.963227
D.bocki,140010837,44547,1,1048,7.48513e-06,134863306,0.963235
D.bocki,140010837,365071,1,1048,7.48513e-06,134864354,0.963242
D.bocki,140010837,146035,1,1048,7.48513e-06,134865402,0.96325
D.bocki,140010837,7746,1,1047,7.47799e-06,134866449,0.963257
D.bocki,140010837,77373,1,1047,7.47799e-06,134867496,0.963265
D.bocki,140010837,376216,1,1047,7.47799e-06,134868543,0.963272
D.bocki,140010837,394395,1,1046,7.47085e-06,134869589,0.96328
D.bocki,140010837,197126,1,1046,7.47085e-06,134870635,0.963287
D.bocki,140010837,175787,1,1043,7.44942e-06,134871678,0.963295
D.bocki,140010837,53878,1,1041,7.43514e-06,134872719,0.963302
D.bocki,140010837,49853,1,1041,7.43514e-06,134873760,0.963309
D.bocki,140010837,254311,1,1041,7.43514e-06,134874801,0.963317
D.bocki,140010837,46783,1,1040,7.428e-06,134875841,0.963324
D.bocki,140010837,261702,1,1040,7.428e-06,134876881,0.963332
D.bocki,140010837,99231,1,1039,7.42085e-06,134877920,0.963339
D.bocki,140010837,193365,1,1039,7.42085e-06,134878959,0.963347
D.bocki,140010837,32318,1,1038,7.41371e-06,134879997,0.963354
D.bocki,140010837,195514,1,1038,7.41371e-06,134881035,0.963361
D.bocki,140010837,103132,1,1038,7.41371e-06,134882073,0.963369
D.bocki,140010837,14038,1,1037,7.40657e-06,134883110,0.963376
D.bocki,140010837,3609,1,1036,7.39943e-06,134884146,0.963384
D.bocki,140010837,198017,1,1036,7.39943e-06,134885182,0.963391
D.bocki,140010837,136258,1,1036,7.39943e-06,134886218,0.963398
D.bocki,140010837,99183,1,1034,7.38514e-06,134887252,0.963406
D.bocki,140010837,416042,1,1033,7.378e-06,134888285,0.963413
D.bocki,140010837,208390,1,1033,7.378e-06,134889318,0.963421
D.bocki,140010837,48718,1,1031,7.36372e-06,134890349,0.963428
D.bocki,140010837,452966,1,1028,7.34229e-06,134891377,0.963435
D.bocki,140010837,351353,1,1027,7.33515e-06,134892404,0.963443
D.bocki,140010837,170651,1,1027,7.33515e-06,134893431,0.96345
D.bocki,140010837,96375,1,1025,7.32086e-06,134894456,0.963457
D.bocki,140010837,249752,1,1024,7.31372e-06,134895480,0.963465
D.bocki,140010837,119821,1,1024,7.31372e-06,134896504,0.963472
D.bocki,140010837,181552,1,1022,7.29943e-06,134897526,0.963479
D.bocki,140010837,129491,1,1022,7.29943e-06,134898548,0.963486
D.bocki,140010837,121865,1,1021,7.29229e-06,134899569,0.963494
D.bocki,140010837,301041,1,1020,7.28515e-06,134900589,0.963501
D.bocki,140010837,86945,1,1019,7.27801e-06,134901608,0.963508
D.bocki,140010837,431123,1,1019,7.27801e-06,134902627,0.963516
D.bocki,140010837,388700,1,1019,7.27801e-06,134903646,0.963523
D.bocki,140010837,338624,1,1019,7.27801e-06,134904665,0.96353
D.bocki,140010837,190877,1,1019,7.27801e-06,134905684,0.963537
D.bocki,140010837,155714,1,1019,7.27801e-06,134906703,0.963545
D.bocki,140010837,8325,1,1018,7.27087e-06,134907721,0.963552
D.bocki,140010837,56412,1,1018,7.27087e-06,134908739,0.963559
D.bocki,140010837,423180,1,1018,7.27087e-06,134909757,0.963567
D.bocki,140010837,416940,1,1018,7.27087e-06,134910775,0.963574
D.bocki,140010837,297349,1,1018,7.27087e-06,134911793,0.963581
D.bocki,140010837,230195,1,1018,7.27087e-06,134912811,0.963588
D.bocki,140010837,181930,1,1018,7.27087e-06,134913829,0.963596
D.bocki,140010837,287532,1,1017,7.26372e-06,134914846,0.963603
D.bocki,140010837,334168,1,1016,7.25658e-06,134915862,0.96361
D.bocki,140010837,237409,1,1016,7.25658e-06,134916878,0.963617
D.bocki,140010837,363513,1,1015,7.24944e-06,134917893,0.963625
D.bocki,140010837,454157,1,1014,7.2423e-06,134918907,0.963632
D.bocki,140010837,351262,1,1014,7.2423e-06,134919921,0.963639
D.bocki,140010837,321111,1,1014,7.2423e-06,134920935,0.963646
D.bocki,140010837,284793,1,1014,7.2423e-06,134921949,0.963654
D.bocki,140010837,454511,1,1013,7.23515e-06,134922962,0.963661
D.bocki,140010837,371721,1,1013,7.23515e-06,134923975,0.963668
D.bocki,140010837,211741,1,1012,7.22801e-06,134924987,0.963675
D.bocki,140010837,136415,1,1012,7.22801e-06,134925999,0.963683
D.bocki,140010837,212144,1,1011,7.22087e-06,134927010,0.96369
D.bocki,140010837,5184,1,1009,7.20659e-06,134928019,0.963697
D.bocki,140010837,419411,1,1009,7.20659e-06,134929028,0.963704
D.bocki,140010837,253067,1,1009,7.20659e-06,134930037,0.963711
D.bocki,140010837,10960,1,1009,7.20659e-06,134931046,0.963719
D.bocki,140010837,298683,1,1008,7.19944e-06,134932054,0.963726
D.bocki,140010837,69055,1,1007,7.1923e-06,134933061,0.963733
D.bocki,140010837,60644,1,1007,7.1923e-06,134934068,0.96374
D.bocki,140010837,56826,1,1007,7.1923e-06,134935075,0.963747
D.bocki,140010837,58918,1,1006,7.18516e-06,134936081,0.963755
D.bocki,140010837,397120,1,1006,7.18516e-06,134937087,0.963762
D.bocki,140010837,444024,1,1005,7.17802e-06,134938092,0.963769
D.bocki,140010837,195415,1,1005,7.17802e-06,134939097,0.963776
D.bocki,140010837,344967,1,1004,7.17087e-06,134940101,0.963783
D.bocki,140010837,175143,1,1004,7.17087e-06,134941105,0.96379
D.bocki,140010837,120166,1,1004,7.17087e-06,134942109,0.963798
D.bocki,140010837,61045,1,1003,7.16373e-06,134943112,0.963805
D.bocki,140010837,218741,1,1003,7.16373e-06,134944115,0.963812
D.bocki,140010837,21045,1,1003,7.16373e-06,134945118,0.963819
D.bocki,140010837,411043,1,1002,7.15659e-06,134946120,0.963826
D.bocki,140010837,139386,1,1002,7.15659e-06,134947122,0.963833
D.bocki,140010837,411328,1,1001,7.14945e-06,134948123,0.963841
D.bocki,140010837,117546,1,1001,7.14945e-06,134949124,0.963848
D.bocki,140010837,304130,1,1000,7.1423e-06,134950124,0.963855
D.bocki,140010837,20921,1,1000,7.1423e-06,134951124,0.963862
D.bocki,140010837,453489,1,999,7.13516e-06,134952123,0.963869
D.bocki,140010837,426583,1,999,7.13516e-06,134953122,0.963876
D.bocki,140010837,328325,1,999,7.13516e-06,134954121,0.963883
D.bocki,140010837,191577,1,999,7.13516e-06,134955120,0.963891
D.bocki,140010837,162037,1,999,7.13516e-06,134956119,0.963898
D.bocki,140010837,451135,1,998,7.12802e-06,134957117,0.963905
D.bocki,140010837,254222,1,998,7.12802e-06,134958115,0.963912
D.bocki,140010837,247119,1,998,7.12802e-06,134959113,0.963919
D.bocki,140010837,242827,1,998,7.12802e-06,134960111,0.963926
D.bocki,140010837,117806,1,998,7.12802e-06,134961109,0.963933
D.bocki,140010837,41515,1,997,7.12088e-06,134962106,0.96394
D.bocki,140010837,221920,1,997,7.12088e-06,134963103,0.963948
D.bocki,140010837,179493,1,997,7.12088e-06,134964100,0.963955
D.bocki,140010837,46239,1,996,7.11374e-06,134965096,0.963962
D.bocki,140010837,414247,1,996,7.11374e-06,134966092,0.963969
D.bocki,140010837,154930,1,996,7.11374e-06,134967088,0.963976
D.bocki,140010837,99579,1,995,7.10659e-06,134968083,0.963983
D.bocki,140010837,69274,1,995,7.10659e-06,134969078,0.96399
D.bocki,140010837,385544,1,995,7.10659e-06,134970073,0.963997
D.bocki,140010837,341953,1,995,7.10659e-06,134971068,0.964004
D.bocki,140010837,294118,1,995,7.10659e-06,134972063,0.964012
D.bocki,140010837,204241,1,995,7.10659e-06,134973058,0.964019
D.bocki,140010837,77690,1,994,7.09945e-06,134974052,0.964026
D.bocki,140010837,77372,1,994,7.09945e-06,134975046,0.964033
D.bocki,140010837,62241,1,994,7.09945e-06,134976040,0.96404
D.bocki,140010837,56383,1,994,7.09945e-06,134977034,0.964047
D.bocki,140010837,454606,1,994,7.09945e-06,134978028,0.964054
D.bocki,140010837,429232,1,994,7.09945e-06,134979022,0.964061
D.bocki,140010837,377809,1,994,7.09945e-06,134980016,0.964068
D.bocki,140010837,340726,1,994,7.09945e-06,134981010,0.964075
D.bocki,140010837,222570,1,994,7.09945e-06,134982004,0.964083
D.bocki,140010837,147167,1,994,7.09945e-06,134982998,0.96409
D.bocki,140010837,89886,1,993,7.09231e-06,134983991,0.964097
D.bocki,140010837,383604,1,993,7.09231e-06,134984984,0.964104
D.bocki,140010837,295540,1,993,7.09231e-06,134985977,0.964111
D.bocki,140010837,268689,1,993,7.09231e-06,134986970,0.964118
D.bocki,140010837,208425,1,993,7.09231e-06,134987963,0.964125
D.bocki,140010837,153333,1,993,7.09231e-06,134988956,0.964132
D.bocki,140010837,117274,1,993,7.09231e-06,134989949,0.964139
D.bocki,140010837,91728,1,992,7.08517e-06,134990941,0.964146
D.bocki,140010837,344358,1,992,7.08517e-06,134991933,0.964153
D.bocki,140010837,336005,1,992,7.08517e-06,134992925,0.964161
D.bocki,140010837,33358,1,992,7.08517e-06,134993917,0.964168
D.bocki,140010837,304304,1,992,7.08517e-06,134994909,0.964175
D.bocki,140010837,282099,1,992,7.08517e-06,134995901,0.964182
D.bocki,140010837,162125,1,992,7.08517e-06,134996893,0.964189
D.bocki,140010837,121096,1,992,7.08517e-06,134997885,0.964196
D.bocki,140010837,88036,1,991,7.07802e-06,134998876,0.964203
D.bocki,140010837,69584,1,991,7.07802e-06,134999867,0.96421
D.bocki,140010837,60389,1,991,7.07802e-06,135000858,0.964217
D.bocki,140010837,441329,1,991,7.07802e-06,135001849,0.964224
D.bocki,140010837,4210,1,991,7.07802e-06,135002840,0.964231
D.bocki,140010837,349938,1,991,7.07802e-06,135003831,0.964238
D.bocki,140010837,336269,1,991,7.07802e-06,135004822,0.964246
D.bocki,140010837,309061,1,991,7.07802e-06,135005813,0.964253
D.bocki,140010837,297165,1,991,7.07802e-06,135006804,0.96426
D.bocki,140010837,230336,1,991,7.07802e-06,135007795,0.964267
D.bocki,140010837,173309,1,991,7.07802e-06,135008786,0.964274
D.bocki,140010837,126515,1,991,7.07802e-06,135009777,0.964281
D.bocki,140010837,9074,1,990,7.07088e-06,135010767,0.964288
D.bocki,140010837,424501,1,990,7.07088e-06,135011757,0.964295
D.bocki,140010837,334644,1,990,7.07088e-06,135012747,0.964302
D.bocki,140010837,182687,1,990,7.07088e-06,135013737,0.964309
D.bocki,140010837,70274,1,989,7.06374e-06,135014726,0.964316
D.bocki,140010837,384714,1,989,7.06374e-06,135015715,0.964323
D.bocki,140010837,18351,1,989,7.06374e-06,135016704,0.96433
D.bocki,140010837,99366,1,988,7.0566e-06,135017692,0.964337
D.bocki,140010837,92576,1,988,7.0566e-06,135018680,0.964344
D.bocki,140010837,453152,1,988,7.0566e-06,135019668,0.964352
D.bocki,140010837,367113,1,988,7.0566e-06,135020656,0.964359
D.bocki,140010837,331638,1,988,7.0566e-06,135021644,0.964366
D.bocki,140010837,29981,1,988,7.0566e-06,135022632,0.964373
D.bocki,140010837,274859,1,988,7.0566e-06,135023620,0.96438
D.bocki,140010837,223905,1,988,7.0566e-06,135024608,0.964387
D.bocki,140010837,168039,1,988,7.0566e-06,135025596,0.964394
D.bocki,140010837,99634,1,987,7.04945e-06,135026583,0.964401
D.bocki,140010837,433058,1,987,7.04945e-06,135027570,0.964408
D.bocki,140010837,413679,1,987,7.04945e-06,135028557,0.964415
D.bocki,140010837,392719,1,987,7.04945e-06,135029544,0.964422
D.bocki,140010837,309228,1,987,7.04945e-06,135030531,0.964429
D.bocki,140010837,253517,1,987,7.04945e-06,135031518,0.964436
D.bocki,140010837,206654,1,987,7.04945e-06,135032505,0.964443
D.bocki,140010837,121982,1,987,7.04945e-06,135033492,0.96445
D.bocki,140010837,12185,1,987,7.04945e-06,135034479,0.964457
D.bocki,140010837,291994,1,986,7.04231e-06,135035465,0.964464
D.bocki,140010837,248685,1,986,7.04231e-06,135036451,0.964471
D.bocki,140010837,105100,1,986,7.04231e-06,135037437,0.964478
D.bocki,140010837,54020,1,985,7.03517e-06,135038422,0.964485
D.bocki,140010837,454039,1,985,7.03517e-06,135039407,0.964493
D.bocki,140010837,436280,1,985,7.03517e-06,135040392,0.9645
D.bocki,140010837,393713,1,985,7.03517e-06,135041377,0.964507
D.bocki,140010837,120957,1,985,7.03517e-06,135042362,0.964514
D.bocki,140010837,114858,1,985,7.03517e-06,135043347,0.964521
D.bocki,140010837,95484,1,984,7.02803e-06,135044331,0.964528
D.bocki,140010837,435087,1,984,7.02803e-06,135045315,0.964535
D.bocki,140010837,357507,1,984,7.02803e-06,135046299,0.964542
D.bocki,140010837,321771,1,984,7.02803e-06,135047283,0.964549
D.bocki,140010837,320364,1,984,7.02803e-06,135048267,0.964556
D.bocki,140010837,29891,1,984,7.02803e-06,135049251,0.964563
D.bocki,140010837,18344,1,984,7.02803e-06,135050235,0.96457
D.bocki,140010837,152318,1,984,7.02803e-06,135051219,0.964577
D.bocki,140010837,111406,1,984,7.02803e-06,135052203,0.964584
D.bocki,140010837,10990,1,984,7.02803e-06,135053187,0.964591
D.bocki,140010837,377016,1,983,7.02089e-06,135054170,0.964598
D.bocki,140010837,299371,1,983,7.02089e-06,135055153,0.964605
D.bocki,140010837,223091,1,983,7.02089e-06,135056136,0.964612
D.bocki,140010837,161818,1,983,7.02089e-06,135057119,0.964619
D.bocki,140010837,161565,1,983,7.02089e-06,135058102,0.964626
D.bocki,140010837,130339,1,983,7.02089e-06,135059085,0.964633
D.bocki,140010837,454428,1,982,7.01374e-06,135060067,0.96464
D.bocki,140010837,454223,1,982,7.01374e-06,135061049,0.964647
D.bocki,140010837,453707,1,982,7.01374e-06,135062031,0.964654
D.bocki,140010837,404923,1,982,7.01374e-06,135063013,0.964661
D.bocki,140010837,392485,1,982,7.01374e-06,135063995,0.964668
D.bocki,140010837,34816,1,982,7.01374e-06,135064977,0.964675
D.bocki,140010837,342874,1,982,7.01374e-06,135065959,0.964682
D.bocki,140010837,184056,1,982,7.01374e-06,135066941,0.964689
D.bocki,140010837,252648,1,981,7.0066e-06,135067922,0.964696
D.bocki,140010837,222955,1,981,7.0066e-06,135068903,0.964703
D.bocki,140010837,113792,1,981,7.0066e-06,135069884,0.96471
D.bocki,140010837,454560,1,980,6.99946e-06,135070864,0.964717
D.bocki,140010837,451870,1,980,6.99946e-06,135071844,0.964724
D.bocki,140010837,362790,1,980,6.99946e-06,135072824,0.964731
D.bocki,140010837,144011,1,980,6.99946e-06,135073804,0.964738
D.bocki,140010837,92645,1,979,6.99232e-06,135074783,0.964745
D.bocki,140010837,81859,1,979,6.99232e-06,135075762,0.964752
D.bocki,140010837,71598,1,979,6.99232e-06,135076741,0.964759
D.bocki,140010837,452844,1,979,6.99232e-06,135077720,0.964766
D.bocki,140010837,445912,1,978,6.98517e-06,135078698,0.964773
D.bocki,140010837,242074,1,978,6.98517e-06,135079676,0.96478
D.bocki,140010837,220042,1,978,6.98517e-06,135080654,0.964787
D.bocki,140010837,217379,1,978,6.98517e-06,135081632,0.964794
D.bocki,140010837,208970,1,978,6.98517e-06,135082610,0.964801
D.bocki,140010837,428198,1,977,6.97803e-06,135083587,0.964808
D.bocki,140010837,265448,1,977,6.97803e-06,135084564,0.964815
D.bocki,140010837,62050,1,976,6.97089e-06,135085540,0.964822
D.bocki,140010837,438475,1,976,6.97089e-06,135086516,0.964829
D.bocki,140010837,452553,1,975,6.96375e-06,135087491,0.964836
D.bocki,140010837,364127,1,975,6.96375e-06,135088466,0.964843
D.bocki,140010837,306692,1,975,6.96375e-06,135089441,0.96485
D.bocki,140010837,252065,1,975,6.96375e-06,135090416,0.964857
D.bocki,140010837,203541,1,975,6.96375e-06,135091391,0.964864
D.bocki,140010837,151,1,975,6.96375e-06,135092366,0.964871
D.bocki,140010837,359444,1,974,6.9566e-06,135093340,0.964878
D.bocki,140010837,344637,1,974,6.9566e-06,135094314,0.964885
D.bocki,140010837,271125,1,974,6.9566e-06,135095288,0.964892
D.bocki,140010837,222233,1,974,6.9566e-06,135096262,0.964899
D.bocki,140010837,125537,1,974,6.9566e-06,135097236,0.964906
D.bocki,140010837,453693,1,973,6.94946e-06,135098209,0.964913
D.bocki,140010837,436662,1,973,6.94946e-06,135099182,0.964919
D.bocki,140010837,389422,1,973,6.94946e-06,135100155,0.964926
D.bocki,140010837,339439,1,973,6.94946e-06,135101128,0.964933
D.bocki,140010837,306394,1,973,6.94946e-06,135102101,0.96494
D.bocki,140010837,221250,1,973,6.94946e-06,135103074,0.964947
D.bocki,140010837,179887,1,973,6.94946e-06,135104047,0.964954
D.bocki,140010837,154519,1,973,6.94946e-06,135105020,0.964961
D.bocki,140010837,101805,1,973,6.94946e-06,135105993,0.964968
D.bocki,140010837,81753,1,972,6.94232e-06,135106965,0.964975
D.bocki,140010837,429161,1,972,6.94232e-06,135107937,0.964982
D.bocki,140010837,399452,1,972,6.94232e-06,135108909,0.964989
D.bocki,140010837,394924,1,972,6.94232e-06,135109881,0.964996
D.bocki,140010837,354341,1,972,6.94232e-06,135110853,0.965003
D.bocki,140010837,34377,1,972,6.94232e-06,135111825,0.96501
D.bocki,140010837,340550,1,972,6.94232e-06,135112797,0.965017
D.bocki,140010837,388663,1,971,6.93518e-06,135113768,0.965024
D.bocki,140010837,381376,1,971,6.93518e-06,135114739,0.965031
D.bocki,140010837,357916,1,971,6.93518e-06,135115710,0.965038
D.bocki,140010837,303634,1,971,6.93518e-06,135116681,0.965044
D.bocki,140010837,279631,1,971,6.93518e-06,135117652,0.965051
D.bocki,140010837,191020,1,971,6.93518e-06,135118623,0.965058
D.bocki,140010837,450931,1,970,6.92804e-06,135119593,0.965065
D.bocki,140010837,376771,1,970,6.92804e-06,135120563,0.965072
D.bocki,140010837,234564,1,970,6.92804e-06,135121533,0.965079
D.bocki,140010837,91438,1,969,6.92089e-06,135122502,0.965086
D.bocki,140010837,452045,1,969,6.92089e-06,135123471,0.965093
D.bocki,140010837,383009,1,969,6.92089e-06,135124440,0.9651
D.bocki,140010837,352362,1,969,6.92089e-06,135125409,0.965107
D.bocki,140010837,244362,1,969,6.92089e-06,135126378,0.965114
D.bocki,140010837,224545,1,969,6.92089e-06,135127347,0.965121
D.bocki,140010837,172546,1,969,6.92089e-06,135128316,0.965128
D.bocki,140010837,69244,1,968,6.91375e-06,135129284,0.965134
D.bocki,140010837,388859,1,968,6.91375e-06,135130252,0.965141
D.bocki,140010837,348084,1,968,6.91375e-06,135131220,0.965148
D.bocki,140010837,328556,1,968,6.91375e-06,135132188,0.965155
D.bocki,140010837,324888,1,968,6.91375e-06,135133156,0.965162
D.bocki,140010837,23124,1,968,6.91375e-06,135134124,0.965169
D.bocki,140010837,221159,1,968,6.91375e-06,135135092,0.965176
D.bocki,140010837,181959,1,968,6.91375e-06,135136060,0.965183
D.bocki,140010837,59086,1,967,6.90661e-06,135137027,0.96519
D.bocki,140010837,49294,1,967,6.90661e-06,135137994,0.965197
D.bocki,140010837,454693,1,967,6.90661e-06,135138961,0.965204
D.bocki,140010837,16830,1,967,6.90661e-06,135139928,0.96521
D.bocki,140010837,114068,1,967,6.90661e-06,135140895,0.965217
D.bocki,140010837,69246,1,966,6.89947e-06,135141861,0.965224
D.bocki,140010837,64290,1,966,6.89947e-06,135142827,0.965231
D.bocki,140010837,452162,1,966,6.89947e-06,135143793,0.965238
D.bocki,140010837,390045,1,966,6.89947e-06,135144759,0.965245
D.bocki,140010837,377127,1,966,6.89947e-06,135145725,0.965252
D.bocki,140010837,337541,1,966,6.89947e-06,135146691,0.965259
D.bocki,140010837,314960,1,966,6.89947e-06,135147657,0.965266
D.bocki,140010837,30668,1,966,6.89947e-06,135148623,0.965273
D.bocki,140010837,258966,1,966,6.89947e-06,135149589,0.965279
D.bocki,140010837,188718,1,966,6.89947e-06,135150555,0.965286
D.bocki,140010837,112608,1,966,6.89947e-06,135151521,0.965293
D.bocki,140010837,423311,1,965,6.89232e-06,135152486,0.9653
D.bocki,140010837,395286,1,965,6.89232e-06,135153451,0.965307
D.bocki,140010837,390121,1,965,6.89232e-06,135154416,0.965314
D.bocki,140010837,372575,1,965,6.89232e-06,135155381,0.965321
D.bocki,140010837,315883,1,965,6.89232e-06,135156346,0.965328
D.bocki,140010837,452039,1,964,6.88518e-06,135157310,0.965335
D.bocki,140010837,447881,1,964,6.88518e-06,135158274,0.965342
D.bocki,140010837,442018,1,964,6.88518e-06,135159238,0.965348
D.bocki,140010837,429770,1,964,6.88518e-06,135160202,0.965355
D.bocki,140010837,378779,1,964,6.88518e-06,135161166,0.965362
D.bocki,140010837,360769,1,964,6.88518e-06,135162130,0.965369
D.bocki,140010837,32386,1,964,6.88518e-06,135163094,0.965376
D.bocki,140010837,257844,1,964,6.88518e-06,135164058,0.965383
D.bocki,140010837,257319,1,964,6.88518e-06,135165022,0.96539
D.bocki,140010837,246648,1,964,6.88518e-06,135165986,0.965397
D.bocki,140010837,233887,1,964,6.88518e-06,135166950,0.965403
D.bocki,140010837,124442,1,964,6.88518e-06,135167914,0.96541
D.bocki,140010837,454298,1,963,6.87804e-06,135168877,0.965417
D.bocki,140010837,440113,1,963,6.87804e-06,135169840,0.965424
D.bocki,140010837,432599,1,963,6.87804e-06,135170803,0.965431
D.bocki,140010837,427752,1,963,6.87804e-06,135171766,0.965438
D.bocki,140010837,408355,1,963,6.87804e-06,135172729,0.965445
D.bocki,140010837,355230,1,963,6.87804e-06,135173692,0.965452
D.bocki,140010837,33823,1,963,6.87804e-06,135174655,0.965459
D.bocki,140010837,225174,1,963,6.87804e-06,135175618,0.965465
D.bocki,140010837,202250,1,963,6.87804e-06,135176581,0.965472
D.bocki,140010837,169913,1,963,6.87804e-06,135177544,0.965479
D.bocki,140010837,54547,1,962,6.8709e-06,135178506,0.965486
D.bocki,140010837,451496,1,962,6.8709e-06,135179468,0.965493
D.bocki,140010837,35457,1,962,6.8709e-06,135180430,0.9655
D.bocki,140010837,217195,1,962,6.8709e-06,135181392,0.965507
D.bocki,140010837,204595,1,962,6.8709e-06,135182354,0.965514
D.bocki,140010837,188695,1,962,6.8709e-06,135183316,0.96552
D.bocki,140010837,68968,1,961,6.86375e-06,135184277,0.965527
D.bocki,140010837,49050,1,961,6.86375e-06,135185238,0.965534
D.bocki,140010837,454375,1,961,6.86375e-06,135186199,0.965541
D.bocki,140010837,277904,1,961,6.86375e-06,135187160,0.965548
D.bocki,140010837,252207,1,961,6.86375e-06,135188121,0.965555
D.bocki,140010837,24977,1,961,6.86375e-06,135189082,0.965562
D.bocki,140010837,155881,1,961,6.86375e-06,135190043,0.965568
D.bocki,140010837,452432,1,960,6.85661e-06,135191003,0.965575
D.bocki,140010837,385039,1,960,6.85661e-06,135191963,0.965582
D.bocki,140010837,229880,1,960,6.85661e-06,135192923,0.965589
D.bocki,140010837,384743,1,959,6.84947e-06,135193882,0.965596
D.bocki,140010837,331349,1,959,6.84947e-06,135194841,0.965603
D.bocki,140010837,321146,1,959,6.84947e-06,135195800,0.96561
D.bocki,140010837,304667,1,959,6.84947e-06,135196759,0.965616
D.bocki,140010837,280806,1,959,6.84947e-06,135197718,0.965623
D.bocki,140010837,158401,1,959,6.84947e-06,135198677,0.96563
D.bocki,140010837,303635,1,958,6.84233e-06,135199635,0.965637
D.bocki,140010837,269709,1,958,6.84233e-06,135200593,0.965644
D.bocki,140010837,191455,1,958,6.84233e-06,135201551,0.965651
D.bocki,140010837,109843,1,958,6.84233e-06,135202509,0.965657
D.bocki,140010837,375506,1,957,6.83519e-06,135203466,0.965664
D.bocki,140010837,245302,1,957,6.83519e-06,135204423,0.965671
D.bocki,140010837,216194,1,957,6.83519e-06,135205380,0.965678
D.bocki,140010837,181551,1,957,6.83519e-06,135206337,0.965685
D.bocki,140010837,65266,1,956,6.82804e-06,135207293,0.965692
D.bocki,140010837,452444,1,956,6.82804e-06,135208249,0.965698
D.bocki,140010837,366058,1,956,6.82804e-06,135209205,0.965705
D.bocki,140010837,355756,1,956,6.82804e-06,135210161,0.965712
D.bocki,140010837,216780,1,956,6.82804e-06,135211117,0.965719
D.bocki,140010837,128723,1,956,6.82804e-06,135212073,0.965726
D.bocki,140010837,117564,1,956,6.82804e-06,135213029,0.965733
D.bocki,140010837,73805,1,955,6.8209e-06,135213984,0.965739
D.bocki,140010837,452330,1,955,6.8209e-06,135214939,0.965746
D.bocki,140010837,391690,1,955,6.8209e-06,135215894,0.965753
D.bocki,140010837,327137,1,955,6.8209e-06,135216849,0.96576
D.bocki,140010837,30191,1,955,6.8209e-06,135217804,0.965767
D.bocki,140010837,276403,1,955,6.8209e-06,135218759,0.965774
D.bocki,140010837,271839,1,955,6.8209e-06,135219714,0.96578
D.bocki,140010837,266795,1,955,6.8209e-06,135220669,0.965787
D.bocki,140010837,247694,1,955,6.8209e-06,135221624,0.965794
D.bocki,140010837,185546,1,955,6.8209e-06,135222579,0.965801
D.bocki,140010837,175396,1,955,6.8209e-06,135223534,0.965808
D.bocki,140010837,453373,1,954,6.81376e-06,135224488,0.965814
D.bocki,140010837,428150,1,954,6.81376e-06,135225442,0.965821
D.bocki,140010837,392717,1,954,6.81376e-06,135226396,0.965828
D.bocki,140010837,375001,1,954,6.81376e-06,135227350,0.965835
D.bocki,140010837,370230,1,954,6.81376e-06,135228304,0.965842
D.bocki,140010837,329784,1,954,6.81376e-06,135229258,0.965849
D.bocki,140010837,144962,1,954,6.81376e-06,135230212,0.965855
D.bocki,140010837,52143,1,953,6.80662e-06,135231165,0.965862
D.bocki,140010837,453259,1,953,6.80662e-06,135232118,0.965869
D.bocki,140010837,451992,1,953,6.80662e-06,135233071,0.965876
D.bocki,140010837,432685,1,953,6.80662e-06,135234024,0.965883
D.bocki,140010837,365891,1,953,6.80662e-06,135234977,0.965889
D.bocki,140010837,357506,1,953,6.80662e-06,135235930,0.965896
D.bocki,140010837,251477,1,953,6.80662e-06,135236883,0.965903
D.bocki,140010837,193325,1,953,6.80662e-06,135237836,0.96591
D.bocki,140010837,187579,1,953,6.80662e-06,135238789,0.965917
D.bocki,140010837,137997,1,953,6.80662e-06,135239742,0.965923
D.bocki,140010837,115795,1,953,6.80662e-06,135240695,0.96593
D.bocki,140010837,438264,1,952,6.79947e-06,135241647,0.965937
D.bocki,140010837,299757,1,952,6.79947e-06,135242599,0.965944
D.bocki,140010837,244272,1,952,6.79947e-06,135243551,0.965951
D.bocki,140010837,209068,1,952,6.79947e-06,135244503,0.965957
D.bocki,140010837,150247,1,952,6.79947e-06,135245455,0.965964
D.bocki,140010837,120347,1,952,6.79947e-06,135246407,0.965971
D.bocki,140010837,53919,1,951,6.79233e-06,135247358,0.965978
D.bocki,140010837,450935,1,951,6.79233e-06,135248309,0.965985
D.bocki,140010837,426833,1,951,6.79233e-06,135249260,0.965991
D.bocki,140010837,405417,1,951,6.79233e-06,135250211,0.965998
D.bocki,140010837,282833,1,951,6.79233e-06,135251162,0.966005
D.bocki,140010837,278145,1,951,6.79233e-06,135252113,0.966012
D.bocki,140010837,210736,1,951,6.79233e-06,135253064,0.966019
D.bocki,140010837,196783,1,951,6.79233e-06,135254015,0.966025
D.bocki,140010837,439737,1,950,6.78519e-06,135254965,0.966032
D.bocki,140010837,379293,1,950,6.78519e-06,135255915,0.966039
D.bocki,140010837,341754,1,950,6.78519e-06,135256865,0.966046
D.bocki,140010837,163823,1,950,6.78519e-06,135257815,0.966052
D.bocki,140010837,107894,1,950,6.78519e-06,135258765,0.966059
D.bocki,140010837,323030,1,949,6.77805e-06,135259714,0.966066
D.bocki,140010837,300113,1,949,6.77805e-06,135260663,0.966073
D.bocki,140010837,248771,1,949,6.77805e-06,135261612,0.96608
D.bocki,140010837,132431,1,949,6.77805e-06,135262561,0.966086
D.bocki,140010837,102574,1,949,6.77805e-06,135263510,0.966093
D.bocki,140010837,428718,1,948,6.7709e-06,135264458,0.9661
D.bocki,140010837,287981,1,948,6.7709e-06,135265406,0.966107
D.bocki,140010837,112098,1,948,6.7709e-06,135266354,0.966113
D.bocki,140010837,67639,1,947,6.76376e-06,135267301,0.96612
D.bocki,140010837,48839,1,947,6.76376e-06,135268248,0.966127
D.bocki,140010837,405149,1,947,6.76376e-06,135269195,0.966134
D.bocki,140010837,37128,1,947,6.76376e-06,135270142,0.966141
D.bocki,140010837,301295,1,947,6.76376e-06,135271089,0.966147
D.bocki,140010837,298586,1,947,6.76376e-06,135272036,0.966154
D.bocki,140010837,280257,1,947,6.76376e-06,135272983,0.966161
D.bocki,140010837,272535,1,947,6.76376e-06,135273930,0.966168
D.bocki,140010837,261053,1,947,6.76376e-06,135274877,0.966174
D.bocki,140010837,245812,1,947,6.76376e-06,135275824,0.966181
D.bocki,140010837,21010,1,947,6.76376e-06,135276771,0.966188
D.bocki,140010837,207136,1,947,6.76376e-06,135277718,0.966195
D.bocki,140010837,135602,1,947,6.76376e-06,135278665,0.966201
D.bocki,140010837,453797,1,946,6.75662e-06,135279611,0.966208
D.bocki,140010837,360619,1,946,6.75662e-06,135280557,0.966215
D.bocki,140010837,335418,1,946,6.75662e-06,135281503,0.966222
D.bocki,140010837,26103,1,946,6.75662e-06,135282449,0.966228
D.bocki,140010837,246416,1,946,6.75662e-06,135283395,0.966235
D.bocki,140010837,155238,1,946,6.75662e-06,135284341,0.966242
D.bocki,140010837,117887,1,946,6.75662e-06,135285287,0.966249
D.bocki,140010837,106009,1,946,6.75662e-06,135286233,0.966255
D.bocki,140010837,453491,1,945,6.74948e-06,135287178,0.966262
D.bocki,140010837,373365,1,945,6.74948e-06,135288123,0.966269
D.bocki,140010837,244447,1,945,6.74948e-06,135289068,0.966276
D.bocki,140010837,220119,1,945,6.74948e-06,135290013,0.966282
D.bocki,140010837,149977,1,945,6.74948e-06,135290958,0.966289
D.bocki,140010837,91000,1,944,6.74234e-06,135291902,0.966296
D.bocki,140010837,454490,1,944,6.74234e-06,135292846,0.966303
D.bocki,140010837,453104,1,944,6.74234e-06,135293790,0.966309
D.bocki,140010837,451690,1,944,6.74234e-06,135294734,0.966316
D.bocki,140010837,39331,1,944,6.74234e-06,135295678,0.966323
D.bocki,140010837,323473,1,944,6.74234e-06,135296622,0.96633
D.bocki,140010837,322593,1,944,6.74234e-06,135297566,0.966336
D.bocki,140010837,304656,1,944,6.74234e-06,135298510,0.966343
D.bocki,140010837,295480,1,944,6.74234e-06,135299454,0.96635
D.bocki,140010837,25588,1,944,6.74234e-06,135300398,0.966357
D.bocki,140010837,255696,1,944,6.74234e-06,135301342,0.966363
D.bocki,140010837,247009,1,944,6.74234e-06,135302286,0.96637
D.bocki,140010837,232516,1,944,6.74234e-06,135303230,0.966377
D.bocki,140010837,103580,1,944,6.74234e-06,135304174,0.966384
D.bocki,140010837,68656,1,943,6.73519e-06,135305117,0.96639
D.bocki,140010837,453115,1,943,6.73519e-06,135306060,0.966397
D.bocki,140010837,451800,1,943,6.73519e-06,135307003,0.966404
D.bocki,140010837,394299,1,943,6.73519e-06,135307946,0.966411
D.bocki,140010837,384647,1,943,6.73519e-06,135308889,0.966417
D.bocki,140010837,362742,1,943,6.73519e-06,135309832,0.966424
D.bocki,140010837,313874,1,943,6.73519e-06,135310775,0.966431
D.bocki,140010837,27658,1,943,6.73519e-06,135311718,0.966437
D.bocki,140010837,237813,1,943,6.73519e-06,135312661,0.966444
D.bocki,140010837,21604,1,943,6.73519e-06,135313604,0.966451
D.bocki,140010837,181143,1,943,6.73519e-06,135314547,0.966458
D.bocki,140010837,96301,1,942,6.72805e-06,135315489,0.966464
D.bocki,140010837,453922,1,942,6.72805e-06,135316431,0.966471
D.bocki,140010837,451016,1,942,6.72805e-06,135317373,0.966478
D.bocki,140010837,194464,1,942,6.72805e-06,135318315,0.966485
D.bocki,140010837,19283,1,942,6.72805e-06,135319257,0.966491
D.bocki,140010837,140194,1,942,6.72805e-06,135320199,0.966498
D.bocki,140010837,451277,1,941,6.72091e-06,135321140,0.966505
D.bocki,140010837,418238,1,941,6.72091e-06,135322081,0.966511
D.bocki,140010837,272407,1,941,6.72091e-06,135323022,0.966518
D.bocki,140010837,243271,1,941,6.72091e-06,135323963,0.966525
D.bocki,140010837,213468,1,941,6.72091e-06,135324904,0.966532
D.bocki,140010837,204628,1,941,6.72091e-06,135325845,0.966538
D.bocki,140010837,98644,1,940,6.71377e-06,135326785,0.966545
D.bocki,140010837,454492,1,940,6.71377e-06,135327725,0.966552
D.bocki,140010837,453225,1,940,6.71377e-06,135328665,0.966559
D.bocki,140010837,451592,1,940,6.71377e-06,135329605,0.966565
D.bocki,140010837,433794,1,940,6.71377e-06,135330545,0.966572
D.bocki,140010837,424087,1,940,6.71377e-06,135331485,0.966579
D.bocki,140010837,294826,1,940,6.71377e-06,135332425,0.966585
D.bocki,140010837,38050,1,939,6.70662e-06,135333364,0.966592
D.bocki,140010837,320625,1,939,6.70662e-06,135334303,0.966599
D.bocki,140010837,303337,1,939,6.70662e-06,135335242,0.966605
D.bocki,140010837,287623,1,939,6.70662e-06,135336181,0.966612
D.bocki,140010837,266917,1,939,6.70662e-06,135337120,0.966619
D.bocki,140010837,21550,1,939,6.70662e-06,135338059,0.966626
D.bocki,140010837,133626,1,939,6.70662e-06,135338998,0.966632
D.bocki,140010837,131810,1,939,6.70662e-06,135339937,0.966639
D.bocki,140010837,128913,1,939,6.70662e-06,135340876,0.966646
D.bocki,140010837,83457,1,938,6.69948e-06,135341814,0.966652
D.bocki,140010837,441837,1,938,6.69948e-06,135342752,0.966659
D.bocki,140010837,397587,1,938,6.69948e-06,135343690,0.966666
D.bocki,140010837,297433,1,938,6.69948e-06,135344628,0.966673
D.bocki,140010837,287622,1,938,6.69948e-06,135345566,0.966679
D.bocki,140010837,271516,1,938,6.69948e-06,135346504,0.966686
D.bocki,140010837,220585,1,938,6.69948e-06,135347442,0.966693
D.bocki,140010837,2196,1,938,6.69948e-06,135348380,0.966699
D.bocki,140010837,190643,1,938,6.69948e-06,135349318,0.966706
D.bocki,140010837,187827,1,938,6.69948e-06,135350256,0.966713
D.bocki,140010837,13008,1,938,6.69948e-06,135351194,0.966719
D.bocki,140010837,453396,1,937,6.69234e-06,135352131,0.966726
D.bocki,140010837,429520,1,937,6.69234e-06,135353068,0.966733
D.bocki,140010837,428357,1,937,6.69234e-06,135354005,0.966739
D.bocki,140010837,397945,1,937,6.69234e-06,135354942,0.966746
D.bocki,140010837,310199,1,937,6.69234e-06,135355879,0.966753
D.bocki,140010837,288286,1,937,6.69234e-06,135356816,0.96676
D.bocki,140010837,189463,1,937,6.69234e-06,135357753,0.966766
D.bocki,140010837,80038,1,936,6.6852e-06,135358689,0.966773
D.bocki,140010837,47159,1,936,6.6852e-06,135359625,0.96678
D.bocki,140010837,452426,1,936,6.6852e-06,135360561,0.966786
D.bocki,140010837,374715,1,936,6.6852e-06,135361497,0.966793
D.bocki,140010837,297434,1,936,6.6852e-06,135362433,0.9668
D.bocki,140010837,239225,1,936,6.6852e-06,135363369,0.966806
D.bocki,140010837,224858,1,936,6.6852e-06,135364305,0.966813
D.bocki,140010837,78935,1,935,6.67805e-06,135365240,0.96682
D.bocki,140010837,382006,1,935,6.67805e-06,135366175,0.966826
D.bocki,140010837,369240,1,935,6.67805e-06,135367110,0.966833
D.bocki,140010837,27577,1,935,6.67805e-06,135368045,0.96684
D.bocki,140010837,274246,1,935,6.67805e-06,135368980,0.966846
D.bocki,140010837,26959,1,935,6.67805e-06,135369915,0.966853
D.bocki,140010837,175504,1,935,6.67805e-06,135370850,0.96686
D.bocki,140010837,131868,1,935,6.67805e-06,135371785,0.966866
D.bocki,140010837,1185,1,935,6.67805e-06,135372720,0.966873
D.bocki,140010837,361774,1,934,6.67091e-06,135373654,0.96688
D.bocki,140010837,320363,1,934,6.67091e-06,135374588,0.966886
D.bocki,140010837,293215,1,934,6.67091e-06,135375522,0.966893
D.bocki,140010837,28337,1,934,6.67091e-06,135376456,0.9669
D.bocki,140010837,276551,1,934,6.67091e-06,135377390,0.966907
D.bocki,140010837,242970,1,934,6.67091e-06,135378324,0.966913
D.bocki,140010837,239477,1,934,6.67091e-06,135379258,0.96692
D.bocki,140010837,188446,1,934,6.67091e-06,135380192,0.966927
D.bocki,140010837,452216,1,933,6.66377e-06,135381125,0.966933
D.bocki,140010837,451877,1,933,6.66377e-06,135382058,0.96694
D.bocki,140010837,359803,1,933,6.66377e-06,135382991,0.966947
D.bocki,140010837,250563,1,933,6.66377e-06,135383924,0.966953
D.bocki,140010837,208010,1,933,6.66377e-06,135384857,0.96696
D.bocki,140010837,194683,1,933,6.66377e-06,135385790,0.966967
D.bocki,140010837,453595,1,932,6.65663e-06,135386722,0.966973
D.bocki,140010837,452100,1,932,6.65663e-06,135387654,0.96698
D.bocki,140010837,40841,1,932,6.65663e-06,135388586,0.966986
D.bocki,140010837,403069,1,932,6.65663e-06,135389518,0.966993
D.bocki,140010837,356284,1,932,6.65663e-06,135390450,0.967
D.bocki,140010837,297111,1,932,6.65663e-06,135391382,0.967006
D.bocki,140010837,289543,1,932,6.65663e-06,135392314,0.967013
D.bocki,140010837,174222,1,932,6.65663e-06,135393246,0.96702
D.bocki,140010837,154049,1,932,6.65663e-06,135394178,0.967026
D.bocki,140010837,113503,1,932,6.65663e-06,135395110,0.967033
D.bocki,140010837,407129,1,931,6.64949e-06,135396041,0.96704
D.bocki,140010837,329314,1,931,6.64949e-06,135396972,0.967046
D.bocki,140010837,286296,1,931,6.64949e-06,135397903,0.967053
D.bocki,140010837,234228,1,931,6.64949e-06,135398834,0.96706
D.bocki,140010837,21606,1,931,6.64949e-06,135399765,0.967066
D.bocki,140010837,17121,1,931,6.64949e-06,135400696,0.967073
D.bocki,140010837,148465,1,931,6.64949e-06,135401627,0.96708
D.bocki,140010837,58325,1,930,6.64234e-06,135402557,0.967086
D.bocki,140010837,341145,1,930,6.64234e-06,135403487,0.967093
D.bocki,140010837,287559,1,930,6.64234e-06,135404417,0.9671
D.bocki,140010837,269142,1,930,6.64234e-06,135405347,0.967106
D.bocki,140010837,261835,1,930,6.64234e-06,135406277,0.967113
D.bocki,140010837,216813,1,930,6.64234e-06,135407207,0.967119
D.bocki,140010837,21011,1,930,6.64234e-06,135408137,0.967126
D.bocki,140010837,209603,1,930,6.64234e-06,135409067,0.967133
D.bocki,140010837,13211,1,930,6.64234e-06,135409997,0.967139
D.bocki,140010837,452241,1,929,6.6352e-06,135410926,0.967146
D.bocki,140010837,394699,1,929,6.6352e-06,135411855,0.967153
D.bocki,140010837,270884,1,929,6.6352e-06,135412784,0.967159
D.bocki,140010837,93089,1,928,6.62806e-06,135413712,0.967166
D.bocki,140010837,88294,1,928,6.62806e-06,135414640,0.967173
D.bocki,140010837,53466,1,928,6.62806e-06,135415568,0.967179
D.bocki,140010837,452505,1,928,6.62806e-06,135416496,0.967186
D.bocki,140010837,363814,1,928,6.62806e-06,135417424,0.967192
D.bocki,140010837,350917,1,928,6.62806e-06,135418352,0.967199
D.bocki,140010837,206870,1,928,6.62806e-06,135419280,0.967206
D.bocki,140010837,165703,1,928,6.62806e-06,135420208,0.967212
D.bocki,140010837,129807,1,928,6.62806e-06,135421136,0.967219
D.bocki,140010837,11738,1,928,6.62806e-06,135422064,0.967226
D.bocki,140010837,6663,1,927,6.62092e-06,135422991,0.967232
D.bocki,140010837,59667,1,927,6.62092e-06,135423918,0.967239
D.bocki,140010837,43145,1,927,6.62092e-06,135424845,0.967245
D.bocki,140010837,431068,1,927,6.62092e-06,135425772,0.967252
D.bocki,140010837,256906,1,927,6.62092e-06,135426699,0.967259
D.bocki,140010837,222856,1,927,6.62092e-06,135427626,0.967265
D.bocki,140010837,211231,1,927,6.62092e-06,135428553,0.967272
D.bocki,140010837,452686,1,926,6.61377e-06,135429479,0.967279
D.bocki,140010837,412886,1,926,6.61377e-06,135430405,0.967285
D.bocki,140010837,31135,1,926,6.61377e-06,135431331,0.967292
D.bocki,140010837,261456,1,926,6.61377e-06,135432257,0.967298
D.bocki,140010837,256416,1,926,6.61377e-06,135433183,0.967305
D.bocki,140010837,203149,1,926,6.61377e-06,135434109,0.967312
D.bocki,140010837,15841,1,926,6.61377e-06,135435035,0.967318
D.bocki,140010837,115991,1,926,6.61377e-06,135435961,0.967325
D.bocki,140010837,78682,1,925,6.60663e-06,135436886,0.967331
D.bocki,140010837,355352,1,925,6.60663e-06,135437811,0.967338
D.bocki,140010837,316389,1,925,6.60663e-06,135438736,0.967345
D.bocki,140010837,312957,1,925,6.60663e-06,135439661,0.967351
D.bocki,140010837,291077,1,925,6.60663e-06,135440586,0.967358
D.bocki,140010837,284775,1,925,6.60663e-06,135441511,0.967364
D.bocki,140010837,279038,1,925,6.60663e-06,135442436,0.967371
D.bocki,140010837,231326,1,925,6.60663e-06,135443361,0.967378
D.bocki,140010837,199100,1,925,6.60663e-06,135444286,0.967384
D.bocki,140010837,191542,1,925,6.60663e-06,135445211,0.967391
D.bocki,140010837,153774,1,925,6.60663e-06,135446136,0.967398
D.bocki,140010837,153072,1,925,6.60663e-06,135447061,0.967404
D.bocki,140010837,142141,1,925,6.60663e-06,135447986,0.967411
D.bocki,140010837,70587,1,924,6.59949e-06,135448910,0.967417
D.bocki,140010837,452942,1,924,6.59949e-06,135449834,0.967424
D.bocki,140010837,45231,1,924,6.59949e-06,135450758,0.967431
D.bocki,140010837,412825,1,924,6.59949e-06,135451682,0.967437
D.bocki,140010837,133321,1,924,6.59949e-06,135452606,0.967444
D.bocki,140010837,88582,1,923,6.59235e-06,135453529,0.96745
D.bocki,140010837,308990,1,923,6.59235e-06,135454452,0.967457
D.bocki,140010837,235556,1,923,6.59235e-06,135455375,0.967464
D.bocki,140010837,173210,1,923,6.59235e-06,135456298,0.96747
D.bocki,140010837,118571,1,923,6.59235e-06,135457221,0.967477
D.bocki,140010837,66868,1,922,6.5852e-06,135458143,0.967483
D.bocki,140010837,453904,1,922,6.5852e-06,135459065,0.96749
D.bocki,140010837,451406,1,922,6.5852e-06,135459987,0.967496
D.bocki,140010837,327695,1,922,6.5852e-06,135460909,0.967503
D.bocki,140010837,265755,1,922,6.5852e-06,135461831,0.96751
D.bocki,140010837,193397,1,922,6.5852e-06,135462753,0.967516
D.bocki,140010837,149570,1,922,6.5852e-06,135463675,0.967523
D.bocki,140010837,13212,1,922,6.5852e-06,135464597,0.967529
D.bocki,140010837,60643,1,921,6.57806e-06,135465518,0.967536
D.bocki,140010837,53916,1,921,6.57806e-06,135466439,0.967543
D.bocki,140010837,424597,1,921,6.57806e-06,135467360,0.967549
D.bocki,140010837,138497,1,921,6.57806e-06,135468281,0.967556
D.bocki,140010837,125504,1,921,6.57806e-06,135469202,0.967562
D.bocki,140010837,90301,1,920,6.57092e-06,135470122,0.967569
D.bocki,140010837,339807,1,920,6.57092e-06,135471042,0.967575
D.bocki,140010837,275386,1,920,6.57092e-06,135471962,0.967582
D.bocki,140010837,240110,1,920,6.57092e-06,135472882,0.967589
D.bocki,140010837,153488,1,920,6.57092e-06,135473802,0.967595
D.bocki,140010837,452927,1,919,6.56378e-06,135474721,0.967602
D.bocki,140010837,451633,1,919,6.56378e-06,135475640,0.967608
D.bocki,140010837,44426,1,919,6.56378e-06,135476559,0.967615
D.bocki,140010837,390327,1,919,6.56378e-06,135477478,0.967621
D.bocki,140010837,354737,1,919,6.56378e-06,135478397,0.967628
D.bocki,140010837,309448,1,919,6.56378e-06,135479316,0.967634
D.bocki,140010837,244252,1,919,6.56378e-06,135480235,0.967641
D.bocki,140010837,128311,1,919,6.56378e-06,135481154,0.967648
D.bocki,140010837,94248,1,918,6.55664e-06,135482072,0.967654
D.bocki,140010837,437263,1,918,6.55664e-06,135482990,0.967661
D.bocki,140010837,414790,1,918,6.55664e-06,135483908,0.967667
D.bocki,140010837,303500,1,918,6.55664e-06,135484826,0.967674
D.bocki,140010837,300971,1,918,6.55664e-06,135485744,0.96768
D.bocki,140010837,289574,1,918,6.55664e-06,135486662,0.967687
D.bocki,140010837,163002,1,918,6.55664e-06,135487580,0.967694
D.bocki,140010837,6404,1,917,6.54949e-06,135488497,0.9677
D.bocki,140010837,453411,1,917,6.54949e-06,135489414,0.967707
D.bocki,140010837,420625,1,917,6.54949e-06,135490331,0.967713
D.bocki,140010837,381600,1,917,6.54949e-06,135491248,0.96772
D.bocki,140010837,358456,1,917,6.54949e-06,135492165,0.967726
D.bocki,140010837,144153,1,917,6.54949e-06,135493082,0.967733
D.bocki,140010837,56305,1,916,6.54235e-06,135493998,0.967739
D.bocki,140010837,437202,1,916,6.54235e-06,135494914,0.967746
D.bocki,140010837,372864,1,916,6.54235e-06,135495830,0.967752
D.bocki,140010837,25544,1,916,6.54235e-06,135496746,0.967759
D.bocki,140010837,230335,1,916,6.54235e-06,135497662,0.967766
D.bocki,140010837,212417,1,916,6.54235e-06,135498578,0.967772
D.bocki,140010837,184826,1,916,6.54235e-06,135499494,0.967779
D.bocki,140010837,180612,1,916,6.54235e-06,135500410,0.967785
D.bocki,140010837,100157,1,916,6.54235e-06,135501326,0.967792
D.bocki,140010837,451130,1,915,6.53521e-06,135502241,0.967798
D.bocki,140010837,137405,1,915,6.53521e-06,135503156,0.967805
D.bocki,140010837,4613,1,914,6.52807e-06,135504070,0.967811
D.bocki,140010837,451731,1,914,6.52807e-06,135504984,0.967818
D.bocki,140010837,437311,1,914,6.52807e-06,135505898,0.967824
D.bocki,140010837,265118,1,914,6.52807e-06,135506812,0.967831
D.bocki,140010837,245083,1,914,6.52807e-06,135507726,0.967837
D.bocki,140010837,22842,1,914,6.52807e-06,135508640,0.967844
D.bocki,140010837,21790,1,914,6.52807e-06,135509554,0.96785
D.bocki,140010837,195070,1,914,6.52807e-06,135510468,0.967857
D.bocki,140010837,95695,1,913,6.52092e-06,135511381,0.967864
D.bocki,140010837,382412,1,913,6.52092e-06,135512294,0.96787
D.bocki,140010837,331394,1,913,6.52092e-06,135513207,0.967877
D.bocki,140010837,329368,1,913,6.52092e-06,135514120,0.967883
D.bocki,140010837,117225,1,913,6.52092e-06,135515033,0.96789
D.bocki,140010837,71803,1,912,6.51378e-06,135515945,0.967896
D.bocki,140010837,453397,1,912,6.51378e-06,135516857,0.967903
D.bocki,140010837,398466,1,912,6.51378e-06,135517769,0.967909
D.bocki,140010837,195869,1,912,6.51378e-06,135518681,0.967916
D.bocki,140010837,137936,1,912,6.51378e-06,135519593,0.967922
D.bocki,140010837,87653,1,911,6.50664e-06,135520504,0.967929
D.bocki,140010837,73715,1,911,6.50664e-06,135521415,0.967935
D.bocki,140010837,427928,1,911,6.50664e-06,135522326,0.967942
D.bocki,140010837,213686,1,911,6.50664e-06,135523237,0.967948
D.bocki,140010837,166844,1,911,6.50664e-06,135524148,0.967955
D.bocki,140010837,56766,1,910,6.4995e-06,135525058,0.967961
D.bocki,140010837,440899,1,910,6.4995e-06,135525968,0.967968
D.bocki,140010837,408624,1,910,6.4995e-06,135526878,0.967974
D.bocki,140010837,398092,1,910,6.4995e-06,135527788,0.967981
D.bocki,140010837,38787,1,910,6.4995e-06,135528698,0.967987
D.bocki,140010837,373543,1,910,6.4995e-06,135529608,0.967994
D.bocki,140010837,331262,1,910,6.4995e-06,135530518,0.968
D.bocki,140010837,310501,1,910,6.4995e-06,135531428,0.968007
D.bocki,140010837,260709,1,910,6.4995e-06,135532338,0.968013
D.bocki,140010837,258258,1,910,6.4995e-06,135533248,0.96802
D.bocki,140010837,248441,1,910,6.4995e-06,135534158,0.968026
D.bocki,140010837,197436,1,910,6.4995e-06,135535068,0.968033
D.bocki,140010837,451615,1,909,6.49235e-06,135535977,0.968039
D.bocki,140010837,438717,1,909,6.49235e-06,135536886,0.968046
D.bocki,140010837,425159,1,909,6.49235e-06,135537795,0.968052
D.bocki,140010837,422754,1,909,6.49235e-06,135538704,0.968059
D.bocki,140010837,419076,1,909,6.49235e-06,135539613,0.968065
D.bocki,140010837,243262,1,909,6.49235e-06,135540522,0.968072
D.bocki,140010837,133779,1,909,6.49235e-06,135541431,0.968078
D.bocki,140010837,103322,1,909,6.49235e-06,135542340,0.968085
D.bocki,140010837,71665,1,908,6.48521e-06,135543248,0.968091
D.bocki,140010837,437203,1,908,6.48521e-06,135544156,0.968098
D.bocki,140010837,433755,1,908,6.48521e-06,135545064,0.968104
D.bocki,140010837,392858,1,908,6.48521e-06,135545972,0.968111
D.bocki,140010837,227301,1,908,6.48521e-06,135546880,0.968117
D.bocki,140010837,196622,1,908,6.48521e-06,135547788,0.968124
D.bocki,140010837,109313,1,908,6.48521e-06,135548696,0.96813
D.bocki,140010837,439478,1,907,6.47807e-06,135549603,0.968137
D.bocki,140010837,367619,1,907,6.47807e-06,135550510,0.968143
D.bocki,140010837,275418,1,907,6.47807e-06,135551417,0.968149
D.bocki,140010837,269283,1,907,6.47807e-06,135552324,0.968156
D.bocki,140010837,260557,1,907,6.47807e-06,135553231,0.968162
D.bocki,140010837,247937,1,907,6.47807e-06,135554138,0.968169
D.bocki,140010837,209522,1,907,6.47807e-06,135555045,0.968175
D.bocki,140010837,16119,1,907,6.47807e-06,135555952,0.968182
D.bocki,140010837,118120,1,907,6.47807e-06,135556859,0.968188
D.bocki,140010837,403946,1,906,6.47093e-06,135557765,0.968195
D.bocki,140010837,393283,1,906,6.47093e-06,135558671,0.968201
D.bocki,140010837,195515,1,906,6.47093e-06,135559577,0.968208
D.bocki,140010837,126995,1,906,6.47093e-06,135560483,0.968214
D.bocki,140010837,431447,1,905,6.46379e-06,135561388,0.968221
D.bocki,140010837,42783,1,905,6.46379e-06,135562293,0.968227
D.bocki,140010837,383223,1,905,6.46379e-06,135563198,0.968234
D.bocki,140010837,198838,1,905,6.46379e-06,135564103,0.96824
D.bocki,140010837,193896,1,905,6.46379e-06,135565008,0.968247
D.bocki,140010837,103200,1,905,6.46379e-06,135565913,0.968253
D.bocki,140010837,93205,1,904,6.45664e-06,135566817,0.968259
D.bocki,140010837,50843,1,904,6.45664e-06,135567721,0.968266
D.bocki,140010837,4095,1,904,6.45664e-06,135568625,0.968272
D.bocki,140010837,385919,1,904,6.45664e-06,135569529,0.968279
D.bocki,140010837,372061,1,904,6.45664e-06,135570433,0.968285
D.bocki,140010837,331393,1,904,6.45664e-06,135571337,0.968292
D.bocki,140010837,314843,1,904,6.45664e-06,135572241,0.968298
D.bocki,140010837,311869,1,904,6.45664e-06,135573145,0.968305
D.bocki,140010837,311282,1,904,6.45664e-06,135574049,0.968311
D.bocki,140010837,219764,1,904,6.45664e-06,135574953,0.968318
D.bocki,140010837,132208,1,904,6.45664e-06,135575857,0.968324
D.bocki,140010837,99056,1,903,6.4495e-06,135576760,0.96833
D.bocki,140010837,454333,1,903,6.4495e-06,135577663,0.968337
D.bocki,140010837,402117,1,903,6.4495e-06,135578566,0.968343
D.bocki,140010837,400181,1,903,6.4495e-06,135579469,0.96835
D.bocki,140010837,313698,1,903,6.4495e-06,135580372,0.968356
D.bocki,140010837,256860,1,903,6.4495e-06,135581275,0.968363
D.bocki,140010837,236042,1,903,6.4495e-06,135582178,0.968369
D.bocki,140010837,181871,1,903,6.4495e-06,135583081,0.968376
D.bocki,140010837,12702,1,903,6.4495e-06,135583984,0.968382
D.bocki,140010837,45055,1,902,6.44236e-06,135584886,0.968389
D.bocki,140010837,450203,1,902,6.44236e-06,135585788,0.968395
D.bocki,140010837,441668,1,902,6.44236e-06,135586690,0.968401
D.bocki,140010837,396034,1,902,6.44236e-06,135587592,0.968408
D.bocki,140010837,284313,1,902,6.44236e-06,135588494,0.968414
D.bocki,140010837,258443,1,902,6.44236e-06,135589396,0.968421
D.bocki,140010837,107324,1,902,6.44236e-06,135590298,0.968427
D.bocki,140010837,7004,1,901,6.43522e-06,135591199,0.968434
D.bocki,140010837,452546,1,901,6.43522e-06,135592100,0.96844
D.bocki,140010837,452510,1,901,6.43522e-06,135593001,0.968446
D.bocki,140010837,423611,1,901,6.43522e-06,135593902,0.968453
D.bocki,140010837,30667,1,901,6.43522e-06,135594803,0.968459
D.bocki,140010837,289200,1,901,6.43522e-06,135595704,0.968466
D.bocki,140010837,287457,1,901,6.43522e-06,135596605,0.968472
D.bocki,140010837,230504,1,901,6.43522e-06,135597506,0.968479
D.bocki,140010837,194057,1,901,6.43522e-06,135598407,0.968485
D.bocki,140010837,173284,1,901,6.43522e-06,135599308,0.968492
D.bocki,140010837,110025,1,901,6.43522e-06,135600209,0.968498
D.bocki,140010837,53064,1,900,6.42807e-06,135601109,0.968504
D.bocki,140010837,454554,1,900,6.42807e-06,135602009,0.968511
D.bocki,140010837,375120,1,900,6.42807e-06,135602909,0.968517
D.bocki,140010837,365735,1,900,6.42807e-06,135603809,0.968524
D.bocki,140010837,291827,1,900,6.42807e-06,135604709,0.96853
D.bocki,140010837,282278,1,900,6.42807e-06,135605609,0.968537
D.bocki,140010837,19245,1,900,6.42807e-06,135606509,0.968543
D.bocki,140010837,50335,1,899,6.42093e-06,135607408,0.968549
D.bocki,140010837,451896,1,899,6.42093e-06,135608307,0.968556
D.bocki,140010837,353769,1,899,6.42093e-06,135609206,0.968562
D.bocki,140010837,337311,1,899,6.42093e-06,135610105,0.968569
D.bocki,140010837,306304,1,899,6.42093e-06,135611004,0.968575
D.bocki,140010837,299088,1,899,6.42093e-06,135611903,0.968581
D.bocki,140010837,245811,1,899,6.42093e-06,135612802,0.968588
D.bocki,140010837,203394,1,899,6.42093e-06,135613701,0.968594
D.bocki,140010837,160804,1,899,6.42093e-06,135614600,0.968601
D.bocki,140010837,103895,1,899,6.42093e-06,135615499,0.968607
D.bocki,140010837,99182,1,898,6.41379e-06,135616397,0.968614
D.bocki,140010837,75839,1,898,6.41379e-06,135617295,0.96862
D.bocki,140010837,452614,1,898,6.41379e-06,135618193,0.968626
D.bocki,140010837,429887,1,898,6.41379e-06,135619091,0.968633
D.bocki,140010837,42576,1,898,6.41379e-06,135619989,0.968639
D.bocki,140010837,242073,1,898,6.41379e-06,135620887,0.968646
D.bocki,140010837,208632,1,898,6.41379e-06,135621785,0.968652
D.bocki,140010837,184937,1,898,6.41379e-06,135622683,0.968658
D.bocki,140010837,181550,1,898,6.41379e-06,135623581,0.968665
D.bocki,140010837,13481,1,898,6.41379e-06,135624479,0.968671
D.bocki,140010837,113308,1,898,6.41379e-06,135625377,0.968678
D.bocki,140010837,367060,1,897,6.40665e-06,135626274,0.968684
D.bocki,140010837,352070,1,897,6.40665e-06,135627171,0.968691
D.bocki,140010837,334956,1,897,6.40665e-06,135628068,0.968697
D.bocki,140010837,275525,1,897,6.40665e-06,135628965,0.968703
D.bocki,140010837,242569,1,897,6.40665e-06,135629862,0.96871
D.bocki,140010837,229290,1,897,6.40665e-06,135630759,0.968716
D.bocki,140010837,115984,1,897,6.40665e-06,135631656,0.968723
D.bocki,140010837,43198,1,896,6.3995e-06,135632552,0.968729
D.bocki,140010837,322816,1,896,6.3995e-06,135633448,0.968735
D.bocki,140010837,266559,1,896,6.3995e-06,135634344,0.968742
D.bocki,140010837,255339,1,896,6.3995e-06,135635240,0.968748
D.bocki,140010837,245047,1,896,6.3995e-06,135636136,0.968755
D.bocki,140010837,228150,1,896,6.3995e-06,135637032,0.968761
D.bocki,140010837,205768,1,896,6.3995e-06,135637928,0.968767
D.bocki,140010837,171379,1,896,6.3995e-06,135638824,0.968774
D.bocki,140010837,71367,1,895,6.39236e-06,135639719,0.96878
D.bocki,140010837,453348,1,895,6.39236e-06,135640614,0.968787
D.bocki,140010837,33685,1,895,6.39236e-06,135641509,0.968793
D.bocki,140010837,315364,1,895,6.39236e-06,135642404,0.968799
D.bocki,140010837,314743,1,895,6.39236e-06,135643299,0.968806
D.bocki,140010837,2749,1,895,6.39236e-06,135644194,0.968812
D.bocki,140010837,241467,1,895,6.39236e-06,135645089,0.968818
D.bocki,140010837,185931,1,895,6.39236e-06,135645984,0.968825
D.bocki,140010837,158588,1,895,6.39236e-06,135646879,0.968831
D.bocki,140010837,141466,1,895,6.39236e-06,135647774,0.968838
D.bocki,140010837,388466,1,894,6.38522e-06,135648668,0.968844
D.bocki,140010837,364716,1,894,6.38522e-06,135649562,0.96885
D.bocki,140010837,290890,1,894,6.38522e-06,135650456,0.968857
D.bocki,140010837,28850,1,894,6.38522e-06,135651350,0.968863
D.bocki,140010837,139768,1,894,6.38522e-06,135652244,0.96887
D.bocki,140010837,406683,1,893,6.37808e-06,135653137,0.968876
D.bocki,140010837,284366,1,893,6.37808e-06,135654030,0.968882
D.bocki,140010837,196053,1,893,6.37808e-06,135654923,0.968889
D.bocki,140010837,166190,1,893,6.37808e-06,135655816,0.968895
D.bocki,140010837,104703,1,893,6.37808e-06,135656709,0.968901
D.bocki,140010837,337968,1,892,6.37094e-06,135657601,0.968908
D.bocki,140010837,273845,1,892,6.37094e-06,135658493,0.968914
D.bocki,140010837,160693,1,892,6.37094e-06,135659385,0.968921
D.bocki,140010837,52294,1,891,6.36379e-06,135660276,0.968927
D.bocki,140010837,436626,1,891,6.36379e-06,135661167,0.968933
D.bocki,140010837,297946,1,891,6.36379e-06,135662058,0.96894
D.bocki,140010837,297432,1,891,6.36379e-06,135662949,0.968946
D.bocki,140010837,264417,1,891,6.36379e-06,135663840,0.968952
D.bocki,140010837,260038,1,891,6.36379e-06,135664731,0.968959
D.bocki,140010837,166246,1,891,6.36379e-06,135665622,0.968965
D.bocki,140010837,12617,1,891,6.36379e-06,135666513,0.968972
D.bocki,140010837,122977,1,891,6.36379e-06,135667404,0.968978
D.bocki,140010837,443068,1,890,6.35665e-06,135668294,0.968984
D.bocki,140010837,412719,1,890,6.35665e-06,135669184,0.968991
D.bocki,140010837,382612,1,890,6.35665e-06,135670074,0.968997
D.bocki,140010837,374293,1,890,6.35665e-06,135670964,0.969003
D.bocki,140010837,321424,1,890,6.35665e-06,135671854,0.96901
D.bocki,140010837,318131,1,890,6.35665e-06,135672744,0.969016
D.bocki,140010837,299089,1,890,6.35665e-06,135673634,0.969022
D.bocki,140010837,206377,1,890,6.35665e-06,135674524,0.969029
D.bocki,140010837,185232,1,890,6.35665e-06,135675414,0.969035
D.bocki,140010837,83147,1,889,6.34951e-06,135676303,0.969041
D.bocki,140010837,75054,1,889,6.34951e-06,135677192,0.969048
D.bocki,140010837,69548,1,889,6.34951e-06,135678081,0.969054
D.bocki,140010837,453035,1,889,6.34951e-06,135678970,0.96906
D.bocki,140010837,44670,1,889,6.34951e-06,135679859,0.969067
D.bocki,140010837,385243,1,889,6.34951e-06,135680748,0.969073
D.bocki,140010837,384648,1,889,6.34951e-06,135681637,0.96908
D.bocki,140010837,351134,1,889,6.34951e-06,135682526,0.969086
D.bocki,140010837,343522,1,889,6.34951e-06,135683415,0.969092
D.bocki,140010837,246868,1,889,6.34951e-06,135684304,0.969099
D.bocki,140010837,209015,1,889,6.34951e-06,135685193,0.969105
D.bocki,140010837,126994,1,889,6.34951e-06,135686082,0.969111
D.bocki,140010837,71307,1,888,6.34237e-06,135686970,0.969118
D.bocki,140010837,453131,1,888,6.34237e-06,135687858,0.969124
D.bocki,140010837,363288,1,888,6.34237e-06,135688746,0.96913
D.bocki,140010837,357306,1,888,6.34237e-06,135689634,0.969137
D.bocki,140010837,329336,1,888,6.34237e-06,135690522,0.969143
D.bocki,140010837,285370,1,888,6.34237e-06,135691410,0.969149
D.bocki,140010837,164408,1,888,6.34237e-06,135692298,0.969156
D.bocki,140010837,155966,1,888,6.34237e-06,135693186,0.969162
D.bocki,140010837,119204,1,888,6.34237e-06,135694074,0.969168
D.bocki,140010837,9595,1,887,6.33522e-06,135694961,0.969175
D.bocki,140010837,49835,1,887,6.33522e-06,135695848,0.969181
D.bocki,140010837,450902,1,887,6.33522e-06,135696735,0.969187
D.bocki,140010837,443067,1,887,6.33522e-06,135697622,0.969194
D.bocki,140010837,441164,1,887,6.33522e-06,135698509,0.9692
D.bocki,140010837,431614,1,887,6.33522e-06,135699396,0.969206
D.bocki,140010837,100990,1,887,6.33522e-06,135700283,0.969213
D.bocki,140010837,95696,1,886,6.32808e-06,135701169,0.969219
D.bocki,140010837,81534,1,886,6.32808e-06,135702055,0.969225
D.bocki,140010837,454815,1,886,6.32808e-06,135702941,0.969232
D.bocki,140010837,27901,1,886,6.32808e-06,135703827,0.969238
D.bocki,140010837,255878,1,886,6.32808e-06,135704713,0.969244
D.bocki,140010837,15731,1,886,6.32808e-06,135705599,0.969251
D.bocki,140010837,78001,1,885,6.32094e-06,135706484,0.969257
D.bocki,140010837,452088,1,885,6.32094e-06,135707369,0.969263
D.bocki,140010837,415017,1,885,6.32094e-06,135708254,0.96927
D.bocki,140010837,382700,1,885,6.32094e-06,135709139,0.969276
D.bocki,140010837,260523,1,885,6.32094e-06,135710024,0.969282
D.bocki,140010837,453679,1,884,6.3138e-06,135710908,0.969289
D.bocki,140010837,426633,1,884,6.3138e-06,135711792,0.969295
D.bocki,140010837,320995,1,884,6.3138e-06,135712676,0.969301
D.bocki,140010837,280773,1,884,6.3138e-06,135713560,0.969308
D.bocki,140010837,277382,1,884,6.3138e-06,135714444,0.969314
D.bocki,140010837,271663,1,884,6.3138e-06,135715328,0.96932
D.bocki,140010837,240429,1,884,6.3138e-06,135716212,0.969326
D.bocki,140010837,175967,1,884,6.3138e-06,135717096,0.969333
D.bocki,140010837,137843,1,884,6.3138e-06,135717980,0.969339
D.bocki,140010837,93432,1,883,6.30665e-06,135718863,0.969345
D.bocki,140010837,48394,1,883,6.30665e-06,135719746,0.969352
D.bocki,140010837,431730,1,883,6.30665e-06,135720629,0.969358
D.bocki,140010837,408623,1,883,6.30665e-06,135721512,0.969364
D.bocki,140010837,351613,1,883,6.30665e-06,135722395,0.969371
D.bocki,140010837,240076,1,883,6.30665e-06,135723278,0.969377
D.bocki,140010837,223583,1,883,6.30665e-06,135724161,0.969383
D.bocki,140010837,179758,1,883,6.30665e-06,135725044,0.96939
D.bocki,140010837,392524,1,882,6.29951e-06,135725926,0.969396
D.bocki,140010837,309227,1,882,6.29951e-06,135726808,0.969402
D.bocki,140010837,289741,1,882,6.29951e-06,135727690,0.969408
D.bocki,140010837,289645,1,882,6.29951e-06,135728572,0.969415
D.bocki,140010837,278174,1,882,6.29951e-06,135729454,0.969421
D.bocki,140010837,13163,1,882,6.29951e-06,135730336,0.969427
D.bocki,140010837,4390,1,881,6.29237e-06,135731217,0.969434
D.bocki,140010837,420806,1,881,6.29237e-06,135732098,0.96944
D.bocki,140010837,335894,1,881,6.29237e-06,135732979,0.969446
D.bocki,140010837,309785,1,881,6.29237e-06,135733860,0.969453
D.bocki,140010837,266585,1,881,6.29237e-06,135734741,0.969459
D.bocki,140010837,24313,1,881,6.29237e-06,135735622,0.969465
D.bocki,140010837,201903,1,881,6.29237e-06,135736503,0.969471
D.bocki,140010837,188159,1,881,6.29237e-06,135737384,0.969478
D.bocki,140010837,14168,1,881,6.29237e-06,135738265,0.969484
D.bocki,140010837,452573,1,880,6.28523e-06,135739145,0.96949
D.bocki,140010837,340107,1,880,6.28523e-06,135740025,0.969497
D.bocki,140010837,292853,1,880,6.28523e-06,135740905,0.969503
D.bocki,140010837,286640,1,880,6.28523e-06,135741785,0.969509
D.bocki,140010837,142142,1,880,6.28523e-06,135742665,0.969515
D.bocki,140010837,114383,1,880,6.28523e-06,135743545,0.969522
D.bocki,140010837,451726,1,879,6.27809e-06,135744424,0.969528
D.bocki,140010837,360666,1,879,6.27809e-06,135745303,0.969534
D.bocki,140010837,202701,1,879,6.27809e-06,135746182,0.969541
D.bocki,140010837,152813,1,879,6.27809e-06,135747061,0.969547
D.bocki,140010837,149401,1,879,6.27809e-06,135747940,0.969553
D.bocki,140010837,64423,1,878,6.27094e-06,135748818,0.969559
D.bocki,140010837,56639,1,878,6.27094e-06,135749696,0.969566
D.bocki,140010837,44209,1,878,6.27094e-06,135750574,0.969572
D.bocki,140010837,241222,1,878,6.27094e-06,135751452,0.969578
D.bocki,140010837,70769,1,877,6.2638e-06,135752329,0.969584
D.bocki,140010837,358196,1,877,6.2638e-06,135753206,0.969591
D.bocki,140010837,80267,1,876,6.25666e-06,135754082,0.969597
D.bocki,140010837,77751,1,876,6.25666e-06,135754958,0.969603
D.bocki,140010837,52906,1,876,6.25666e-06,135755834,0.969609
D.bocki,140010837,454280,1,876,6.25666e-06,135756710,0.969616
D.bocki,140010837,433903,1,876,6.25666e-06,135757586,0.969622
D.bocki,140010837,346033,1,876,6.25666e-06,135758462,0.969628
D.bocki,140010837,296805,1,876,6.25666e-06,135759338,0.969635
D.bocki,140010837,296477,1,876,6.25666e-06,135760214,0.969641
D.bocki,140010837,268521,1,876,6.25666e-06,135761090,0.969647
D.bocki,140010837,257012,1,876,6.25666e-06,135761966,0.969653
D.bocki,140010837,209449,1,876,6.25666e-06,135762842,0.96966
D.bocki,140010837,156245,1,876,6.25666e-06,135763718,0.969666
D.bocki,140010837,128991,1,876,6.25666e-06,135764594,0.969672
D.bocki,140010837,54791,1,875,6.24952e-06,135765469,0.969678
D.bocki,140010837,400098,1,875,6.24952e-06,135766344,0.969685
D.bocki,140010837,365355,1,875,6.24952e-06,135767219,0.969691
D.bocki,140010837,344047,1,875,6.24952e-06,135768094,0.969697
D.bocki,140010837,306856,1,875,6.24952e-06,135768969,0.969703
D.bocki,140010837,26636,1,875,6.24952e-06,135769844,0.96971
D.bocki,140010837,261834,1,875,6.24952e-06,135770719,0.969716
D.bocki,140010837,24704,1,875,6.24952e-06,135771594,0.969722
D.bocki,140010837,95483,1,874,6.24237e-06,135772468,0.969728
D.bocki,140010837,83514,1,874,6.24237e-06,135773342,0.969735
D.bocki,140010837,452561,1,874,6.24237e-06,135774216,0.969741
D.bocki,140010837,451625,1,874,6.24237e-06,135775090,0.969747
D.bocki,140010837,440732,1,874,6.24237e-06,135775964,0.969753
D.bocki,140010837,40439,1,874,6.24237e-06,135776838,0.969759
D.bocki,140010837,402285,1,874,6.24237e-06,135777712,0.969766
D.bocki,140010837,364947,1,874,6.24237e-06,135778586,0.969772
D.bocki,140010837,194873,1,874,6.24237e-06,135779460,0.969778
D.bocki,140010837,973,1,873,6.23523e-06,135780333,0.969784
D.bocki,140010837,328793,1,873,6.23523e-06,135781206,0.969791
D.bocki,140010837,219238,1,873,6.23523e-06,135782079,0.969797
D.bocki,140010837,174353,1,873,6.23523e-06,135782952,0.969803
D.bocki,140010837,159955,1,873,6.23523e-06,135783825,0.969809
D.bocki,140010837,452995,1,872,6.22809e-06,135784697,0.969816
D.bocki,140010837,451857,1,872,6.22809e-06,135785569,0.969822
D.bocki,140010837,408495,1,872,6.22809e-06,135786441,0.969828
D.bocki,140010837,389704,1,872,6.22809e-06,135787313,0.969834
D.bocki,140010837,349093,1,872,6.22809e-06,135788185,0.969841
D.bocki,140010837,346611,1,872,6.22809e-06,135789057,0.969847
D.bocki,140010837,323073,1,872,6.22809e-06,135789929,0.969853
D.bocki,140010837,295650,1,872,6.22809e-06,135790801,0.969859
D.bocki,140010837,203010,1,872,6.22809e-06,135791673,0.969865
D.bocki,140010837,202962,1,872,6.22809e-06,135792545,0.969872
D.bocki,140010837,147238,1,872,6.22809e-06,135793417,0.969878
D.bocki,140010837,97031,1,871,6.22095e-06,135794288,0.969884
D.bocki,140010837,88511,1,871,6.22095e-06,135795159,0.96989
D.bocki,140010837,50537,1,871,6.22095e-06,135796030,0.969897
D.bocki,140010837,47091,1,871,6.22095e-06,135796901,0.969903
D.bocki,140010837,446378,1,871,6.22095e-06,135797772,0.969909
D.bocki,140010837,445052,1,871,6.22095e-06,135798643,0.969915
D.bocki,140010837,410266,1,871,6.22095e-06,135799514,0.969921
D.bocki,140010837,390220,1,871,6.22095e-06,135800385,0.969928
D.bocki,140010837,305780,1,871,6.22095e-06,135801256,0.969934
D.bocki,140010837,295960,1,871,6.22095e-06,135802127,0.96994
D.bocki,140010837,279852,1,871,6.22095e-06,135802998,0.969946
D.bocki,140010837,208424,1,871,6.22095e-06,135803869,0.969953
D.bocki,140010837,202188,1,871,6.22095e-06,135804740,0.969959
D.bocki,140010837,152781,1,871,6.22095e-06,135805611,0.969965
D.bocki,140010837,109272,1,871,6.22095e-06,135806482,0.969971
D.bocki,140010837,107096,1,871,6.22095e-06,135807353,0.969977
D.bocki,140010837,44137,1,870,6.2138e-06,135808223,0.969984
D.bocki,140010837,412495,1,870,6.2138e-06,135809093,0.96999
D.bocki,140010837,324417,1,870,6.2138e-06,135809963,0.969996
D.bocki,140010837,296885,1,870,6.2138e-06,135810833,0.970002
D.bocki,140010837,275813,1,870,6.2138e-06,135811703,0.970009
D.bocki,140010837,229906,1,870,6.2138e-06,135812573,0.970015
D.bocki,140010837,147729,1,870,6.2138e-06,135813443,0.970021
D.bocki,140010837,118637,1,870,6.2138e-06,135814313,0.970027
D.bocki,140010837,99342,1,869,6.20666e-06,135815182,0.970033
D.bocki,140010837,83062,1,869,6.20666e-06,135816051,0.97004
D.bocki,140010837,451855,1,869,6.20666e-06,135816920,0.970046
D.bocki,140010837,39171,1,869,6.20666e-06,135817789,0.970052
D.bocki,140010837,311639,1,869,6.20666e-06,135818658,0.970058
D.bocki,140010837,174955,1,869,6.20666e-06,135819527,0.970064
D.bocki,140010837,158254,1,869,6.20666e-06,135820396,0.970071
D.bocki,140010837,81776,1,868,6.19952e-06,135821264,0.970077
D.bocki,140010837,451735,1,868,6.19952e-06,135822132,0.970083
D.bocki,140010837,403149,1,868,6.19952e-06,135823000,0.970089
D.bocki,140010837,352491,1,868,6.19952e-06,135823868,0.970095
D.bocki,140010837,268114,1,868,6.19952e-06,135824736,0.970102
D.bocki,140010837,120106,1,868,6.19952e-06,135825604,0.970108
D.bocki,140010837,74693,1,867,6.19238e-06,135826471,0.970114
D.bocki,140010837,427646,1,867,6.19238e-06,135827338,0.97012
D.bocki,140010837,317837,1,867,6.19238e-06,135828205,0.970126
D.bocki,140010837,316067,1,867,6.19238e-06,135829072,0.970133
D.bocki,140010837,301350,1,867,6.19238e-06,135829939,0.970139
D.bocki,140010837,298114,1,867,6.19238e-06,135830806,0.970145
D.bocki,140010837,234399,1,867,6.19238e-06,135831673,0.970151
D.bocki,140010837,194165,1,867,6.19238e-06,135832540,0.970157
D.bocki,140010837,184638,1,867,6.19238e-06,135833407,0.970164
D.bocki,140010837,159832,1,867,6.19238e-06,135834274,0.97017
D.bocki,140010837,107864,1,867,6.19238e-06,135835141,0.970176
D.bocki,140010837,451066,1,866,6.18524e-06,135836007,0.970182
D.bocki,140010837,395102,1,866,6.18524e-06,135836873,0.970188
D.bocki,140010837,365319,1,866,6.18524e-06,135837739,0.970194
D.bocki,140010837,189289,1,866,6.18524e-06,135838605,0.970201
D.bocki,140010837,164764,1,866,6.18524e-06,135839471,0.970207
D.bocki,140010837,101566,1,866,6.18524e-06,135840337,0.970213
D.bocki,140010837,412774,1,865,6.17809e-06,135841202,0.970219
D.bocki,140010837,28010,1,865,6.17809e-06,135842067,0.970225
D.bocki,140010837,21260,1,865,6.17809e-06,135842932,0.970232
D.bocki,140010837,73112,1,864,6.17095e-06,135843796,0.970238
D.bocki,140010837,446059,1,864,6.17095e-06,135844660,0.970244
D.bocki,140010837,246981,1,864,6.17095e-06,135845524,0.97025
D.bocki,140010837,245810,1,864,6.17095e-06,135846388,0.970256
D.bocki,140010837,214418,1,864,6.17095e-06,135847252,0.970262
D.bocki,140010837,198787,1,864,6.17095e-06,135848116,0.970269
D.bocki,140010837,166245,1,864,6.17095e-06,135848980,0.970275
D.bocki,140010837,10176,1,864,6.17095e-06,135849844,0.970281
D.bocki,140010837,8164,1,863,6.16381e-06,135850707,0.970287
D.bocki,140010837,300967,1,863,6.16381e-06,135851570,0.970293
D.bocki,140010837,235890,1,863,6.16381e-06,135852433,0.970299
D.bocki,140010837,185481,1,863,6.16381e-06,135853296,0.970306
D.bocki,140010837,133227,1,863,6.16381e-06,135854159,0.970312
D.bocki,140010837,54690,1,862,6.15667e-06,135855021,0.970318
D.bocki,140010837,419386,1,862,6.15667e-06,135855883,0.970324
D.bocki,140010837,37848,1,862,6.15667e-06,135856745,0.97033
D.bocki,140010837,362741,1,862,6.15667e-06,135857607,0.970336
D.bocki,140010837,356131,1,862,6.15667e-06,135858469,0.970343
D.bocki,140010837,150848,1,862,6.15667e-06,135859331,0.970349
D.bocki,140010837,75260,1,861,6.14952e-06,135860192,0.970355
D.bocki,140010837,65798,1,861,6.14952e-06,135861053,0.970361
D.bocki,140010837,454467,1,861,6.14952e-06,135861914,0.970367
D.bocki,140010837,444183,1,861,6.14952e-06,135862775,0.970373
D.bocki,140010837,332022,1,861,6.14952e-06,135863636,0.970379
D.bocki,140010837,311965,1,861,6.14952e-06,135864497,0.970386
D.bocki,140010837,279087,1,861,6.14952e-06,135865358,0.970392
D.bocki,140010837,233172,1,861,6.14952e-06,135866219,0.970398
D.bocki,140010837,138137,1,861,6.14952e-06,135867080,0.970404
D.bocki,140010837,119687,1,861,6.14952e-06,135867941,0.97041
D.bocki,140010837,367489,1,860,6.14238e-06,135868801,0.970416
D.bocki,140010837,366389,1,860,6.14238e-06,135869661,0.970422
D.bocki,140010837,310270,1,860,6.14238e-06,135870521,0.970429
D.bocki,140010837,272,1,860,6.14238e-06,135871381,0.970435
D.bocki,140010837,271174,1,860,6.14238e-06,135872241,0.970441
D.bocki,140010837,268353,1,860,6.14238e-06,135873101,0.970447
D.bocki,140010837,201199,1,860,6.14238e-06,135873961,0.970453
D.bocki,140010837,188349,1,860,6.14238e-06,135874821,0.970459
D.bocki,140010837,177324,1,860,6.14238e-06,135875681,0.970465
D.bocki,140010837,134222,1,860,6.14238e-06,135876541,0.970472
D.bocki,140010837,787,1,859,6.13524e-06,135877400,0.970478
D.bocki,140010837,74287,1,859,6.13524e-06,135878259,0.970484
D.bocki,140010837,450165,1,859,6.13524e-06,135879118,0.97049
D.bocki,140010837,38188,1,859,6.13524e-06,135879977,0.970496
D.bocki,140010837,344731,1,859,6.13524e-06,135880836,0.970502
D.bocki,140010837,243717,1,859,6.13524e-06,135881695,0.970508
D.bocki,140010837,227412,1,859,6.13524e-06,135882554,0.970515
D.bocki,140010837,207354,1,859,6.13524e-06,135883413,0.970521
D.bocki,140010837,171464,1,859,6.13524e-06,135884272,0.970527
D.bocki,140010837,157185,1,859,6.13524e-06,135885131,0.970533
D.bocki,140010837,72515,1,858,6.1281e-06,135885989,0.970539
D.bocki,140010837,451401,1,858,6.1281e-06,135886847,0.970545
D.bocki,140010837,401300,1,858,6.1281e-06,135887705,0.970551
D.bocki,140010837,386234,1,858,6.1281e-06,135888563,0.970557
D.bocki,140010837,314629,1,858,6.1281e-06,135889421,0.970564
D.bocki,140010837,287560,1,858,6.1281e-06,135890279,0.97057
D.bocki,140010837,250347,1,858,6.1281e-06,135891137,0.970576
D.bocki,140010837,241347,1,858,6.1281e-06,135891995,0.970582
D.bocki,140010837,223269,1,858,6.1281e-06,135892853,0.970588
D.bocki,140010837,191905,1,858,6.1281e-06,135893711,0.970594
D.bocki,140010837,103106,1,858,6.1281e-06,135894569,0.9706
D.bocki,140010837,415125,1,857,6.12095e-06,135895426,0.970606
D.bocki,140010837,331844,1,857,6.12095e-06,135896283,0.970613
D.bocki,140010837,198326,1,857,6.12095e-06,135897140,0.970619
D.bocki,140010837,454381,1,856,6.11381e-06,135897996,0.970625
D.bocki,140010837,451328,1,856,6.11381e-06,135898852,0.970631
D.bocki,140010837,392949,1,856,6.11381e-06,135899708,0.970637
D.bocki,140010837,376392,1,856,6.11381e-06,135900564,0.970643
D.bocki,140010837,26825,1,856,6.11381e-06,135901420,0.970649
D.bocki,140010837,26822,1,856,6.11381e-06,135902276,0.970655
D.bocki,140010837,244487,1,856,6.11381e-06,135903132,0.970662
D.bocki,140010837,239975,1,856,6.11381e-06,135903988,0.970668
D.bocki,140010837,228789,1,856,6.11381e-06,135904844,0.970674
D.bocki,140010837,211583,1,856,6.11381e-06,135905700,0.97068
D.bocki,140010837,174264,1,856,6.11381e-06,135906556,0.970686
D.bocki,140010837,170953,1,856,6.11381e-06,135907412,0.970692
D.bocki,140010837,167788,1,856,6.11381e-06,135908268,0.970698
D.bocki,140010837,157081,1,856,6.11381e-06,135909124,0.970704
D.bocki,140010837,72025,1,855,6.10667e-06,135909979,0.97071
D.bocki,140010837,61261,1,855,6.10667e-06,135910834,0.970717
D.bocki,140010837,452190,1,855,6.10667e-06,135911689,0.970723
D.bocki,140010837,452157,1,855,6.10667e-06,135912544,0.970729
D.bocki,140010837,437339,1,855,6.10667e-06,135913399,0.970735
D.bocki,140010837,414403,1,855,6.10667e-06,135914254,0.970741
D.bocki,140010837,38187,1,855,6.10667e-06,135915109,0.970747
D.bocki,140010837,371803,1,855,6.10667e-06,135915964,0.970753
D.bocki,140010837,219975,1,855,6.10667e-06,135916819,0.970759
D.bocki,140010837,17095,1,855,6.10667e-06,135917674,0.970765
D.bocki,140010837,71989,1,854,6.09953e-06,135918528,0.970771
D.bocki,140010837,454328,1,854,6.09953e-06,135919382,0.970778
D.bocki,140010837,398091,1,854,6.09953e-06,135920236,0.970784
D.bocki,140010837,307567,1,854,6.09953e-06,135921090,0.97079
D.bocki,140010837,287455,1,854,6.09953e-06,135921944,0.970796
D.bocki,140010837,282481,1,854,6.09953e-06,135922798,0.970802
D.bocki,140010837,259240,1,854,6.09953e-06,135923652,0.970808
D.bocki,140010837,90022,1,853,6.09239e-06,135924505,0.970814
D.bocki,140010837,408281,1,853,6.09239e-06,135925358,0.97082
D.bocki,140010837,261669,1,853,6.09239e-06,135926211,0.970826
D.bocki,140010837,214988,1,853,6.09239e-06,135927064,0.970832
D.bocki,140010837,452643,1,852,6.08524e-06,135927916,0.970839
D.bocki,140010837,451236,1,852,6.08524e-06,135928768,0.970845
D.bocki,140010837,356154,1,852,6.08524e-06,135929620,0.970851
D.bocki,140010837,312673,1,852,6.08524e-06,135930472,0.970857
D.bocki,140010837,102731,1,852,6.08524e-06,135931324,0.970863
D.bocki,140010837,59696,1,851,6.0781e-06,135932175,0.970869
D.bocki,140010837,391836,1,851,6.0781e-06,135933026,0.970875
D.bocki,140010837,359701,1,851,6.0781e-06,135933877,0.970881
D.bocki,140010837,320705,1,851,6.0781e-06,135934728,0.970887
D.bocki,140010837,305498,1,851,6.0781e-06,135935579,0.970893
D.bocki,140010837,241565,1,851,6.0781e-06,135936430,0.970899
D.bocki,140010837,212253,1,851,6.0781e-06,135937281,0.970905
D.bocki,140010837,155125,1,851,6.0781e-06,135938132,0.970912
D.bocki,140010837,145638,1,851,6.0781e-06,135938983,0.970918
D.bocki,140010837,111215,1,851,6.0781e-06,135939834,0.970924
D.bocki,140010837,77371,1,850,6.07096e-06,135940684,0.97093
D.bocki,140010837,69002,1,850,6.07096e-06,135941534,0.970936
D.bocki,140010837,452171,1,850,6.07096e-06,135942384,0.970942
D.bocki,140010837,400915,1,850,6.07096e-06,135943234,0.970948
D.bocki,140010837,380386,1,850,6.07096e-06,135944084,0.970954
D.bocki,140010837,346085,1,850,6.07096e-06,135944934,0.97096
D.bocki,140010837,32550,1,850,6.07096e-06,135945784,0.970966
D.bocki,140010837,191564,1,850,6.07096e-06,135946634,0.970972
D.bocki,140010837,96556,1,849,6.06382e-06,135947483,0.970978
D.bocki,140010837,94746,1,849,6.06382e-06,135948332,0.970984
D.bocki,140010837,75838,1,849,6.06382e-06,135949181,0.97099
D.bocki,140010837,430915,1,849,6.06382e-06,135950030,0.970996
D.bocki,140010837,290670,1,849,6.06382e-06,135950879,0.971003
D.bocki,140010837,270326,1,849,6.06382e-06,135951728,0.971009
D.bocki,140010837,229133,1,849,6.06382e-06,135952577,0.971015
D.bocki,140010837,220953,1,849,6.06382e-06,135953426,0.971021
D.bocki,140010837,100453,1,849,6.06382e-06,135954275,0.971027
D.bocki,140010837,74956,1,848,6.05667e-06,135955123,0.971033
D.bocki,140010837,454730,1,848,6.05667e-06,135955971,0.971039
D.bocki,140010837,441019,1,848,6.05667e-06,135956819,0.971045
D.bocki,140010837,355462,1,848,6.05667e-06,135957667,0.971051
D.bocki,140010837,35178,1,848,6.05667e-06,135958515,0.971057
D.bocki,140010837,307050,1,848,6.05667e-06,135959363,0.971063
D.bocki,140010837,257951,1,848,6.05667e-06,135960211,0.971069
D.bocki,140010837,20146,1,848,6.05667e-06,135961059,0.971075
D.bocki,140010837,452127,1,847,6.04953e-06,135961906,0.971081
D.bocki,140010837,439360,1,847,6.04953e-06,135962753,0.971087
D.bocki,140010837,436304,1,847,6.04953e-06,135963600,0.971093
D.bocki,140010837,387054,1,847,6.04953e-06,135964447,0.971099
D.bocki,140010837,32745,1,847,6.04953e-06,135965294,0.971106
D.bocki,140010837,23998,1,847,6.04953e-06,135966141,0.971112
D.bocki,140010837,233175,1,847,6.04953e-06,135966988,0.971118
D.bocki,140010837,55550,1,846,6.04239e-06,135967834,0.971124
D.bocki,140010837,451299,1,846,6.04239e-06,135968680,0.97113
D.bocki,140010837,416301,1,846,6.04239e-06,135969526,0.971136
D.bocki,140010837,402918,1,846,6.04239e-06,135970372,0.971142
D.bocki,140010837,33784,1,846,6.04239e-06,135971218,0.971148
D.bocki,140010837,28981,1,846,6.04239e-06,135972064,0.971154
D.bocki,140010837,185831,1,846,6.04239e-06,135972910,0.97116
D.bocki,140010837,114382,1,846,6.04239e-06,135973756,0.971166
D.bocki,140010837,92885,1,845,6.03525e-06,135974601,0.971172
D.bocki,140010837,57228,1,845,6.03525e-06,135975446,0.971178
D.bocki,140010837,52582,1,845,6.03525e-06,135976291,0.971184
D.bocki,140010837,377650,1,845,6.03525e-06,135977136,0.97119
D.bocki,140010837,33023,1,845,6.03525e-06,135977981,0.971196
D.bocki,140010837,313794,1,845,6.03525e-06,135978826,0.971202
D.bocki,140010837,293847,1,845,6.03525e-06,135979671,0.971208
D.bocki,140010837,280256,1,845,6.03525e-06,135980516,0.971214
D.bocki,140010837,209345,1,845,6.03525e-06,135981361,0.97122
D.bocki,140010837,171393,1,845,6.03525e-06,135982206,0.971226
D.bocki,140010837,116088,1,845,6.03525e-06,135983051,0.971232
D.bocki,140010837,113072,1,845,6.03525e-06,135983896,0.971238
D.bocki,140010837,112850,1,845,6.03525e-06,135984741,0.971244
D.bocki,140010837,57490,1,844,6.0281e-06,135985585,0.97125
D.bocki,140010837,292819,1,844,6.0281e-06,135986429,0.971256
D.bocki,140010837,166189,1,844,6.0281e-06,135987273,0.971262
D.bocki,140010837,156244,1,844,6.0281e-06,135988117,0.971269
D.bocki,140010837,151195,1,844,6.0281e-06,135988961,0.971275
D.bocki,140010837,141654,1,844,6.0281e-06,135989805,0.971281
D.bocki,140010837,355205,1,843,6.02096e-06,135990648,0.971287
D.bocki,140010837,261330,1,843,6.02096e-06,135991491,0.971293
D.bocki,140010837,148458,1,843,6.02096e-06,135992334,0.971299
D.bocki,140010837,129654,1,843,6.02096e-06,135993177,0.971305
D.bocki,140010837,448354,1,842,6.01382e-06,135994019,0.971311
D.bocki,140010837,443257,1,842,6.01382e-06,135994861,0.971317
D.bocki,140010837,406177,1,842,6.01382e-06,135995703,0.971323
D.bocki,140010837,393590,1,842,6.01382e-06,135996545,0.971329
D.bocki,140010837,368087,1,842,6.01382e-06,135997387,0.971335
D.bocki,140010837,364668,1,842,6.01382e-06,135998229,0.971341
D.bocki,140010837,340819,1,842,6.01382e-06,135999071,0.971347
D.bocki,140010837,331782,1,842,6.01382e-06,135999913,0.971353
D.bocki,140010837,30785,1,842,6.01382e-06,136000755,0.971359
D.bocki,140010837,307371,1,842,6.01382e-06,136001597,0.971365
D.bocki,140010837,277685,1,842,6.01382e-06,136002439,0.971371
D.bocki,140010837,25587,1,842,6.01382e-06,136003281,0.971377
D.bocki,140010837,129527,1,842,6.01382e-06,136004123,0.971383
D.bocki,140010837,123676,1,842,6.01382e-06,136004965,0.971389
D.bocki,140010837,97107,1,841,6.00668e-06,136005806,0.971395
D.bocki,140010837,71236,1,841,6.00668e-06,136006647,0.971401
D.bocki,140010837,424096,1,841,6.00668e-06,136007488,0.971407
D.bocki,140010837,305735,1,841,6.00668e-06,136008329,0.971413
D.bocki,140010837,262036,1,841,6.00668e-06,136009170,0.971419
D.bocki,140010837,186702,1,841,6.00668e-06,136010011,0.971425
D.bocki,140010837,180298,1,841,6.00668e-06,136010852,0.971431
D.bocki,140010837,154023,1,841,6.00668e-06,136011693,0.971437
D.bocki,140010837,91934,1,840,5.99954e-06,136012533,0.971443
D.bocki,140010837,76041,1,840,5.99954e-06,136013373,0.971449
D.bocki,140010837,73929,1,840,5.99954e-06,136014213,0.971455
D.bocki,140010837,48596,1,840,5.99954e-06,136015053,0.971461
D.bocki,140010837,453295,1,840,5.99954e-06,136015893,0.971467
D.bocki,140010837,403599,1,840,5.99954e-06,136016733,0.971473
D.bocki,140010837,399173,1,840,5.99954e-06,136017573,0.971479
D.bocki,140010837,3498,1,840,5.99954e-06,136018413,0.971485
D.bocki,140010837,342939,1,840,5.99954e-06,136019253,0.971491
D.bocki,140010837,268468,1,840,5.99954e-06,136020093,0.971497
D.bocki,140010837,245971,1,840,5.99954e-06,136020933,0.971503
D.bocki,140010837,217378,1,840,5.99954e-06,136021773,0.971509
D.bocki,140010837,65416,1,839,5.99239e-06,136022612,0.971515
D.bocki,140010837,61568,1,839,5.99239e-06,136023451,0.971521
D.bocki,140010837,454363,1,839,5.99239e-06,136024290,0.971527
D.bocki,140010837,420766,1,839,5.99239e-06,136025129,0.971533
D.bocki,140010837,409713,1,839,5.99239e-06,136025968,0.971539
D.bocki,140010837,322496,1,839,5.99239e-06,136026807,0.971545
D.bocki,140010837,190220,1,839,5.99239e-06,136027646,0.971551
D.bocki,140010837,143552,1,839,5.99239e-06,136028485,0.971557
D.bocki,140010837,140977,1,839,5.99239e-06,136029324,0.971563
D.bocki,140010837,104493,1,839,5.99239e-06,136030163,0.971569
D.bocki,140010837,88124,1,838,5.98525e-06,136031001,0.971575
D.bocki,140010837,85476,1,838,5.98525e-06,136031839,0.971581
D.bocki,140010837,76221,1,838,5.98525e-06,136032677,0.971587
D.bocki,140010837,449637,1,838,5.98525e-06,136033515,0.971593
D.bocki,140010837,431795,1,838,5.98525e-06,136034353,0.971599
D.bocki,140010837,424156,1,838,5.98525e-06,136035191,0.971605
D.bocki,140010837,406770,1,838,5.98525e-06,136036029,0.971611
D.bocki,140010837,35255,1,838,5.98525e-06,136036867,0.971617
D.bocki,140010837,226510,1,838,5.98525e-06,136037705,0.971623
D.bocki,140010837,210734,1,838,5.98525e-06,136038543,0.971629
D.bocki,140010837,203898,1,838,5.98525e-06,136039381,0.971635
D.bocki,140010837,16974,1,838,5.98525e-06,136040219,0.971641
D.bocki,140010837,166188,1,838,5.98525e-06,136041057,0.971647
D.bocki,140010837,100992,1,838,5.98525e-06,136041895,0.971653
D.bocki,140010837,453860,1,837,5.97811e-06,136042732,0.971659
D.bocki,140010837,437310,1,837,5.97811e-06,136043569,0.971665
D.bocki,140010837,429769,1,837,5.97811e-06,136044406,0.971671
D.bocki,140010837,347749,1,837,5.97811e-06,136045243,0.971677
D.bocki,140010837,322914,1,837,5.97811e-06,136046080,0.971682
D.bocki,140010837,283465,1,837,5.97811e-06,136046917,0.971688
D.bocki,140010837,213944,1,837,5.97811e-06,136047754,0.971694
D.bocki,140010837,202486,1,837,5.97811e-06,136048591,0.9717
D.bocki,140010837,193609,1,837,5.97811e-06,136049428,0.971706
D.bocki,140010837,166935,1,837,5.97811e-06,136050265,0.971712
D.bocki,140010837,61182,1,836,5.97097e-06,136051101,0.971718
D.bocki,140010837,47928,1,836,5.97097e-06,136051937,0.971724
D.bocki,140010837,427317,1,836,5.97097e-06,136052773,0.97173
D.bocki,140010837,229184,1,836,5.97097e-06,136053609,0.971736
D.bocki,140010837,225040,1,836,5.97097e-06,136054445,0.971742
D.bocki,140010837,111733,1,836,5.97097e-06,136055281,0.971748
D.bocki,140010837,7417,1,835,5.96382e-06,136056116,0.971754
D.bocki,140010837,451528,1,835,5.96382e-06,136056951,0.97176
D.bocki,140010837,40600,1,835,5.96382e-06,136057786,0.971766
D.bocki,140010837,36932,1,835,5.96382e-06,136058621,0.971772
D.bocki,140010837,368011,1,835,5.96382e-06,136059456,0.971778
D.bocki,140010837,364097,1,835,5.96382e-06,136060291,0.971784
D.bocki,140010837,352285,1,835,5.96382e-06,136061126,0.97179
D.bocki,140010837,339844,1,835,5.96382e-06,136061961,0.971796
D.bocki,140010837,33411,1,835,5.96382e-06,136062796,0.971802
D.bocki,140010837,325290,1,835,5.96382e-06,136063631,0.971808
D.bocki,140010837,305871,1,835,5.96382e-06,136064466,0.971814
D.bocki,140010837,300766,1,835,5.96382e-06,136065301,0.97182
D.bocki,140010837,300483,1,835,5.96382e-06,136066136,0.971826
D.bocki,140010837,214371,1,835,5.96382e-06,136066971,0.971832
D.bocki,140010837,104135,1,835,5.96382e-06,136067806,0.971838
D.bocki,140010837,93241,1,834,5.95668e-06,136068640,0.971844
D.bocki,140010837,454194,1,834,5.95668e-06,136069474,0.97185
D.bocki,140010837,452017,1,834,5.95668e-06,136070308,0.971856
D.bocki,140010837,395716,1,834,5.95668e-06,136071142,0.971861
D.bocki,140010837,379709,1,834,5.95668e-06,136071976,0.971867
D.bocki,140010837,360370,1,834,5.95668e-06,136072810,0.971873
D.bocki,140010837,341313,1,834,5.95668e-06,136073644,0.971879
D.bocki,140010837,286638,1,834,5.95668e-06,136074478,0.971885
D.bocki,140010837,204529,1,834,5.95668e-06,136075312,0.971891
D.bocki,140010837,202008,1,834,5.95668e-06,136076146,0.971897
D.bocki,140010837,181671,1,834,5.95668e-06,136076980,0.971903
D.bocki,140010837,177081,1,834,5.95668e-06,136077814,0.971909
D.bocki,140010837,173477,1,834,5.95668e-06,136078648,0.971915
D.bocki,140010837,16765,1,834,5.95668e-06,136079482,0.971921
D.bocki,140010837,13247,1,834,5.95668e-06,136080316,0.971927
D.bocki,140010837,11541,1,834,5.95668e-06,136081150,0.971933
D.bocki,140010837,426086,1,833,5.94954e-06,136081983,0.971939
D.bocki,140010837,398973,1,833,5.94954e-06,136082816,0.971945
D.bocki,140010837,3688,1,833,5.94954e-06,136083649,0.971951
D.bocki,140010837,354937,1,833,5.94954e-06,136084482,0.971957
D.bocki,140010837,333032,1,833,5.94954e-06,136085315,0.971963
D.bocki,140010837,263776,1,833,5.94954e-06,136086148,0.971969
D.bocki,140010837,228540,1,833,5.94954e-06,136086981,0.971975
D.bocki,140010837,217830,1,833,5.94954e-06,136087814,0.971981
D.bocki,140010837,208250,1,833,5.94954e-06,136088647,0.971987
D.bocki,140010837,193141,1,833,5.94954e-06,136089480,0.971992
D.bocki,140010837,159389,1,833,5.94954e-06,136090313,0.971998
D.bocki,140010837,155910,1,833,5.94954e-06,136091146,0.972004
D.bocki,140010837,140822,1,833,5.94954e-06,136091979,0.97201
D.bocki,140010837,451530,1,832,5.9424e-06,136092811,0.972016
D.bocki,140010837,430750,1,832,5.9424e-06,136093643,0.972022
D.bocki,140010837,37560,1,832,5.9424e-06,136094475,0.972028
D.bocki,140010837,372835,1,832,5.9424e-06,136095307,0.972034
D.bocki,140010837,305870,1,832,5.9424e-06,136096139,0.97204
D.bocki,140010837,276160,1,832,5.9424e-06,136096971,0.972046
D.bocki,140010837,23030,1,832,5.9424e-06,136097803,0.972052
D.bocki,140010837,75837,1,831,5.93525e-06,136098634,0.972058
D.bocki,140010837,452961,1,831,5.93525e-06,136099465,0.972064
D.bocki,140010837,397811,1,831,5.93525e-06,136100296,0.97207
D.bocki,140010837,392941,1,831,5.93525e-06,136101127,0.972076
D.bocki,140010837,380583,1,831,5.93525e-06,136101958,0.972082
D.bocki,140010837,375881,1,831,5.93525e-06,136102789,0.972088
D.bocki,140010837,302385,1,831,5.93525e-06,136103620,0.972093
D.bocki,140010837,170285,1,831,5.93525e-06,136104451,0.972099
D.bocki,140010837,16859,1,831,5.93525e-06,136105282,0.972105
D.bocki,140010837,142333,1,831,5.93525e-06,136106113,0.972111
D.bocki,140010837,437096,1,830,5.92811e-06,136106943,0.972117
D.bocki,140010837,352106,1,830,5.92811e-06,136107773,0.972123
D.bocki,140010837,337891,1,830,5.92811e-06,136108603,0.972129
D.bocki,140010837,258150,1,830,5.92811e-06,136109433,0.972135
D.bocki,140010837,216834,1,830,5.92811e-06,136110263,0.972141
D.bocki,140010837,158252,1,830,5.92811e-06,136111093,0.972147
D.bocki,140010837,71000,1,829,5.92097e-06,136111922,0.972153
D.bocki,140010837,453093,1,829,5.92097e-06,136112751,0.972159
D.bocki,140010837,174743,1,829,5.92097e-06,136113580,0.972165
D.bocki,140010837,155546,1,829,5.92097e-06,136114409,0.972171
D.bocki,140010837,133748,1,829,5.92097e-06,136115238,0.972176
D.bocki,140010837,116480,1,829,5.92097e-06,136116067,0.972182
D.bocki,140010837,101455,1,829,5.92097e-06,136116896,0.972188
D.bocki,140010837,9594,1,828,5.91383e-06,136117724,0.972194
D.bocki,140010837,408311,1,828,5.91383e-06,136118552,0.9722
D.bocki,140010837,272883,1,828,5.91383e-06,136119380,0.972206
D.bocki,140010837,268012,1,828,5.91383e-06,136120208,0.972212
D.bocki,140010837,214538,1,828,5.91383e-06,136121036,0.972218
D.bocki,140010837,2143,1,828,5.91383e-06,136121864,0.972224
D.bocki,140010837,168488,1,828,5.91383e-06,136122692,0.97223
D.bocki,140010837,13246,1,828,5.91383e-06,136123520,0.972236
D.bocki,140010837,56140,1,827,5.90669e-06,136124347,0.972242
D.bocki,140010837,46727,1,827,5.90669e-06,136125174,0.972247
D.bocki,140010837,454819,1,827,5.90669e-06,136126001,0.972253
D.bocki,140010837,454159,1,827,5.90669e-06,136126828,0.972259
D.bocki,140010837,434236,1,827,5.90669e-06,136127655,0.972265
D.bocki,140010837,40201,1,827,5.90669e-06,136128482,0.972271
D.bocki,140010837,358195,1,827,5.90669e-06,136129309,0.972277
D.bocki,140010837,344424,1,827,5.90669e-06,136130136,0.972283
D.bocki,140010837,236007,1,827,5.90669e-06,136130963,0.972289
D.bocki,140010837,230620,1,827,5.90669e-06,136131790,0.972295
D.bocki,140010837,160889,1,827,5.90669e-06,136132617,0.972301
D.bocki,140010837,147826,1,827,5.90669e-06,136133444,0.972306
D.bocki,140010837,137810,1,827,5.90669e-06,136134271,0.972312
D.bocki,140010837,129194,1,827,5.90669e-06,136135098,0.972318
D.bocki,140010837,112161,1,827,5.90669e-06,136135925,0.972324
D.bocki,140010837,88903,1,826,5.89954e-06,136136751,0.97233
D.bocki,140010837,402661,1,826,5.89954e-06,136137577,0.972336
D.bocki,140010837,400941,1,826,5.89954e-06,136138403,0.972342
D.bocki,140010837,382950,1,826,5.89954e-06,136139229,0.972348
D.bocki,140010837,32612,1,826,5.89954e-06,136140055,0.972354
D.bocki,140010837,300382,1,826,5.89954e-06,136140881,0.97236
D.bocki,140010837,288755,1,826,5.89954e-06,136141707,0.972365
D.bocki,140010837,255597,1,826,5.89954e-06,136142533,0.972371
D.bocki,140010837,24197,1,826,5.89954e-06,136143359,0.972377
D.bocki,140010837,189323,1,826,5.89954e-06,136144185,0.972383
D.bocki,140010837,70273,1,825,5.8924e-06,136145010,0.972389
D.bocki,140010837,439573,1,825,5.8924e-06,136145835,0.972395
D.bocki,140010837,378703,1,825,5.8924e-06,136146660,0.972401
D.bocki,140010837,367796,1,825,5.8924e-06,136147485,0.972407
D.bocki,140010837,340850,1,825,5.8924e-06,136148310,0.972413
D.bocki,140010837,306212,1,825,5.8924e-06,136149135,0.972419
D.bocki,140010837,243344,1,825,5.8924e-06,136149960,0.972424
D.bocki,140010837,229879,1,825,5.8924e-06,136150785,0.97243
D.bocki,140010837,130592,1,825,5.8924e-06,136151610,0.972436
D.bocki,140010837,10047,1,825,5.8924e-06,136152435,0.972442
D.bocki,140010837,441325,1,824,5.88526e-06,136153259,0.972448
D.bocki,140010837,348993,1,824,5.88526e-06,136154083,0.972454
D.bocki,140010837,305573,1,824,5.88526e-06,136154907,0.97246
D.bocki,140010837,271302,1,824,5.88526e-06,136155731,0.972466
D.bocki,140010837,254903,1,824,5.88526e-06,136156555,0.972472
D.bocki,140010837,103302,1,824,5.88526e-06,136157379,0.972477
D.bocki,140010837,98967,1,823,5.87812e-06,136158202,0.972483
D.bocki,140010837,53093,1,823,5.87812e-06,136159025,0.972489
D.bocki,140010837,452659,1,823,5.87812e-06,136159848,0.972495
D.bocki,140010837,451462,1,823,5.87812e-06,136160671,0.972501
D.bocki,140010837,450544,1,823,5.87812e-06,136161494,0.972507
D.bocki,140010837,444819,1,823,5.87812e-06,136162317,0.972513
D.bocki,140010837,358762,1,823,5.87812e-06,136163140,0.972519
D.bocki,140010837,354366,1,823,5.87812e-06,136163963,0.972524
D.bocki,140010837,321423,1,823,5.87812e-06,136164786,0.97253
D.bocki,140010837,315946,1,823,5.87812e-06,136165609,0.972536
D.bocki,140010837,311063,1,823,5.87812e-06,136166432,0.972542
D.bocki,140010837,280022,1,823,5.87812e-06,136167255,0.972548
D.bocki,140010837,252123,1,823,5.87812e-06,136168078,0.972554
D.bocki,140010837,196144,1,823,5.87812e-06,136168901,0.97256
D.bocki,140010837,156243,1,823,5.87812e-06,136169724,0.972566
D.bocki,140010837,130915,1,823,5.87812e-06,136170547,0.972571
D.bocki,140010837,451237,1,822,5.87097e-06,136171369,0.972577
D.bocki,140010837,423499,1,822,5.87097e-06,136172191,0.972583
D.bocki,140010837,402643,1,822,5.87097e-06,136173013,0.972589
D.bocki,140010837,352525,1,822,5.87097e-06,136173835,0.972595
D.bocki,140010837,332275,1,822,5.87097e-06,136174657,0.972601
D.bocki,140010837,329631,1,822,5.87097e-06,136175479,0.972607
D.bocki,140010837,246577,1,822,5.87097e-06,136176301,0.972613
D.bocki,140010837,163021,1,822,5.87097e-06,136177123,0.972618
D.bocki,140010837,107996,1,822,5.87097e-06,136177945,0.972624
D.bocki,140010837,83456,1,821,5.86383e-06,136178766,0.97263
D.bocki,140010837,366663,1,821,5.86383e-06,136179587,0.972636
D.bocki,140010837,339518,1,821,5.86383e-06,136180408,0.972642
D.bocki,140010837,319177,1,821,5.86383e-06,136181229,0.972648
D.bocki,140010837,267426,1,821,5.86383e-06,136182050,0.972654
D.bocki,140010837,258002,1,821,5.86383e-06,136182871,0.97266
D.bocki,140010837,254198,1,821,5.86383e-06,136183692,0.972665
D.bocki,140010837,25207,1,821,5.86383e-06,136184513,0.972671
D.bocki,140010837,249142,1,821,5.86383e-06,136185334,0.972677
D.bocki,140010837,224830,1,821,5.86383e-06,136186155,0.972683
D.bocki,140010837,99123,1,820,5.85669e-06,136186975,0.972689
D.bocki,140010837,90976,1,820,5.85669e-06,136187795,0.972695
D.bocki,140010837,451621,1,820,5.85669e-06,136188615,0.972701
D.bocki,140010837,412102,1,820,5.85669e-06,136189435,0.972706
D.bocki,140010837,385607,1,820,5.85669e-06,136190255,0.972712
D.bocki,140010837,378956,1,820,5.85669e-06,136191075,0.972718
D.bocki,140010837,362882,1,820,5.85669e-06,136191895,0.972724
D.bocki,140010837,308941,1,820,5.85669e-06,136192715,0.97273
D.bocki,140010837,223756,1,820,5.85669e-06,136193535,0.972736
D.bocki,140010837,219926,1,820,5.85669e-06,136194355,0.972742
D.bocki,140010837,213222,1,820,5.85669e-06,136195175,0.972747
D.bocki,140010837,200592,1,820,5.85669e-06,136195995,0.972753
D.bocki,140010837,186024,1,820,5.85669e-06,136196815,0.972759
D.bocki,140010837,172449,1,820,5.85669e-06,136197635,0.972765
D.bocki,140010837,129131,1,820,5.85669e-06,136198455,0.972771
D.bocki,140010837,51073,1,819,5.84955e-06,136199274,0.972777
D.bocki,140010837,48270,1,819,5.84955e-06,136200093,0.972783
D.bocki,140010837,404255,1,819,5.84955e-06,136200912,0.972788
D.bocki,140010837,362656,1,819,5.84955e-06,136201731,0.972794
D.bocki,140010837,360070,1,819,5.84955e-06,136202550,0.9728
D.bocki,140010837,346367,1,819,5.84955e-06,136203369,0.972806
D.bocki,140010837,267145,1,819,5.84955e-06,136204188,0.972812
D.bocki,140010837,240503,1,819,5.84955e-06,136205007,0.972818
D.bocki,140010837,238638,1,819,5.84955e-06,136205826,0.972823
D.bocki,140010837,233467,1,819,5.84955e-06,136206645,0.972829
D.bocki,140010837,223252,1,819,5.84955e-06,136207464,0.972835
D.bocki,140010837,214225,1,819,5.84955e-06,136208283,0.972841
D.bocki,140010837,454279,1,818,5.8424e-06,136209101,0.972847
D.bocki,140010837,452034,1,818,5.8424e-06,136209919,0.972853
D.bocki,140010837,312613,1,818,5.8424e-06,136210737,0.972859
D.bocki,140010837,297431,1,818,5.8424e-06,136211555,0.972864
D.bocki,140010837,272307,1,818,5.8424e-06,136212373,0.97287
D.bocki,140010837,168243,1,818,5.8424e-06,136213191,0.972876
D.bocki,140010837,146768,1,818,5.8424e-06,136214009,0.972882
D.bocki,140010837,397560,1,817,5.83526e-06,136214826,0.972888
D.bocki,140010837,313453,1,817,5.83526e-06,136215643,0.972894
D.bocki,140010837,25025,1,817,5.83526e-06,136216460,0.972899
D.bocki,140010837,227611,1,817,5.83526e-06,136217277,0.972905
D.bocki,140010837,226540,1,817,5.83526e-06,136218094,0.972911
D.bocki,140010837,175836,1,817,5.83526e-06,136218911,0.972917
D.bocki,140010837,152846,1,817,5.83526e-06,136219728,0.972923
D.bocki,140010837,101961,1,817,5.83526e-06,136220545,0.972929
D.bocki,140010837,100991,1,817,5.83526e-06,136221362,0.972934
D.bocki,140010837,83307,1,816,5.82812e-06,136222178,0.97294
D.bocki,140010837,70707,1,816,5.82812e-06,136222994,0.972946
D.bocki,140010837,440805,1,816,5.82812e-06,136223810,0.972952
D.bocki,140010837,337092,1,816,5.82812e-06,136224626,0.972958
D.bocki,140010837,305433,1,816,5.82812e-06,136225442,0.972964
D.bocki,140010837,296205,1,816,5.82812e-06,136226258,0.972969
D.bocki,140010837,259239,1,816,5.82812e-06,136227074,0.972975
D.bocki,140010837,225485,1,816,5.82812e-06,136227890,0.972981
D.bocki,140010837,21109,1,816,5.82812e-06,136228706,0.972987
D.bocki,140010837,189462,1,816,5.82812e-06,136229522,0.972993
D.bocki,140010837,168686,1,816,5.82812e-06,136230338,0.972999
D.bocki,140010837,154491,1,816,5.82812e-06,136231154,0.973004
D.bocki,140010837,139528,1,816,5.82812e-06,136231970,0.97301
D.bocki,140010837,123572,1,816,5.82812e-06,136232786,0.973016
D.bocki,140010837,99818,1,815,5.82098e-06,136233601,0.973022
D.bocki,140010837,65904,1,815,5.82098e-06,136234416,0.973028
D.bocki,140010837,451659,1,815,5.82098e-06,136235231,0.973033
D.bocki,140010837,451407,1,815,5.82098e-06,136236046,0.973039
D.bocki,140010837,377675,1,815,5.82098e-06,136236861,0.973045
D.bocki,140010837,350736,1,815,5.82098e-06,136237676,0.973051
D.bocki,140010837,33723,1,815,5.82098e-06,136238491,0.973057
D.bocki,140010837,287458,1,815,5.82098e-06,136239306,0.973063
D.bocki,140010837,229007,1,815,5.82098e-06,136240121,0.973068
D.bocki,140010837,204180,1,815,5.82098e-06,136240936,0.973074
D.bocki,140010837,96801,1,814,5.81384e-06,136241750,0.97308
D.bocki,140010837,63426,1,814,5.81384e-06,136242564,0.973086
D.bocki,140010837,451747,1,814,5.81384e-06,136243378,0.973092
D.bocki,140010837,440755,1,814,5.81384e-06,136244192,0.973097
D.bocki,140010837,3610,1,814,5.81384e-06,136245006,0.973103
D.bocki,140010837,316251,1,814,5.81384e-06,136245820,0.973109
D.bocki,140010837,265314,1,814,5.81384e-06,136246634,0.973115
D.bocki,140010837,222769,1,814,5.81384e-06,136247448,0.973121
D.bocki,140010837,173476,1,814,5.81384e-06,136248262,0.973127
D.bocki,140010837,5413,1,813,5.80669e-06,136249075,0.973132
D.bocki,140010837,400295,1,813,5.80669e-06,136249888,0.973138
D.bocki,140010837,386394,1,813,5.80669e-06,136250701,0.973144
D.bocki,140010837,370016,1,813,5.80669e-06,136251514,0.97315
D.bocki,140010837,36600,1,813,5.80669e-06,136252327,0.973156
D.bocki,140010837,351762,1,813,5.80669e-06,136253140,0.973161
D.bocki,140010837,289206,1,813,5.80669e-06,136253953,0.973167
D.bocki,140010837,269447,1,813,5.80669e-06,136254766,0.973173
D.bocki,140010837,205127,1,813,5.80669e-06,136255579,0.973179
D.bocki,140010837,175586,1,813,5.80669e-06,136256392,0.973185
D.bocki,140010837,45843,1,812,5.79955e-06,136257204,0.97319
D.bocki,140010837,44159,1,812,5.79955e-06,136258016,0.973196
D.bocki,140010837,423763,1,812,5.79955e-06,136258828,0.973202
D.bocki,140010837,35254,1,812,5.79955e-06,136259640,0.973208
D.bocki,140010837,293780,1,812,5.79955e-06,136260452,0.973214
D.bocki,140010837,181517,1,812,5.79955e-06,136261264,0.973219
D.bocki,140010837,16983,1,812,5.79955e-06,136262076,0.973225
D.bocki,140010837,73202,1,811,5.79241e-06,136262887,0.973231
D.bocki,140010837,5212,1,811,5.79241e-06,136263698,0.973237
D.bocki,140010837,387453,1,811,5.79241e-06,136264509,0.973243
D.bocki,140010837,378873,1,811,5.79241e-06,136265320,0.973248
D.bocki,140010837,28714,1,811,5.79241e-06,136266131,0.973254
D.bocki,140010837,283987,1,811,5.79241e-06,136266942,0.97326
D.bocki,140010837,274030,1,811,5.79241e-06,136267753,0.973266
D.bocki,140010837,251303,1,811,5.79241e-06,136268564,0.973272
D.bocki,140010837,219628,1,811,5.79241e-06,136269375,0.973277
D.bocki,140010837,215877,1,811,5.79241e-06,136270186,0.973283
D.bocki,140010837,196980,1,811,5.79241e-06,136270997,0.973289
D.bocki,140010837,9531,1,810,5.78527e-06,136271807,0.973295
D.bocki,140010837,89560,1,810,5.78527e-06,136272617,0.9733
D.bocki,140010837,85513,1,810,5.78527e-06,136273427,0.973306
D.bocki,140010837,58721,1,810,5.78527e-06,136274237,0.973312
D.bocki,140010837,364783,1,810,5.78527e-06,136275047,0.973318
D.bocki,140010837,349204,1,810,5.78527e-06,136275857,0.973324
D.bocki,140010837,331845,1,810,5.78527e-06,136276667,0.973329
D.bocki,140010837,32131,1,810,5.78527e-06,136277477,0.973335
D.bocki,140010837,244643,1,810,5.78527e-06,136278287,0.973341
D.bocki,140010837,197078,1,810,5.78527e-06,136279097,0.973347
D.bocki,140010837,19439,1,810,5.78527e-06,136279907,0.973353
D.bocki,140010837,161564,1,810,5.78527e-06,136280717,0.973358
D.bocki,140010837,78595,1,809,5.77812e-06,136281526,0.973364
D.bocki,140010837,46808,1,809,5.77812e-06,136282335,0.97337
D.bocki,140010837,450852,1,809,5.77812e-06,136283144,0.973376
D.bocki,140010837,430951,1,809,5.77812e-06,136283953,0.973381
D.bocki,140010837,39203,1,809,5.77812e-06,136284762,0.973387
D.bocki,140010837,308287,1,809,5.77812e-06,136285571,0.973393
D.bocki,140010837,306683,1,809,5.77812e-06,136286380,0.973399
D.bocki,140010837,298296,1,809,5.77812e-06,136287189,0.973405
D.bocki,140010837,258661,1,809,5.77812e-06,136287998,0.97341
D.bocki,140010837,237263,1,809,5.77812e-06,136288807,0.973416
D.bocki,140010837,212239,1,809,5.77812e-06,136289616,0.973422
D.bocki,140010837,163370,1,809,5.77812e-06,136290425,0.973428
D.bocki,140010837,15344,1,809,5.77812e-06,136291234,0.973433
D.bocki,140010837,148213,1,809,5.77812e-06,136292043,0.973439
D.bocki,140010837,125335,1,809,5.77812e-06,136292852,0.973445
D.bocki,140010837,85475,1,808,5.77098e-06,136293660,0.973451
D.bocki,140010837,69780,1,808,5.77098e-06,136294468,0.973457
D.bocki,140010837,56348,1,808,5.77098e-06,136295276,0.973462
D.bocki,140010837,453994,1,808,5.77098e-06,136296084,0.973468
D.bocki,140010837,397219,1,808,5.77098e-06,136296892,0.973474
D.bocki,140010837,390864,1,808,5.77098e-06,136297700,0.97348
D.bocki,140010837,377952,1,808,5.77098e-06,136298508,0.973485
D.bocki,140010837,367352,1,808,5.77098e-06,136299316,0.973491
D.bocki,140010837,346164,1,808,5.77098e-06,136300124,0.973497
D.bocki,140010837,303688,1,808,5.77098e-06,136300932,0.973503
D.bocki,140010837,268169,1,808,5.77098e-06,136301740,0.973509
D.bocki,140010837,259618,1,808,5.77098e-06,136302548,0.973514
D.bocki,140010837,6236,1,807,5.76384e-06,136303355,0.97352
D.bocki,140010837,405286,1,807,5.76384e-06,136304162,0.973526
D.bocki,140010837,322028,1,807,5.76384e-06,136304969,0.973532
D.bocki,140010837,317403,1,807,5.76384e-06,136305776,0.973537
D.bocki,140010837,204374,1,807,5.76384e-06,136306583,0.973543
D.bocki,140010837,184400,1,807,5.76384e-06,136307390,0.973549
D.bocki,140010837,184057,1,807,5.76384e-06,136308197,0.973555
D.bocki,140010837,65958,1,806,5.7567e-06,136309003,0.97356
D.bocki,140010837,6394,1,806,5.7567e-06,136309809,0.973566
D.bocki,140010837,40003,1,806,5.7567e-06,136310615,0.973572
D.bocki,140010837,311089,1,806,5.7567e-06,136311421,0.973578
D.bocki,140010837,306464,1,806,5.7567e-06,136312227,0.973583
D.bocki,140010837,30070,1,806,5.7567e-06,136313033,0.973589
D.bocki,140010837,281082,1,806,5.7567e-06,136313839,0.973595
D.bocki,140010837,196496,1,806,5.7567e-06,136314645,0.973601
D.bocki,140010837,188267,1,806,5.7567e-06,136315451,0.973606
D.bocki,140010837,86714,1,805,5.74955e-06,136316256,0.973612
D.bocki,140010837,453289,1,805,5.74955e-06,136317061,0.973618
D.bocki,140010837,452612,1,805,5.74955e-06,136317866,0.973624
D.bocki,140010837,397340,1,805,5.74955e-06,136318671,0.973629
D.bocki,140010837,385331,1,805,5.74955e-06,136319476,0.973635
D.bocki,140010837,240951,1,805,5.74955e-06,136320281,0.973641
D.bocki,140010837,163789,1,805,5.74955e-06,136321086,0.973647
D.bocki,140010837,102025,1,805,5.74955e-06,136321891,0.973652
D.bocki,140010837,94954,1,804,5.74241e-06,136322695,0.973658
D.bocki,140010837,79591,1,804,5.74241e-06,136323499,0.973664
D.bocki,140010837,451458,1,804,5.74241e-06,136324303,0.97367
D.bocki,140010837,421978,1,804,5.74241e-06,136325107,0.973675
D.bocki,140010837,401352,1,804,5.74241e-06,136325911,0.973681
D.bocki,140010837,388528,1,804,5.74241e-06,136326715,0.973687
D.bocki,140010837,3469,1,804,5.74241e-06,136327519,0.973693
D.bocki,140010837,291464,1,804,5.74241e-06,136328323,0.973698
D.bocki,140010837,280577,1,804,5.74241e-06,136329127,0.973704
D.bocki,140010837,227353,1,804,5.74241e-06,136329931,0.97371
D.bocki,140010837,187691,1,804,5.74241e-06,136330735,0.973716
D.bocki,140010837,154894,1,804,5.74241e-06,136331539,0.973721
D.bocki,140010837,121177,1,804,5.74241e-06,136332343,0.973727
D.bocki,140010837,376579,1,803,5.73527e-06,136333146,0.973733
D.bocki,140010837,343333,1,803,5.73527e-06,136333949,0.973739
D.bocki,140010837,27499,1,803,5.73527e-06,136334752,0.973744
D.bocki,140010837,154250,1,803,5.73527e-06,136335555,0.97375
D.bocki,140010837,7869,1,802,5.72813e-06,136336357,0.973756
D.bocki,140010837,4281,1,802,5.72813e-06,136337159,0.973761
D.bocki,140010837,412824,1,802,5.72813e-06,136337961,0.973767
D.bocki,140010837,394635,1,802,5.72813e-06,136338763,0.973773
D.bocki,140010837,340106,1,802,5.72813e-06,136339565,0.973779
D.bocki,140010837,208389,1,802,5.72813e-06,136340367,0.973784
D.bocki,140010837,15479,1,802,5.72813e-06,136341169,0.97379
D.bocki,140010837,89889,1,801,5.72099e-06,136341970,0.973796
D.bocki,140010837,64580,1,801,5.72099e-06,136342771,0.973802
D.bocki,140010837,434929,1,801,5.72099e-06,136343572,0.973807
D.bocki,140010837,427985,1,801,5.72099e-06,136344373,0.973813
D.bocki,140010837,361958,1,801,5.72099e-06,136345174,0.973819
D.bocki,140010837,333854,1,801,5.72099e-06,136345975,0.973824
D.bocki,140010837,303094,1,801,5.72099e-06,136346776,0.97383
D.bocki,140010837,251094,1,801,5.72099e-06,136347577,0.973836
D.bocki,140010837,242296,1,801,5.72099e-06,136348378,0.973842
D.bocki,140010837,87527,1,800,5.71384e-06,136349178,0.973847
D.bocki,140010837,72118,1,800,5.71384e-06,136349978,0.973853
D.bocki,140010837,452099,1,800,5.71384e-06,136350778,0.973859
D.bocki,140010837,285853,1,800,5.71384e-06,136351578,0.973864
D.bocki,140010837,253552,1,800,5.71384e-06,136352378,0.97387
D.bocki,140010837,240109,1,800,5.71384e-06,136353178,0.973876
D.bocki,140010837,190548,1,800,5.71384e-06,136353978,0.973882
D.bocki,140010837,164505,1,800,5.71384e-06,136354778,0.973887
D.bocki,140010837,140443,1,800,5.71384e-06,136355578,0.973893
D.bocki,140010837,87700,1,799,5.7067e-06,136356377,0.973899
D.bocki,140010837,6662,1,799,5.7067e-06,136357176,0.973904
D.bocki,140010837,450849,1,799,5.7067e-06,136357975,0.97391
D.bocki,140010837,446012,1,799,5.7067e-06,136358774,0.973916
D.bocki,140010837,431367,1,799,5.7067e-06,136359573,0.973922
D.bocki,140010837,36167,1,799,5.7067e-06,136360372,0.973927
D.bocki,140010837,312841,1,799,5.7067e-06,136361171,0.973933
D.bocki,140010837,23659,1,799,5.7067e-06,136361970,0.973939
D.bocki,140010837,203513,1,799,5.7067e-06,136362769,0.973944
D.bocki,140010837,173838,1,799,5.7067e-06,136363568,0.97395
D.bocki,140010837,135442,1,799,5.7067e-06,136364367,0.973956
D.bocki,140010837,90156,1,798,5.69956e-06,136365165,0.973962
D.bocki,140010837,73577,1,798,5.69956e-06,136365963,0.973967
D.bocki,140010837,6166,1,798,5.69956e-06,136366761,0.973973
D.bocki,140010837,450833,1,798,5.69956e-06,136367559,0.973979
D.bocki,140010837,450501,1,798,5.69956e-06,136368357,0.973984
D.bocki,140010837,448061,1,798,5.69956e-06,136369155,0.97399
D.bocki,140010837,404099,1,798,5.69956e-06,136369953,0.973996
D.bocki,140010837,321704,1,798,5.69956e-06,136370751,0.974001
D.bocki,140010837,317572,1,798,5.69956e-06,136371549,0.974007
D.bocki,140010837,286639,1,798,5.69956e-06,136372347,0.974013
D.bocki,140010837,244984,1,798,5.69956e-06,136373145,0.974018
D.bocki,140010837,227411,1,798,5.69956e-06,136373943,0.974024
D.bocki,140010837,216337,1,798,5.69956e-06,136374741,0.97403
D.bocki,140010837,211620,1,798,5.69956e-06,136375539,0.974036
D.bocki,140010837,196143,1,798,5.69956e-06,136376337,0.974041
D.bocki,140010837,17446,1,798,5.69956e-06,136377135,0.974047
D.bocki,140010837,90387,1,797,5.69242e-06,136377932,0.974053
D.bocki,140010837,55176,1,797,5.69242e-06,136378729,0.974058
D.bocki,140010837,453192,1,797,5.69242e-06,136379526,0.974064
D.bocki,140010837,433866,1,797,5.69242e-06,136380323,0.97407
D.bocki,140010837,410416,1,797,5.69242e-06,136381120,0.974075
D.bocki,140010837,39059,1,797,5.69242e-06,136381917,0.974081
D.bocki,140010837,252282,1,797,5.69242e-06,136382714,0.974087
D.bocki,140010837,240502,1,797,5.69242e-06,136383511,0.974093
D.bocki,140010837,210537,1,797,5.69242e-06,136384308,0.974098
D.bocki,140010837,4153,1,796,5.68527e-06,136385104,0.974104
D.bocki,140010837,350598,1,796,5.68527e-06,136385900,0.97411
D.bocki,140010837,34211,1,796,5.68527e-06,136386696,0.974115
D.bocki,140010837,214782,1,796,5.68527e-06,136387492,0.974121
D.bocki,140010837,18278,1,796,5.68527e-06,136388288,0.974127
D.bocki,140010837,13856,1,796,5.68527e-06,136389084,0.974132
D.bocki,140010837,311944,1,795,5.67813e-06,136389879,0.974138
D.bocki,140010837,311247,1,795,5.67813e-06,136390674,0.974144
D.bocki,140010837,252032,1,795,5.67813e-06,136391469,0.974149
D.bocki,140010837,220175,1,795,5.67813e-06,136392264,0.974155
D.bocki,140010837,194215,1,795,5.67813e-06,136393059,0.974161
D.bocki,140010837,170425,1,795,5.67813e-06,136393854,0.974166
D.bocki,140010837,42565,1,794,5.67099e-06,136394648,0.974172
D.bocki,140010837,414895,1,794,5.67099e-06,136395442,0.974178
D.bocki,140010837,408353,1,794,5.67099e-06,136396236,0.974183
D.bocki,140010837,405908,1,794,5.67099e-06,136397030,0.974189
D.bocki,140010837,391020,1,794,5.67099e-06,136397824,0.974195
D.bocki,140010837,380854,1,794,5.67099e-06,136398618,0.9742
D.bocki,140010837,368770,1,794,5.67099e-06,136399412,0.974206
D.bocki,140010837,302893,1,794,5.67099e-06,136400206,0.974212
D.bocki,140010837,209041,1,794,5.67099e-06,136401000,0.974217
D.bocki,140010837,9238,1,793,5.66385e-06,136401793,0.974223
D.bocki,140010837,454405,1,793,5.66385e-06,136402586,0.974229
D.bocki,140010837,454030,1,793,5.66385e-06,136403379,0.974234
D.bocki,140010837,451014,1,793,5.66385e-06,136404172,0.97424
D.bocki,140010837,357504,1,793,5.66385e-06,136404965,0.974246
D.bocki,140010837,30833,1,793,5.66385e-06,136405758,0.974251
D.bocki,140010837,25233,1,793,5.66385e-06,136406551,0.974257
D.bocki,140010837,191054,1,793,5.66385e-06,136407344,0.974263
D.bocki,140010837,176939,1,793,5.66385e-06,136408137,0.974268
D.bocki,140010837,128137,1,793,5.66385e-06,136408930,0.974274
D.bocki,140010837,12674,1,793,5.66385e-06,136409723,0.97428
D.bocki,140010837,125462,1,793,5.66385e-06,136410516,0.974285
D.bocki,140010837,11949,1,793,5.66385e-06,136411309,0.974291
D.bocki,140010837,101112,1,793,5.66385e-06,136412102,0.974297
D.bocki,140010837,433397,1,792,5.6567e-06,136412894,0.974302
D.bocki,140010837,421878,1,792,5.6567e-06,136413686,0.974308
D.bocki,140010837,410136,1,792,5.6567e-06,136414478,0.974314
D.bocki,140010837,380799,1,792,5.6567e-06,136415270,0.974319
D.bocki,140010837,369342,1,792,5.6567e-06,136416062,0.974325
D.bocki,140010837,304081,1,792,5.6567e-06,136416854,0.974331
D.bocki,140010837,283312,1,792,5.6567e-06,136417646,0.974336
D.bocki,140010837,271396,1,792,5.6567e-06,136418438,0.974342
D.bocki,140010837,167149,1,792,5.6567e-06,136419230,0.974348
D.bocki,140010837,102897,1,792,5.6567e-06,136420022,0.974353
D.bocki,140010837,96800,1,791,5.64956e-06,136420813,0.974359
D.bocki,140010837,64546,1,791,5.64956e-06,136421604,0.974365
D.bocki,140010837,280114,1,791,5.64956e-06,136422395,0.97437
D.bocki,140010837,262131,1,791,5.64956e-06,136423186,0.974376
D.bocki,140010837,180501,1,791,5.64956e-06,136423977,0.974382
D.bocki,140010837,175619,1,791,5.64956e-06,136424768,0.974387
D.bocki,140010837,151366,1,791,5.64956e-06,136425559,0.974393
D.bocki,140010837,117679,1,791,5.64956e-06,136426350,0.974399
D.bocki,140010837,105029,1,791,5.64956e-06,136427141,0.974404
D.bocki,140010837,97889,1,790,5.64242e-06,136427931,0.97441
D.bocki,140010837,444820,1,790,5.64242e-06,136428721,0.974415
D.bocki,140010837,408213,1,790,5.64242e-06,136429511,0.974421
D.bocki,140010837,399928,1,790,5.64242e-06,136430301,0.974427
D.bocki,140010837,367444,1,790,5.64242e-06,136431091,0.974432
D.bocki,140010837,367353,1,790,5.64242e-06,136431881,0.974438
D.bocki,140010837,205410,1,790,5.64242e-06,136432671,0.974444
D.bocki,140010837,129902,1,790,5.64242e-06,136433461,0.974449
D.bocki,140010837,113502,1,790,5.64242e-06,136434251,0.974455
D.bocki,140010837,92722,1,789,5.63528e-06,136435040,0.974461
D.bocki,140010837,85202,1,789,5.63528e-06,136435829,0.974466
D.bocki,140010837,81983,1,789,5.63528e-06,136436618,0.974472
D.bocki,140010837,454089,1,789,5.63528e-06,136437407,0.974477
D.bocki,140010837,40839,1,789,5.63528e-06,136438196,0.974483
D.bocki,140010837,379708,1,789,5.63528e-06,136438985,0.974489
D.bocki,140010837,346086,1,789,5.63528e-06,136439774,0.974494
D.bocki,140010837,316611,1,789,5.63528e-06,136440563,0.9745
D.bocki,140010837,304502,1,789,5.63528e-06,136441352,0.974506
D.bocki,140010837,291003,1,789,5.63528e-06,136442141,0.974511
D.bocki,140010837,283146,1,789,5.63528e-06,136442930,0.974517
D.bocki,140010837,261331,1,789,5.63528e-06,136443719,0.974523
D.bocki,140010837,1994,1,789,5.63528e-06,136444508,0.974528
D.bocki,140010837,180817,1,789,5.63528e-06,136445297,0.974534
D.bocki,140010837,142378,1,789,5.63528e-06,136446086,0.974539
D.bocki,140010837,92952,1,788,5.62814e-06,136446874,0.974545
D.bocki,140010837,438525,1,788,5.62814e-06,136447662,0.974551
D.bocki,140010837,387480,1,788,5.62814e-06,136448450,0.974556
D.bocki,140010837,367872,1,788,5.62814e-06,136449238,0.974562
D.bocki,140010837,355973,1,788,5.62814e-06,136450026,0.974568
D.bocki,140010837,287456,1,788,5.62814e-06,136450814,0.974573
D.bocki,140010837,160265,1,788,5.62814e-06,136451602,0.974579
D.bocki,140010837,143611,1,788,5.62814e-06,136452390,0.974584
D.bocki,140010837,450439,1,787,5.62099e-06,136453177,0.97459
D.bocki,140010837,432519,1,787,5.62099e-06,136453964,0.974596
D.bocki,140010837,423354,1,787,5.62099e-06,136454751,0.974601
D.bocki,140010837,377842,1,787,5.62099e-06,136455538,0.974607
D.bocki,140010837,376326,1,787,5.62099e-06,136456325,0.974613
D.bocki,140010837,357505,1,787,5.62099e-06,136457112,0.974618
D.bocki,140010837,35522,1,787,5.62099e-06,136457899,0.974624
D.bocki,140010837,299352,1,787,5.62099e-06,136458686,0.974629
D.bocki,140010837,26160,1,787,5.62099e-06,136459473,0.974635
D.bocki,140010837,222225,1,787,5.62099e-06,136460260,0.974641
D.bocki,140010837,214895,1,787,5.62099e-06,136461047,0.974646
D.bocki,140010837,205774,1,787,5.62099e-06,136461834,0.974652
D.bocki,140010837,168745,1,787,5.62099e-06,136462621,0.974658
D.bocki,140010837,159190,1,787,5.62099e-06,136463408,0.974663
D.bocki,140010837,87316,1,786,5.61385e-06,136464194,0.974669
D.bocki,140010837,453892,1,786,5.61385e-06,136464980,0.974674
D.bocki,140010837,403473,1,786,5.61385e-06,136465766,0.97468
D.bocki,140010837,397810,1,786,5.61385e-06,136466552,0.974686
D.bocki,140010837,352369,1,786,5.61385e-06,136467338,0.974691
D.bocki,140010837,299136,1,786,5.61385e-06,136468124,0.974697
D.bocki,140010837,289542,1,786,5.61385e-06,136468910,0.974702
D.bocki,140010837,283464,1,786,5.61385e-06,136469696,0.974708
D.bocki,140010837,272097,1,786,5.61385e-06,136470482,0.974714
D.bocki,140010837,261538,1,786,5.61385e-06,136471268,0.974719
D.bocki,140010837,254474,1,786,5.61385e-06,136472054,0.974725
D.bocki,140010837,24650,1,786,5.61385e-06,136472840,0.974731
D.bocki,140010837,243830,1,786,5.61385e-06,136473626,0.974736
D.bocki,140010837,201612,1,786,5.61385e-06,136474412,0.974742
D.bocki,140010837,190763,1,786,5.61385e-06,136475198,0.974747
D.bocki,140010837,177935,1,786,5.61385e-06,136475984,0.974753
D.bocki,140010837,111599,1,786,5.61385e-06,136476770,0.974759
D.bocki,140010837,451591,1,785,5.60671e-06,136477555,0.974764
D.bocki,140010837,420354,1,785,5.60671e-06,136478340,0.97477
D.bocki,140010837,384313,1,785,5.60671e-06,136479125,0.974775
D.bocki,140010837,360491,1,785,5.60671e-06,136479910,0.974781
D.bocki,140010837,337012,1,785,5.60671e-06,136480695,0.974787
D.bocki,140010837,324920,1,785,5.60671e-06,136481480,0.974792
D.bocki,140010837,318665,1,785,5.60671e-06,136482265,0.974798
D.bocki,140010837,316362,1,785,5.60671e-06,136483050,0.974803
D.bocki,140010837,301744,1,785,5.60671e-06,136483835,0.974809
D.bocki,140010837,270606,1,785,5.60671e-06,136484620,0.974815
D.bocki,140010837,152438,1,785,5.60671e-06,136485405,0.97482
D.bocki,140010837,127482,1,785,5.60671e-06,136486190,0.974826
D.bocki,140010837,124465,1,785,5.60671e-06,136486975,0.974832
D.bocki,140010837,115181,1,785,5.60671e-06,136487760,0.974837
D.bocki,140010837,454022,1,784,5.59957e-06,136488544,0.974843
D.bocki,140010837,450937,1,784,5.59957e-06,136489328,0.974848
D.bocki,140010837,412992,1,784,5.59957e-06,136490112,0.974854
D.bocki,140010837,409679,1,784,5.59957e-06,136490896,0.97486
D.bocki,140010837,394542,1,784,5.59957e-06,136491680,0.974865
D.bocki,140010837,379146,1,784,5.59957e-06,136492464,0.974871
D.bocki,140010837,338896,1,784,5.59957e-06,136493248,0.974876
D.bocki,140010837,318881,1,784,5.59957e-06,136494032,0.974882
D.bocki,140010837,308443,1,784,5.59957e-06,136494816,0.974888
D.bocki,140010837,294031,1,784,5.59957e-06,136495600,0.974893
D.bocki,140010837,2576,1,784,5.59957e-06,136496384,0.974899
D.bocki,140010837,184323,1,784,5.59957e-06,136497168,0.974904
D.bocki,140010837,68720,1,783,5.59242e-06,136497951,0.97491
D.bocki,140010837,51134,1,783,5.59242e-06,136498734,0.974915
D.bocki,140010837,272098,1,783,5.59242e-06,136499517,0.974921
D.bocki,140010837,23958,1,783,5.59242e-06,136500300,0.974927
D.bocki,140010837,229964,1,783,5.59242e-06,136501083,0.974932
D.bocki,140010837,225310,1,783,5.59242e-06,136501866,0.974938
D.bocki,140010837,211475,1,783,5.59242e-06,136502649,0.974943
D.bocki,140010837,179757,1,783,5.59242e-06,136503432,0.974949
D.bocki,140010837,77494,1,782,5.58528e-06,136504214,0.974955
D.bocki,140010837,453500,1,782,5.58528e-06,136504996,0.97496
D.bocki,140010837,451424,1,782,5.58528e-06,136505778,0.974966
D.bocki,140010837,301768,1,782,5.58528e-06,136506560,0.974971
D.bocki,140010837,296691,1,782,5.58528e-06,136507342,0.974977
D.bocki,140010837,218195,1,782,5.58528e-06,136508124,0.974983
D.bocki,140010837,212021,1,782,5.58528e-06,136508906,0.974988
D.bocki,140010837,20701,1,782,5.58528e-06,136509688,0.974994
D.bocki,140010837,154959,1,782,5.58528e-06,136510470,0.974999
D.bocki,140010837,148824,1,782,5.58528e-06,136511252,0.975005
D.bocki,140010837,872,1,781,5.57814e-06,136512033,0.97501
D.bocki,140010837,85264,1,781,5.57814e-06,136512814,0.975016
D.bocki,140010837,64211,1,781,5.57814e-06,136513595,0.975022
D.bocki,140010837,52905,1,781,5.57814e-06,136514376,0.975027
D.bocki,140010837,452555,1,781,5.57814e-06,136515157,0.975033
D.bocki,140010837,452441,1,781,5.57814e-06,136515938,0.975038
D.bocki,140010837,416818,1,781,5.57814e-06,136516719,0.975044
D.bocki,140010837,340849,1,781,5.57814e-06,136517500,0.97505
D.bocki,140010837,332891,1,781,5.57814e-06,136518281,0.975055
D.bocki,140010837,28512,1,781,5.57814e-06,136519062,0.975061
D.bocki,140010837,209142,1,781,5.57814e-06,136519843,0.975066
D.bocki,140010837,147827,1,781,5.57814e-06,136520624,0.975072
D.bocki,140010837,94428,1,780,5.571e-06,136521404,0.975077
D.bocki,140010837,60169,1,780,5.571e-06,136522184,0.975083
D.bocki,140010837,58324,1,780,5.571e-06,136522964,0.975089
D.bocki,140010837,448566,1,780,5.571e-06,136523744,0.975094
D.bocki,140010837,4338,1,780,5.571e-06,136524524,0.9751
D.bocki,140010837,375526,1,780,5.571e-06,136525304,0.975105
D.bocki,140010837,36426,1,780,5.571e-06,136526084,0.975111
D.bocki,140010837,78751,1,779,5.56386e-06,136526863,0.975116
D.bocki,140010837,62315,1,779,5.56386e-06,136527642,0.975122
D.bocki,140010837,56239,1,779,5.56386e-06,136528421,0.975128
D.bocki,140010837,454648,1,779,5.56386e-06,136529200,0.975133
D.bocki,140010837,436211,1,779,5.56386e-06,136529979,0.975139
D.bocki,140010837,357021,1,779,5.56386e-06,136530758,0.975144
D.bocki,140010837,326611,1,779,5.56386e-06,136531537,0.97515
D.bocki,140010837,293890,1,779,5.56386e-06,136532316,0.975155
D.bocki,140010837,257952,1,779,5.56386e-06,136533095,0.975161
D.bocki,140010837,244248,1,779,5.56386e-06,136533874,0.975166
D.bocki,140010837,204527,1,779,5.56386e-06,136534653,0.975172
D.bocki,140010837,170626,1,779,5.56386e-06,136535432,0.975178
D.bocki,140010837,72146,1,778,5.55671e-06,136536210,0.975183
D.bocki,140010837,45759,1,778,5.55671e-06,136536988,0.975189
D.bocki,140010837,448567,1,778,5.55671e-06,136537766,0.975194
D.bocki,140010837,410615,1,778,5.55671e-06,136538544,0.9752
D.bocki,140010837,40892,1,778,5.55671e-06,136539322,0.975205
D.bocki,140010837,366665,1,778,5.55671e-06,136540100,0.975211
D.bocki,140010837,276269,1,778,5.55671e-06,136540878,0.975216
D.bocki,140010837,26756,1,778,5.55671e-06,136541656,0.975222
D.bocki,140010837,236875,1,778,5.55671e-06,136542434,0.975228
D.bocki,140010837,222540,1,778,5.55671e-06,136543212,0.975233
D.bocki,140010837,216297,1,778,5.55671e-06,136543990,0.975239
D.bocki,140010837,209521,1,778,5.55671e-06,136544768,0.975244
D.bocki,140010837,193258,1,778,5.55671e-06,136545546,0.97525
D.bocki,140010837,192123,1,778,5.55671e-06,136546324,0.975255
D.bocki,140010837,167380,1,778,5.55671e-06,136547102,0.975261
D.bocki,140010837,144130,1,778,5.55671e-06,136547880,0.975267
D.bocki,140010837,139426,1,778,5.55671e-06,136548658,0.975272
D.bocki,140010837,106671,1,778,5.55671e-06,136549436,0.975278
D.bocki,140010837,8269,1,777,5.54957e-06,136550213,0.975283
D.bocki,140010837,454029,1,777,5.54957e-06,136550990,0.975289
D.bocki,140010837,453002,1,777,5.54957e-06,136551767,0.975294
D.bocki,140010837,452310,1,777,5.54957e-06,136552544,0.9753
D.bocki,140010837,431336,1,777,5.54957e-06,136553321,0.975305
D.bocki,140010837,422119,1,777,5.54957e-06,136554098,0.975311
D.bocki,140010837,399926,1,777,5.54957e-06,136554875,0.975316
D.bocki,140010837,348608,1,777,5.54957e-06,136555652,0.975322
D.bocki,140010837,333556,1,777,5.54957e-06,136556429,0.975328
D.bocki,140010837,31118,1,777,5.54957e-06,136557206,0.975333
D.bocki,140010837,306184,1,777,5.54957e-06,136557983,0.975339
D.bocki,140010837,25834,1,777,5.54957e-06,136558760,0.975344
D.bocki,140010837,193895,1,777,5.54957e-06,136559537,0.97535
D.bocki,140010837,157366,1,777,5.54957e-06,136560314,0.975355
D.bocki,140010837,454106,1,776,5.54243e-06,136561090,0.975361
D.bocki,140010837,450943,1,776,5.54243e-06,136561866,0.975366
D.bocki,140010837,437158,1,776,5.54243e-06,136562642,0.975372
D.bocki,140010837,431033,1,776,5.54243e-06,136563418,0.975377
D.bocki,140010837,429663,1,776,5.54243e-06,136564194,0.975383
D.bocki,140010837,404681,1,776,5.54243e-06,136564970,0.975389
D.bocki,140010837,395200,1,776,5.54243e-06,136565746,0.975394
D.bocki,140010837,387605,1,776,5.54243e-06,136566522,0.9754
D.bocki,140010837,35832,1,776,5.54243e-06,136567298,0.975405
D.bocki,140010837,348877,1,776,5.54243e-06,136568074,0.975411
D.bocki,140010837,339064,1,776,5.54243e-06,136568850,0.975416
D.bocki,140010837,257700,1,776,5.54243e-06,136569626,0.975422
D.bocki,140010837,24408,1,776,5.54243e-06,136570402,0.975427
D.bocki,140010837,185639,1,776,5.54243e-06,136571178,0.975433
D.bocki,140010837,125238,1,776,5.54243e-06,136571954,0.975438
D.bocki,140010837,68514,1,775,5.53529e-06,136572729,0.975444
D.bocki,140010837,61181,1,775,5.53529e-06,136573504,0.97545
D.bocki,140010837,451827,1,775,5.53529e-06,136574279,0.975455
D.bocki,140010837,428419,1,775,5.53529e-06,136575054,0.975461
D.bocki,140010837,425567,1,775,5.53529e-06,136575829,0.975466
D.bocki,140010837,335361,1,775,5.53529e-06,136576604,0.975472
D.bocki,140010837,271688,1,775,5.53529e-06,136577379,0.975477
D.bocki,140010837,102403,1,775,5.53529e-06,136578154,0.975483
D.bocki,140010837,449959,1,774,5.52814e-06,136578928,0.975488
D.bocki,140010837,414446,1,774,5.52814e-06,136579702,0.975494
D.bocki,140010837,39560,1,774,5.52814e-06,136580476,0.975499
D.bocki,140010837,344666,1,774,5.52814e-06,136581250,0.975505
D.bocki,140010837,33611,1,774,5.52814e-06,136582024,0.97551
D.bocki,140010837,325105,1,774,5.52814e-06,136582798,0.975516
D.bocki,140010837,324233,1,774,5.52814e-06,136583572,0.975521
D.bocki,140010837,311062,1,774,5.52814e-06,136584346,0.975527
D.bocki,140010837,295618,1,774,5.52814e-06,136585120,0.975532
D.bocki,140010837,291621,1,774,5.52814e-06,136585894,0.975538
D.bocki,140010837,255360,1,774,5.52814e-06,136586668,0.975544
D.bocki,140010837,247074,1,774,5.52814e-06,136587442,0.975549
D.bocki,140010837,234519,1,774,5.52814e-06,136588216,0.975555
D.bocki,140010837,171603,1,774,5.52814e-06,136588990,0.97556
D.bocki,140010837,147093,1,774,5.52814e-06,136589764,0.975566
D.bocki,140010837,114191,1,774,5.52814e-06,136590538,0.975571
D.bocki,140010837,82342,1,773,5.521e-06,136591311,0.975577
D.bocki,140010837,68623,1,773,5.521e-06,136592084,0.975582
D.bocki,140010837,59695,1,773,5.521e-06,136592857,0.975588
D.bocki,140010837,436504,1,773,5.521e-06,136593630,0.975593
D.bocki,140010837,432160,1,773,5.521e-06,136594403,0.975599
D.bocki,140010837,427901,1,773,5.521e-06,136595176,0.975604
D.bocki,140010837,407186,1,773,5.521e-06,136595949,0.97561
D.bocki,140010837,397750,1,773,5.521e-06,136596722,0.975615
D.bocki,140010837,324067,1,773,5.521e-06,136597495,0.975621
D.bocki,140010837,222909,1,773,5.521e-06,136598268,0.975626
D.bocki,140010837,197077,1,773,5.521e-06,136599041,0.975632
D.bocki,140010837,12758,1,773,5.521e-06,136599814,0.975637
D.bocki,140010837,122553,1,773,5.521e-06,136600587,0.975643
D.bocki,140010837,109371,1,773,5.521e-06,136601360,0.975648
D.bocki,140010837,102201,1,773,5.521e-06,136602133,0.975654
D.bocki,140010837,59756,1,772,5.51386e-06,136602905,0.97566
D.bocki,140010837,58797,1,772,5.51386e-06,136603677,0.975665
D.bocki,140010837,55412,1,772,5.51386e-06,136604449,0.975671
D.bocki,140010837,47883,1,772,5.51386e-06,136605221,0.975676
D.bocki,140010837,453113,1,772,5.51386e-06,136605993,0.975682
D.bocki,140010837,452665,1,772,5.51386e-06,136606765,0.975687
D.bocki,140010837,3959,1,772,5.51386e-06,136607537,0.975693
D.bocki,140010837,394246,1,772,5.51386e-06,136608309,0.975698
D.bocki,140010837,392928,1,772,5.51386e-06,136609081,0.975704
D.bocki,140010837,348596,1,772,5.51386e-06,136609853,0.975709
D.bocki,140010837,341753,1,772,5.51386e-06,136610625,0.975715
D.bocki,140010837,317680,1,772,5.51386e-06,136611397,0.97572
D.bocki,140010837,269989,1,772,5.51386e-06,136612169,0.975726
D.bocki,140010837,267658,1,772,5.51386e-06,136612941,0.975731
D.bocki,140010837,237666,1,772,5.51386e-06,136613713,0.975737
D.bocki,140010837,229364,1,772,5.51386e-06,136614485,0.975742
D.bocki,140010837,196293,1,772,5.51386e-06,136615257,0.975748
D.bocki,140010837,173904,1,772,5.51386e-06,136616029,0.975753
D.bocki,140010837,115794,1,772,5.51386e-06,136616801,0.975759
D.bocki,140010837,101029,1,772,5.51386e-06,136617573,0.975764
D.bocki,140010837,81831,1,771,5.50672e-06,136618344,0.97577
D.bocki,140010837,453592,1,771,5.50672e-06,136619115,0.975775
D.bocki,140010837,452358,1,771,5.50672e-06,136619886,0.975781
D.bocki,140010837,452309,1,771,5.50672e-06,136620657,0.975786
D.bocki,140010837,356516,1,771,5.50672e-06,136621428,0.975792
D.bocki,140010837,331205,1,771,5.50672e-06,136622199,0.975797
D.bocki,140010837,304595,1,771,5.50672e-06,136622970,0.975803
D.bocki,140010837,281484,1,771,5.50672e-06,136623741,0.975808
D.bocki,140010837,252126,1,771,5.50672e-06,136624512,0.975814
D.bocki,140010837,241377,1,771,5.50672e-06,136625283,0.975819
D.bocki,140010837,195350,1,771,5.50672e-06,136626054,0.975825
D.bocki,140010837,172266,1,771,5.50672e-06,136626825,0.97583
D.bocki,140010837,138826,1,771,5.50672e-06,136627596,0.975836
D.bocki,140010837,126805,1,771,5.50672e-06,136628367,0.975841
D.bocki,140010837,67638,1,770,5.49957e-06,136629137,0.975847
D.bocki,140010837,413307,1,770,5.49957e-06,136629907,0.975852
D.bocki,140010837,401523,1,770,5.49957e-06,136630677,0.975858
D.bocki,140010837,350771,1,770,5.49957e-06,136631447,0.975863
D.bocki,140010837,231014,1,770,5.49957e-06,136632217,0.975869
D.bocki,140010837,142862,1,770,5.49957e-06,136632987,0.975874
D.bocki,140010837,440009,1,769,5.49243e-06,136633756,0.97588
D.bocki,140010837,324689,1,769,5.49243e-06,136634525,0.975885
D.bocki,140010837,315945,1,769,5.49243e-06,136635294,0.975891
D.bocki,140010837,307049,1,769,5.49243e-06,136636063,0.975896
D.bocki,140010837,300346,1,769,5.49243e-06,136636832,0.975902
D.bocki,140010837,273273,1,769,5.49243e-06,136637601,0.975907
D.bocki,140010837,262246,1,769,5.49243e-06,136638370,0.975913
D.bocki,140010837,165881,1,769,5.49243e-06,136639139,0.975918
D.bocki,140010837,15443,1,769,5.49243e-06,136639908,0.975924
D.bocki,140010837,125706,1,769,5.49243e-06,136640677,0.975929
D.bocki,140010837,94217,1,768,5.48529e-06,136641445,0.975935
D.bocki,140010837,410415,1,768,5.48529e-06,136642213,0.97594
D.bocki,140010837,409528,1,768,5.48529e-06,136642981,0.975946
D.bocki,140010837,392158,1,768,5.48529e-06,136643749,0.975951
D.bocki,140010837,371317,1,768,5.48529e-06,136644517,0.975957
D.bocki,140010837,368634,1,768,5.48529e-06,136645285,0.975962
D.bocki,140010837,305837,1,768,5.48529e-06,136646053,0.975968
D.bocki,140010837,282898,1,768,5.48529e-06,136646821,0.975973
D.bocki,140010837,279455,1,768,5.48529e-06,136647589,0.975979
D.bocki,140010837,235333,1,768,5.48529e-06,136648357,0.975984
D.bocki,140010837,229993,1,768,5.48529e-06,136649125,0.97599
D.bocki,140010837,194471,1,768,5.48529e-06,136649893,0.975995
D.bocki,140010837,144784,1,768,5.48529e-06,136650661,0.976001
D.bocki,140010837,120885,1,768,5.48529e-06,136651429,0.976006
D.bocki,140010837,10929,1,768,5.48529e-06,136652197,0.976012
D.bocki,140010837,5476,1,767,5.47815e-06,136652964,0.976017
D.bocki,140010837,451746,1,767,5.47815e-06,136653731,0.976023
D.bocki,140010837,425653,1,767,5.47815e-06,136654498,0.976028
D.bocki,140010837,360255,1,767,5.47815e-06,136655265,0.976033
D.bocki,140010837,354011,1,767,5.47815e-06,136656032,0.976039
D.bocki,140010837,345344,1,767,5.47815e-06,136656799,0.976044
D.bocki,140010837,335589,1,767,5.47815e-06,136657566,0.97605
D.bocki,140010837,331495,1,767,5.47815e-06,136658333,0.976055
D.bocki,140010837,323148,1,767,5.47815e-06,136659100,0.976061
D.bocki,140010837,281277,1,767,5.47815e-06,136659867,0.976066
D.bocki,140010837,271662,1,767,5.47815e-06,136660634,0.976072
D.bocki,140010837,241262,1,767,5.47815e-06,136661401,0.976077
D.bocki,140010837,211854,1,767,5.47815e-06,136662168,0.976083
D.bocki,140010837,113501,1,767,5.47815e-06,136662935,0.976088
D.bocki,140010837,105674,1,767,5.47815e-06,136663702,0.976094
D.bocki,140010837,94408,1,766,5.47101e-06,136664468,0.976099
D.bocki,140010837,94407,1,766,5.47101e-06,136665234,0.976105
D.bocki,140010837,72848,1,766,5.47101e-06,136666000,0.97611
D.bocki,140010837,453754,1,766,5.47101e-06,136666766,0.976116
D.bocki,140010837,407740,1,766,5.47101e-06,136667532,0.976121
D.bocki,140010837,253917,1,766,5.47101e-06,136668298,0.976127
D.bocki,140010837,22195,1,766,5.47101e-06,136669064,0.976132
D.bocki,140010837,186264,1,766,5.47101e-06,136669830,0.976138
D.bocki,140010837,169522,1,766,5.47101e-06,136670596,0.976143
D.bocki,140010837,140981,1,766,5.47101e-06,136671362,0.976148
D.bocki,140010837,140506,1,766,5.47101e-06,136672128,0.976154
D.bocki,140010837,432432,1,765,5.46386e-06,136672893,0.976159
D.bocki,140010837,35076,1,765,5.46386e-06,136673658,0.976165
D.bocki,140010837,250008,1,765,5.46386e-06,136674423,0.97617
D.bocki,140010837,230503,1,765,5.46386e-06,136675188,0.976176
D.bocki,140010837,200023,1,765,5.46386e-06,136675953,0.976181
D.bocki,140010837,192503,1,765,5.46386e-06,136676718,0.976187
D.bocki,140010837,112434,1,765,5.46386e-06,136677483,0.976192
D.bocki,140010837,106321,1,765,5.46386e-06,136678248,0.976198
D.bocki,140010837,9977,1,764,5.45672e-06,136679012,0.976203
D.bocki,140010837,96933,1,764,5.45672e-06,136679776,0.976209
D.bocki,140010837,377325,1,764,5.45672e-06,136680540,0.976214
D.bocki,140010837,335487,1,764,5.45672e-06,136681304,0.976219
D.bocki,140010837,321735,1,764,5.45672e-06,136682068,0.976225
D.bocki,140010837,279247,1,764,5.45672e-06,136682832,0.97623
D.bocki,140010837,234191,1,764,5.45672e-06,136683596,0.976236
D.bocki,140010837,213043,1,764,5.45672e-06,136684360,0.976241
D.bocki,140010837,184206,1,764,5.45672e-06,136685124,0.976247
D.bocki,140010837,168486,1,764,5.45672e-06,136685888,0.976252
D.bocki,140010837,149269,1,764,5.45672e-06,136686652,0.976258
D.bocki,140010837,118,1,764,5.45672e-06,136687416,0.976263
D.bocki,140010837,91691,1,763,5.44958e-06,136688179,0.976269
D.bocki,140010837,68111,1,763,5.44958e-06,136688942,0.976274
D.bocki,140010837,454367,1,763,5.44958e-06,136689705,0.976279
D.bocki,140010837,345518,1,763,5.44958e-06,136690468,0.976285
D.bocki,140010837,25356,1,763,5.44958e-06,136691231,0.97629
D.bocki,140010837,175966,1,763,5.44958e-06,136691994,0.976296
D.bocki,140010837,16707,1,763,5.44958e-06,136692757,0.976301
D.bocki,140010837,14903,1,763,5.44958e-06,136693520,0.976307
D.bocki,140010837,120264,1,763,5.44958e-06,136694283,0.976312
D.bocki,140010837,74718,1,762,5.44244e-06,136695045,0.976318
D.bocki,140010837,5932,1,762,5.44244e-06,136695807,0.976323
D.bocki,140010837,453473,1,762,5.44244e-06,136696569,0.976328
D.bocki,140010837,448528,1,762,5.44244e-06,136697331,0.976334
D.bocki,140010837,431503,1,762,5.44244e-06,136698093,0.976339
D.bocki,140010837,352005,1,762,5.44244e-06,136698855,0.976345
D.bocki,140010837,301322,1,762,5.44244e-06,136699617,0.97635
D.bocki,140010837,283363,1,762,5.44244e-06,136700379,0.976356
D.bocki,140010837,233443,1,762,5.44244e-06,136701141,0.976361
D.bocki,140010837,165852,1,762,5.44244e-06,136701903,0.976367
D.bocki,140010837,163643,1,762,5.44244e-06,136702665,0.976372
D.bocki,140010837,133367,1,762,5.44244e-06,136703427,0.976377
D.bocki,140010837,122364,1,762,5.44244e-06,136704189,0.976383
D.bocki,140010837,118830,1,762,5.44244e-06,136704951,0.976388
D.bocki,140010837,99859,1,761,5.43529e-06,136705712,0.976394
D.bocki,140010837,53915,1,761,5.43529e-06,136706473,0.976399
D.bocki,140010837,5347,1,761,5.43529e-06,136707234,0.976405
D.bocki,140010837,452801,1,761,5.43529e-06,136707995,0.97641
D.bocki,140010837,437465,1,761,5.43529e-06,136708756,0.976416
D.bocki,140010837,426554,1,761,5.43529e-06,136709517,0.976421
D.bocki,140010837,395393,1,761,5.43529e-06,136710278,0.976426
D.bocki,140010837,348965,1,761,5.43529e-06,136711039,0.976432
D.bocki,140010837,327817,1,761,5.43529e-06,136711800,0.976437
D.bocki,140010837,309747,1,761,5.43529e-06,136712561,0.976443
D.bocki,140010837,285473,1,761,5.43529e-06,136713322,0.976448
D.bocki,140010837,135916,1,761,5.43529e-06,136714083,0.976454
D.bocki,140010837,454416,1,760,5.42815e-06,136714843,0.976459
D.bocki,140010837,423808,1,760,5.42815e-06,136715603,0.976464
D.bocki,140010837,37973,1,760,5.42815e-06,136716363,0.97647
D.bocki,140010837,370910,1,760,5.42815e-06,136717123,0.976475
D.bocki,140010837,358422,1,760,5.42815e-06,136717883,0.976481
D.bocki,140010837,358063,1,760,5.42815e-06,136718643,0.976486
D.bocki,140010837,306695,1,760,5.42815e-06,136719403,0.976492
D.bocki,140010837,302806,1,760,5.42815e-06,136720163,0.976497
D.bocki,140010837,283623,1,760,5.42815e-06,136720923,0.976502
D.bocki,140010837,252517,1,760,5.42815e-06,136721683,0.976508
D.bocki,140010837,212572,1,760,5.42815e-06,136722443,0.976513
D.bocki,140010837,117516,1,760,5.42815e-06,136723203,0.976519
D.bocki,140010837,103208,1,760,5.42815e-06,136723963,0.976524
D.bocki,140010837,7003,1,759,5.42101e-06,136724722,0.97653
D.bocki,140010837,454655,1,759,5.42101e-06,136725481,0.976535
D.bocki,140010837,454055,1,759,5.42101e-06,136726240,0.97654
D.bocki,140010837,450640,1,759,5.42101e-06,136726999,0.976546
D.bocki,140010837,39236,1,759,5.42101e-06,136727758,0.976551
D.bocki,140010837,296976,1,759,5.42101e-06,136728517,0.976557
D.bocki,140010837,290326,1,759,5.42101e-06,136729276,0.976562
D.bocki,140010837,280063,1,759,5.42101e-06,136730035,0.976568
D.bocki,140010837,26757,1,759,5.42101e-06,136730794,0.976573
D.bocki,140010837,196434,1,759,5.42101e-06,136731553,0.976578
D.bocki,140010837,120073,1,759,5.42101e-06,136732312,0.976584
D.bocki,140010837,352284,1,758,5.41387e-06,136733070,0.976589
D.bocki,140010837,350916,1,758,5.41387e-06,136733828,0.976595
D.bocki,140010837,350428,1,758,5.41387e-06,136734586,0.9766
D.bocki,140010837,286203,1,758,5.41387e-06,136735344,0.976605
D.bocki,140010837,27472,1,758,5.41387e-06,136736102,0.976611
D.bocki,140010837,231699,1,758,5.41387e-06,136736860,0.976616
D.bocki,140010837,225722,1,758,5.41387e-06,136737618,0.976622
D.bocki,140010837,203991,1,758,5.41387e-06,136738376,0.976627
D.bocki,140010837,20180,1,758,5.41387e-06,136739134,0.976633
D.bocki,140010837,168485,1,758,5.41387e-06,136739892,0.976638
D.bocki,140010837,86006,1,757,5.40672e-06,136740649,0.976643
D.bocki,140010837,84273,1,757,5.40672e-06,136741406,0.976649
D.bocki,140010837,56050,1,757,5.40672e-06,136742163,0.976654
D.bocki,140010837,450245,1,757,5.40672e-06,136742920,0.97666
D.bocki,140010837,290327,1,757,5.40672e-06,136743677,0.976665
D.bocki,140010837,265222,1,757,5.40672e-06,136744434,0.97667
D.bocki,140010837,213152,1,757,5.40672e-06,136745191,0.976676
D.bocki,140010837,156978,1,757,5.40672e-06,136745948,0.976681
D.bocki,140010837,124466,1,757,5.40672e-06,136746705,0.976687
D.bocki,140010837,89126,1,756,5.39958e-06,136747461,0.976692
D.bocki,140010837,69245,1,756,5.39958e-06,136748217,0.976697
D.bocki,140010837,55589,1,756,5.39958e-06,136748973,0.976703
D.bocki,140010837,45663,1,756,5.39958e-06,136749729,0.976708
D.bocki,140010837,373034,1,756,5.39958e-06,136750485,0.976714
D.bocki,140010837,366970,1,756,5.39958e-06,136751241,0.976719
D.bocki,140010837,294559,1,756,5.39958e-06,136751997,0.976724
D.bocki,140010837,269799,1,756,5.39958e-06,136752753,0.97673
D.bocki,140010837,206154,1,756,5.39958e-06,136753509,0.976735
D.bocki,140010837,200089,1,756,5.39958e-06,136754265,0.976741
D.bocki,140010837,138777,1,756,5.39958e-06,136755021,0.976746
D.bocki,140010837,125590,1,756,5.39958e-06,136755777,0.976751
D.bocki,140010837,69292,1,755,5.39244e-06,136756532,0.976757
D.bocki,140010837,443908,1,755,5.39244e-06,136757287,0.976762
D.bocki,140010837,425812,1,755,5.39244e-06,136758042,0.976768
D.bocki,140010837,400584,1,755,5.39244e-06,136758797,0.976773
D.bocki,140010837,385011,1,755,5.39244e-06,136759552,0.976778
D.bocki,140010837,256964,1,755,5.39244e-06,136760307,0.976784
D.bocki,140010837,184511,1,755,5.39244e-06,136761062,0.976789
D.bocki,140010837,172318,1,755,5.39244e-06,136761817,0.976795
D.bocki,140010837,168283,1,755,5.39244e-06,136762572,0.9768
D.bocki,140010837,145144,1,755,5.39244e-06,136763327,0.976805
D.bocki,140010837,131992,1,755,5.39244e-06,136764082,0.976811
D.bocki,140010837,103607,1,755,5.39244e-06,136764837,0.976816
D.bocki,140010837,57291,1,754,5.3853e-06,136765591,0.976821
D.bocki,140010837,454661,1,754,5.3853e-06,136766345,0.976827
D.bocki,140010837,451038,1,754,5.3853e-06,136767099,0.976832
D.bocki,140010837,415355,1,754,5.3853e-06,136767853,0.976838
D.bocki,140010837,397415,1,754,5.3853e-06,136768607,0.976843
D.bocki,140010837,387735,1,754,5.3853e-06,136769361,0.976848
D.bocki,140010837,355783,1,754,5.3853e-06,136770115,0.976854
D.bocki,140010837,340620,1,754,5.3853e-06,136770869,0.976859
D.bocki,140010837,316571,1,754,5.3853e-06,136771623,0.976865
D.bocki,140010837,30867,1,754,5.3853e-06,136772377,0.97687
D.bocki,140010837,286862,1,754,5.3853e-06,136773131,0.976875
D.bocki,140010837,279036,1,754,5.3853e-06,136773885,0.976881
D.bocki,140010837,214622,1,754,5.3853e-06,136774639,0.976886
D.bocki,140010837,192542,1,754,5.3853e-06,136775393,0.976891
D.bocki,140010837,109698,1,754,5.3853e-06,136776147,0.976897
D.bocki,140010837,88681,1,753,5.37816e-06,136776900,0.976902
D.bocki,140010837,430751,1,753,5.37816e-06,136777653,0.976908
D.bocki,140010837,369794,1,753,5.37816e-06,136778406,0.976913
D.bocki,140010837,332649,1,753,5.37816e-06,136779159,0.976918
D.bocki,140010837,310661,1,753,5.37816e-06,136779912,0.976924
D.bocki,140010837,282684,1,753,5.37816e-06,136780665,0.976929
D.bocki,140010837,261940,1,753,5.37816e-06,136781418,0.976935
D.bocki,140010837,260663,1,753,5.37816e-06,136782171,0.97694
D.bocki,140010837,54109,1,752,5.37101e-06,136782923,0.976945
D.bocki,140010837,442880,1,752,5.37101e-06,136783675,0.976951
D.bocki,140010837,427042,1,752,5.37101e-06,136784427,0.976956
D.bocki,140010837,418325,1,752,5.37101e-06,136785179,0.976961
D.bocki,140010837,361349,1,752,5.37101e-06,136785931,0.976967
D.bocki,140010837,327668,1,752,5.37101e-06,136786683,0.976972
D.bocki,140010837,32066,1,752,5.37101e-06,136787435,0.976977
D.bocki,140010837,316165,1,752,5.37101e-06,136788187,0.976983
D.bocki,140010837,150001,1,752,5.37101e-06,136788939,0.976988
D.bocki,140010837,81145,1,751,5.36387e-06,136789690,0.976994
D.bocki,140010837,79847,1,751,5.36387e-06,136790441,0.976999
D.bocki,140010837,79846,1,751,5.36387e-06,136791192,0.977004
D.bocki,140010837,73003,1,751,5.36387e-06,136791943,0.97701
D.bocki,140010837,70622,1,751,5.36387e-06,136792694,0.977015
D.bocki,140010837,452176,1,751,5.36387e-06,136793445,0.97702
D.bocki,140010837,437573,1,751,5.36387e-06,136794196,0.977026
D.bocki,140010837,372415,1,751,5.36387e-06,136794947,0.977031
D.bocki,140010837,344285,1,751,5.36387e-06,136795698,0.977036
D.bocki,140010837,332126,1,751,5.36387e-06,136796449,0.977042
D.bocki,140010837,311554,1,751,5.36387e-06,136797200,0.977047
D.bocki,140010837,269356,1,751,5.36387e-06,136797951,0.977053
D.bocki,140010837,247744,1,751,5.36387e-06,136798702,0.977058
D.bocki,140010837,232538,1,751,5.36387e-06,136799453,0.977063
D.bocki,140010837,20554,1,751,5.36387e-06,136800204,0.977069
D.bocki,140010837,187322,1,751,5.36387e-06,136800955,0.977074
D.bocki,140010837,143164,1,751,5.36387e-06,136801706,0.977079
D.bocki,140010837,14130,1,751,5.36387e-06,136802457,0.977085
D.bocki,140010837,13162,1,751,5.36387e-06,136803208,0.97709
D.bocki,140010837,124732,1,751,5.36387e-06,136803959,0.977096
D.bocki,140010837,115300,1,751,5.36387e-06,136804710,0.977101
D.bocki,140010837,9720,1,750,5.35673e-06,136805460,0.977106
D.bocki,140010837,9530,1,750,5.35673e-06,136806210,0.977112
D.bocki,140010837,7870,1,750,5.35673e-06,136806960,0.977117
D.bocki,140010837,64051,1,750,5.35673e-06,136807710,0.977122
D.bocki,140010837,57562,1,750,5.35673e-06,136808460,0.977128
D.bocki,140010837,55273,1,750,5.35673e-06,136809210,0.977133
D.bocki,140010837,398829,1,750,5.35673e-06,136809960,0.977138
D.bocki,140010837,375303,1,750,5.35673e-06,136810710,0.977144
D.bocki,140010837,353550,1,750,5.35673e-06,136811460,0.977149
D.bocki,140010837,329221,1,750,5.35673e-06,136812210,0.977154
D.bocki,140010837,327159,1,750,5.35673e-06,136812960,0.97716
D.bocki,140010837,279037,1,750,5.35673e-06,136813710,0.977165
D.bocki,140010837,254221,1,750,5.35673e-06,136814460,0.977171
D.bocki,140010837,190858,1,750,5.35673e-06,136815210,0.977176
D.bocki,140010837,151133,1,750,5.35673e-06,136815960,0.977181
D.bocki,140010837,146180,1,750,5.35673e-06,136816710,0.977187
D.bocki,140010837,130988,1,750,5.35673e-06,136817460,0.977192
D.bocki,140010837,453114,1,749,5.34959e-06,136818209,0.977197
D.bocki,140010837,421617,1,749,5.34959e-06,136818958,0.977203
D.bocki,140010837,417642,1,749,5.34959e-06,136819707,0.977208
D.bocki,140010837,361650,1,749,5.34959e-06,136820456,0.977213
D.bocki,140010837,356253,1,749,5.34959e-06,136821205,0.977219
D.bocki,140010837,344694,1,749,5.34959e-06,136821954,0.977224
D.bocki,140010837,327630,1,749,5.34959e-06,136822703,0.977229
D.bocki,140010837,302323,1,749,5.34959e-06,136823452,0.977235
D.bocki,140010837,210085,1,749,5.34959e-06,136824201,0.97724
D.bocki,140010837,195105,1,749,5.34959e-06,136824950,0.977245
D.bocki,140010837,135443,1,749,5.34959e-06,136825699,0.977251
D.bocki,140010837,71415,1,748,5.34244e-06,136826447,0.977256
D.bocki,140010837,398867,1,748,5.34244e-06,136827195,0.977261
D.bocki,140010837,308522,1,748,5.34244e-06,136827943,0.977267
D.bocki,140010837,261794,1,748,5.34244e-06,136828691,0.977272
D.bocki,140010837,203111,1,748,5.34244e-06,136829439,0.977277
D.bocki,140010837,94461,1,747,5.3353e-06,136830186,0.977283
D.bocki,140010837,55103,1,747,5.3353e-06,136830933,0.977288
D.bocki,140010837,454098,1,747,5.3353e-06,136831680,0.977293
D.bocki,140010837,417578,1,747,5.3353e-06,136832427,0.977299
D.bocki,140010837,385038,1,747,5.3353e-06,136833174,0.977304
D.bocki,140010837,377015,1,747,5.3353e-06,136833921,0.977309
D.bocki,140010837,341645,1,747,5.3353e-06,136834668,0.977315
D.bocki,140010837,314477,1,747,5.3353e-06,136835415,0.97732
D.bocki,140010837,210908,1,747,5.3353e-06,136836162,0.977326
D.bocki,140010837,152567,1,747,5.3353e-06,136836909,0.977331
D.bocki,140010837,81903,1,746,5.32816e-06,136837655,0.977336
D.bocki,140010837,68092,1,746,5.32816e-06,136838401,0.977341
D.bocki,140010837,65342,1,746,5.32816e-06,136839147,0.977347
D.bocki,140010837,451691,1,746,5.32816e-06,136839893,0.977352
D.bocki,140010837,417091,1,746,5.32816e-06,136840639,0.977357
D.bocki,140010837,357774,1,746,5.32816e-06,136841385,0.977363
D.bocki,140010837,333496,1,746,5.32816e-06,136842131,0.977368
D.bocki,140010837,27073,1,746,5.32816e-06,136842877,0.977373
D.bocki,140010837,234609,1,746,5.32816e-06,136843623,0.977379
D.bocki,140010837,210733,1,746,5.32816e-06,136844369,0.977384
D.bocki,140010837,15787,1,746,5.32816e-06,136845115,0.977389
D.bocki,140010837,112553,1,746,5.32816e-06,136845861,0.977395
D.bocki,140010837,427696,1,745,5.32102e-06,136846606,0.9774
D.bocki,140010837,401492,1,745,5.32102e-06,136847351,0.977405
D.bocki,140010837,270447,1,745,5.32102e-06,136848096,0.977411
D.bocki,140010837,245111,1,745,5.32102e-06,136848841,0.977416
D.bocki,140010837,213020,1,745,5.32102e-06,136849586,0.977421
D.bocki,140010837,207384,1,745,5.32102e-06,136850331,0.977427
D.bocki,140010837,194214,1,745,5.32102e-06,136851076,0.977432
D.bocki,140010837,162721,1,745,5.32102e-06,136851821,0.977437
D.bocki,140010837,144704,1,745,5.32102e-06,136852566,0.977443
D.bocki,140010837,138778,1,745,5.32102e-06,136853311,0.977448
D.bocki,140010837,131651,1,745,5.32102e-06,136854056,0.977453
D.bocki,140010837,322408,1,744,5.31387e-06,136854800,0.977459
D.bocki,140010837,311868,1,744,5.31387e-06,136855544,0.977464
D.bocki,140010837,283594,1,744,5.31387e-06,136856288,0.977469
D.bocki,140010837,155254,1,744,5.31387e-06,136857032,0.977475
D.bocki,140010837,83688,1,743,5.30673e-06,136857775,0.97748
D.bocki,140010837,59614,1,743,5.30673e-06,136858518,0.977485
D.bocki,140010837,44962,1,743,5.30673e-06,136859261,0.97749
D.bocki,140010837,373843,1,743,5.30673e-06,136860004,0.977496
D.bocki,140010837,335892,1,743,5.30673e-06,136860747,0.977501
D.bocki,140010837,31646,1,743,5.30673e-06,136861490,0.977506
D.bocki,140010837,312339,1,743,5.30673e-06,136862233,0.977512
D.bocki,140010837,27965,1,743,5.30673e-06,136862976,0.977517
D.bocki,140010837,279254,1,743,5.30673e-06,136863719,0.977522
D.bocki,140010837,274896,1,743,5.30673e-06,136864462,0.977528
D.bocki,140010837,237782,1,743,5.30673e-06,136865205,0.977533
D.bocki,140010837,197649,1,743,5.30673e-06,136865948,0.977538
D.bocki,140010837,153911,1,743,5.30673e-06,136866691,0.977544
D.bocki,140010837,123531,1,743,5.30673e-06,136867434,0.977549
D.bocki,140010837,114004,1,743,5.30673e-06,136868177,0.977554
D.bocki,140010837,7416,1,742,5.29959e-06,136868919,0.977559
D.bocki,140010837,453733,1,742,5.29959e-06,136869661,0.977565
D.bocki,140010837,425158,1,742,5.29959e-06,136870403,0.97757
D.bocki,140010837,406503,1,742,5.29959e-06,136871145,0.977575
D.bocki,140010837,390018,1,742,5.29959e-06,136871887,0.977581
D.bocki,140010837,383412,1,742,5.29959e-06,136872629,0.977586
D.bocki,140010837,375266,1,742,5.29959e-06,136873371,0.977591
D.bocki,140010837,358988,1,742,5.29959e-06,136874113,0.977597
D.bocki,140010837,19685,1,742,5.29959e-06,136874855,0.977602
D.bocki,140010837,157585,1,742,5.29959e-06,136875597,0.977607
D.bocki,140010837,127901,1,742,5.29959e-06,136876339,0.977612
D.bocki,140010837,95397,1,741,5.29245e-06,136877080,0.977618
D.bocki,140010837,67517,1,741,5.29245e-06,136877821,0.977623
D.bocki,140010837,427644,1,741,5.29245e-06,136878562,0.977628
D.bocki,140010837,424774,1,741,5.29245e-06,136879303,0.977634
D.bocki,140010837,399025,1,741,5.29245e-06,136880044,0.977639
D.bocki,140010837,381059,1,741,5.29245e-06,136880785,0.977644
D.bocki,140010837,352614,1,741,5.29245e-06,136881526,0.97765
D.bocki,140010837,316014,1,741,5.29245e-06,136882267,0.977655
D.bocki,140010837,226138,1,741,5.29245e-06,136883008,0.97766
D.bocki,140010837,207837,1,741,5.29245e-06,136883749,0.977665
D.bocki,140010837,154619,1,741,5.29245e-06,136884490,0.977671
D.bocki,140010837,143225,1,741,5.29245e-06,136885231,0.977676
D.bocki,140010837,97233,1,740,5.28531e-06,136885971,0.977681
D.bocki,140010837,82445,1,740,5.28531e-06,136886711,0.977687
D.bocki,140010837,437041,1,740,5.28531e-06,136887451,0.977692
D.bocki,140010837,436084,1,740,5.28531e-06,136888191,0.977697
D.bocki,140010837,433185,1,740,5.28531e-06,136888931,0.977702
D.bocki,140010837,375093,1,740,5.28531e-06,136889671,0.977708
D.bocki,140010837,281213,1,740,5.28531e-06,136890411,0.977713
D.bocki,140010837,273401,1,740,5.28531e-06,136891151,0.977718
D.bocki,140010837,205509,1,740,5.28531e-06,136891891,0.977724
D.bocki,140010837,168324,1,740,5.28531e-06,136892631,0.977729
D.bocki,140010837,96783,1,739,5.27816e-06,136893370,0.977734
D.bocki,140010837,84934,1,739,5.27816e-06,136894109,0.977739
D.bocki,140010837,54368,1,739,5.27816e-06,136894848,0.977745
D.bocki,140010837,451250,1,739,5.27816e-06,136895587,0.97775
D.bocki,140010837,434194,1,739,5.27816e-06,136896326,0.977755
D.bocki,140010837,411535,1,739,5.27816e-06,136897065,0.97776
D.bocki,140010837,387642,1,739,5.27816e-06,136897804,0.977766
D.bocki,140010837,387379,1,739,5.27816e-06,136898543,0.977771
D.bocki,140010837,319622,1,739,5.27816e-06,136899282,0.977776
D.bocki,140010837,277778,1,739,5.27816e-06,136900021,0.977782
D.bocki,140010837,26663,1,739,5.27816e-06,136900760,0.977787
D.bocki,140010837,252002,1,739,5.27816e-06,136901499,0.977792
D.bocki,140010837,21416,1,739,5.27816e-06,136902238,0.977797
D.bocki,140010837,190762,1,739,5.27816e-06,136902977,0.977803
D.bocki,140010837,144642,1,739,5.27816e-06,136903716,0.977808
D.bocki,140010837,137734,1,739,5.27816e-06,136904455,0.977813
D.bocki,140010837,93373,1,738,5.27102e-06,136905193,0.977819
D.bocki,140010837,453972,1,738,5.27102e-06,136905931,0.977824
D.bocki,140010837,452834,1,738,5.27102e-06,136906669,0.977829
D.bocki,140010837,408818,1,738,5.27102e-06,136907407,0.977834
D.bocki,140010837,357857,1,738,5.27102e-06,136908145,0.97784
D.bocki,140010837,331604,1,738,5.27102e-06,136908883,0.977845
D.bocki,140010837,298472,1,738,5.27102e-06,136909621,0.97785
D.bocki,140010837,277172,1,738,5.27102e-06,136910359,0.977855
D.bocki,140010837,245331,1,738,5.27102e-06,136911097,0.977861
D.bocki,140010837,106438,1,738,5.27102e-06,136911835,0.977866
D.bocki,140010837,73714,1,737,5.26388e-06,136912572,0.977871
D.bocki,140010837,7032,1,737,5.26388e-06,136913309,0.977877
D.bocki,140010837,69781,1,737,5.26388e-06,136914046,0.977882
D.bocki,140010837,69136,1,737,5.26388e-06,136914783,0.977887
D.bocki,140010837,56139,1,737,5.26388e-06,136915520,0.977892
D.bocki,140010837,49293,1,737,5.26388e-06,136916257,0.977898
D.bocki,140010837,451481,1,737,5.26388e-06,136916994,0.977903
D.bocki,140010837,434513,1,737,5.26388e-06,136917731,0.977908
D.bocki,140010837,412773,1,737,5.26388e-06,136918468,0.977913
D.bocki,140010837,405180,1,737,5.26388e-06,136919205,0.977919
D.bocki,140010837,401983,1,737,5.26388e-06,136919942,0.977924
D.bocki,140010837,321110,1,737,5.26388e-06,136920679,0.977929
D.bocki,140010837,296651,1,737,5.26388e-06,136921416,0.977934
D.bocki,140010837,247118,1,737,5.26388e-06,136922153,0.97794
D.bocki,140010837,185341,1,737,5.26388e-06,136922890,0.977945
D.bocki,140010837,166134,1,737,5.26388e-06,136923627,0.97795
D.bocki,140010837,164219,1,737,5.26388e-06,136924364,0.977955
D.bocki,140010837,162195,1,737,5.26388e-06,136925101,0.977961
D.bocki,140010837,141924,1,737,5.26388e-06,136925838,0.977966
D.bocki,140010837,587,1,736,5.25674e-06,136926574,0.977971
D.bocki,140010837,454382,1,736,5.25674e-06,136927310,0.977977
D.bocki,140010837,446011,1,736,5.25674e-06,136928046,0.977982
D.bocki,140010837,422784,1,736,5.25674e-06,136928782,0.977987
D.bocki,140010837,410795,1,736,5.25674e-06,136929518,0.977992
D.bocki,140010837,382922,1,736,5.25674e-06,136930254,0.977998
D.bocki,140010837,376674,1,736,5.25674e-06,136930990,0.978003
D.bocki,140010837,360770,1,736,5.25674e-06,136931726,0.978008
D.bocki,140010837,349784,1,736,5.25674e-06,136932462,0.978013
D.bocki,140010837,269393,1,736,5.25674e-06,136933198,0.978019
D.bocki,140010837,266432,1,736,5.25674e-06,136933934,0.978024
D.bocki,140010837,231400,1,736,5.25674e-06,136934670,0.978029
D.bocki,140010837,220872,1,736,5.25674e-06,136935406,0.978034
D.bocki,140010837,195623,1,736,5.25674e-06,136936142,0.97804
D.bocki,140010837,160191,1,736,5.25674e-06,136936878,0.978045
D.bocki,140010837,151843,1,736,5.25674e-06,136937614,0.97805
D.bocki,140010837,131520,1,736,5.25674e-06,136938350,0.978055
D.bocki,140010837,105206,1,736,5.25674e-06,136939086,0.978061
D.bocki,140010837,93596,1,735,5.24959e-06,136939821,0.978066
D.bocki,140010837,71688,1,735,5.24959e-06,136940556,0.978071
D.bocki,140010837,71465,1,735,5.24959e-06,136941291,0.978076
D.bocki,140010837,454524,1,735,5.24959e-06,136942026,0.978082
D.bocki,140010837,446406,1,735,5.24959e-06,136942761,0.978087
D.bocki,140010837,444357,1,735,5.24959e-06,136943496,0.978092
D.bocki,140010837,42589,1,735,5.24959e-06,136944231,0.978097
D.bocki,140010837,379252,1,735,5.24959e-06,136944966,0.978103
D.bocki,140010837,303267,1,735,5.24959e-06,136945701,0.978108
D.bocki,140010837,30319,1,735,5.24959e-06,136946436,0.978113
D.bocki,140010837,286670,1,735,5.24959e-06,136947171,0.978118
D.bocki,140010837,277381,1,735,5.24959e-06,136947906,0.978124
D.bocki,140010837,243829,1,735,5.24959e-06,136948641,0.978129
D.bocki,140010837,235489,1,735,5.24959e-06,136949376,0.978134
D.bocki,140010837,216947,1,735,5.24959e-06,136950111,0.978139
D.bocki,140010837,203988,1,735,5.24959e-06,136950846,0.978145
D.bocki,140010837,173961,1,735,5.24959e-06,136951581,0.97815
D.bocki,140010837,156032,1,735,5.24959e-06,136952316,0.978155
D.bocki,140010837,148042,1,735,5.24959e-06,136953051,0.97816
D.bocki,140010837,128244,1,735,5.24959e-06,136953786,0.978166
D.bocki,140010837,120072,1,735,5.24959e-06,136954521,0.978171
D.bocki,140010837,119582,1,735,5.24959e-06,136955256,0.978176
D.bocki,140010837,83579,1,734,5.24245e-06,136955990,0.978181
D.bocki,140010837,75884,1,734,5.24245e-06,136956724,0.978187
D.bocki,140010837,453689,1,734,5.24245e-06,136957458,0.978192
D.bocki,140010837,448171,1,734,5.24245e-06,136958192,0.978197
D.bocki,140010837,403682,1,734,5.24245e-06,136958926,0.978202
D.bocki,140010837,401132,1,734,5.24245e-06,136959660,0.978208
D.bocki,140010837,373212,1,734,5.24245e-06,136960394,0.978213
D.bocki,140010837,357750,1,734,5.24245e-06,136961128,0.978218
D.bocki,140010837,320539,1,734,5.24245e-06,136961862,0.978223
D.bocki,140010837,314995,1,734,5.24245e-06,136962596,0.978229
D.bocki,140010837,313017,1,734,5.24245e-06,136963330,0.978234
D.bocki,140010837,302199,1,734,5.24245e-06,136964064,0.978239
D.bocki,140010837,266384,1,734,5.24245e-06,136964798,0.978244
D.bocki,140010837,253152,1,734,5.24245e-06,136965532,0.97825
D.bocki,140010837,198818,1,734,5.24245e-06,136966266,0.978255
D.bocki,140010837,114857,1,734,5.24245e-06,136967000,0.97826
D.bocki,140010837,61260,1,733,5.23531e-06,136967733,0.978265
D.bocki,140010837,452299,1,733,5.23531e-06,136968466,0.97827
D.bocki,140010837,427521,1,733,5.23531e-06,136969199,0.978276
D.bocki,140010837,41588,1,733,5.23531e-06,136969932,0.978281
D.bocki,140010837,403532,1,733,5.23531e-06,136970665,0.978286
D.bocki,140010837,400922,1,733,5.23531e-06,136971398,0.978291
D.bocki,140010837,392012,1,733,5.23531e-06,136972131,0.978297
D.bocki,140010837,314959,1,733,5.23531e-06,136972864,0.978302
D.bocki,140010837,253636,1,733,5.23531e-06,136973597,0.978307
D.bocki,140010837,22773,1,733,5.23531e-06,136974330,0.978312
D.bocki,140010837,184543,1,733,5.23531e-06,136975063,0.978318
D.bocki,140010837,119131,1,733,5.23531e-06,136975796,0.978323
D.bocki,140010837,112739,1,733,5.23531e-06,136976529,0.978328
D.bocki,140010837,453824,1,732,5.22817e-06,136977261,0.978333
D.bocki,140010837,442046,1,732,5.22817e-06,136977993,0.978339
D.bocki,140010837,422031,1,732,5.22817e-06,136978725,0.978344
D.bocki,140010837,341238,1,732,5.22817e-06,136979457,0.978349
D.bocki,140010837,254309,1,732,5.22817e-06,136980189,0.978354
D.bocki,140010837,201902,1,732,5.22817e-06,136980921,0.978359
D.bocki,140010837,161070,1,732,5.22817e-06,136981653,0.978365
D.bocki,140010837,108891,1,732,5.22817e-06,136982385,0.97837
D.bocki,140010837,448565,1,731,5.22102e-06,136983116,0.978375
D.bocki,140010837,378517,1,731,5.22102e-06,136983847,0.97838
D.bocki,140010837,358888,1,731,5.22102e-06,136984578,0.978386
D.bocki,140010837,350995,1,731,5.22102e-06,136985309,0.978391
D.bocki,140010837,276007,1,731,5.22102e-06,136986040,0.978396
D.bocki,140010837,241705,1,731,5.22102e-06,136986771,0.978401
D.bocki,140010837,226008,1,731,5.22102e-06,136987502,0.978406
D.bocki,140010837,207864,1,731,5.22102e-06,136988233,0.978412
D.bocki,140010837,177449,1,731,5.22102e-06,136988964,0.978417
D.bocki,140010837,160635,1,731,5.22102e-06,136989695,0.978422
D.bocki,140010837,66250,1,730,5.21388e-06,136990425,0.978427
D.bocki,140010837,453926,1,730,5.21388e-06,136991155,0.978433
D.bocki,140010837,451304,1,730,5.21388e-06,136991885,0.978438
D.bocki,140010837,445051,1,730,5.21388e-06,136992615,0.978443
D.bocki,140010837,44362,1,730,5.21388e-06,136993345,0.978448
D.bocki,140010837,380466,1,730,5.21388e-06,136994075,0.978453
D.bocki,140010837,375734,1,730,5.21388e-06,136994805,0.978459
D.bocki,140010837,36279,1,730,5.21388e-06,136995535,0.978464
D.bocki,140010837,356991,1,730,5.21388e-06,136996265,0.978469
D.bocki,140010837,345072,1,730,5.21388e-06,136996995,0.978474
D.bocki,140010837,336983,1,730,5.21388e-06,136997725,0.978479
D.bocki,140010837,336666,1,730,5.21388e-06,136998455,0.978485
D.bocki,140010837,304066,1,730,5.21388e-06,136999185,0.97849
D.bocki,140010837,28387,1,730,5.21388e-06,136999915,0.978495
D.bocki,140010837,2692,1,730,5.21388e-06,137000645,0.9785
D.bocki,140010837,240654,1,730,5.21388e-06,137001375,0.978506
D.bocki,140010837,207028,1,730,5.21388e-06,137002105,0.978511
D.bocki,140010837,186921,1,730,5.21388e-06,137002835,0.978516
D.bocki,140010837,182777,1,730,5.21388e-06,137003565,0.978521
D.bocki,140010837,161721,1,730,5.21388e-06,137004295,0.978526
D.bocki,140010837,158253,1,730,5.21388e-06,137005025,0.978532
D.bocki,140010837,135187,1,730,5.21388e-06,137005755,0.978537
D.bocki,140010837,134917,1,730,5.21388e-06,137006485,0.978542
D.bocki,140010837,116262,1,730,5.21388e-06,137007215,0.978547
D.bocki,140010837,95176,1,729,5.20674e-06,137007944,0.978552
D.bocki,140010837,65056,1,729,5.20674e-06,137008673,0.978558
D.bocki,140010837,414372,1,729,5.20674e-06,137009402,0.978563
D.bocki,140010837,414010,1,729,5.20674e-06,137010131,0.978568
D.bocki,140010837,410913,1,729,5.20674e-06,137010860,0.978573
D.bocki,140010837,382921,1,729,5.20674e-06,137011589,0.978578
D.bocki,140010837,369158,1,729,5.20674e-06,137012318,0.978584
D.bocki,140010837,337508,1,729,5.20674e-06,137013047,0.978589
D.bocki,140010837,321354,1,729,5.20674e-06,137013776,0.978594
D.bocki,140010837,3172,1,729,5.20674e-06,137014505,0.978599
D.bocki,140010837,307370,1,729,5.20674e-06,137015234,0.978604
D.bocki,140010837,297475,1,729,5.20674e-06,137015963,0.97861
D.bocki,140010837,263684,1,729,5.20674e-06,137016692,0.978615
D.bocki,140010837,249382,1,729,5.20674e-06,137017421,0.97862
D.bocki,140010837,243236,1,729,5.20674e-06,137018150,0.978625
D.bocki,140010837,23169,1,729,5.20674e-06,137018879,0.978631
D.bocki,140010837,143838,1,729,5.20674e-06,137019608,0.978636
D.bocki,140010837,88268,1,728,5.1996e-06,137020336,0.978641
D.bocki,140010837,72484,1,728,5.1996e-06,137021064,0.978646
D.bocki,140010837,6133,1,728,5.1996e-06,137021792,0.978651
D.bocki,140010837,454158,1,728,5.1996e-06,137022520,0.978657
D.bocki,140010837,448353,1,728,5.1996e-06,137023248,0.978662
D.bocki,140010837,445177,1,728,5.1996e-06,137023976,0.978667
D.bocki,140010837,438993,1,728,5.1996e-06,137024704,0.978672
D.bocki,140010837,422755,1,728,5.1996e-06,137025432,0.978677
D.bocki,140010837,410327,1,728,5.1996e-06,137026160,0.978683
D.bocki,140010837,399024,1,728,5.1996e-06,137026888,0.978688
D.bocki,140010837,373799,1,728,5.1996e-06,137027616,0.978693
D.bocki,140010837,265853,1,728,5.1996e-06,137028344,0.978698
D.bocki,140010837,197479,1,728,5.1996e-06,137029072,0.978703
D.bocki,140010837,150169,1,728,5.1996e-06,137029800,0.978709
D.bocki,140010837,139094,1,728,5.1996e-06,137030528,0.978714
D.bocki,140010837,453126,1,727,5.19246e-06,137031255,0.978719
D.bocki,140010837,432159,1,727,5.19246e-06,137031982,0.978724
D.bocki,140010837,38002,1,727,5.19246e-06,137032709,0.978729
D.bocki,140010837,377589,1,727,5.19246e-06,137033436,0.978734
D.bocki,140010837,368688,1,727,5.19246e-06,137034163,0.97874
D.bocki,140010837,365644,1,727,5.19246e-06,137034890,0.978745
D.bocki,140010837,3577,1,727,5.19246e-06,137035617,0.97875
D.bocki,140010837,306768,1,727,5.19246e-06,137036344,0.978755
D.bocki,140010837,295539,1,727,5.19246e-06,137037071,0.97876
D.bocki,140010837,295431,1,727,5.19246e-06,137037798,0.978766
D.bocki,140010837,278076,1,727,5.19246e-06,137038525,0.978771
D.bocki,140010837,263462,1,727,5.19246e-06,137039252,0.978776
D.bocki,140010837,185186,1,727,5.19246e-06,137039979,0.978781
D.bocki,140010837,172711,1,727,5.19246e-06,137040706,0.978786
D.bocki,140010837,157992,1,727,5.19246e-06,137041433,0.978792
D.bocki,140010837,99947,1,726,5.18531e-06,137042159,0.978797
D.bocki,140010837,452806,1,726,5.18531e-06,137042885,0.978802
D.bocki,140010837,450119,1,726,5.18531e-06,137043611,0.978807
D.bocki,140010837,433720,1,726,5.18531e-06,137044337,0.978812
D.bocki,140010837,429160,1,726,5.18531e-06,137045063,0.978818
D.bocki,140010837,341866,1,726,5.18531e-06,137045789,0.978823
D.bocki,140010837,339355,1,726,5.18531e-06,137046515,0.978828
D.bocki,140010837,332203,1,726,5.18531e-06,137047241,0.978833
D.bocki,140010837,236066,1,726,5.18531e-06,137047967,0.978838
D.bocki,140010837,98582,1,725,5.17817e-06,137048692,0.978843
D.bocki,140010837,451382,1,725,5.17817e-06,137049417,0.978849
D.bocki,140010837,439420,1,725,5.17817e-06,137050142,0.978854
D.bocki,140010837,429948,1,725,5.17817e-06,137050867,0.978859
D.bocki,140010837,425618,1,725,5.17817e-06,137051592,0.978864
D.bocki,140010837,400823,1,725,5.17817e-06,137052317,0.978869
D.bocki,140010837,377346,1,725,5.17817e-06,137053042,0.978875
D.bocki,140010837,356252,1,725,5.17817e-06,137053767,0.97888
D.bocki,140010837,355420,1,725,5.17817e-06,137054492,0.978885
D.bocki,140010837,350369,1,725,5.17817e-06,137055217,0.97889
D.bocki,140010837,348994,1,725,5.17817e-06,137055942,0.978895
D.bocki,140010837,307540,1,725,5.17817e-06,137056667,0.9789
D.bocki,140010837,26159,1,725,5.17817e-06,137057392,0.978906
D.bocki,140010837,253346,1,725,5.17817e-06,137058117,0.978911
D.bocki,140010837,244820,1,725,5.17817e-06,137058842,0.978916
D.bocki,140010837,21289,1,725,5.17817e-06,137059567,0.978921
D.bocki,140010837,200330,1,725,5.17817e-06,137060292,0.978926
D.bocki,140010837,189940,1,725,5.17817e-06,137061017,0.978931
D.bocki,140010837,120411,1,725,5.17817e-06,137061742,0.978937
D.bocki,140010837,76714,1,724,5.17103e-06,137062466,0.978942
D.bocki,140010837,63126,1,724,5.17103e-06,137063190,0.978947
D.bocki,140010837,453688,1,724,5.17103e-06,137063914,0.978952
D.bocki,140010837,41245,1,724,5.17103e-06,137064638,0.978957
D.bocki,140010837,390929,1,724,5.17103e-06,137065362,0.978963
D.bocki,140010837,315758,1,724,5.17103e-06,137066086,0.978968
D.bocki,140010837,278389,1,724,5.17103e-06,137066810,0.978973
D.bocki,140010837,257908,1,724,5.17103e-06,137067534,0.978978
D.bocki,140010837,240341,1,724,5.17103e-06,137068258,0.978983
D.bocki,140010837,237960,1,724,5.17103e-06,137068982,0.978988
D.bocki,140010837,191543,1,724,5.17103e-06,137069706,0.978994
D.bocki,140010837,178218,1,724,5.17103e-06,137070430,0.978999
D.bocki,140010837,162682,1,724,5.17103e-06,137071154,0.979004
D.bocki,140010837,114420,1,724,5.17103e-06,137071878,0.979009
D.bocki,140010837,113280,1,724,5.17103e-06,137072602,0.979014
D.bocki,140010837,111401,1,724,5.17103e-06,137073326,0.979019
D.bocki,140010837,99364,1,723,5.16389e-06,137074049,0.979025
D.bocki,140010837,95263,1,723,5.16389e-06,137074772,0.97903
D.bocki,140010837,82992,1,723,5.16389e-06,137075495,0.979035
D.bocki,140010837,45980,1,723,5.16389e-06,137076218,0.97904
D.bocki,140010837,452286,1,723,5.16389e-06,137076941,0.979045
D.bocki,140010837,444720,1,723,5.16389e-06,137077664,0.97905
D.bocki,140010837,415667,1,723,5.16389e-06,137078387,0.979056
D.bocki,140010837,390079,1,723,5.16389e-06,137079110,0.979061
D.bocki,140010837,377777,1,723,5.16389e-06,137079833,0.979066
D.bocki,140010837,366136,1,723,5.16389e-06,137080556,0.979071
D.bocki,140010837,33906,1,723,5.16389e-06,137081279,0.979076
D.bocki,140010837,323753,1,723,5.16389e-06,137082002,0.979081
D.bocki,140010837,269798,1,723,5.16389e-06,137082725,0.979087
D.bocki,140010837,148286,1,723,5.16389e-06,137083448,0.979092
D.bocki,140010837,8841,1,722,5.15674e-06,137084170,0.979097
D.bocki,140010837,428545,1,722,5.15674e-06,137084892,0.979102
D.bocki,140010837,401047,1,722,5.15674e-06,137085614,0.979107
D.bocki,140010837,392417,1,722,5.15674e-06,137086336,0.979112
D.bocki,140010837,374147,1,722,5.15674e-06,137087058,0.979117
D.bocki,140010837,344573,1,722,5.15674e-06,137087780,0.979123
D.bocki,140010837,317916,1,722,5.15674e-06,137088502,0.979128
D.bocki,140010837,306938,1,722,5.15674e-06,137089224,0.979133
D.bocki,140010837,266185,1,722,5.15674e-06,137089946,0.979138
D.bocki,140010837,90281,1,721,5.1496e-06,137090667,0.979143
D.bocki,140010837,394394,1,721,5.1496e-06,137091388,0.979148
D.bocki,140010837,391365,1,721,5.1496e-06,137092109,0.979154
D.bocki,140010837,376770,1,721,5.1496e-06,137092830,0.979159
D.bocki,140010837,371343,1,721,5.1496e-06,137093551,0.979164
D.bocki,140010837,360898,1,721,5.1496e-06,137094272,0.979169
D.bocki,140010837,350769,1,721,5.1496e-06,137094993,0.979174
D.bocki,140010837,335301,1,721,5.1496e-06,137095714,0.979179
D.bocki,140010837,293598,1,721,5.1496e-06,137096435,0.979184
D.bocki,140010837,2828,1,721,5.1496e-06,137097156,0.97919
D.bocki,140010837,281729,1,721,5.1496e-06,137097877,0.979195
D.bocki,140010837,243342,1,721,5.1496e-06,137098598,0.9792
D.bocki,140010837,242137,1,721,5.1496e-06,137099319,0.979205
D.bocki,140010837,240717,1,721,5.1496e-06,137100040,0.97921
D.bocki,140010837,239520,1,721,5.1496e-06,137100761,0.979215
D.bocki,140010837,205312,1,721,5.1496e-06,137101482,0.979221
D.bocki,140010837,126911,1,721,5.1496e-06,137102203,0.979226
D.bocki,140010837,89607,1,720,5.14246e-06,137102923,0.979231
D.bocki,140010837,73354,1,720,5.14246e-06,137103643,0.979236
D.bocki,140010837,57262,1,720,5.14246e-06,137104363,0.979241
D.bocki,140010837,453833,1,720,5.14246e-06,137105083,0.979246
D.bocki,140010837,394864,1,720,5.14246e-06,137105803,0.979251
D.bocki,140010837,393040,1,720,5.14246e-06,137106523,0.979257
D.bocki,140010837,3812,1,720,5.14246e-06,137107243,0.979262
D.bocki,140010837,310944,1,720,5.14246e-06,137107963,0.979267
D.bocki,140010837,310599,1,720,5.14246e-06,137108683,0.979272
D.bocki,140010837,137528,1,720,5.14246e-06,137109403,0.979277
D.bocki,140010837,8760,1,719,5.13532e-06,137110122,0.979282
D.bocki,140010837,61405,1,719,5.13532e-06,137110841,0.979287
D.bocki,140010837,415780,1,719,5.13532e-06,137111560,0.979292
D.bocki,140010837,404286,1,719,5.13532e-06,137112279,0.979298
D.bocki,140010837,403501,1,719,5.13532e-06,137112998,0.979303
D.bocki,140010837,398614,1,719,5.13532e-06,137113717,0.979308
D.bocki,140010837,370863,1,719,5.13532e-06,137114436,0.979313
D.bocki,140010837,319787,1,719,5.13532e-06,137115155,0.979318
D.bocki,140010837,314748,1,719,5.13532e-06,137115874,0.979323
D.bocki,140010837,242237,1,719,5.13532e-06,137116593,0.979328
D.bocki,140010837,206734,1,719,5.13532e-06,137117312,0.979334
D.bocki,140010837,185187,1,719,5.13532e-06,137118031,0.979339
D.bocki,140010837,179793,1,719,5.13532e-06,137118750,0.979344
D.bocki,140010837,153559,1,719,5.13532e-06,137119469,0.979349
D.bocki,140010837,61657,1,718,5.12817e-06,137120187,0.979354
D.bocki,140010837,55792,1,718,5.12817e-06,137120905,0.979359
D.bocki,140010837,451643,1,718,5.12817e-06,137121623,0.979364
D.bocki,140010837,411534,1,718,5.12817e-06,137122341,0.979369
D.bocki,140010837,403315,1,718,5.12817e-06,137123059,0.979375
D.bocki,140010837,337065,1,718,5.12817e-06,137123777,0.97938
D.bocki,140010837,305255,1,718,5.12817e-06,137124495,0.979385
D.bocki,140010837,298233,1,718,5.12817e-06,137125213,0.97939
D.bocki,140010837,294321,1,718,5.12817e-06,137125931,0.979395
D.bocki,140010837,240501,1,718,5.12817e-06,137126649,0.9794
D.bocki,140010837,238815,1,718,5.12817e-06,137127367,0.979405
D.bocki,140010837,208704,1,718,5.12817e-06,137128085,0.979411
D.bocki,140010837,1618,1,718,5.12817e-06,137128803,0.979416
D.bocki,140010837,148315,1,718,5.12817e-06,137129521,0.979421
D.bocki,140010837,127703,1,718,5.12817e-06,137130239,0.979426
D.bocki,140010837,1132,1,718,5.12817e-06,137130957,0.979431
D.bocki,140010837,109881,1,718,5.12817e-06,137131675,0.979436
D.bocki,140010837,82036,1,717,5.12103e-06,137132392,0.979441
D.bocki,140010837,80659,1,717,5.12103e-06,137133109,0.979446
D.bocki,140010837,63963,1,717,5.12103e-06,137133826,0.979452
D.bocki,140010837,400621,1,717,5.12103e-06,137134543,0.979457
D.bocki,140010837,345386,1,717,5.12103e-06,137135260,0.979462
D.bocki,140010837,343359,1,717,5.12103e-06,137135977,0.979467
D.bocki,140010837,334299,1,717,5.12103e-06,137136694,0.979472
D.bocki,140010837,323962,1,717,5.12103e-06,137137411,0.979477
D.bocki,140010837,263207,1,717,5.12103e-06,137138128,0.979482
D.bocki,140010837,215874,1,717,5.12103e-06,137138845,0.979487
D.bocki,140010837,174388,1,717,5.12103e-06,137139562,0.979492
D.bocki,140010837,133979,1,717,5.12103e-06,137140279,0.979498
D.bocki,140010837,11632,1,717,5.12103e-06,137140996,0.979503
D.bocki,140010837,116178,1,717,5.12103e-06,137141713,0.979508
D.bocki,140010837,113442,1,717,5.12103e-06,137142430,0.979513
D.bocki,140010837,6235,1,716,5.11389e-06,137143146,0.979518
D.bocki,140010837,452473,1,716,5.11389e-06,137143862,0.979523
D.bocki,140010837,447047,1,716,5.11389e-06,137144578,0.979528
D.bocki,140010837,44359,1,716,5.11389e-06,137145294,0.979533
D.bocki,140010837,391101,1,716,5.11389e-06,137146010,0.979539
D.bocki,140010837,343593,1,716,5.11389e-06,137146726,0.979544
D.bocki,140010837,342143,1,716,5.11389e-06,137147442,0.979549
D.bocki,140010837,340291,1,716,5.11389e-06,137148158,0.979554
D.bocki,140010837,304662,1,716,5.11389e-06,137148874,0.979559
D.bocki,140010837,284774,1,716,5.11389e-06,137149590,0.979564
D.bocki,140010837,215550,1,716,5.11389e-06,137150306,0.979569
D.bocki,140010837,160150,1,716,5.11389e-06,137151022,0.979574
D.bocki,140010837,158409,1,716,5.11389e-06,137151738,0.979579
D.bocki,140010837,149943,1,716,5.11389e-06,137152454,0.979585
D.bocki,140010837,453985,1,715,5.10675e-06,137153169,0.97959
D.bocki,140010837,40571,1,715,5.10675e-06,137153884,0.979595
D.bocki,140010837,394319,1,715,5.10675e-06,137154599,0.9796
D.bocki,140010837,354631,1,715,5.10675e-06,137155314,0.979605
D.bocki,140010837,353768,1,715,5.10675e-06,137156029,0.97961
D.bocki,140010837,314038,1,715,5.10675e-06,137156744,0.979615
D.bocki,140010837,260421,1,715,5.10675e-06,137157459,0.97962
D.bocki,140010837,211988,1,715,5.10675e-06,137158174,0.979625
D.bocki,140010837,100050,1,715,5.10675e-06,137158889,0.979631
D.bocki,140010837,55033,1,714,5.09961e-06,137159603,0.979636
D.bocki,140010837,451685,1,714,5.09961e-06,137160317,0.979641
D.bocki,140010837,444432,1,714,5.09961e-06,137161031,0.979646
D.bocki,140010837,434115,1,714,5.09961e-06,137161745,0.979651
D.bocki,140010837,427900,1,714,5.09961e-06,137162459,0.979656
D.bocki,140010837,400693,1,714,5.09961e-06,137163173,0.979661
D.bocki,140010837,372089,1,714,5.09961e-06,137163887,0.979666
D.bocki,140010837,357603,1,714,5.09961e-06,137164601,0.979671
D.bocki,140010837,352,1,714,5.09961e-06,137165315,0.979676
D.bocki,140010837,336688,1,714,5.09961e-06,137166029,0.979682
D.bocki,140010837,31924,1,714,5.09961e-06,137166743,0.979687
D.bocki,140010837,174044,1,714,5.09961e-06,137167457,0.979692
D.bocki,140010837,140927,1,714,5.09961e-06,137168171,0.979697
D.bocki,140010837,115225,1,714,5.09961e-06,137168885,0.979702
D.bocki,140010837,10618,1,714,5.09961e-06,137169599,0.979707
D.bocki,140010837,100989,1,714,5.09961e-06,137170313,0.979712
D.bocki,140010837,90330,1,713,5.09246e-06,137171026,0.979717
D.bocki,140010837,89322,1,713,5.09246e-06,137171739,0.979722
D.bocki,140010837,76322,1,713,5.09246e-06,137172452,0.979727
D.bocki,140010837,56539,1,713,5.09246e-06,137173165,0.979732
D.bocki,140010837,444518,1,713,5.09246e-06,137173878,0.979738
D.bocki,140010837,427984,1,713,5.09246e-06,137174591,0.979743
D.bocki,140010837,414728,1,713,5.09246e-06,137175304,0.979748
D.bocki,140010837,262370,1,713,5.09246e-06,137176017,0.979753
D.bocki,140010837,252609,1,713,5.09246e-06,137176730,0.979758
D.bocki,140010837,247846,1,713,5.09246e-06,137177443,0.979763
D.bocki,140010837,195385,1,713,5.09246e-06,137178156,0.979768
D.bocki,140010837,191701,1,713,5.09246e-06,137178869,0.979773
D.bocki,140010837,149747,1,713,5.09246e-06,137179582,0.979778
D.bocki,140010837,147913,1,713,5.09246e-06,137180295,0.979783
D.bocki,140010837,139051,1,713,5.09246e-06,137181008,0.979789
D.bocki,140010837,122938,1,713,5.09246e-06,137181721,0.979794
D.bocki,140010837,62095,1,712,5.08532e-06,137182433,0.979799
D.bocki,140010837,61934,1,712,5.08532e-06,137183145,0.979804
D.bocki,140010837,51304,1,712,5.08532e-06,137183857,0.979809
D.bocki,140010837,41246,1,712,5.08532e-06,137184569,0.979814
D.bocki,140010837,406138,1,712,5.08532e-06,137185281,0.979819
D.bocki,140010837,399674,1,712,5.08532e-06,137185993,0.979824
D.bocki,140010837,345132,1,712,5.08532e-06,137186705,0.979829
D.bocki,140010837,330510,1,712,5.08532e-06,137187417,0.979834
D.bocki,140010837,330294,1,712,5.08532e-06,137188129,0.979839
D.bocki,140010837,29599,1,712,5.08532e-06,137188841,0.979844
D.bocki,140010837,21507,1,712,5.08532e-06,137189553,0.97985
D.bocki,140010837,185285,1,712,5.08532e-06,137190265,0.979855
D.bocki,140010837,125625,1,712,5.08532e-06,137190977,0.97986
D.bocki,140010837,68349,1,711,5.07818e-06,137191688,0.979865
D.bocki,140010837,439258,1,711,5.07818e-06,137192399,0.97987
D.bocki,140010837,372769,1,711,5.07818e-06,137193110,0.979875
D.bocki,140010837,355974,1,711,5.07818e-06,137193821,0.97988
D.bocki,140010837,276268,1,711,5.07818e-06,137194532,0.979885
D.bocki,140010837,269247,1,711,5.07818e-06,137195243,0.97989
D.bocki,140010837,257815,1,711,5.07818e-06,137195954,0.979895
D.bocki,140010837,254954,1,711,5.07818e-06,137196665,0.9799
D.bocki,140010837,223900,1,711,5.07818e-06,137197376,0.979905
D.bocki,140010837,210869,1,711,5.07818e-06,137198087,0.97991
D.bocki,140010837,19885,1,711,5.07818e-06,137198798,0.979916
D.bocki,140010837,123755,1,711,5.07818e-06,137199509,0.979921
D.bocki,140010837,110584,1,711,5.07818e-06,137200220,0.979926
D.bocki,140010837,93088,1,710,5.07104e-06,137200930,0.979931
D.bocki,140010837,64853,1,710,5.07104e-06,137201640,0.979936
D.bocki,140010837,357389,1,710,5.07104e-06,137202350,0.979941
D.bocki,140010837,35726,1,710,5.07104e-06,137203060,0.979946
D.bocki,140010837,343594,1,710,5.07104e-06,137203770,0.979951
D.bocki,140010837,343521,1,710,5.07104e-06,137204480,0.979956
D.bocki,140010837,243545,1,710,5.07104e-06,137205190,0.979961
D.bocki,140010837,105464,1,710,5.07104e-06,137205900,0.979966
D.bocki,140010837,97059,1,709,5.06389e-06,137206609,0.979971
D.bocki,140010837,454392,1,709,5.06389e-06,137207318,0.979976
D.bocki,140010837,449854,1,709,5.06389e-06,137208027,0.979981
D.bocki,140010837,441487,1,709,5.06389e-06,137208736,0.979987
D.bocki,140010837,439358,1,709,5.06389e-06,137209445,0.979992
D.bocki,140010837,399925,1,709,5.06389e-06,137210154,0.979997
D.bocki,140010837,395586,1,709,5.06389e-06,137210863,0.980002
D.bocki,140010837,334494,1,709,5.06389e-06,137211572,0.980007
D.bocki,140010837,324266,1,709,5.06389e-06,137212281,0.980012
D.bocki,140010837,281021,1,709,5.06389e-06,137212990,0.980017
D.bocki,140010837,274954,1,709,5.06389e-06,137213699,0.980022
D.bocki,140010837,193455,1,709,5.06389e-06,137214408,0.980027
D.bocki,140010837,186128,1,709,5.06389e-06,137215117,0.980032
D.bocki,140010837,171973,1,709,5.06389e-06,137215826,0.980037
D.bocki,140010837,448592,1,708,5.05675e-06,137216534,0.980042
D.bocki,140010837,420594,1,708,5.05675e-06,137217242,0.980047
D.bocki,140010837,414630,1,708,5.05675e-06,137217950,0.980052
D.bocki,140010837,336874,1,708,5.05675e-06,137218658,0.980057
D.bocki,140010837,302739,1,708,5.05675e-06,137219366,0.980062
D.bocki,140010837,227879,1,708,5.05675e-06,137220074,0.980068
D.bocki,140010837,206566,1,708,5.05675e-06,137220782,0.980073
D.bocki,140010837,19376,1,708,5.05675e-06,137221490,0.980078
D.bocki,140010837,168244,1,708,5.05675e-06,137222198,0.980083
D.bocki,140010837,133515,1,708,5.05675e-06,137222906,0.980088
D.bocki,140010837,113566,1,708,5.05675e-06,137223614,0.980093
D.bocki,140010837,59557,1,707,5.04961e-06,137224321,0.980098
D.bocki,140010837,427845,1,707,5.04961e-06,137225028,0.980103
D.bocki,140010837,425950,1,707,5.04961e-06,137225735,0.980108
D.bocki,140010837,423439,1,707,5.04961e-06,137226442,0.980113
D.bocki,140010837,406712,1,707,5.04961e-06,137227149,0.980118
D.bocki,140010837,339731,1,707,5.04961e-06,137227856,0.980123
D.bocki,140010837,310708,1,707,5.04961e-06,137228563,0.980128
D.bocki,140010837,309937,1,707,5.04961e-06,137229270,0.980133
D.bocki,140010837,298232,1,707,5.04961e-06,137229977,0.980138
D.bocki,140010837,270539,1,707,5.04961e-06,137230684,0.980143
D.bocki,140010837,200776,1,707,5.04961e-06,137231391,0.980148
D.bocki,140010837,183590,1,707,5.04961e-06,137232098,0.980153
D.bocki,140010837,181444,1,707,5.04961e-06,137232805,0.980158
D.bocki,140010837,150898,1,707,5.04961e-06,137233512,0.980163
D.bocki,140010837,135267,1,707,5.04961e-06,137234219,0.980169
D.bocki,140010837,117861,1,707,5.04961e-06,137234926,0.980174
D.bocki,140010837,77940,1,706,5.04247e-06,137235632,0.980179
D.bocki,140010837,67876,1,706,5.04247e-06,137236338,0.980184
D.bocki,140010837,454631,1,706,5.04247e-06,137237044,0.980189
D.bocki,140010837,451179,1,706,5.04247e-06,137237750,0.980194
D.bocki,140010837,405349,1,706,5.04247e-06,137238456,0.980199
D.bocki,140010837,395480,1,706,5.04247e-06,137239162,0.980204
D.bocki,140010837,379145,1,706,5.04247e-06,137239868,0.980209
D.bocki,140010837,32246,1,706,5.04247e-06,137240574,0.980214
D.bocki,140010837,292664,1,706,5.04247e-06,137241280,0.980219
D.bocki,140010837,244007,1,706,5.04247e-06,137241986,0.980224
D.bocki,140010837,232781,1,706,5.04247e-06,137242692,0.980229
D.bocki,140010837,184883,1,706,5.04247e-06,137243398,0.980234
D.bocki,140010837,139922,1,706,5.04247e-06,137244104,0.980239
D.bocki,140010837,134030,1,706,5.04247e-06,137244810,0.980244
D.bocki,140010837,125461,1,706,5.04247e-06,137245516,0.980249
D.bocki,140010837,46292,1,705,5.03532e-06,137246221,0.980254
D.bocki,140010837,452793,1,705,5.03532e-06,137246926,0.980259
D.bocki,140010837,414,1,705,5.03532e-06,137247631,0.980264
D.bocki,140010837,406630,1,705,5.03532e-06,137248336,0.980269
D.bocki,140010837,390733,1,705,5.03532e-06,137249041,0.980274
D.bocki,140010837,389646,1,705,5.03532e-06,137249746,0.980279
D.bocki,140010837,385982,1,705,5.03532e-06,137250451,0.980284
D.bocki,140010837,382313,1,705,5.03532e-06,137251156,0.98029
D.bocki,140010837,369221,1,705,5.03532e-06,137251861,0.980295
D.bocki,140010837,357332,1,705,5.03532e-06,137252566,0.9803
D.bocki,140010837,314996,1,705,5.03532e-06,137253271,0.980305
D.bocki,140010837,228175,1,705,5.03532e-06,137253976,0.98031
D.bocki,140010837,202665,1,705,5.03532e-06,137254681,0.980315
D.bocki,140010837,1956,1,705,5.03532e-06,137255386,0.98032
D.bocki,140010837,17520,1,705,5.03532e-06,137256091,0.980325
D.bocki,140010837,170993,1,705,5.03532e-06,137256796,0.98033
D.bocki,140010837,64092,1,704,5.02818e-06,137257500,0.980335
D.bocki,140010837,440364,1,704,5.02818e-06,137258204,0.98034
D.bocki,140010837,416564,1,704,5.02818e-06,137258908,0.980345
D.bocki,140010837,414727,1,704,5.02818e-06,137259612,0.98035
D.bocki,140010837,412936,1,704,5.02818e-06,137260316,0.980355
D.bocki,140010837,365566,1,704,5.02818e-06,137261020,0.98036
D.bocki,140010837,337066,1,704,5.02818e-06,137261724,0.980365
D.bocki,140010837,334426,1,704,5.02818e-06,137262428,0.98037
D.bocki,140010837,319662,1,704,5.02818e-06,137263132,0.980375
D.bocki,140010837,315176,1,704,5.02818e-06,137263836,0.98038
D.bocki,140010837,293290,1,704,5.02818e-06,137264540,0.980385
D.bocki,140010837,261419,1,704,5.02818e-06,137265244,0.98039
D.bocki,140010837,19686,1,704,5.02818e-06,137265948,0.980395
D.bocki,140010837,188487,1,704,5.02818e-06,137266652,0.9804
D.bocki,140010837,186349,1,704,5.02818e-06,137267356,0.980405
D.bocki,140010837,166133,1,704,5.02818e-06,137268060,0.98041
D.bocki,140010837,160228,1,704,5.02818e-06,137268764,0.980415
D.bocki,140010837,14162,1,704,5.02818e-06,137269468,0.98042
D.bocki,140010837,60388,1,703,5.02104e-06,137270171,0.980425
D.bocki,140010837,52824,1,703,5.02104e-06,137270874,0.98043
D.bocki,140010837,454191,1,703,5.02104e-06,137271577,0.980435
D.bocki,140010837,414952,1,703,5.02104e-06,137272280,0.98044
D.bocki,140010837,392785,1,703,5.02104e-06,137272983,0.980445
D.bocki,140010837,388404,1,703,5.02104e-06,137273686,0.98045
D.bocki,140010837,348755,1,703,5.02104e-06,137274389,0.980455
D.bocki,140010837,338556,1,703,5.02104e-06,137275092,0.98046
D.bocki,140010837,333630,1,703,5.02104e-06,137275795,0.980465
D.bocki,140010837,297945,1,703,5.02104e-06,137276498,0.980471
D.bocki,140010837,18331,1,703,5.02104e-06,137277201,0.980476
D.bocki,140010837,182943,1,703,5.02104e-06,137277904,0.980481
D.bocki,140010837,175925,1,703,5.02104e-06,137278607,0.980486
D.bocki,140010837,174847,1,703,5.02104e-06,137279310,0.980491
D.bocki,140010837,98027,1,702,5.0139e-06,137280012,0.980496
D.bocki,140010837,70461,1,702,5.0139e-06,137280714,0.980501
D.bocki,140010837,57057,1,702,5.0139e-06,137281416,0.980506
D.bocki,140010837,53959,1,702,5.0139e-06,137282118,0.980511
D.bocki,140010837,453801,1,702,5.0139e-06,137282820,0.980516
D.bocki,140010837,446867,1,702,5.0139e-06,137283522,0.980521
D.bocki,140010837,435742,1,702,5.0139e-06,137284224,0.980526
D.bocki,140010837,432822,1,702,5.0139e-06,137284926,0.980531
D.bocki,140010837,391864,1,702,5.0139e-06,137285628,0.980536
D.bocki,140010837,314650,1,702,5.0139e-06,137286330,0.980541
D.bocki,140010837,282774,1,702,5.0139e-06,137287032,0.980546
D.bocki,140010837,271061,1,702,5.0139e-06,137287734,0.980551
D.bocki,140010837,268787,1,702,5.0139e-06,137288436,0.980556
D.bocki,140010837,235139,1,702,5.0139e-06,137289138,0.980561
D.bocki,140010837,133778,1,702,5.0139e-06,137289840,0.980566
D.bocki,140010837,128535,1,702,5.0139e-06,137290542,0.980571
D.bocki,140010837,11948,1,702,5.0139e-06,137291244,0.980576
D.bocki,140010837,101083,1,702,5.0139e-06,137291946,0.980581
D.bocki,140010837,70442,1,701,5.00676e-06,137292647,0.980586
D.bocki,140010837,52097,1,701,5.00676e-06,137293348,0.980591
D.bocki,140010837,450921,1,701,5.00676e-06,137294049,0.980596
D.bocki,140010837,416453,1,701,5.00676e-06,137294750,0.980601
D.bocki,140010837,389601,1,701,5.00676e-06,137295451,0.980606
D.bocki,140010837,380190,1,701,5.00676e-06,137296152,0.980611
D.bocki,140010837,328888,1,701,5.00676e-06,137296853,0.980616
D.bocki,140010837,303434,1,701,5.00676e-06,137297554,0.980621
D.bocki,140010837,248085,1,701,5.00676e-06,137298255,0.980626
D.bocki,140010837,23276,1,701,5.00676e-06,137298956,0.980631
D.bocki,140010837,231913,1,701,5.00676e-06,137299657,0.980636
D.bocki,140010837,22631,1,701,5.00676e-06,137300358,0.980641
D.bocki,140010837,175420,1,701,5.00676e-06,137301059,0.980646
D.bocki,140010837,16644,1,701,5.00676e-06,137301760,0.980651
D.bocki,140010837,162588,1,701,5.00676e-06,137302461,0.980656
D.bocki,140010837,153947,1,701,5.00676e-06,137303162,0.980661
D.bocki,140010837,150245,1,701,5.00676e-06,137303863,0.980666
D.bocki,140010837,143360,1,701,5.00676e-06,137304564,0.980671
D.bocki,140010837,138447,1,701,5.00676e-06,137305265,0.980676
D.bocki,140010837,103513,1,701,5.00676e-06,137305966,0.980681
D.bocki,140010837,100259,1,701,5.00676e-06,137306667,0.980686
D.bocki,140010837,82035,1,700,4.99961e-06,137307367,0.980691
D.bocki,140010837,64760,1,700,4.99961e-06,137308067,0.980696
D.bocki,140010837,57260,1,700,4.99961e-06,137308767,0.980701
D.bocki,140010837,56476,1,700,4.99961e-06,137309467,0.980706
D.bocki,140010837,49789,1,700,4.99961e-06,137310167,0.980711
D.bocki,140010837,45661,1,700,4.99961e-06,137310867,0.980716
D.bocki,140010837,414317,1,700,4.99961e-06,137311567,0.980721
D.bocki,140010837,400824,1,700,4.99961e-06,137312267,0.980726
D.bocki,140010837,328043,1,700,4.99961e-06,137312967,0.980731
D.bocki,140010837,310410,1,700,4.99961e-06,137313667,0.980736
D.bocki,140010837,271687,1,700,4.99961e-06,137314367,0.980741
D.bocki,140010837,26564,1,700,4.99961e-06,137315067,0.980746
D.bocki,140010837,256292,1,700,4.99961e-06,137315767,0.980751
D.bocki,140010837,191249,1,700,4.99961e-06,137316467,0.980756
D.bocki,140010837,119583,1,700,4.99961e-06,137317167,0.980761
D.bocki,140010837,444517,1,699,4.99247e-06,137317866,0.980766
D.bocki,140010837,398956,1,699,4.99247e-06,137318565,0.980771
D.bocki,140010837,39511,1,699,4.99247e-06,137319264,0.980776
D.bocki,140010837,370117,1,699,4.99247e-06,137319963,0.980781
D.bocki,140010837,362291,1,699,4.99247e-06,137320662,0.980786
D.bocki,140010837,361467,1,699,4.99247e-06,137321361,0.980791
D.bocki,140010837,328482,1,699,4.99247e-06,137322060,0.980796
D.bocki,140010837,312551,1,699,4.99247e-06,137322759,0.980801
D.bocki,140010837,281870,1,699,4.99247e-06,137323458,0.980806
D.bocki,140010837,2371,1,699,4.99247e-06,137324157,0.980811
D.bocki,140010837,192225,1,699,4.99247e-06,137324856,0.980816
D.bocki,140010837,167229,1,699,4.99247e-06,137325555,0.980821
D.bocki,140010837,76159,1,698,4.98533e-06,137326253,0.980826
D.bocki,140010837,55274,1,698,4.98533e-06,137326951,0.980831
D.bocki,140010837,451915,1,698,4.98533e-06,137327649,0.980836
D.bocki,140010837,434719,1,698,4.98533e-06,137328347,0.980841
D.bocki,140010837,433361,1,698,4.98533e-06,137329045,0.980846
D.bocki,140010837,430361,1,698,4.98533e-06,137329743,0.980851
D.bocki,140010837,427873,1,698,4.98533e-06,137330441,0.980856
D.bocki,140010837,401351,1,698,4.98533e-06,137331139,0.980861
D.bocki,140010837,401195,1,698,4.98533e-06,137331837,0.980866
D.bocki,140010837,323717,1,698,4.98533e-06,137332535,0.980871
D.bocki,140010837,293560,1,698,4.98533e-06,137333233,0.980876
D.bocki,140010837,266759,1,698,4.98533e-06,137333931,0.980881
D.bocki,140010837,263997,1,698,4.98533e-06,137334629,0.980886
D.bocki,140010837,202583,1,698,4.98533e-06,137335327,0.980891
D.bocki,140010837,185967,1,698,4.98533e-06,137336025,0.980896
D.bocki,140010837,15054,1,698,4.98533e-06,137336723,0.980901
D.bocki,140010837,1418,1,698,4.98533e-06,137337421,0.980906
D.bocki,140010837,132055,1,698,4.98533e-06,137338119,0.980911
D.bocki,140010837,102785,1,698,4.98533e-06,137338817,0.980916
D.bocki,140010837,453699,1,697,4.97819e-06,137339514,0.980921
D.bocki,140010837,451099,1,697,4.97819e-06,137340211,0.980926
D.bocki,140010837,449595,1,697,4.97819e-06,137340908,0.980931
D.bocki,140010837,432646,1,697,4.97819e-06,137341605,0.980936
D.bocki,140010837,410953,1,697,4.97819e-06,137342302,0.980941
D.bocki,140010837,382985,1,697,4.97819e-06,137342999,0.980945
D.bocki,140010837,375631,1,697,4.97819e-06,137343696,0.98095
D.bocki,140010837,268788,1,697,4.97819e-06,137344393,0.980955
D.bocki,140010837,247878,1,697,4.97819e-06,137345090,0.98096
D.bocki,140010837,230082,1,697,4.97819e-06,137345787,0.980965
D.bocki,140010837,22630,1,697,4.97819e-06,137346484,0.98097
D.bocki,140010837,21901,1,697,4.97819e-06,137347181,0.980975
D.bocki,140010837,182913,1,697,4.97819e-06,137347878,0.98098
D.bocki,140010837,156687,1,697,4.97819e-06,137348575,0.980985
D.bocki,140010837,154815,1,697,4.97819e-06,137349272,0.98099
D.bocki,140010837,115037,1,697,4.97819e-06,137349969,0.980995
D.bocki,140010837,110538,1,697,4.97819e-06,137350666,0.981
D.bocki,140010837,428544,1,696,4.97104e-06,137351362,0.981005
D.bocki,140010837,36199,1,696,4.97104e-06,137352058,0.98101
D.bocki,140010837,339033,1,696,4.97104e-06,137352754,0.981015
D.bocki,140010837,330894,1,696,4.97104e-06,137353450,0.98102
D.bocki,140010837,311671,1,696,4.97104e-06,137354146,0.981025
D.bocki,140010837,284884,1,696,4.97104e-06,137354842,0.98103
D.bocki,140010837,262035,1,696,4.97104e-06,137355538,0.981035
D.bocki,140010837,216390,1,696,4.97104e-06,137356234,0.98104
D.bocki,140010837,214986,1,696,4.97104e-06,137356930,0.981045
D.bocki,140010837,201947,1,696,4.97104e-06,137357626,0.98105
D.bocki,140010837,172612,1,696,4.97104e-06,137358322,0.981055
D.bocki,140010837,160190,1,696,4.97104e-06,137359018,0.98106
D.bocki,140010837,134433,1,696,4.97104e-06,137359714,0.981065
D.bocki,140010837,122466,1,696,4.97104e-06,137360410,0.98107
D.bocki,140010837,11317,1,696,4.97104e-06,137361106,0.981075
D.bocki,140010837,59340,1,695,4.9639e-06,137361801,0.98108
D.bocki,140010837,55302,1,695,4.9639e-06,137362496,0.981085
D.bocki,140010837,452096,1,695,4.9639e-06,137363191,0.98109
D.bocki,140010837,382556,1,695,4.9639e-06,137363886,0.981095
D.bocki,140010837,323367,1,695,4.9639e-06,137364581,0.9811
D.bocki,140010837,29890,1,695,4.9639e-06,137365276,0.981105
D.bocki,140010837,282524,1,695,4.9639e-06,137365971,0.98111
D.bocki,140010837,280507,1,695,4.9639e-06,137366666,0.981115
D.bocki,140010837,273512,1,695,4.9639e-06,137367361,0.981119
D.bocki,140010837,27339,1,695,4.9639e-06,137368056,0.981124
D.bocki,140010837,270051,1,695,4.9639e-06,137368751,0.981129
D.bocki,140010837,211619,1,695,4.9639e-06,137369446,0.981134
D.bocki,140010837,200951,1,695,4.9639e-06,137370141,0.981139
D.bocki,140010837,17736,1,695,4.9639e-06,137370836,0.981144
D.bocki,140010837,101176,1,695,4.9639e-06,137371531,0.981149
D.bocki,140010837,80613,1,694,4.95676e-06,137372225,0.981154
D.bocki,140010837,79021,1,694,4.95676e-06,137372919,0.981159
D.bocki,140010837,61372,1,694,4.95676e-06,137373613,0.981164
D.bocki,140010837,57353,1,694,4.95676e-06,137374307,0.981169
D.bocki,140010837,53523,1,694,4.95676e-06,137375001,0.981174
D.bocki,140010837,47447,1,694,4.95676e-06,137375695,0.981179
D.bocki,140010837,438969,1,694,4.95676e-06,137376389,0.981184
D.bocki,140010837,428989,1,694,4.95676e-06,137377083,0.981189
D.bocki,140010837,392811,1,694,4.95676e-06,137377777,0.981194
D.bocki,140010837,384854,1,694,4.95676e-06,137378471,0.981199
D.bocki,140010837,379070,1,694,4.95676e-06,137379165,0.981204
D.bocki,140010837,377807,1,694,4.95676e-06,137379859,0.981209
D.bocki,140010837,319929,1,694,4.95676e-06,137380553,0.981214
D.bocki,140010837,319093,1,694,4.95676e-06,137381247,0.981219
D.bocki,140010837,303921,1,694,4.95676e-06,137381941,0.981224
D.bocki,140010837,299212,1,694,4.95676e-06,137382635,0.981229
D.bocki,140010837,271124,1,694,4.95676e-06,137383329,0.981234
D.bocki,140010837,267497,1,694,4.95676e-06,137384023,0.981238
D.bocki,140010837,109282,1,694,4.95676e-06,137384717,0.981243
D.bocki,140010837,449216,1,693,4.94962e-06,137385410,0.981248
D.bocki,140010837,448379,1,693,4.94962e-06,137386103,0.981253
D.bocki,140010837,40764,1,693,4.94962e-06,137386796,0.981258
D.bocki,140010837,395899,1,693,4.94962e-06,137387489,0.981263
D.bocki,140010837,380668,1,693,4.94962e-06,137388182,0.981268
D.bocki,140010837,327561,1,693,4.94962e-06,137388875,0.981273
D.bocki,140010837,311865,1,693,4.94962e-06,137389568,0.981278
D.bocki,140010837,29682,1,693,4.94962e-06,137390261,0.981283
D.bocki,140010837,262932,1,693,4.94962e-06,137390954,0.981288
D.bocki,140010837,260144,1,693,4.94962e-06,137391647,0.981293
D.bocki,140010837,228870,1,693,4.94962e-06,137392340,0.981298
D.bocki,140010837,202325,1,693,4.94962e-06,137393033,0.981303
D.bocki,140010837,162750,1,693,4.94962e-06,137393726,0.981308
D.bocki,140010837,151297,1,693,4.94962e-06,137394419,0.981313
D.bocki,140010837,136470,1,693,4.94962e-06,137395112,0.981318
D.bocki,140010837,71988,1,692,4.94247e-06,137395804,0.981323
D.bocki,140010837,6429,1,692,4.94247e-06,137396496,0.981328
D.bocki,140010837,61406,1,692,4.94247e-06,137397188,0.981333
D.bocki,140010837,452336,1,692,4.94247e-06,137397880,0.981337
D.bocki,140010837,451719,1,692,4.94247e-06,137398572,0.981342
D.bocki,140010837,450851,1,692,4.94247e-06,137399264,0.981347
D.bocki,140010837,444182,1,692,4.94247e-06,137399956,0.981352
D.bocki,140010837,438554,1,692,4.94247e-06,137400648,0.981357
D.bocki,140010837,406137,1,692,4.94247e-06,137401340,0.981362
D.bocki,140010837,390448,1,692,4.94247e-06,137402032,0.981367
D.bocki,140010837,383943,1,692,4.94247e-06,137402724,0.981372
D.bocki,140010837,313452,1,692,4.94247e-06,137403416,0.981377
D.bocki,140010837,298585,1,692,4.94247e-06,137404108,0.981382
D.bocki,140010837,285333,1,692,4.94247e-06,137404800,0.981387
D.bocki,140010837,272058,1,692,4.94247e-06,137405492,0.981392
D.bocki,140010837,247569,1,692,4.94247e-06,137406184,0.981397
D.bocki,140010837,24225,1,692,4.94247e-06,137406876,0.981402
D.bocki,140010837,210606,1,692,4.94247e-06,137407568,0.981407
D.bocki,140010837,177714,1,692,4.94247e-06,137408260,0.981412
D.bocki,140010837,169671,1,692,4.94247e-06,137408952,0.981417
D.bocki,140010837,87516,1,691,4.93533e-06,137409643,0.981421
D.bocki,140010837,78000,1,691,4.93533e-06,137410334,0.981426
D.bocki,140010837,453506,1,691,4.93533e-06,137411025,0.981431
D.bocki,140010837,434781,1,691,4.93533e-06,137411716,0.981436
D.bocki,140010837,344390,1,691,4.93533e-06,137412407,0.981441
D.bocki,140010837,245586,1,691,4.93533e-06,137413098,0.981446
D.bocki,140010837,202609,1,691,4.93533e-06,137413789,0.981451
D.bocki,140010837,125951,1,691,4.93533e-06,137414480,0.981456
D.bocki,140010837,95580,1,690,4.92819e-06,137415170,0.981461
D.bocki,140010837,9271,1,690,4.92819e-06,137415860,0.981466
D.bocki,140010837,74200,1,690,4.92819e-06,137416550,0.981471
D.bocki,140010837,71737,1,690,4.92819e-06,137417240,0.981476
D.bocki,140010837,452364,1,690,4.92819e-06,137417930,0.981481
D.bocki,140010837,450936,1,690,4.92819e-06,137418620,0.981486
D.bocki,140010837,448437,1,690,4.92819e-06,137419310,0.981491
D.bocki,140010837,446866,1,690,4.92819e-06,137420000,0.981495
D.bocki,140010837,438135,1,690,4.92819e-06,137420690,0.9815
D.bocki,140010837,358989,1,690,4.92819e-06,137421380,0.981505
D.bocki,140010837,357361,1,690,4.92819e-06,137422070,0.98151
D.bocki,140010837,31510,1,690,4.92819e-06,137422760,0.981515
D.bocki,140010837,259615,1,690,4.92819e-06,137423450,0.98152
D.bocki,140010837,23123,1,690,4.92819e-06,137424140,0.981525
D.bocki,140010837,215938,1,690,4.92819e-06,137424830,0.98153
D.bocki,140010837,202700,1,690,4.92819e-06,137425520,0.981535
D.bocki,140010837,188469,1,690,4.92819e-06,137426210,0.98154
D.bocki,140010837,173503,1,690,4.92819e-06,137426900,0.981545
D.bocki,140010837,164720,1,690,4.92819e-06,137427590,0.98155
D.bocki,140010837,154,1,690,4.92819e-06,137428280,0.981555
D.bocki,140010837,53203,1,689,4.92105e-06,137428969,0.98156
D.bocki,140010837,48212,1,689,4.92105e-06,137429658,0.981564
D.bocki,140010837,332292,1,689,4.92105e-06,137430347,0.981569
D.bocki,140010837,225745,1,689,4.92105e-06,137431036,0.981574
D.bocki,140010837,202758,1,689,4.92105e-06,137431725,0.981579
D.bocki,140010837,171070,1,689,4.92105e-06,137432414,0.981584
D.bocki,140010837,144039,1,689,4.92105e-06,137433103,0.981589
D.bocki,140010837,95260,1,688,4.91391e-06,137433791,0.981594
D.bocki,140010837,91248,1,688,4.91391e-06,137434479,0.981599
D.bocki,140010837,6961,1,688,4.91391e-06,137435167,0.981604
D.bocki,140010837,443256,1,688,4.91391e-06,137435855,0.981609
D.bocki,140010837,42035,1,688,4.91391e-06,137436543,0.981614
D.bocki,140010837,415256,1,688,4.91391e-06,137437231,0.981619
D.bocki,140010837,382239,1,688,4.91391e-06,137437919,0.981623
D.bocki,140010837,298295,1,688,4.91391e-06,137438607,0.981628
D.bocki,140010837,267311,1,688,4.91391e-06,137439295,0.981633
D.bocki,140010837,228174,1,688,4.91391e-06,137439983,0.981638
D.bocki,140010837,224705,1,688,4.91391e-06,137440671,0.981643
D.bocki,140010837,216877,1,688,4.91391e-06,137441359,0.981648
D.bocki,140010837,151650,1,688,4.91391e-06,137442047,0.981653
D.bocki,140010837,139050,1,688,4.91391e-06,137442735,0.981658
D.bocki,140010837,137708,1,688,4.91391e-06,137443423,0.981663
D.bocki,140010837,128536,1,688,4.91391e-06,137444111,0.981668
D.bocki,140010837,12340,1,688,4.91391e-06,137444799,0.981673
D.bocki,140010837,98789,1,687,4.90676e-06,137445486,0.981677
D.bocki,140010837,90733,1,687,4.90676e-06,137446173,0.981682
D.bocki,140010837,78750,1,687,4.90676e-06,137446860,0.981687
D.bocki,140010837,60790,1,687,4.90676e-06,137447547,0.981692
D.bocki,140010837,60589,1,687,4.90676e-06,137448234,0.981697
D.bocki,140010837,452144,1,687,4.90676e-06,137448921,0.981702
D.bocki,140010837,44799,1,687,4.90676e-06,137449608,0.981707
D.bocki,140010837,414510,1,687,4.90676e-06,137450295,0.981712
D.bocki,140010837,409220,1,687,4.90676e-06,137450982,0.981717
D.bocki,140010837,398895,1,687,4.90676e-06,137451669,0.981722
D.bocki,140010837,389365,1,687,4.90676e-06,137452356,0.981727
D.bocki,140010837,361756,1,687,4.90676e-06,137453043,0.981731
D.bocki,140010837,343021,1,687,4.90676e-06,137453730,0.981736
D.bocki,140010837,319973,1,687,4.90676e-06,137454417,0.981741
D.bocki,140010837,316042,1,687,4.90676e-06,137455104,0.981746
D.bocki,140010837,30096,1,687,4.90676e-06,137455791,0.981751
D.bocki,140010837,249684,1,687,4.90676e-06,137456478,0.981756
D.bocki,140010837,208313,1,687,4.90676e-06,137457165,0.981761
D.bocki,140010837,184936,1,687,4.90676e-06,137457852,0.981766
D.bocki,140010837,169239,1,687,4.90676e-06,137458539,0.981771
D.bocki,140010837,131808,1,687,4.90676e-06,137459226,0.981776
D.bocki,140010837,124068,1,687,4.90676e-06,137459913,0.981781
D.bocki,140010837,109421,1,687,4.90676e-06,137460600,0.981785
D.bocki,140010837,96048,1,686,4.89962e-06,137461286,0.98179
D.bocki,140010837,87123,1,686,4.89962e-06,137461972,0.981795
D.bocki,140010837,62741,1,686,4.89962e-06,137462658,0.9818
D.bocki,140010837,454790,1,686,4.89962e-06,137463344,0.981805
D.bocki,140010837,453752,1,686,4.89962e-06,137464030,0.98181
D.bocki,140010837,423993,1,686,4.89962e-06,137464716,0.981815
D.bocki,140010837,318174,1,686,4.89962e-06,137465402,0.98182
D.bocki,140010837,225068,1,686,4.89962e-06,137466088,0.981825
D.bocki,140010837,171118,1,686,4.89962e-06,137466774,0.98183
D.bocki,140010837,92433,1,685,4.89248e-06,137467459,0.981834
D.bocki,140010837,79328,1,685,4.89248e-06,137468144,0.981839
D.bocki,140010837,76806,1,685,4.89248e-06,137468829,0.981844
D.bocki,140010837,6899,1,685,4.89248e-06,137469514,0.981849
D.bocki,140010837,62463,1,685,4.89248e-06,137470199,0.981854
D.bocki,140010837,450689,1,685,4.89248e-06,137470884,0.981859
D.bocki,140010837,42749,1,685,4.89248e-06,137471569,0.981864
D.bocki,140010837,415319,1,685,4.89248e-06,137472254,0.981869
D.bocki,140010837,374292,1,685,4.89248e-06,137472939,0.981874
D.bocki,140010837,372734,1,685,4.89248e-06,137473624,0.981878
D.bocki,140010837,297767,1,685,4.89248e-06,137474309,0.981883
D.bocki,140010837,254246,1,685,4.89248e-06,137474994,0.981888
D.bocki,140010837,238736,1,685,4.89248e-06,137475679,0.981893
D.bocki,140010837,238605,1,685,4.89248e-06,137476364,0.981898
D.bocki,140010837,197435,1,685,4.89248e-06,137477049,0.981903
D.bocki,140010837,189688,1,685,4.89248e-06,137477734,0.981908
D.bocki,140010837,134004,1,685,4.89248e-06,137478419,0.981913
D.bocki,140010837,110399,1,685,4.89248e-06,137479104,0.981918
D.bocki,140010837,84123,1,684,4.88534e-06,137479788,0.981922
D.bocki,140010837,376907,1,684,4.88534e-06,137480472,0.981927
D.bocki,140010837,340686,1,684,4.88534e-06,137481156,0.981932
D.bocki,140010837,334671,1,684,4.88534e-06,137481840,0.981937
D.bocki,140010837,305730,1,684,4.88534e-06,137482524,0.981942
D.bocki,140010837,282894,1,684,4.88534e-06,137483208,0.981947
D.bocki,140010837,266099,1,684,4.88534e-06,137483892,0.981952
D.bocki,140010837,239404,1,684,4.88534e-06,137484576,0.981957
D.bocki,140010837,23627,1,684,4.88534e-06,137485260,0.981962
D.bocki,140010837,231778,1,684,4.88534e-06,137485944,0.981966
D.bocki,140010837,211003,1,684,4.88534e-06,137486628,0.981971
D.bocki,140010837,164407,1,684,4.88534e-06,137487312,0.981976
D.bocki,140010837,138921,1,684,4.88534e-06,137487996,0.981981
D.bocki,140010837,116388,1,684,4.88534e-06,137488680,0.981986
D.bocki,140010837,55246,1,683,4.87819e-06,137489363,0.981991
D.bocki,140010837,45075,1,683,4.87819e-06,137490046,0.981996
D.bocki,140010837,448836,1,683,4.87819e-06,137490729,0.982001
D.bocki,140010837,393341,1,683,4.87819e-06,137491412,0.982006
D.bocki,140010837,343592,1,683,4.87819e-06,137492095,0.98201
D.bocki,140010837,311061,1,683,4.87819e-06,137492778,0.982015
D.bocki,140010837,304283,1,683,4.87819e-06,137493461,0.98202
D.bocki,140010837,29305,1,683,4.87819e-06,137494144,0.982025
D.bocki,140010837,286116,1,683,4.87819e-06,137494827,0.98203
D.bocki,140010837,213123,1,683,4.87819e-06,137495510,0.982035
D.bocki,140010837,202417,1,683,4.87819e-06,137496193,0.98204
D.bocki,140010837,196499,1,683,4.87819e-06,137496876,0.982045
D.bocki,140010837,116150,1,683,4.87819e-06,137497559,0.982049
D.bocki,140010837,95583,1,682,4.87105e-06,137498241,0.982054
D.bocki,140010837,60006,1,682,4.87105e-06,137498923,0.982059
D.bocki,140010837,451825,1,682,4.87105e-06,137499605,0.982064
D.bocki,140010837,432431,1,682,4.87105e-06,137500287,0.982069
D.bocki,140010837,405673,1,682,4.87105e-06,137500969,0.982074
D.bocki,140010837,390461,1,682,4.87105e-06,137501651,0.982079
D.bocki,140010837,370973,1,682,4.87105e-06,137502333,0.982084
D.bocki,140010837,352853,1,682,4.87105e-06,137503015,0.982088
D.bocki,140010837,336350,1,682,4.87105e-06,137503697,0.982093
D.bocki,140010837,332162,1,682,4.87105e-06,137504379,0.982098
D.bocki,140010837,330988,1,682,4.87105e-06,137505061,0.982103
D.bocki,140010837,324066,1,682,4.87105e-06,137505743,0.982108
D.bocki,140010837,304661,1,682,4.87105e-06,137506425,0.982113
D.bocki,140010837,284677,1,682,4.87105e-06,137507107,0.982118
D.bocki,140010837,209487,1,682,4.87105e-06,137507789,0.982122
D.bocki,140010837,20555,1,682,4.87105e-06,137508471,0.982127
D.bocki,140010837,183189,1,682,4.87105e-06,137509153,0.982132
D.bocki,140010837,148955,1,682,4.87105e-06,137509835,0.982137
D.bocki,140010837,113140,1,682,4.87105e-06,137510517,0.982142
D.bocki,140010837,74346,1,681,4.86391e-06,137511198,0.982147
D.bocki,140010837,58916,1,681,4.86391e-06,137511879,0.982152
D.bocki,140010837,55517,1,681,4.86391e-06,137512560,0.982157
D.bocki,140010837,397944,1,681,4.86391e-06,137513241,0.982161
D.bocki,140010837,334194,1,681,4.86391e-06,137513922,0.982166
D.bocki,140010837,322762,1,681,4.86391e-06,137514603,0.982171
D.bocki,140010837,290738,1,681,4.86391e-06,137515284,0.982176
D.bocki,140010837,285256,1,681,4.86391e-06,137515965,0.982181
D.bocki,140010837,270959,1,681,4.86391e-06,137516646,0.982186
D.bocki,140010837,214894,1,681,4.86391e-06,137517327,0.982191
D.bocki,140010837,210118,1,681,4.86391e-06,137518008,0.982195
D.bocki,140010837,177139,1,681,4.86391e-06,137518689,0.9822
D.bocki,140010837,111669,1,681,4.86391e-06,137519370,0.982205
D.bocki,140010837,4946,1,680,4.85677e-06,137520050,0.98221
D.bocki,140010837,452261,1,680,4.85677e-06,137520730,0.982215
D.bocki,140010837,451630,1,680,4.85677e-06,137521410,0.98222
D.bocki,140010837,420561,1,680,4.85677e-06,137522090,0.982225
D.bocki,140010837,420267,1,680,4.85677e-06,137522770,0.982229
D.bocki,140010837,371865,1,680,4.85677e-06,137523450,0.982234
D.bocki,140010837,341351,1,680,4.85677e-06,137524130,0.982239
D.bocki,140010837,32355,1,680,4.85677e-06,137524810,0.982244
D.bocki,140010837,272182,1,680,4.85677e-06,137525490,0.982249
D.bocki,140010837,26563,1,680,4.85677e-06,137526170,0.982254
D.bocki,140010837,264181,1,680,4.85677e-06,137526850,0.982259
D.bocki,140010837,263554,1,680,4.85677e-06,137527530,0.982263
D.bocki,140010837,252742,1,680,4.85677e-06,137528210,0.982268
D.bocki,140010837,246803,1,680,4.85677e-06,137528890,0.982273
D.bocki,140010837,200159,1,680,4.85677e-06,137529570,0.982278
D.bocki,140010837,199132,1,680,4.85677e-06,137530250,0.982283
D.bocki,140010837,181253,1,680,4.85677e-06,137530930,0.982288
D.bocki,140010837,17949,1,680,4.85677e-06,137531610,0.982293
D.bocki,140010837,178653,1,680,4.85677e-06,137532290,0.982297
D.bocki,140010837,177863,1,680,4.85677e-06,137532970,0.982302
D.bocki,140010837,161441,1,680,4.85677e-06,137533650,0.982307
D.bocki,140010837,117224,1,680,4.85677e-06,137534330,0.982312
D.bocki,140010837,81105,1,679,4.84962e-06,137535009,0.982317
D.bocki,140010837,5614,1,679,4.84962e-06,137535688,0.982322
D.bocki,140010837,55954,1,679,4.84962e-06,137536367,0.982327
D.bocki,140010837,453321,1,679,4.84962e-06,137537046,0.982331
D.bocki,140010837,446405,1,679,4.84962e-06,137537725,0.982336
D.bocki,140010837,407453,1,679,4.84962e-06,137538404,0.982341
D.bocki,140010837,401863,1,679,4.84962e-06,137539083,0.982346
D.bocki,140010837,401584,1,679,4.84962e-06,137539762,0.982351
D.bocki,140010837,379754,1,679,4.84962e-06,137540441,0.982356
D.bocki,140010837,355841,1,679,4.84962e-06,137541120,0.982361
D.bocki,140010837,218953,1,679,4.84962e-06,137541799,0.982365
D.bocki,140010837,204579,1,679,4.84962e-06,137542478,0.98237
D.bocki,140010837,177480,1,679,4.84962e-06,137543157,0.982375
D.bocki,140010837,166381,1,679,4.84962e-06,137543836,0.98238
D.bocki,140010837,150219,1,679,4.84962e-06,137544515,0.982385
D.bocki,140010837,139463,1,679,4.84962e-06,137545194,0.98239
D.bocki,140010837,138874,1,679,4.84962e-06,137545873,0.982394
D.bocki,140010837,122240,1,679,4.84962e-06,137546552,0.982399
D.bocki,140010837,111408,1,679,4.84962e-06,137547231,0.982404
D.bocki,140010837,70821,1,678,4.84248e-06,137547909,0.982409
D.bocki,140010837,434969,1,678,4.84248e-06,137548587,0.982414
D.bocki,140010837,398465,1,678,4.84248e-06,137549265,0.982419
D.bocki,140010837,397846,1,678,4.84248e-06,137549943,0.982424
D.bocki,140010837,326711,1,678,4.84248e-06,137550621,0.982428
D.bocki,140010837,274141,1,678,4.84248e-06,137551299,0.982433
D.bocki,140010837,258496,1,678,4.84248e-06,137551977,0.982438
D.bocki,140010837,228116,1,678,4.84248e-06,137552655,0.982443
D.bocki,140010837,227199,1,678,4.84248e-06,137553333,0.982448
D.bocki,140010837,21603,1,678,4.84248e-06,137554011,0.982453
D.bocki,140010837,206211,1,678,4.84248e-06,137554689,0.982457
D.bocki,140010837,190613,1,678,4.84248e-06,137555367,0.982462
D.bocki,140010837,177832,1,678,4.84248e-06,137556045,0.982467
D.bocki,140010837,16145,1,678,4.84248e-06,137556723,0.982472
D.bocki,140010837,158322,1,678,4.84248e-06,137557401,0.982477
D.bocki,140010837,156242,1,678,4.84248e-06,137558079,0.982482
D.bocki,140010837,141431,1,678,4.84248e-06,137558757,0.982486
D.bocki,140010837,119796,1,678,4.84248e-06,137559435,0.982491
D.bocki,140010837,95613,1,677,4.83534e-06,137560112,0.982496
D.bocki,140010837,82991,1,677,4.83534e-06,137560789,0.982501
D.bocki,140010837,78934,1,677,4.83534e-06,137561466,0.982506
D.bocki,140010837,61880,1,677,4.83534e-06,137562143,0.982511
D.bocki,140010837,573,1,677,4.83534e-06,137562820,0.982516
D.bocki,140010837,452297,1,677,4.83534e-06,137563497,0.98252
D.bocki,140010837,426849,1,677,4.83534e-06,137564174,0.982525
D.bocki,140010837,422326,1,677,4.83534e-06,137564851,0.98253
D.bocki,140010837,300765,1,677,4.83534e-06,137565528,0.982535
D.bocki,140010837,266949,1,677,4.83534e-06,137566205,0.98254
D.bocki,140010837,155037,1,677,4.83534e-06,137566882,0.982545
D.bocki,140010837,152679,1,677,4.83534e-06,137567559,0.982549
D.bocki,140010837,142411,1,677,4.83534e-06,137568236,0.982554
D.bocki,140010837,101644,1,677,4.83534e-06,137568913,0.982559
D.bocki,140010837,90198,1,676,4.8282e-06,137569589,0.982564
D.bocki,140010837,442182,1,676,4.8282e-06,137570265,0.982569
D.bocki,140010837,423634,1,676,4.8282e-06,137570941,0.982574
D.bocki,140010837,402660,1,676,4.8282e-06,137571617,0.982578
D.bocki,140010837,395418,1,676,4.8282e-06,137572293,0.982583
D.bocki,140010837,343421,1,676,4.8282e-06,137572969,0.982588
D.bocki,140010837,312522,1,676,4.8282e-06,137573645,0.982593
D.bocki,140010837,289290,1,676,4.8282e-06,137574321,0.982598
D.bocki,140010837,288053,1,676,4.8282e-06,137574997,0.982602
D.bocki,140010837,275682,1,676,4.8282e-06,137575673,0.982607
D.bocki,140010837,251811,1,676,4.8282e-06,137576349,0.982612
D.bocki,140010837,239646,1,676,4.8282e-06,137577025,0.982617
D.bocki,140010837,232715,1,676,4.8282e-06,137577701,0.982622
D.bocki,140010837,231192,1,676,4.8282e-06,137578377,0.982627
D.bocki,140010837,223423,1,676,4.8282e-06,137579053,0.982631
D.bocki,140010837,155515,1,676,4.8282e-06,137579729,0.982636
D.bocki,140010837,115299,1,676,4.8282e-06,137580405,0.982641
D.bocki,140010837,110970,1,676,4.8282e-06,137581081,0.982646
D.bocki,140010837,102784,1,676,4.8282e-06,137581757,0.982651
D.bocki,140010837,62948,1,675,4.82106e-06,137582432,0.982656
D.bocki,140010837,439534,1,675,4.82106e-06,137583107,0.98266
D.bocki,140010837,35509,1,675,4.82106e-06,137583782,0.982665
D.bocki,140010837,354699,1,675,4.82106e-06,137584457,0.98267
D.bocki,140010837,336873,1,675,4.82106e-06,137585132,0.982675
D.bocki,140010837,32519,1,675,4.82106e-06,137585807,0.98268
D.bocki,140010837,316957,1,675,4.82106e-06,137586482,0.982685
D.bocki,140010837,303222,1,675,4.82106e-06,137587157,0.982689
D.bocki,140010837,283177,1,675,4.82106e-06,137587832,0.982694
D.bocki,140010837,270083,1,675,4.82106e-06,137588507,0.982699
D.bocki,140010837,225204,1,675,4.82106e-06,137589182,0.982704
D.bocki,140010837,200550,1,675,4.82106e-06,137589857,0.982709
D.bocki,140010837,167469,1,675,4.82106e-06,137590532,0.982713
D.bocki,140010837,156686,1,675,4.82106e-06,137591207,0.982718
D.bocki,140010837,153190,1,675,4.82106e-06,137591882,0.982723
D.bocki,140010837,132521,1,675,4.82106e-06,137592557,0.982728
D.bocki,140010837,125129,1,675,4.82106e-06,137593232,0.982733
D.bocki,140010837,123103,1,675,4.82106e-06,137593907,0.982738
D.bocki,140010837,12270,1,675,4.82106e-06,137594582,0.982742
D.bocki,140010837,90199,1,674,4.81391e-06,137595256,0.982747
D.bocki,140010837,57411,1,674,4.81391e-06,137595930,0.982752
D.bocki,140010837,454850,1,674,4.81391e-06,137596604,0.982757
D.bocki,140010837,433030,1,674,4.81391e-06,137597278,0.982762
D.bocki,140010837,410577,1,674,4.81391e-06,137597952,0.982766
D.bocki,140010837,379099,1,674,4.81391e-06,137598626,0.982771
D.bocki,140010837,287422,1,674,4.81391e-06,137599300,0.982776
D.bocki,140010837,274029,1,674,4.81391e-06,137599974,0.982781
D.bocki,140010837,255505,1,674,4.81391e-06,137600648,0.982786
D.bocki,140010837,24502,1,674,4.81391e-06,137601322,0.982791
D.bocki,140010837,170908,1,674,4.81391e-06,137601996,0.982795
D.bocki,140010837,166974,1,674,4.81391e-06,137602670,0.9828
D.bocki,140010837,163334,1,674,4.81391e-06,137603344,0.982805
D.bocki,140010837,111708,1,674,4.81391e-06,137604018,0.98281
D.bocki,140010837,81723,1,673,4.80677e-06,137604691,0.982815
D.bocki,140010837,81619,1,673,4.80677e-06,137605364,0.982819
D.bocki,140010837,454532,1,673,4.80677e-06,137606037,0.982824
D.bocki,140010837,441489,1,673,4.80677e-06,137606710,0.982829
D.bocki,140010837,379144,1,673,4.80677e-06,137607383,0.982834
D.bocki,140010837,333281,1,673,4.80677e-06,137608056,0.982839
D.bocki,140010837,332756,1,673,4.80677e-06,137608729,0.982843
D.bocki,140010837,283521,1,673,4.80677e-06,137609402,0.982848
D.bocki,140010837,265261,1,673,4.80677e-06,137610075,0.982853
D.bocki,140010837,212145,1,673,4.80677e-06,137610748,0.982858
D.bocki,140010837,179441,1,673,4.80677e-06,137611421,0.982863
D.bocki,140010837,98149,1,672,4.79963e-06,137612093,0.982867
D.bocki,140010837,454189,1,672,4.79963e-06,137612765,0.982872
D.bocki,140010837,442507,1,672,4.79963e-06,137613437,0.982877
D.bocki,140010837,427262,1,672,4.79963e-06,137614109,0.982882
D.bocki,140010837,406602,1,672,4.79963e-06,137614781,0.982887
D.bocki,140010837,361096,1,672,4.79963e-06,137615453,0.982891
D.bocki,140010837,356040,1,672,4.79963e-06,137616125,0.982896
D.bocki,140010837,316122,1,672,4.79963e-06,137616797,0.982901
D.bocki,140010837,288483,1,672,4.79963e-06,137617469,0.982906
D.bocki,140010837,241827,1,672,4.79963e-06,137618141,0.982911
D.bocki,140010837,175228,1,672,4.79963e-06,137618813,0.982915
D.bocki,140010837,175059,1,672,4.79963e-06,137619485,0.98292
D.bocki,140010837,161415,1,672,4.79963e-06,137620157,0.982925
D.bocki,140010837,125262,1,672,4.79963e-06,137620829,0.98293
D.bocki,140010837,9885,1,671,4.79249e-06,137621500,0.982935
D.bocki,140010837,96452,1,671,4.79249e-06,137622171,0.982939
D.bocki,140010837,86264,1,671,4.79249e-06,137622842,0.982944
D.bocki,140010837,81176,1,671,4.79249e-06,137623513,0.982949
D.bocki,140010837,76423,1,671,4.79249e-06,137624184,0.982954
D.bocki,140010837,436718,1,671,4.79249e-06,137624855,0.982959
D.bocki,140010837,366505,1,671,4.79249e-06,137625526,0.982963
D.bocki,140010837,34886,1,671,4.79249e-06,137626197,0.982968
D.bocki,140010837,341722,1,671,4.79249e-06,137626868,0.982973
D.bocki,140010837,32282,1,671,4.79249e-06,137627539,0.982978
D.bocki,140010837,25779,1,671,4.79249e-06,137628210,0.982983
D.bocki,140010837,248980,1,671,4.79249e-06,137628881,0.982987
D.bocki,140010837,243802,1,671,4.79249e-06,137629552,0.982992
D.bocki,140010837,22100,1,671,4.79249e-06,137630223,0.982997
D.bocki,140010837,208009,1,671,4.79249e-06,137630894,0.983002
D.bocki,140010837,203487,1,671,4.79249e-06,137631565,0.983007
D.bocki,140010837,82096,1,670,4.78534e-06,137632235,0.983011
D.bocki,140010837,452766,1,670,4.78534e-06,137632905,0.983016
D.bocki,140010837,425347,1,670,4.78534e-06,137633575,0.983021
D.bocki,140010837,424657,1,670,4.78534e-06,137634245,0.983026
D.bocki,140010837,398721,1,670,4.78534e-06,137634915,0.98303
D.bocki,140010837,390153,1,670,4.78534e-06,137635585,0.983035
D.bocki,140010837,358643,1,670,4.78534e-06,137636255,0.98304
D.bocki,140010837,353114,1,670,4.78534e-06,137636925,0.983045
D.bocki,140010837,292569,1,670,4.78534e-06,137637595,0.98305
D.bocki,140010837,286086,1,670,4.78534e-06,137638265,0.983054
D.bocki,140010837,282603,1,670,4.78534e-06,137638935,0.983059
D.bocki,140010837,262744,1,670,4.78534e-06,137639605,0.983064
D.bocki,140010837,255938,1,670,4.78534e-06,137640275,0.983069
D.bocki,140010837,226854,1,670,4.78534e-06,137640945,0.983074
D.bocki,140010837,216423,1,670,4.78534e-06,137641615,0.983078
D.bocki,140010837,213019,1,670,4.78534e-06,137642285,0.983083
D.bocki,140010837,126542,1,670,4.78534e-06,137642955,0.983088
D.bocki,140010837,99606,1,669,4.7782e-06,137643624,0.983093
D.bocki,140010837,42178,1,669,4.7782e-06,137644293,0.983097
D.bocki,140010837,412637,1,669,4.7782e-06,137644962,0.983102
D.bocki,140010837,378337,1,669,4.7782e-06,137645631,0.983107
D.bocki,140010837,365663,1,669,4.7782e-06,137646300,0.983112
D.bocki,140010837,363131,1,669,4.7782e-06,137646969,0.983117
D.bocki,140010837,349586,1,669,4.7782e-06,137647638,0.983121
D.bocki,140010837,347530,1,669,4.7782e-06,137648307,0.983126
D.bocki,140010837,307154,1,669,4.7782e-06,137648976,0.983131
D.bocki,140010837,227518,1,669,4.7782e-06,137649645,0.983136
D.bocki,140010837,206562,1,669,4.7782e-06,137650314,0.98314
D.bocki,140010837,159073,1,669,4.7782e-06,137650983,0.983145
D.bocki,140010837,156900,1,669,4.7782e-06,137651652,0.98315
D.bocki,140010837,137642,1,669,4.7782e-06,137652321,0.983155
D.bocki,140010837,121274,1,669,4.7782e-06,137652990,0.98316
D.bocki,140010837,92721,1,668,4.77106e-06,137653658,0.983164
D.bocki,140010837,64210,1,668,4.77106e-06,137654326,0.983169
D.bocki,140010837,5834,1,668,4.77106e-06,137654994,0.983174
D.bocki,140010837,453243,1,668,4.77106e-06,137655662,0.983179
D.bocki,140010837,446478,1,668,4.77106e-06,137656330,0.983183
D.bocki,140010837,389462,1,668,4.77106e-06,137656998,0.983188
D.bocki,140010837,372933,1,668,4.77106e-06,137657666,0.983193
D.bocki,140010837,35219,1,668,4.77106e-06,137658334,0.983198
D.bocki,140010837,290669,1,668,4.77106e-06,137659002,0.983202
D.bocki,140010837,282605,1,668,4.77106e-06,137659670,0.983207
D.bocki,140010837,281483,1,668,4.77106e-06,137660338,0.983212
D.bocki,140010837,266760,1,668,4.77106e-06,137661006,0.983217
D.bocki,140010837,230334,1,668,4.77106e-06,137661674,0.983222
D.bocki,140010837,227198,1,668,4.77106e-06,137662342,0.983226
D.bocki,140010837,220257,1,668,4.77106e-06,137663010,0.983231
D.bocki,140010837,198918,1,668,4.77106e-06,137663678,0.983236
D.bocki,140010837,108917,1,668,4.77106e-06,137664346,0.983241
D.bocki,140010837,98759,1,667,4.76392e-06,137665013,0.983245
D.bocki,140010837,82259,1,667,4.76392e-06,137665680,0.98325
D.bocki,140010837,7868,1,667,4.76392e-06,137666347,0.983255
D.bocki,140010837,73603,1,667,4.76392e-06,137667014,0.98326
D.bocki,140010837,48037,1,667,4.76392e-06,137667681,0.983264
D.bocki,140010837,453298,1,667,4.76392e-06,137668348,0.983269
D.bocki,140010837,372550,1,667,4.76392e-06,137669015,0.983274
D.bocki,140010837,369919,1,667,4.76392e-06,137669682,0.983279
D.bocki,140010837,350122,1,667,4.76392e-06,137670349,0.983284
D.bocki,140010837,339606,1,667,4.76392e-06,137671016,0.983288
D.bocki,140010837,293752,1,667,4.76392e-06,137671683,0.983293
D.bocki,140010837,276950,1,667,4.76392e-06,137672350,0.983298
D.bocki,140010837,265962,1,667,4.76392e-06,137673017,0.983303
D.bocki,140010837,210407,1,667,4.76392e-06,137673684,0.983307
D.bocki,140010837,210117,1,667,4.76392e-06,137674351,0.983312
D.bocki,140010837,20064,1,667,4.76392e-06,137675018,0.983317
D.bocki,140010837,17974,1,667,4.76392e-06,137675685,0.983322
D.bocki,140010837,172964,1,667,4.76392e-06,137676352,0.983326
D.bocki,140010837,170992,1,667,4.76392e-06,137677019,0.983331
D.bocki,140010837,164034,1,667,4.76392e-06,137677686,0.983336
D.bocki,140010837,159954,1,667,4.76392e-06,137678353,0.983341
D.bocki,140010837,127590,1,667,4.76392e-06,137679020,0.983345
D.bocki,140010837,86713,1,666,4.75677e-06,137679686,0.98335
D.bocki,140010837,85704,1,666,4.75677e-06,137680352,0.983355
D.bocki,140010837,453209,1,666,4.75677e-06,137681018,0.98336
D.bocki,140010837,453165,1,666,4.75677e-06,137681684,0.983364
D.bocki,140010837,430304,1,666,4.75677e-06,137682350,0.983369
D.bocki,140010837,411701,1,666,4.75677e-06,137683016,0.983374
D.bocki,140010837,399820,1,666,4.75677e-06,137683682,0.983379
D.bocki,140010837,385242,1,666,4.75677e-06,137684348,0.983384
D.bocki,140010837,377162,1,666,4.75677e-06,137685014,0.983388
D.bocki,140010837,310105,1,666,4.75677e-06,137685680,0.983393
D.bocki,140010837,302607,1,666,4.75677e-06,137686346,0.983398
D.bocki,140010837,290458,1,666,4.75677e-06,137687012,0.983403
D.bocki,140010837,289817,1,666,4.75677e-06,137687678,0.983407
D.bocki,140010837,28828,1,666,4.75677e-06,137688344,0.983412
D.bocki,140010837,285579,1,666,4.75677e-06,137689010,0.983417
D.bocki,140010837,266407,1,666,4.75677e-06,137689676,0.983422
D.bocki,140010837,262339,1,666,4.75677e-06,137690342,0.983426
D.bocki,140010837,252569,1,666,4.75677e-06,137691008,0.983431
D.bocki,140010837,22749,1,666,4.75677e-06,137691674,0.983436
D.bocki,140010837,184711,1,666,4.75677e-06,137692340,0.983441
D.bocki,140010837,175835,1,666,4.75677e-06,137693006,0.983445
D.bocki,140010837,152719,1,666,4.75677e-06,137693672,0.98345
D.bocki,140010837,150170,1,666,4.75677e-06,137694338,0.983455
D.bocki,140010837,142530,1,666,4.75677e-06,137695004,0.98346
D.bocki,140010837,115329,1,666,4.75677e-06,137695670,0.983464
D.bocki,140010837,66844,1,665,4.74963e-06,137696335,0.983469
D.bocki,140010837,451866,1,665,4.74963e-06,137697000,0.983474
D.bocki,140010837,443459,1,665,4.74963e-06,137697665,0.983479
D.bocki,140010837,436938,1,665,4.74963e-06,137698330,0.983483
D.bocki,140010837,43646,1,665,4.74963e-06,137698995,0.983488
D.bocki,140010837,382005,1,665,4.74963e-06,137699660,0.983493
D.bocki,140010837,345419,1,665,4.74963e-06,137700325,0.983498
D.bocki,140010837,318599,1,665,4.74963e-06,137700990,0.983502
D.bocki,140010837,309272,1,665,4.74963e-06,137701655,0.983507
D.bocki,140010837,309188,1,665,4.74963e-06,137702320,0.983512
D.bocki,140010837,295744,1,665,4.74963e-06,137702985,0.983517
D.bocki,140010837,259641,1,665,4.74963e-06,137703650,0.983521
D.bocki,140010837,233831,1,665,4.74963e-06,137704315,0.983526
D.bocki,140010837,227071,1,665,4.74963e-06,137704980,0.983531
D.bocki,140010837,193658,1,665,4.74963e-06,137705645,0.983536
D.bocki,140010837,179124,1,665,4.74963e-06,137706310,0.98354
D.bocki,140010837,176031,1,665,4.74963e-06,137706975,0.983545
D.bocki,140010837,155007,1,665,4.74963e-06,137707640,0.98355
D.bocki,140010837,101930,1,665,4.74963e-06,137708305,0.983555
D.bocki,140010837,46204,1,664,4.74249e-06,137708969,0.983559
D.bocki,140010837,44700,1,664,4.74249e-06,137709633,0.983564
D.bocki,140010837,382238,1,664,4.74249e-06,137710297,0.983569
D.bocki,140010837,352941,1,664,4.74249e-06,137710961,0.983574
D.bocki,140010837,331667,1,664,4.74249e-06,137711625,0.983578
D.bocki,140010837,323577,1,664,4.74249e-06,137712289,0.983583
D.bocki,140010837,292895,1,664,4.74249e-06,137712953,0.983588
D.bocki,140010837,290430,1,664,4.74249e-06,137713617,0.983593
D.bocki,140010837,223743,1,664,4.74249e-06,137714281,0.983597
D.bocki,140010837,22168,1,664,4.74249e-06,137714945,0.983602
D.bocki,140010837,206733,1,664,4.74249e-06,137715609,0.983607
D.bocki,140010837,199896,1,664,4.74249e-06,137716273,0.983612
D.bocki,140010837,199660,1,664,4.74249e-06,137716937,0.983616
D.bocki,140010837,190547,1,664,4.74249e-06,137717601,0.983621
D.bocki,140010837,167511,1,664,4.74249e-06,137718265,0.983626
D.bocki,140010837,139862,1,664,4.74249e-06,137718929,0.98363
D.bocki,140010837,91792,1,663,4.73535e-06,137719592,0.983635
D.bocki,140010837,61151,1,663,4.73535e-06,137720255,0.98364
D.bocki,140010837,449370,1,663,4.73535e-06,137720918,0.983645
D.bocki,140010837,449369,1,663,4.73535e-06,137721581,0.983649
D.bocki,140010837,444970,1,663,4.73535e-06,137722244,0.983654
D.bocki,140010837,433506,1,663,4.73535e-06,137722907,0.983659
D.bocki,140010837,41587,1,663,4.73535e-06,137723570,0.983664
D.bocki,140010837,401299,1,663,4.73535e-06,137724233,0.983668
D.bocki,140010837,349325,1,663,4.73535e-06,137724896,0.983673
D.bocki,140010837,288984,1,663,4.73535e-06,137725559,0.983678
D.bocki,140010837,271215,1,663,4.73535e-06,137726222,0.983683
D.bocki,140010837,230654,1,663,4.73535e-06,137726885,0.983687
D.bocki,140010837,183863,1,663,4.73535e-06,137727548,0.983692
D.bocki,140010837,16432,1,663,4.73535e-06,137728211,0.983697
D.bocki,140010837,158728,1,663,4.73535e-06,137728874,0.983702
D.bocki,140010837,139079,1,663,4.73535e-06,137729537,0.983706
D.bocki,140010837,123490,1,663,4.73535e-06,137730200,0.983711
D.bocki,140010837,108053,1,663,4.73535e-06,137730863,0.983716
D.bocki,140010837,78795,1,662,4.72821e-06,137731525,0.98372
D.bocki,140010837,75363,1,662,4.72821e-06,137732187,0.983725
D.bocki,140010837,46113,1,662,4.72821e-06,137732849,0.98373
D.bocki,140010837,443820,1,662,4.72821e-06,137733511,0.983735
D.bocki,140010837,433029,1,662,4.72821e-06,137734173,0.983739
D.bocki,140010837,414049,1,662,4.72821e-06,137734835,0.983744
D.bocki,140010837,392009,1,662,4.72821e-06,137735497,0.983749
D.bocki,140010837,355646,1,662,4.72821e-06,137736159,0.983754
D.bocki,140010837,354630,1,662,4.72821e-06,137736821,0.983758
D.bocki,140010837,31819,1,662,4.72821e-06,137737483,0.983763
D.bocki,140010837,306273,1,662,4.72821e-06,137738145,0.983768
D.bocki,140010837,28953,1,662,4.72821e-06,137738807,0.983772
D.bocki,140010837,283017,1,662,4.72821e-06,137739469,0.983777
D.bocki,140010837,256319,1,662,4.72821e-06,137740131,0.983782
D.bocki,140010837,150788,1,662,4.72821e-06,137740793,0.983787
D.bocki,140010837,138207,1,662,4.72821e-06,137741455,0.983791
D.bocki,140010837,116118,1,662,4.72821e-06,137742117,0.983796
D.bocki,140010837,82905,1,661,4.72106e-06,137742778,0.983801
D.bocki,140010837,55819,1,661,4.72106e-06,137743439,0.983806
D.bocki,140010837,450856,1,661,4.72106e-06,137744100,0.98381
D.bocki,140010837,445498,1,661,4.72106e-06,137744761,0.983815
D.bocki,140010837,437656,1,661,4.72106e-06,137745422,0.98382
D.bocki,140010837,434365,1,661,4.72106e-06,137746083,0.983824
D.bocki,140010837,402887,1,661,4.72106e-06,137746744,0.983829
D.bocki,140010837,361452,1,661,4.72106e-06,137747405,0.983834
D.bocki,140010837,349937,1,661,4.72106e-06,137748066,0.983839
D.bocki,140010837,309578,1,661,4.72106e-06,137748727,0.983843
D.bocki,140010837,253281,1,661,4.72106e-06,137749388,0.983848
D.bocki,140010837,236450,1,661,4.72106e-06,137750049,0.983853
D.bocki,140010837,188861,1,661,4.72106e-06,137750710,0.983857
D.bocki,140010837,142531,1,661,4.72106e-06,137751371,0.983862
D.bocki,140010837,137674,1,661,4.72106e-06,137752032,0.983867
D.bocki,140010837,134243,1,661,4.72106e-06,137752693,0.983872
D.bocki,140010837,126993,1,661,4.72106e-06,137753354,0.983876
D.bocki,140010837,117488,1,661,4.72106e-06,137754015,0.983881
D.bocki,140010837,108753,1,661,4.72106e-06,137754676,0.983886
D.bocki,140010837,454035,1,660,4.71392e-06,137755336,0.983891
D.bocki,140010837,44089,1,660,4.71392e-06,137755996,0.983895
D.bocki,140010837,423438,1,660,4.71392e-06,137756656,0.9839
D.bocki,140010837,417463,1,660,4.71392e-06,137757316,0.983905
D.bocki,140010837,356094,1,660,4.71392e-06,137757976,0.983909
D.bocki,140010837,296485,1,660,4.71392e-06,137758636,0.983914
D.bocki,140010837,286055,1,660,4.71392e-06,137759296,0.983919
D.bocki,140010837,280113,1,660,4.71392e-06,137759956,0.983924
D.bocki,140010837,278997,1,660,4.71392e-06,137760616,0.983928
D.bocki,140010837,246750,1,660,4.71392e-06,137761276,0.983933
D.bocki,140010837,232601,1,660,4.71392e-06,137761936,0.983938
D.bocki,140010837,221202,1,660,4.71392e-06,137762596,0.983942
D.bocki,140010837,178217,1,660,4.71392e-06,137763256,0.983947
D.bocki,140010837,148261,1,660,4.71392e-06,137763916,0.983952
D.bocki,140010837,451078,1,659,4.70678e-06,137764575,0.983957
D.bocki,140010837,444135,1,659,4.70678e-06,137765234,0.983961
D.bocki,140010837,422666,1,659,4.70678e-06,137765893,0.983966
D.bocki,140010837,394173,1,659,4.70678e-06,137766552,0.983971
D.bocki,140010837,378906,1,659,4.70678e-06,137767211,0.983975
D.bocki,140010837,324891,1,659,4.70678e-06,137767870,0.98398
D.bocki,140010837,281145,1,659,4.70678e-06,137768529,0.983985
D.bocki,140010837,258602,1,659,4.70678e-06,137769188,0.983989
D.bocki,140010837,256931,1,659,4.70678e-06,137769847,0.983994
D.bocki,140010837,243371,1,659,4.70678e-06,137770506,0.983999
D.bocki,140010837,207251,1,659,4.70678e-06,137771165,0.984004
D.bocki,140010837,191247,1,659,4.70678e-06,137771824,0.984008
D.bocki,140010837,165814,1,659,4.70678e-06,137772483,0.984013
D.bocki,140010837,428058,1,658,4.69964e-06,137773141,0.984018
D.bocki,140010837,38524,1,658,4.69964e-06,137773799,0.984022
D.bocki,140010837,353480,1,658,4.69964e-06,137774457,0.984027
D.bocki,140010837,311121,1,658,4.69964e-06,137775115,0.984032
D.bocki,140010837,306767,1,658,4.69964e-06,137775773,0.984036
D.bocki,140010837,303048,1,658,4.69964e-06,137776431,0.984041
D.bocki,140010837,23733,1,658,4.69964e-06,137777089,0.984046
D.bocki,140010837,232780,1,658,4.69964e-06,137777747,0.984051
D.bocki,140010837,21690,1,658,4.69964e-06,137778405,0.984055
D.bocki,140010837,204155,1,658,4.69964e-06,137779063,0.98406
D.bocki,140010837,18811,1,658,4.69964e-06,137779721,0.984065
D.bocki,140010837,178619,1,658,4.69964e-06,137780379,0.984069
D.bocki,140010837,151518,1,658,4.69964e-06,137781037,0.984074
D.bocki,140010837,135880,1,658,4.69964e-06,137781695,0.984079
D.bocki,140010837,10657,1,658,4.69964e-06,137782353,0.984083
D.bocki,140010837,101213,1,658,4.69964e-06,137783011,0.984088
D.bocki,140010837,9564,1,657,4.69249e-06,137783668,0.984093
D.bocki,140010837,66558,1,657,4.69249e-06,137784325,0.984098
D.bocki,140010837,60640,1,657,4.69249e-06,137784982,0.984102
D.bocki,140010837,52791,1,657,4.69249e-06,137785639,0.984107
D.bocki,140010837,441051,1,657,4.69249e-06,137786296,0.984112
D.bocki,140010837,436408,1,657,4.69249e-06,137786953,0.984116
D.bocki,140010837,409342,1,657,4.69249e-06,137787610,0.984121
D.bocki,140010837,390017,1,657,4.69249e-06,137788267,0.984126
D.bocki,140010837,375212,1,657,4.69249e-06,137788924,0.98413
D.bocki,140010837,361050,1,657,4.69249e-06,137789581,0.984135
D.bocki,140010837,355613,1,657,4.69249e-06,137790238,0.98414
D.bocki,140010837,351421,1,657,4.69249e-06,137790895,0.984144
D.bocki,140010837,308633,1,657,4.69249e-06,137791552,0.984149
D.bocki,140010837,226539,1,657,4.69249e-06,137792209,0.984154
D.bocki,140010837,225212,1,657,4.69249e-06,137792866,0.984159
D.bocki,140010837,193747,1,657,4.69249e-06,137793523,0.984163
D.bocki,140010837,178367,1,657,4.69249e-06,137794180,0.984168
D.bocki,140010837,160634,1,657,4.69249e-06,137794837,0.984173
D.bocki,140010837,12791,1,657,4.69249e-06,137795494,0.984177
D.bocki,140010837,105028,1,657,4.69249e-06,137796151,0.984182
D.bocki,140010837,83209,1,656,4.68535e-06,137796807,0.984187
D.bocki,140010837,80760,1,656,4.68535e-06,137797463,0.984191
D.bocki,140010837,57959,1,656,4.68535e-06,137798119,0.984196
D.bocki,140010837,397943,1,656,4.68535e-06,137798775,0.984201
D.bocki,140010837,296211,1,656,4.68535e-06,137799431,0.984205
D.bocki,140010837,176406,1,656,4.68535e-06,137800087,0.98421
D.bocki,140010837,153017,1,656,4.68535e-06,137800743,0.984215
D.bocki,140010837,114100,1,656,4.68535e-06,137801399,0.98422
D.bocki,140010837,111937,1,656,4.68535e-06,137802055,0.984224
D.bocki,140010837,91791,1,655,4.67821e-06,137802710,0.984229
D.bocki,140010837,84272,1,655,4.67821e-06,137803365,0.984234
D.bocki,140010837,75804,1,655,4.67821e-06,137804020,0.984238
D.bocki,140010837,74434,1,655,4.67821e-06,137804675,0.984243
D.bocki,140010837,450688,1,655,4.67821e-06,137805330,0.984248
D.bocki,140010837,437095,1,655,4.67821e-06,137805985,0.984252
D.bocki,140010837,41306,1,655,4.67821e-06,137806640,0.984257
D.bocki,140010837,389602,1,655,4.67821e-06,137807295,0.984262
D.bocki,140010837,368800,1,655,4.67821e-06,137807950,0.984266
D.bocki,140010837,362707,1,655,4.67821e-06,137808605,0.984271
D.bocki,140010837,357602,1,655,4.67821e-06,137809260,0.984276
D.bocki,140010837,333853,1,655,4.67821e-06,137809915,0.98428
D.bocki,140010837,327075,1,655,4.67821e-06,137810570,0.984285
D.bocki,140010837,319505,1,655,4.67821e-06,137811225,0.98429
D.bocki,140010837,308588,1,655,4.67821e-06,137811880,0.984294
D.bocki,140010837,211688,1,655,4.67821e-06,137812535,0.984299
D.bocki,140010837,210116,1,655,4.67821e-06,137813190,0.984304
D.bocki,140010837,18110,1,655,4.67821e-06,137813845,0.984308
D.bocki,140010837,176213,1,655,4.67821e-06,137814500,0.984313
D.bocki,140010837,147003,1,655,4.67821e-06,137815155,0.984318
D.bocki,140010837,12382,1,655,4.67821e-06,137815810,0.984322
D.bocki,140010837,90551,1,654,4.67107e-06,137816464,0.984327
D.bocki,140010837,395760,1,654,4.67107e-06,137817118,0.984332
D.bocki,140010837,395236,1,654,4.67107e-06,137817772,0.984336
D.bocki,140010837,389864,1,654,4.67107e-06,137818426,0.984341
D.bocki,140010837,358813,1,654,4.67107e-06,137819080,0.984346
D.bocki,140010837,310598,1,654,4.67107e-06,137819734,0.98435
D.bocki,140010837,304303,1,654,4.67107e-06,137820388,0.984355
D.bocki,140010837,299829,1,654,4.67107e-06,137821042,0.98436
D.bocki,140010837,291076,1,654,4.67107e-06,137821696,0.984364
D.bocki,140010837,288878,1,654,4.67107e-06,137822350,0.984369
D.bocki,140010837,287790,1,654,4.67107e-06,137823004,0.984374
D.bocki,140010837,265072,1,654,4.67107e-06,137823658,0.984379
D.bocki,140010837,262769,1,654,4.67107e-06,137824312,0.984383
D.bocki,140010837,262606,1,654,4.67107e-06,137824966,0.984388
D.bocki,140010837,18277,1,654,4.67107e-06,137825620,0.984393
D.bocki,140010837,175332,1,654,4.67107e-06,137826274,0.984397
D.bocki,140010837,172265,1,654,4.67107e-06,137826928,0.984402
D.bocki,140010837,16902,1,654,4.67107e-06,137827582,0.984407
D.bocki,140010837,166530,1,654,4.67107e-06,137828236,0.984411
D.bocki,140010837,162589,1,654,4.67107e-06,137828890,0.984416
D.bocki,140010837,73866,1,653,4.66392e-06,137829543,0.984421
D.bocki,140010837,43325,1,653,4.66392e-06,137830196,0.984425
D.bocki,140010837,416009,1,653,4.66392e-06,137830849,0.98443
D.bocki,140010837,387539,1,653,4.66392e-06,137831502,0.984435
D.bocki,140010837,333282,1,653,4.66392e-06,137832155,0.984439
D.bocki,140010837,30009,1,653,4.66392e-06,137832808,0.984444
D.bocki,140010837,294657,1,653,4.66392e-06,137833461,0.984449
D.bocki,140010837,264581,1,653,4.66392e-06,137834114,0.984453
D.bocki,140010837,262403,1,653,4.66392e-06,137834767,0.984458
D.bocki,140010837,240527,1,653,4.66392e-06,137835420,0.984463
D.bocki,140010837,210325,1,653,4.66392e-06,137836073,0.984467
D.bocki,140010837,206092,1,653,4.66392e-06,137836726,0.984472
D.bocki,140010837,189085,1,653,4.66392e-06,137837379,0.984477
D.bocki,140010837,143658,1,653,4.66392e-06,137838032,0.984481
D.bocki,140010837,136768,1,653,4.66392e-06,137838685,0.984486
D.bocki,140010837,111060,1,653,4.66392e-06,137839338,0.98449
D.bocki,140010837,70037,1,652,4.65678e-06,137839990,0.984495
D.bocki,140010837,68200,1,652,4.65678e-06,137840642,0.9845
D.bocki,140010837,53661,1,652,4.65678e-06,137841294,0.984504
D.bocki,140010837,453924,1,652,4.65678e-06,137841946,0.984509
D.bocki,140010837,453019,1,652,4.65678e-06,137842598,0.984514
D.bocki,140010837,4389,1,652,4.65678e-06,137843250,0.984518
D.bocki,140010837,426421,1,652,4.65678e-06,137843902,0.984523
D.bocki,140010837,404784,1,652,4.65678e-06,137844554,0.984528
D.bocki,140010837,371316,1,652,4.65678e-06,137845206,0.984532
D.bocki,140010837,36236,1,652,4.65678e-06,137845858,0.984537
D.bocki,140010837,362359,1,652,4.65678e-06,137846510,0.984542
D.bocki,140010837,334337,1,652,4.65678e-06,137847162,0.984546
D.bocki,140010837,319175,1,652,4.65678e-06,137847814,0.984551
D.bocki,140010837,286669,1,652,4.65678e-06,137848466,0.984556
D.bocki,140010837,211989,1,652,4.65678e-06,137849118,0.98456
D.bocki,140010837,193093,1,652,4.65678e-06,137849770,0.984565
D.bocki,140010837,188930,1,652,4.65678e-06,137850422,0.98457
D.bocki,140010837,171568,1,652,4.65678e-06,137851074,0.984574
D.bocki,140010837,156462,1,652,4.65678e-06,137851726,0.984579
D.bocki,140010837,127818,1,652,4.65678e-06,137852378,0.984584
D.bocki,140010837,79566,1,651,4.64964e-06,137853029,0.984588
D.bocki,140010837,454828,1,651,4.64964e-06,137853680,0.984593
D.bocki,140010837,439234,1,651,4.64964e-06,137854331,0.984598
D.bocki,140010837,416383,1,651,4.64964e-06,137854982,0.984602
D.bocki,140010837,413474,1,651,4.64964e-06,137855633,0.984607
D.bocki,140010837,409086,1,651,4.64964e-06,137856284,0.984612
D.bocki,140010837,392323,1,651,4.64964e-06,137856935,0.984616
D.bocki,140010837,340189,1,651,4.64964e-06,137857586,0.984621
D.bocki,140010837,336241,1,651,4.64964e-06,137858237,0.984625
D.bocki,140010837,263798,1,651,4.64964e-06,137858888,0.98463
D.bocki,140010837,247439,1,651,4.64964e-06,137859539,0.984635
D.bocki,140010837,236326,1,651,4.64964e-06,137860190,0.984639
D.bocki,140010837,234161,1,651,4.64964e-06,137860841,0.984644
D.bocki,140010837,17707,1,651,4.64964e-06,137861492,0.984649
D.bocki,140010837,172931,1,651,4.64964e-06,137862143,0.984653
D.bocki,140010837,170424,1,651,4.64964e-06,137862794,0.984658
D.bocki,140010837,169118,1,651,4.64964e-06,137863445,0.984663
D.bocki,140010837,16901,1,651,4.64964e-06,137864096,0.984667
D.bocki,140010837,166218,1,651,4.64964e-06,137864747,0.984672
D.bocki,140010837,153305,1,651,4.64964e-06,137865398,0.984677
D.bocki,140010837,141285,1,651,4.64964e-06,137866049,0.984681
D.bocki,140010837,130591,1,651,4.64964e-06,137866700,0.984686
D.bocki,140010837,85814,1,650,4.6425e-06,137867350,0.984691
D.bocki,140010837,82733,1,650,4.6425e-06,137868000,0.984695
D.bocki,140010837,71857,1,650,4.6425e-06,137868650,0.9847
D.bocki,140010837,65581,1,650,4.6425e-06,137869300,0.984704
D.bocki,140010837,428325,1,650,4.6425e-06,137869950,0.984709
D.bocki,140010837,396076,1,650,4.6425e-06,137870600,0.984714
D.bocki,140010837,378955,1,650,4.6425e-06,137871250,0.984718
D.bocki,140010837,372319,1,650,4.6425e-06,137871900,0.984723
D.bocki,140010837,353848,1,650,4.6425e-06,137872550,0.984728
D.bocki,140010837,334934,1,650,4.6425e-06,137873200,0.984732
D.bocki,140010837,324479,1,650,4.6425e-06,137873850,0.984737
D.bocki,140010837,320166,1,650,4.6425e-06,137874500,0.984742
D.bocki,140010837,315789,1,650,4.6425e-06,137875150,0.984746
D.bocki,140010837,281527,1,650,4.6425e-06,137875800,0.984751
D.bocki,140010837,279086,1,650,4.6425e-06,137876450,0.984756
D.bocki,140010837,265063,1,650,4.6425e-06,137877100,0.98476
D.bocki,140010837,253667,1,650,4.6425e-06,137877750,0.984765
D.bocki,140010837,252546,1,650,4.6425e-06,137878400,0.984769
D.bocki,140010837,207970,1,650,4.6425e-06,137879050,0.984774
D.bocki,140010837,196349,1,650,4.6425e-06,137879700,0.984779
D.bocki,140010837,191248,1,650,4.6425e-06,137880350,0.984783
D.bocki,140010837,185128,1,650,4.6425e-06,137881000,0.984788
D.bocki,140010837,130099,1,650,4.6425e-06,137881650,0.984793
D.bocki,140010837,74345,1,649,4.63536e-06,137882299,0.984797
D.bocki,140010837,450818,1,649,4.63536e-06,137882948,0.984802
D.bocki,140010837,447,1,649,4.63536e-06,137883597,0.984807
D.bocki,140010837,425420,1,649,4.63536e-06,137884246,0.984811
D.bocki,140010837,418903,1,649,4.63536e-06,137884895,0.984816
D.bocki,140010837,368932,1,649,4.63536e-06,137885544,0.984821
D.bocki,140010837,355204,1,649,4.63536e-06,137886193,0.984825
D.bocki,140010837,353823,1,649,4.63536e-06,137886842,0.98483
D.bocki,140010837,229266,1,649,4.63536e-06,137887491,0.984834
D.bocki,140010837,191667,1,649,4.63536e-06,137888140,0.984839
D.bocki,140010837,162542,1,649,4.63536e-06,137888789,0.984844
D.bocki,140010837,150685,1,649,4.63536e-06,137889438,0.984848
D.bocki,140010837,134976,1,649,4.63536e-06,137890087,0.984853
D.bocki,140010837,89725,1,648,4.62821e-06,137890735,0.984858
D.bocki,140010837,60363,1,648,4.62821e-06,137891383,0.984862
D.bocki,140010837,57625,1,648,4.62821e-06,137892031,0.984867
D.bocki,140010837,453188,1,648,4.62821e-06,137892679,0.984871
D.bocki,140010837,446924,1,648,4.62821e-06,137893327,0.984876
D.bocki,140010837,444278,1,648,4.62821e-06,137893975,0.984881
D.bocki,140010837,443674,1,648,4.62821e-06,137894623,0.984885
D.bocki,140010837,414511,1,648,4.62821e-06,137895271,0.98489
D.bocki,140010837,392826,1,648,4.62821e-06,137895919,0.984895
D.bocki,140010837,377013,1,648,4.62821e-06,137896567,0.984899
D.bocki,140010837,354125,1,648,4.62821e-06,137897215,0.984904
D.bocki,140010837,338597,1,648,4.62821e-06,137897863,0.984908
D.bocki,140010837,299628,1,648,4.62821e-06,137898511,0.984913
D.bocki,140010837,285369,1,648,4.62821e-06,137899159,0.984918
D.bocki,140010837,283072,1,648,4.62821e-06,137899807,0.984922
D.bocki,140010837,239895,1,648,4.62821e-06,137900455,0.984927
D.bocki,140010837,220213,1,648,4.62821e-06,137901103,0.984932
D.bocki,140010837,218708,1,648,4.62821e-06,137901751,0.984936
D.bocki,140010837,21731,1,648,4.62821e-06,137902399,0.984941
D.bocki,140010837,177542,1,648,4.62821e-06,137903047,0.984946
D.bocki,140010837,175869,1,648,4.62821e-06,137903695,0.98495
D.bocki,140010837,171972,1,648,4.62821e-06,137904343,0.984955
D.bocki,140010837,17004,1,648,4.62821e-06,137904991,0.984959
D.bocki,140010837,115446,1,648,4.62821e-06,137905639,0.984964
D.bocki,140010837,9529,1,647,4.62107e-06,137906286,0.984969
D.bocki,140010837,94048,1,647,4.62107e-06,137906933,0.984973
D.bocki,140010837,53451,1,647,4.62107e-06,137907580,0.984978
D.bocki,140010837,47511,1,647,4.62107e-06,137908227,0.984983
D.bocki,140010837,445725,1,647,4.62107e-06,137908874,0.984987
D.bocki,140010837,445597,1,647,4.62107e-06,137909521,0.984992
D.bocki,140010837,425181,1,647,4.62107e-06,137910168,0.984996
D.bocki,140010837,415164,1,647,4.62107e-06,137910815,0.985001
D.bocki,140010837,397414,1,647,4.62107e-06,137911462,0.985006
D.bocki,140010837,39629,1,647,4.62107e-06,137912109,0.98501
D.bocki,140010837,386200,1,647,4.62107e-06,137912756,0.985015
D.bocki,140010837,367112,1,647,4.62107e-06,137913403,0.985019
D.bocki,140010837,354441,1,647,4.62107e-06,137914050,0.985024
D.bocki,140010837,341206,1,647,4.62107e-06,137914697,0.985029
D.bocki,140010837,333526,1,647,4.62107e-06,137915344,0.985033
D.bocki,140010837,328267,1,647,4.62107e-06,137915991,0.985038
D.bocki,140010837,321627,1,647,4.62107e-06,137916638,0.985043
D.bocki,140010837,315944,1,647,4.62107e-06,137917285,0.985047
D.bocki,140010837,290816,1,647,4.62107e-06,137917932,0.985052
D.bocki,140010837,287980,1,647,4.62107e-06,137918579,0.985056
D.bocki,140010837,280173,1,647,4.62107e-06,137919226,0.985061
D.bocki,140010837,261076,1,647,4.62107e-06,137919873,0.985066
D.bocki,140010837,241704,1,647,4.62107e-06,137920520,0.98507
D.bocki,140010837,21642,1,647,4.62107e-06,137921167,0.985075
D.bocki,140010837,150246,1,647,4.62107e-06,137921814,0.98508
D.bocki,140010837,5738,1,646,4.61393e-06,137922460,0.985084
D.bocki,140010837,55142,1,646,4.61393e-06,137923106,0.985089
D.bocki,140010837,454855,1,646,4.61393e-06,137923752,0.985093
D.bocki,140010837,453498,1,646,4.61393e-06,137924398,0.985098
D.bocki,140010837,44546,1,646,4.61393e-06,137925044,0.985103
D.bocki,140010837,440898,1,646,4.61393e-06,137925690,0.985107
D.bocki,140010837,418122,1,646,4.61393e-06,137926336,0.985112
D.bocki,140010837,396074,1,646,4.61393e-06,137926982,0.985116
D.bocki,140010837,374941,1,646,4.61393e-06,137927628,0.985121
D.bocki,140010837,338720,1,646,4.61393e-06,137928274,0.985126
D.bocki,140010837,315092,1,646,4.61393e-06,137928920,0.98513
D.bocki,140010837,176850,1,646,4.61393e-06,137929566,0.985135
D.bocki,140010837,160440,1,646,4.61393e-06,137930212,0.98514
D.bocki,140010837,147197,1,646,4.61393e-06,137930858,0.985144
D.bocki,140010837,126748,1,646,4.61393e-06,137931504,0.985149
D.bocki,140010837,110645,1,646,4.61393e-06,137932150,0.985153
D.bocki,140010837,77584,1,645,4.60679e-06,137932795,0.985158
D.bocki,140010837,451703,1,645,4.60679e-06,137933440,0.985163
D.bocki,140010837,430635,1,645,4.60679e-06,137934085,0.985167
D.bocki,140010837,427237,1,645,4.60679e-06,137934730,0.985172
D.bocki,140010837,385210,1,645,4.60679e-06,137935375,0.985176
D.bocki,140010837,35767,1,645,4.60679e-06,137936020,0.985181
D.bocki,140010837,308818,1,645,4.60679e-06,137936665,0.985186
D.bocki,140010837,297191,1,645,4.60679e-06,137937310,0.98519
D.bocki,140010837,29681,1,645,4.60679e-06,137937955,0.985195
D.bocki,140010837,288876,1,645,4.60679e-06,137938600,0.985199
D.bocki,140010837,278312,1,645,4.60679e-06,137939245,0.985204
D.bocki,140010837,217619,1,645,4.60679e-06,137939890,0.985209
D.bocki,140010837,179720,1,645,4.60679e-06,137940535,0.985213
D.bocki,140010837,1706,1,645,4.60679e-06,137941180,0.985218
D.bocki,140010837,156349,1,645,4.60679e-06,137941825,0.985222
D.bocki,140010837,143072,1,645,4.60679e-06,137942470,0.985227
D.bocki,140010837,13245,1,645,4.60679e-06,137943115,0.985232
D.bocki,140010837,125623,1,645,4.60679e-06,137943760,0.985236
D.bocki,140010837,110186,1,645,4.60679e-06,137944405,0.985241
D.bocki,140010837,94757,1,644,4.59964e-06,137945049,0.985246
D.bocki,140010837,86357,1,644,4.59964e-06,137945693,0.98525
D.bocki,140010837,75339,1,644,4.59964e-06,137946337,0.985255
D.bocki,140010837,71499,1,644,4.59964e-06,137946981,0.985259
D.bocki,140010837,53554,1,644,4.59964e-06,137947625,0.985264
D.bocki,140010837,453175,1,644,4.59964e-06,137948269,0.985269
D.bocki,140010837,452037,1,644,4.59964e-06,137948913,0.985273
D.bocki,140010837,375092,1,644,4.59964e-06,137949557,0.985278
D.bocki,140010837,339543,1,644,4.59964e-06,137950201,0.985282
D.bocki,140010837,329313,1,644,4.59964e-06,137950845,0.985287
D.bocki,140010837,300076,1,644,4.59964e-06,137951489,0.985292
D.bocki,140010837,250605,1,644,4.59964e-06,137952133,0.985296
D.bocki,140010837,24312,1,644,4.59964e-06,137952777,0.985301
D.bocki,140010837,221989,1,644,4.59964e-06,137953421,0.985305
D.bocki,140010837,211106,1,644,4.59964e-06,137954065,0.98531
D.bocki,140010837,179655,1,644,4.59964e-06,137954709,0.985315
D.bocki,140010837,165319,1,644,4.59964e-06,137955353,0.985319
D.bocki,140010837,155156,1,644,4.59964e-06,137955997,0.985324
D.bocki,140010837,124810,1,644,4.59964e-06,137956641,0.985328
D.bocki,140010837,115627,1,644,4.59964e-06,137957285,0.985333
D.bocki,140010837,451000,1,643,4.5925e-06,137957928,0.985337
D.bocki,140010837,444062,1,643,4.5925e-06,137958571,0.985342
D.bocki,140010837,417322,1,643,4.5925e-06,137959214,0.985347
D.bocki,140010837,403917,1,643,4.5925e-06,137959857,0.985351
D.bocki,140010837,360422,1,643,4.5925e-06,137960500,0.985356
D.bocki,140010837,30095,1,643,4.5925e-06,137961143,0.98536
D.bocki,140010837,29371,1,643,4.5925e-06,137961786,0.985365
D.bocki,140010837,267624,1,643,4.5925e-06,137962429,0.98537
D.bocki,140010837,266915,1,643,4.5925e-06,137963072,0.985374
D.bocki,140010837,23576,1,643,4.5925e-06,137963715,0.985379
D.bocki,140010837,214987,1,643,4.5925e-06,137964358,0.985383
D.bocki,140010837,171913,1,643,4.5925e-06,137965001,0.985388
D.bocki,140010837,158323,1,643,4.5925e-06,137965644,0.985393
D.bocki,140010837,136951,1,643,4.5925e-06,137966287,0.985397
D.bocki,140010837,63905,1,642,4.58536e-06,137966929,0.985402
D.bocki,140010837,57817,1,642,4.58536e-06,137967571,0.985406
D.bocki,140010837,5679,1,642,4.58536e-06,137968213,0.985411
D.bocki,140010837,4428,1,642,4.58536e-06,137968855,0.985416
D.bocki,140010837,438524,1,642,4.58536e-06,137969497,0.98542
D.bocki,140010837,411103,1,642,4.58536e-06,137970139,0.985425
D.bocki,140010837,379519,1,642,4.58536e-06,137970781,0.985429
D.bocki,140010837,366138,1,642,4.58536e-06,137971423,0.985434
D.bocki,140010837,359386,1,642,4.58536e-06,137972065,0.985438
D.bocki,140010837,320133,1,642,4.58536e-06,137972707,0.985443
D.bocki,140010837,300727,1,642,4.58536e-06,137973349,0.985448
D.bocki,140010837,2632,1,642,4.58536e-06,137973991,0.985452
D.bocki,140010837,164890,1,642,4.58536e-06,137974633,0.985457
D.bocki,140010837,153015,1,642,4.58536e-06,137975275,0.985461
D.bocki,140010837,146448,1,642,4.58536e-06,137975917,0.985466
D.bocki,140010837,95900,1,641,4.57822e-06,137976558,0.985471
D.bocki,140010837,85010,1,641,4.57822e-06,137977199,0.985475
D.bocki,140010837,50022,1,641,4.57822e-06,137977840,0.98548
D.bocki,140010837,453433,1,641,4.57822e-06,137978481,0.985484
D.bocki,140010837,433793,1,641,4.57822e-06,137979122,0.985489
D.bocki,140010837,399409,1,641,4.57822e-06,137979763,0.985493
D.bocki,140010837,276697,1,641,4.57822e-06,137980404,0.985498
D.bocki,140010837,2748,1,641,4.57822e-06,137981045,0.985503
D.bocki,140010837,251507,1,641,4.57822e-06,137981686,0.985507
D.bocki,140010837,24503,1,641,4.57822e-06,137982327,0.985512
D.bocki,140010837,227383,1,641,4.57822e-06,137982968,0.985516
D.bocki,140010837,162720,1,641,4.57822e-06,137983609,0.985521
D.bocki,140010837,160014,1,641,4.57822e-06,137984250,0.985525
D.bocki,140010837,154819,1,641,4.57822e-06,137984891,0.98553
D.bocki,140010837,149094,1,641,4.57822e-06,137985532,0.985535
D.bocki,140010837,122780,1,641,4.57822e-06,137986173,0.985539
D.bocki,140010837,93370,1,640,4.57107e-06,137986813,0.985544
D.bocki,140010837,88851,1,640,4.57107e-06,137987453,0.985548
D.bocki,140010837,60308,1,640,4.57107e-06,137988093,0.985553
D.bocki,140010837,385419,1,640,4.57107e-06,137988733,0.985558
D.bocki,140010837,35283,1,640,4.57107e-06,137989373,0.985562
D.bocki,140010837,340496,1,640,4.57107e-06,137990013,0.985567
D.bocki,140010837,335836,1,640,4.57107e-06,137990653,0.985571
D.bocki,140010837,292795,1,640,4.57107e-06,137991293,0.985576
D.bocki,140010837,283760,1,640,4.57107e-06,137991933,0.98558
D.bocki,140010837,247778,1,640,4.57107e-06,137992573,0.985585
D.bocki,140010837,238838,1,640,4.57107e-06,137993213,0.98559
D.bocki,140010837,238030,1,640,4.57107e-06,137993853,0.985594
D.bocki,140010837,221049,1,640,4.57107e-06,137994493,0.985599
D.bocki,140010837,19804,1,640,4.57107e-06,137995133,0.985603
D.bocki,140010837,188578,1,640,4.57107e-06,137995773,0.985608
D.bocki,140010837,181493,1,640,4.57107e-06,137996413,0.985612
D.bocki,140010837,452685,1,639,4.56393e-06,137997052,0.985617
D.bocki,140010837,427695,1,639,4.56393e-06,137997691,0.985621
D.bocki,140010837,372834,1,639,4.56393e-06,137998330,0.985626
D.bocki,140010837,361374,1,639,4.56393e-06,137998969,0.985631
D.bocki,140010837,323634,1,639,4.56393e-06,137999608,0.985635
D.bocki,140010837,245300,1,639,4.56393e-06,138000247,0.98564
D.bocki,140010837,241495,1,639,4.56393e-06,138000886,0.985644
D.bocki,140010837,231847,1,639,4.56393e-06,138001525,0.985649
D.bocki,140010837,223450,1,639,4.56393e-06,138002164,0.985653
D.bocki,140010837,216196,1,639,4.56393e-06,138002803,0.985658
D.bocki,140010837,190987,1,639,4.56393e-06,138003442,0.985663
D.bocki,140010837,132518,1,639,4.56393e-06,138004081,0.985667
D.bocki,140010837,102520,1,639,4.56393e-06,138004720,0.985672
D.bocki,140010837,97450,1,638,4.55679e-06,138005358,0.985676
D.bocki,140010837,92930,1,638,4.55679e-06,138005996,0.985681
D.bocki,140010837,83355,1,638,4.55679e-06,138006634,0.985685
D.bocki,140010837,75404,1,638,4.55679e-06,138007272,0.98569
D.bocki,140010837,5870,1,638,4.55679e-06,138007910,0.985694
D.bocki,140010837,445789,1,638,4.55679e-06,138008548,0.985699
D.bocki,140010837,443643,1,638,4.55679e-06,138009186,0.985704
D.bocki,140010837,434366,1,638,4.55679e-06,138009824,0.985708
D.bocki,140010837,418123,1,638,4.55679e-06,138010462,0.985713
D.bocki,140010837,415779,1,638,4.55679e-06,138011100,0.985717
D.bocki,140010837,398280,1,638,4.55679e-06,138011738,0.985722
D.bocki,140010837,365977,1,638,4.55679e-06,138012376,0.985726
D.bocki,140010837,330390,1,638,4.55679e-06,138013014,0.985731
D.bocki,140010837,150963,1,638,4.55679e-06,138013652,0.985735
D.bocki,140010837,103551,1,638,4.55679e-06,138014290,0.98574
D.bocki,140010837,59615,1,637,4.54965e-06,138014927,0.985745
D.bocki,140010837,50943,1,637,4.54965e-06,138015564,0.985749
D.bocki,140010837,40231,1,637,4.54965e-06,138016201,0.985754
D.bocki,140010837,370673,1,637,4.54965e-06,138016838,0.985758
D.bocki,140010837,31707,1,637,4.54965e-06,138017475,0.985763
D.bocki,140010837,315579,1,637,4.54965e-06,138018112,0.985767
D.bocki,140010837,31062,1,637,4.54965e-06,138018749,0.985772
D.bocki,140010837,309059,1,637,4.54965e-06,138019386,0.985776
D.bocki,140010837,26911,1,637,4.54965e-06,138020023,0.985781
D.bocki,140010837,264143,1,637,4.54965e-06,138020660,0.985786
D.bocki,140010837,25585,1,637,4.54965e-06,138021297,0.98579
D.bocki,140010837,244950,1,637,4.54965e-06,138021934,0.985795
D.bocki,140010837,225579,1,637,4.54965e-06,138022571,0.985799
D.bocki,140010837,186180,1,637,4.54965e-06,138023208,0.985804
D.bocki,140010837,169180,1,637,4.54965e-06,138023845,0.985808
D.bocki,140010837,146121,1,637,4.54965e-06,138024482,0.985813
D.bocki,140010837,131219,1,637,4.54965e-06,138025119,0.985817
D.bocki,140010837,97106,1,636,4.54251e-06,138025755,0.985822
D.bocki,140010837,454332,1,636,4.54251e-06,138026391,0.985826
D.bocki,140010837,453329,1,636,4.54251e-06,138027027,0.985831
D.bocki,140010837,450983,1,636,4.54251e-06,138027663,0.985836
D.bocki,140010837,440513,1,636,4.54251e-06,138028299,0.98584
D.bocki,140010837,434928,1,636,4.54251e-06,138028935,0.985845
D.bocki,140010837,434270,1,636,4.54251e-06,138029571,0.985849
D.bocki,140010837,419869,1,636,4.54251e-06,138030207,0.985854
D.bocki,140010837,35131,1,636,4.54251e-06,138030843,0.985858
D.bocki,140010837,34277,1,636,4.54251e-06,138031479,0.985863
D.bocki,140010837,311786,1,636,4.54251e-06,138032115,0.985867
D.bocki,140010837,310223,1,636,4.54251e-06,138032751,0.985872
D.bocki,140010837,253064,1,636,4.54251e-06,138033387,0.985876
D.bocki,140010837,22666,1,636,4.54251e-06,138034023,0.985881
D.bocki,140010837,149745,1,636,4.54251e-06,138034659,0.985886
D.bocki,140010837,120103,1,636,4.54251e-06,138035295,0.98589
D.bocki,140010837,100782,1,636,4.54251e-06,138035931,0.985895
D.bocki,140010837,55838,1,635,4.53536e-06,138036566,0.985899
D.bocki,140010837,454462,1,635,4.53536e-06,138037201,0.985904
D.bocki,140010837,439123,1,635,4.53536e-06,138037836,0.985908
D.bocki,140010837,392837,1,635,4.53536e-06,138038471,0.985913
D.bocki,140010837,38213,1,635,4.53536e-06,138039106,0.985917
D.bocki,140010837,295876,1,635,4.53536e-06,138039741,0.985922
D.bocki,140010837,294264,1,635,4.53536e-06,138040376,0.985926
D.bocki,140010837,290737,1,635,4.53536e-06,138041011,0.985931
D.bocki,140010837,281529,1,635,4.53536e-06,138041646,0.985935
D.bocki,140010837,242102,1,635,4.53536e-06,138042281,0.98594
D.bocki,140010837,203488,1,635,4.53536e-06,138042916,0.985945
D.bocki,140010837,186385,1,635,4.53536e-06,138043551,0.985949
D.bocki,140010837,134956,1,635,4.53536e-06,138044186,0.985954
D.bocki,140010837,134670,1,635,4.53536e-06,138044821,0.985958
D.bocki,140010837,131126,1,635,4.53536e-06,138045456,0.985963
D.bocki,140010837,77092,1,634,4.52822e-06,138046090,0.985967
D.bocki,140010837,65550,1,634,4.52822e-06,138046724,0.985972
D.bocki,140010837,60789,1,634,4.52822e-06,138047358,0.985976
D.bocki,140010837,348128,1,634,4.52822e-06,138047992,0.985981
D.bocki,140010837,333782,1,634,4.52822e-06,138048626,0.985985
D.bocki,140010837,322026,1,634,4.52822e-06,138049260,0.98599
D.bocki,140010837,312614,1,634,4.52822e-06,138049894,0.985994
D.bocki,140010837,289247,1,634,4.52822e-06,138050528,0.985999
D.bocki,140010837,281805,1,634,4.52822e-06,138051162,0.986003
D.bocki,140010837,275417,1,634,4.52822e-06,138051796,0.986008
D.bocki,140010837,272271,1,634,4.52822e-06,138052430,0.986012
D.bocki,140010837,257192,1,634,4.52822e-06,138053064,0.986017
D.bocki,140010837,208839,1,634,4.52822e-06,138053698,0.986022
D.bocki,140010837,198755,1,634,4.52822e-06,138054332,0.986026
D.bocki,140010837,191574,1,634,4.52822e-06,138054966,0.986031
D.bocki,140010837,181421,1,634,4.52822e-06,138055600,0.986035
D.bocki,140010837,160264,1,634,4.52822e-06,138056234,0.98604
D.bocki,140010837,109370,1,634,4.52822e-06,138056868,0.986044
D.bocki,140010837,86536,1,633,4.52108e-06,138057501,0.986049
D.bocki,140010837,73764,1,633,4.52108e-06,138058134,0.986053
D.bocki,140010837,436625,1,633,4.52108e-06,138058767,0.986058
D.bocki,140010837,433901,1,633,4.52108e-06,138059400,0.986062
D.bocki,140010837,432252,1,633,4.52108e-06,138060033,0.986067
D.bocki,140010837,430270,1,633,4.52108e-06,138060666,0.986071
D.bocki,140010837,385330,1,633,4.52108e-06,138061299,0.986076
D.bocki,140010837,377950,1,633,4.52108e-06,138061932,0.98608
D.bocki,140010837,367443,1,633,4.52108e-06,138062565,0.986085
D.bocki,140010837,342493,1,633,4.52108e-06,138063198,0.986089
D.bocki,140010837,341643,1,633,4.52108e-06,138063831,0.986094
D.bocki,140010837,302058,1,633,4.52108e-06,138064464,0.986098
D.bocki,140010837,258444,1,633,4.52108e-06,138065097,0.986103
D.bocki,140010837,190436,1,633,4.52108e-06,138065730,0.986107
D.bocki,140010837,182544,1,633,4.52108e-06,138066363,0.986112
D.bocki,140010837,1791,1,633,4.52108e-06,138066996,0.986116
D.bocki,140010837,173428,1,633,4.52108e-06,138067629,0.986121
D.bocki,140010837,96420,1,632,4.51394e-06,138068261,0.986126
D.bocki,140010837,88480,1,632,4.51394e-06,138068893,0.98613
D.bocki,140010837,74060,1,632,4.51394e-06,138069525,0.986135
D.bocki,140010837,451946,1,632,4.51394e-06,138070157,0.986139
D.bocki,140010837,428836,1,632,4.51394e-06,138070789,0.986144
D.bocki,140010837,421266,1,632,4.51394e-06,138071421,0.986148
D.bocki,140010837,405907,1,632,4.51394e-06,138072053,0.986153
D.bocki,140010837,393815,1,632,4.51394e-06,138072685,0.986157
D.bocki,140010837,392894,1,632,4.51394e-06,138073317,0.986162
D.bocki,140010837,375655,1,632,4.51394e-06,138073949,0.986166
D.bocki,140010837,355842,1,632,4.51394e-06,138074581,0.986171
D.bocki,140010837,267543,1,632,4.51394e-06,138075213,0.986175
D.bocki,140010837,235665,1,632,4.51394e-06,138075845,0.98618
D.bocki,140010837,228083,1,632,4.51394e-06,138076477,0.986184
D.bocki,140010837,217828,1,632,4.51394e-06,138077109,0.986189
D.bocki,140010837,154557,1,632,4.51394e-06,138077741,0.986193
D.bocki,140010837,142806,1,632,4.51394e-06,138078373,0.986198
D.bocki,140010837,121920,1,632,4.51394e-06,138079005,0.986202
D.bocki,140010837,106160,1,632,4.51394e-06,138079637,0.986207
D.bocki,140010837,101804,1,632,4.51394e-06,138080269,0.986211
D.bocki,140010837,9976,1,631,4.50679e-06,138080900,0.986216
D.bocki,140010837,64925,1,631,4.50679e-06,138081531,0.98622
D.bocki,140010837,57728,1,631,4.50679e-06,138082162,0.986225
D.bocki,140010837,421221,1,631,4.50679e-06,138082793,0.986229
D.bocki,140010837,392011,1,631,4.50679e-06,138083424,0.986234
D.bocki,140010837,376806,1,631,4.50679e-06,138084055,0.986238
D.bocki,140010837,366504,1,631,4.50679e-06,138084686,0.986243
D.bocki,140010837,356216,1,631,4.50679e-06,138085317,0.986247
D.bocki,140010837,348911,1,631,4.50679e-06,138085948,0.986252
D.bocki,140010837,340521,1,631,4.50679e-06,138086579,0.986256
D.bocki,140010837,336754,1,631,4.50679e-06,138087210,0.986261
D.bocki,140010837,321073,1,631,4.50679e-06,138087841,0.986265
D.bocki,140010837,306370,1,631,4.50679e-06,138088472,0.98627
D.bocki,140010837,306272,1,631,4.50679e-06,138089103,0.986274
D.bocki,140010837,285226,1,631,4.50679e-06,138089734,0.986279
D.bocki,140010837,279226,1,631,4.50679e-06,138090365,0.986283
D.bocki,140010837,259298,1,631,4.50679e-06,138090996,0.986288
D.bocki,140010837,252690,1,631,4.50679e-06,138091627,0.986292
D.bocki,140010837,241732,1,631,4.50679e-06,138092258,0.986297
D.bocki,140010837,135541,1,631,4.50679e-06,138092889,0.986301
D.bocki,140010837,99031,1,630,4.49965e-06,138093519,0.986306
D.bocki,140010837,6234,1,630,4.49965e-06,138094149,0.98631
D.bocki,140010837,55587,1,630,4.49965e-06,138094779,0.986315
D.bocki,140010837,434967,1,630,4.49965e-06,138095409,0.986319
D.bocki,140010837,414274,1,630,4.49965e-06,138096039,0.986324
D.bocki,140010837,404284,1,630,4.49965e-06,138096669,0.986328
D.bocki,140010837,396109,1,630,4.49965e-06,138097299,0.986333
D.bocki,140010837,374529,1,630,4.49965e-06,138097929,0.986337
D.bocki,140010837,36237,1,630,4.49965e-06,138098559,0.986342
D.bocki,140010837,351589,1,630,4.49965e-06,138099189,0.986346
D.bocki,140010837,340937,1,630,4.49965e-06,138099819,0.986351
D.bocki,140010837,297644,1,630,4.49965e-06,138100449,0.986355
D.bocki,140010837,296456,1,630,4.49965e-06,138101079,0.98636
D.bocki,140010837,281871,1,630,4.49965e-06,138101709,0.986364
D.bocki,140010837,270704,1,630,4.49965e-06,138102339,0.986369
D.bocki,140010837,259203,1,630,4.49965e-06,138102969,0.986373
D.bocki,140010837,251269,1,630,4.49965e-06,138103599,0.986378
D.bocki,140010837,249141,1,630,4.49965e-06,138104229,0.986382
D.bocki,140010837,17948,1,630,4.49965e-06,138104859,0.986387
D.bocki,140010837,159805,1,630,4.49965e-06,138105489,0.986391
D.bocki,140010837,156933,1,630,4.49965e-06,138106119,0.986396
D.bocki,140010837,153250,1,630,4.49965e-06,138106749,0.9864
D.bocki,140010837,131564,1,630,4.49965e-06,138107379,0.986405
D.bocki,140010837,117353,1,630,4.49965e-06,138108009,0.986409
D.bocki,140010837,95647,1,629,4.49251e-06,138108638,0.986414
D.bocki,140010837,83406,1,629,4.49251e-06,138109267,0.986418
D.bocki,140010837,453612,1,629,4.49251e-06,138109896,0.986423
D.bocki,140010837,445330,1,629,4.49251e-06,138110525,0.986427
D.bocki,140010837,388258,1,629,4.49251e-06,138111154,0.986432
D.bocki,140010837,366388,1,629,4.49251e-06,138111783,0.986436
D.bocki,140010837,359323,1,629,4.49251e-06,138112412,0.986441
D.bocki,140010837,358644,1,629,4.49251e-06,138113041,0.986445
D.bocki,140010837,294631,1,629,4.49251e-06,138113670,0.98645
D.bocki,140010837,288363,1,629,4.49251e-06,138114299,0.986454
D.bocki,140010837,254004,1,629,4.49251e-06,138114928,0.986459
D.bocki,140010837,231299,1,629,4.49251e-06,138115557,0.986463
D.bocki,140010837,172904,1,629,4.49251e-06,138116186,0.986468
D.bocki,140010837,150539,1,629,4.49251e-06,138116815,0.986472
D.bocki,140010837,147856,1,629,4.49251e-06,138117444,0.986477
D.bocki,140010837,125910,1,629,4.49251e-06,138118073,0.986481
D.bocki,140010837,73297,1,628,4.48537e-06,138118701,0.986486
D.bocki,140010837,62562,1,628,4.48537e-06,138119329,0.98649
D.bocki,140010837,452514,1,628,4.48537e-06,138119957,0.986495
D.bocki,140010837,436198,1,628,4.48537e-06,138120585,0.986499
D.bocki,140010837,421469,1,628,4.48537e-06,138121213,0.986504
D.bocki,140010837,406213,1,628,4.48537e-06,138121841,0.986508
D.bocki,140010837,395152,1,628,4.48537e-06,138122469,0.986513
D.bocki,140010837,386523,1,628,4.48537e-06,138123097,0.986517
D.bocki,140010837,332544,1,628,4.48537e-06,138123725,0.986522
D.bocki,140010837,265472,1,628,4.48537e-06,138124353,0.986526
D.bocki,140010837,256680,1,628,4.48537e-06,138124981,0.986531
D.bocki,140010837,256623,1,628,4.48537e-06,138125609,0.986535
D.bocki,140010837,244607,1,628,4.48537e-06,138126237,0.98654
D.bocki,140010837,216545,1,628,4.48537e-06,138126865,0.986544
D.bocki,140010837,2046,1,628,4.48537e-06,138127493,0.986549
D.bocki,140010837,180338,1,628,4.48537e-06,138128121,0.986553
D.bocki,140010837,137842,1,628,4.48537e-06,138128749,0.986558
D.bocki,140010837,134698,1,628,4.48537e-06,138129377,0.986562
D.bocki,140010837,82133,1,627,4.47822e-06,138130004,0.986567
D.bocki,140010837,76188,1,627,4.47822e-06,138130631,0.986571
D.bocki,140010837,65733,1,627,4.47822e-06,138131258,0.986575
D.bocki,140010837,62889,1,627,4.47822e-06,138131885,0.98658
D.bocki,140010837,62409,1,627,4.47822e-06,138132512,0.986584
D.bocki,140010837,411327,1,627,4.47822e-06,138133139,0.986589
D.bocki,140010837,40661,1,627,4.47822e-06,138133766,0.986593
D.bocki,140010837,345130,1,627,4.47822e-06,138134393,0.986598
D.bocki,140010837,345002,1,627,4.47822e-06,138135020,0.986602
D.bocki,140010837,326363,1,627,4.47822e-06,138135647,0.986607
D.bocki,140010837,315732,1,627,4.47822e-06,138136274,0.986611
D.bocki,140010837,306182,1,627,4.47822e-06,138136901,0.986616
D.bocki,140010837,29338,1,627,4.47822e-06,138137528,0.98662
D.bocki,140010837,274594,1,627,4.47822e-06,138138155,0.986625
D.bocki,140010837,266356,1,627,4.47822e-06,138138782,0.986629
D.bocki,140010837,233598,1,627,4.47822e-06,138139409,0.986634
D.bocki,140010837,187373,1,627,4.47822e-06,138140036,0.986638
D.bocki,140010837,167872,1,627,4.47822e-06,138140663,0.986643
D.bocki,140010837,130158,1,627,4.47822e-06,138141290,0.986647
D.bocki,140010837,116213,1,627,4.47822e-06,138141917,0.986652
D.bocki,140010837,99731,1,626,4.47108e-06,138142543,0.986656
D.bocki,140010837,74887,1,626,4.47108e-06,138143169,0.986661
D.bocki,140010837,452996,1,626,4.47108e-06,138143795,0.986665
D.bocki,140010837,451195,1,626,4.47108e-06,138144421,0.986669
D.bocki,140010837,435767,1,626,4.47108e-06,138145047,0.986674
D.bocki,140010837,425566,1,626,4.47108e-06,138145673,0.986678
D.bocki,140010837,349063,1,626,4.47108e-06,138146299,0.986683
D.bocki,140010837,31706,1,626,4.47108e-06,138146925,0.986687
D.bocki,140010837,301376,1,626,4.47108e-06,138147551,0.986692
D.bocki,140010837,22899,1,626,4.47108e-06,138148177,0.986696
D.bocki,140010837,211529,1,626,4.47108e-06,138148803,0.986701
D.bocki,140010837,203753,1,626,4.47108e-06,138149429,0.986705
D.bocki,140010837,17496,1,626,4.47108e-06,138150055,0.98671
D.bocki,140010837,154249,1,626,4.47108e-06,138150681,0.986714
D.bocki,140010837,101702,1,626,4.47108e-06,138151307,0.986719
D.bocki,140010837,100295,1,626,4.47108e-06,138151933,0.986723
D.bocki,140010837,78355,1,625,4.46394e-06,138152558,0.986728
D.bocki,140010837,75308,1,625,4.46394e-06,138153183,0.986732
D.bocki,140010837,70169,1,625,4.46394e-06,138153808,0.986737
D.bocki,140010837,6960,1,625,4.46394e-06,138154433,0.986741
D.bocki,140010837,453436,1,625,4.46394e-06,138155058,0.986745
D.bocki,140010837,429093,1,625,4.46394e-06,138155683,0.98675
D.bocki,140010837,42563,1,625,4.46394e-06,138156308,0.986754
D.bocki,140010837,374120,1,625,4.46394e-06,138156933,0.986759
D.bocki,140010837,325038,1,625,4.46394e-06,138157558,0.986763
D.bocki,140010837,25586,1,625,4.46394e-06,138158183,0.986768
D.bocki,140010837,224218,1,625,4.46394e-06,138158808,0.986772
D.bocki,140010837,186176,1,625,4.46394e-06,138159433,0.986777
D.bocki,140010837,182300,1,625,4.46394e-06,138160058,0.986781
D.bocki,140010837,174648,1,625,4.46394e-06,138160683,0.986786
D.bocki,140010837,158555,1,625,4.46394e-06,138161308,0.98679
D.bocki,140010837,141811,1,625,4.46394e-06,138161933,0.986795
D.bocki,140010837,106790,1,625,4.46394e-06,138162558,0.986799
D.bocki,140010837,84090,1,624,4.4568e-06,138163182,0.986803
D.bocki,140010837,66441,1,624,4.4568e-06,138163806,0.986808
D.bocki,140010837,451551,1,624,4.4568e-06,138164430,0.986812
D.bocki,140010837,423791,1,624,4.4568e-06,138165054,0.986817
D.bocki,140010837,422509,1,624,4.4568e-06,138165678,0.986821
D.bocki,140010837,396174,1,624,4.4568e-06,138166302,0.986826
D.bocki,140010837,323823,1,624,4.4568e-06,138166926,0.98683
D.bocki,140010837,322722,1,624,4.4568e-06,138167550,0.986835
D.bocki,140010837,301847,1,624,4.4568e-06,138168174,0.986839
D.bocki,140010837,292434,1,624,4.4568e-06,138168798,0.986844
D.bocki,140010837,285875,1,624,4.4568e-06,138169422,0.986848
D.bocki,140010837,2660,1,624,4.4568e-06,138170046,0.986853
D.bocki,140010837,213332,1,624,4.4568e-06,138170670,0.986857
D.bocki,140010837,196919,1,624,4.4568e-06,138171294,0.986861
D.bocki,140010837,184483,1,624,4.4568e-06,138171918,0.986866
D.bocki,140010837,183701,1,624,4.4568e-06,138172542,0.98687
D.bocki,140010837,171144,1,624,4.4568e-06,138173166,0.986875
D.bocki,140010837,163978,1,624,4.4568e-06,138173790,0.986879
D.bocki,140010837,126346,1,624,4.4568e-06,138174414,0.986884
D.bocki,140010837,86384,1,623,4.44966e-06,138175037,0.986888
D.bocki,140010837,84436,1,623,4.44966e-06,138175660,0.986893
D.bocki,140010837,82637,1,623,4.44966e-06,138176283,0.986897
D.bocki,140010837,61404,1,623,4.44966e-06,138176906,0.986902
D.bocki,140010837,49702,1,623,4.44966e-06,138177529,0.986906
D.bocki,140010837,450960,1,623,4.44966e-06,138178152,0.98691
D.bocki,140010837,441163,1,623,4.44966e-06,138178775,0.986915
D.bocki,140010837,433295,1,623,4.44966e-06,138179398,0.986919
D.bocki,140010837,428240,1,623,4.44966e-06,138180021,0.986924
D.bocki,140010837,425419,1,623,4.44966e-06,138180644,0.986928
D.bocki,140010837,411825,1,623,4.44966e-06,138181267,0.986933
D.bocki,140010837,407328,1,623,4.44966e-06,138181890,0.986937
D.bocki,140010837,372060,1,623,4.44966e-06,138182513,0.986942
D.bocki,140010837,371616,1,623,4.44966e-06,138183136,0.986946
D.bocki,140010837,369516,1,623,4.44966e-06,138183759,0.98695
D.bocki,140010837,343446,1,623,4.44966e-06,138184382,0.986955
D.bocki,140010837,333147,1,623,4.44966e-06,138185005,0.986959
D.bocki,140010837,308918,1,623,4.44966e-06,138185628,0.986964
D.bocki,140010837,303091,1,623,4.44966e-06,138186251,0.986968
D.bocki,140010837,292852,1,623,4.44966e-06,138186874,0.986973
D.bocki,140010837,292633,1,623,4.44966e-06,138187497,0.986977
D.bocki,140010837,240949,1,623,4.44966e-06,138188120,0.986982
D.bocki,140010837,238121,1,623,4.44966e-06,138188743,0.986986
D.bocki,140010837,214714,1,623,4.44966e-06,138189366,0.98699
D.bocki,140010837,176879,1,623,4.44966e-06,138189989,0.986995
D.bocki,140010837,40954,1,622,4.44251e-06,138190611,0.986999
D.bocki,140010837,407662,1,622,4.44251e-06,138191233,0.987004
D.bocki,140010837,405448,1,622,4.44251e-06,138191855,0.987008
D.bocki,140010837,394838,1,622,4.44251e-06,138192477,0.987013
D.bocki,140010837,371483,1,622,4.44251e-06,138193099,0.987017
D.bocki,140010837,362457,1,622,4.44251e-06,138193721,0.987022
D.bocki,140010837,360799,1,622,4.44251e-06,138194343,0.987026
D.bocki,140010837,346800,1,622,4.44251e-06,138194965,0.98703
D.bocki,140010837,337363,1,622,4.44251e-06,138195587,0.987035
D.bocki,140010837,329366,1,622,4.44251e-06,138196209,0.987039
D.bocki,140010837,236849,1,622,4.44251e-06,138196831,0.987044
D.bocki,140010837,232960,1,622,4.44251e-06,138197453,0.987048
D.bocki,140010837,215450,1,622,4.44251e-06,138198075,0.987053
D.bocki,140010837,213943,1,622,4.44251e-06,138198697,0.987057
D.bocki,140010837,157365,1,622,4.44251e-06,138199319,0.987062
D.bocki,140010837,122334,1,622,4.44251e-06,138199941,0.987066
D.bocki,140010837,100185,1,622,4.44251e-06,138200563,0.98707
D.bocki,140010837,8924,1,621,4.43537e-06,138201184,0.987075
D.bocki,140010837,453652,1,621,4.43537e-06,138201805,0.987079
D.bocki,140010837,450991,1,621,4.43537e-06,138202426,0.987084
D.bocki,140010837,43791,1,621,4.43537e-06,138203047,0.987088
D.bocki,140010837,433227,1,621,4.43537e-06,138203668,0.987093
D.bocki,140010837,408243,1,621,4.43537e-06,138204289,0.987097
D.bocki,140010837,402957,1,621,4.43537e-06,138204910,0.987102
D.bocki,140010837,372883,1,621,4.43537e-06,138205531,0.987106
D.bocki,140010837,370615,1,621,4.43537e-06,138206152,0.98711
D.bocki,140010837,320958,1,621,4.43537e-06,138206773,0.987115
D.bocki,140010837,293558,1,621,4.43537e-06,138207394,0.987119
D.bocki,140010837,29245,1,621,4.43537e-06,138208015,0.987124
D.bocki,140010837,292158,1,621,4.43537e-06,138208636,0.987128
D.bocki,140010837,275169,1,621,4.43537e-06,138209257,0.987133
D.bocki,140010837,245658,1,621,4.43537e-06,138209878,0.987137
D.bocki,140010837,245457,1,621,4.43537e-06,138210499,0.987141
D.bocki,140010837,240981,1,621,4.43537e-06,138211120,0.987146
D.bocki,140010837,229851,1,621,4.43537e-06,138211741,0.98715
D.bocki,140010837,171912,1,621,4.43537e-06,138212362,0.987155
D.bocki,140010837,159388,1,621,4.43537e-06,138212983,0.987159
D.bocki,140010837,138048,1,621,4.43537e-06,138213604,0.987164
D.bocki,140010837,114419,1,621,4.43537e-06,138214225,0.987168
D.bocki,140010837,113500,1,621,4.43537e-06,138214846,0.987172
D.bocki,140010837,98790,1,620,4.42823e-06,138215466,0.987177
D.bocki,140010837,438752,1,620,4.42823e-06,138216086,0.987181
D.bocki,140010837,394968,1,620,4.42823e-06,138216706,0.987186
D.bocki,140010837,392913,1,620,4.42823e-06,138217326,0.98719
D.bocki,140010837,372159,1,620,4.42823e-06,138217946,0.987195
D.bocki,140010837,363946,1,620,4.42823e-06,138218566,0.987199
D.bocki,140010837,355647,1,620,4.42823e-06,138219186,0.987203
D.bocki,140010837,34573,1,620,4.42823e-06,138219806,0.987208
D.bocki,140010837,284917,1,620,4.42823e-06,138220426,0.987212
D.bocki,140010837,282901,1,620,4.42823e-06,138221046,0.987217
D.bocki,140010837,260352,1,620,4.42823e-06,138221666,0.987221
D.bocki,140010837,257193,1,620,4.42823e-06,138222286,0.987226
D.bocki,140010837,202296,1,620,4.42823e-06,138222906,0.98723
D.bocki,140010837,195420,1,620,4.42823e-06,138223526,0.987234
D.bocki,140010837,186847,1,620,4.42823e-06,138224146,0.987239
D.bocki,140010837,123259,1,620,4.42823e-06,138224766,0.987243
D.bocki,140010837,116023,1,620,4.42823e-06,138225386,0.987248
D.bocki,140010837,94508,1,619,4.42109e-06,138226005,0.987252
D.bocki,140010837,92272,1,619,4.42109e-06,138226624,0.987257
D.bocki,140010837,83405,1,619,4.42109e-06,138227243,0.987261
D.bocki,140010837,76476,1,619,4.42109e-06,138227862,0.987265
D.bocki,140010837,365846,1,619,4.42109e-06,138228481,0.98727
D.bocki,140010837,352490,1,619,4.42109e-06,138229100,0.987274
D.bocki,140010837,28579,1,619,4.42109e-06,138229719,0.987279
D.bocki,140010837,254649,1,619,4.42109e-06,138230338,0.987283
D.bocki,140010837,242201,1,619,4.42109e-06,138230957,0.987288
D.bocki,140010837,234607,1,619,4.42109e-06,138231576,0.987292
D.bocki,140010837,166135,1,619,4.42109e-06,138232195,0.987296
D.bocki,140010837,137673,1,619,4.42109e-06,138232814,0.987301
D.bocki,140010837,116634,1,619,4.42109e-06,138233433,0.987305
D.bocki,140010837,105535,1,619,4.42109e-06,138234052,0.98731
D.bocki,140010837,89320,1,618,4.41394e-06,138234670,0.987314
D.bocki,140010837,52711,1,618,4.41394e-06,138235288,0.987318
D.bocki,140010837,443876,1,618,4.41394e-06,138235906,0.987323
D.bocki,140010837,430271,1,618,4.41394e-06,138236524,0.987327
D.bocki,140010837,39299,1,618,4.41394e-06,138237142,0.987332
D.bocki,140010837,370587,1,618,4.41394e-06,138237760,0.987336
D.bocki,140010837,36753,1,618,4.41394e-06,138238378,0.987341
D.bocki,140010837,354393,1,618,4.41394e-06,138238996,0.987345
D.bocki,140010837,349426,1,618,4.41394e-06,138239614,0.987349
D.bocki,140010837,338207,1,618,4.41394e-06,138240232,0.987354
D.bocki,140010837,331392,1,618,4.41394e-06,138240850,0.987358
D.bocki,140010837,307626,1,618,4.41394e-06,138241468,0.987363
D.bocki,140010837,297110,1,618,4.41394e-06,138242086,0.987367
D.bocki,140010837,296520,1,618,4.41394e-06,138242704,0.987371
D.bocki,140010837,247642,1,618,4.41394e-06,138243322,0.987376
D.bocki,140010837,222455,1,618,4.41394e-06,138243940,0.98738
D.bocki,140010837,194814,1,618,4.41394e-06,138244558,0.987385
D.bocki,140010837,16674,1,618,4.41394e-06,138245176,0.987389
D.bocki,140010837,164406,1,618,4.41394e-06,138245794,0.987394
D.bocki,140010837,143359,1,618,4.41394e-06,138246412,0.987398
D.bocki,140010837,132729,1,618,4.41394e-06,138247030,0.987402
D.bocki,140010837,110128,1,618,4.41394e-06,138247648,0.987407
D.bocki,140010837,44763,1,617,4.4068e-06,138248265,0.987411
D.bocki,140010837,443360,1,617,4.4068e-06,138248882,0.987416
D.bocki,140010837,433228,1,617,4.4068e-06,138249499,0.98742
D.bocki,140010837,380255,1,617,4.4068e-06,138250116,0.987424
D.bocki,140010837,369945,1,617,4.4068e-06,138250733,0.987429
D.bocki,140010837,350038,1,617,4.4068e-06,138251350,0.987433
D.bocki,140010837,300519,1,617,4.4068e-06,138251967,0.987438
D.bocki,140010837,295901,1,617,4.4068e-06,138252584,0.987442
D.bocki,140010837,275524,1,617,4.4068e-06,138253201,0.987446
D.bocki,140010837,223268,1,617,4.4068e-06,138253818,0.987451
D.bocki,140010837,210868,1,617,4.4068e-06,138254435,0.987455
D.bocki,140010837,186644,1,617,4.4068e-06,138255052,0.98746
D.bocki,140010837,145234,1,617,4.4068e-06,138255669,0.987464
D.bocki,140010837,106116,1,617,4.4068e-06,138256286,0.987468
D.bocki,140010837,103273,1,617,4.4068e-06,138256903,0.987473
D.bocki,140010837,10211,1,617,4.4068e-06,138257520,0.987477
D.bocki,140010837,9563,1,616,4.39966e-06,138258136,0.987482
D.bocki,140010837,93879,1,616,4.39966e-06,138258752,0.987486
D.bocki,140010837,76988,1,616,4.39966e-06,138259368,0.98749
D.bocki,140010837,451440,1,616,4.39966e-06,138259984,0.987495
D.bocki,140010837,430147,1,616,4.39966e-06,138260600,0.987499
D.bocki,140010837,38717,1,616,4.39966e-06,138261216,0.987504
D.bocki,140010837,386574,1,616,4.39966e-06,138261832,0.987508
D.bocki,140010837,352890,1,616,4.39966e-06,138262448,0.987512
D.bocki,140010837,348426,1,616,4.39966e-06,138263064,0.987517
D.bocki,140010837,340190,1,616,4.39966e-06,138263680,0.987521
D.bocki,140010837,326929,1,616,4.39966e-06,138264296,0.987526
D.bocki,140010837,307772,1,616,4.39966e-06,138264912,0.98753
D.bocki,140010837,29641,1,616,4.39966e-06,138265528,0.987534
D.bocki,140010837,27531,1,616,4.39966e-06,138266144,0.987539
D.bocki,140010837,27174,1,616,4.39966e-06,138266760,0.987543
D.bocki,140010837,251506,1,616,4.39966e-06,138267376,0.987548
D.bocki,140010837,243422,1,616,4.39966e-06,138267992,0.987552
D.bocki,140010837,243340,1,616,4.39966e-06,138268608,0.987556
D.bocki,140010837,239317,1,616,4.39966e-06,138269224,0.987561
D.bocki,140010837,178584,1,616,4.39966e-06,138269840,0.987565
D.bocki,140010837,177682,1,616,4.39966e-06,138270456,0.98757
D.bocki,140010837,169323,1,616,4.39966e-06,138271072,0.987574
D.bocki,140010837,138142,1,616,4.39966e-06,138271688,0.987578
D.bocki,140010837,126316,1,616,4.39966e-06,138272304,0.987583
D.bocki,140010837,107099,1,616,4.39966e-06,138272920,0.987587
D.bocki,140010837,103812,1,616,4.39966e-06,138273536,0.987592
D.bocki,140010837,912,1,615,4.39252e-06,138274151,0.987596
D.bocki,140010837,76187,1,615,4.39252e-06,138274766,0.9876
D.bocki,140010837,571,1,615,4.39252e-06,138275381,0.987605
D.bocki,140010837,454145,1,615,4.39252e-06,138275996,0.987609
D.bocki,140010837,452080,1,615,4.39252e-06,138276611,0.987614
D.bocki,140010837,429204,1,615,4.39252e-06,138277226,0.987618
D.bocki,140010837,417882,1,615,4.39252e-06,138277841,0.987622
D.bocki,140010837,417724,1,615,4.39252e-06,138278456,0.987627
D.bocki,140010837,417492,1,615,4.39252e-06,138279071,0.987631
D.bocki,140010837,414273,1,615,4.39252e-06,138279686,0.987636
D.bocki,140010837,411214,1,615,4.39252e-06,138280301,0.98764
D.bocki,140010837,357915,1,615,4.39252e-06,138280916,0.987644
D.bocki,140010837,356898,1,615,4.39252e-06,138281531,0.987649
D.bocki,140010837,313042,1,615,4.39252e-06,138282146,0.987653
D.bocki,140010837,312864,1,615,4.39252e-06,138282761,0.987658
D.bocki,140010837,236652,1,615,4.39252e-06,138283376,0.987662
D.bocki,140010837,215186,1,615,4.39252e-06,138283991,0.987666
D.bocki,140010837,198720,1,615,4.39252e-06,138284606,0.987671
D.bocki,140010837,184299,1,615,4.39252e-06,138285221,0.987675
D.bocki,140010837,149467,1,615,4.39252e-06,138285836,0.98768
D.bocki,140010837,13692,1,615,4.39252e-06,138286451,0.987684
D.bocki,140010837,135871,1,615,4.39252e-06,138287066,0.987688
D.bocki,140010837,128212,1,615,4.39252e-06,138287681,0.987693
D.bocki,140010837,99604,1,614,4.38537e-06,138288295,0.987697
D.bocki,140010837,6059,1,614,4.38537e-06,138288909,0.987701
D.bocki,140010837,55817,1,614,4.38537e-06,138289523,0.987706
D.bocki,140010837,451467,1,614,4.38537e-06,138290137,0.98771
D.bocki,140010837,44626,1,614,4.38537e-06,138290751,0.987715
D.bocki,140010837,44400,1,614,4.38537e-06,138291365,0.987719
D.bocki,140010837,412905,1,614,4.38537e-06,138291979,0.987723
D.bocki,140010837,391586,1,614,4.38537e-06,138292593,0.987728
D.bocki,140010837,388967,1,614,4.38537e-06,138293207,0.987732
D.bocki,140010837,344046,1,614,4.38537e-06,138293821,0.987737
D.bocki,140010837,335082,1,614,4.38537e-06,138294435,0.987741
D.bocki,140010837,300594,1,614,4.38537e-06,138295049,0.987745
D.bocki,140010837,297318,1,614,4.38537e-06,138295663,0.98775
D.bocki,140010837,254307,1,614,4.38537e-06,138296277,0.987754
D.bocki,140010837,142967,1,614,4.38537e-06,138296891,0.987758
D.bocki,140010837,102546,1,614,4.38537e-06,138297505,0.987763
D.bocki,140010837,91028,1,613,4.37823e-06,138298118,0.987767
D.bocki,140010837,78481,1,613,4.37823e-06,138298731,0.987772
D.bocki,140010837,453859,1,613,4.37823e-06,138299344,0.987776
D.bocki,140010837,439978,1,613,4.37823e-06,138299957,0.98778
D.bocki,140010837,434192,1,613,4.37823e-06,138300570,0.987785
D.bocki,140010837,416541,1,613,4.37823e-06,138301183,0.987789
D.bocki,140010837,412604,1,613,4.37823e-06,138301796,0.987794
D.bocki,140010837,404199,1,613,4.37823e-06,138302409,0.987798
D.bocki,140010837,394102,1,613,4.37823e-06,138303022,0.987802
D.bocki,140010837,387734,1,613,4.37823e-06,138303635,0.987807
D.bocki,140010837,387337,1,613,4.37823e-06,138304248,0.987811
D.bocki,140010837,384037,1,613,4.37823e-06,138304861,0.987815
D.bocki,140010837,379069,1,613,4.37823e-06,138305474,0.98782
D.bocki,140010837,374473,1,613,4.37823e-06,138306087,0.987824
D.bocki,140010837,354442,1,613,4.37823e-06,138306700,0.987829
D.bocki,140010837,343020,1,613,4.37823e-06,138307313,0.987833
D.bocki,140010837,320935,1,613,4.37823e-06,138307926,0.987837
D.bocki,140010837,303537,1,613,4.37823e-06,138308539,0.987842
D.bocki,140010837,300381,1,613,4.37823e-06,138309152,0.987846
D.bocki,140010837,269926,1,613,4.37823e-06,138309765,0.98785
D.bocki,140010837,258122,1,613,4.37823e-06,138310378,0.987855
D.bocki,140010837,234608,1,613,4.37823e-06,138310991,0.987859
D.bocki,140010837,216609,1,613,4.37823e-06,138311604,0.987864
D.bocki,140010837,207783,1,613,4.37823e-06,138312217,0.987868
D.bocki,140010837,193050,1,613,4.37823e-06,138312830,0.987872
D.bocki,140010837,188524,1,613,4.37823e-06,138313443,0.987877
D.bocki,140010837,181252,1,613,4.37823e-06,138314056,0.987881
D.bocki,140010837,15818,1,613,4.37823e-06,138314669,0.987885
D.bocki,140010837,147061,1,613,4.37823e-06,138315282,0.98789
D.bocki,140010837,146510,1,613,4.37823e-06,138315895,0.987894
D.bocki,140010837,138920,1,613,4.37823e-06,138316508,0.987899
D.bocki,140010837,125503,1,613,4.37823e-06,138317121,0.987903
D.bocki,140010837,125459,1,613,4.37823e-06,138317734,0.987907
D.bocki,140010837,85603,1,612,4.37109e-06,138318346,0.987912
D.bocki,140010837,69479,1,612,4.37109e-06,138318958,0.987916
D.bocki,140010837,61403,1,612,4.37109e-06,138319570,0.98792
D.bocki,140010837,384287,1,612,4.37109e-06,138320182,0.987925
D.bocki,140010837,367211,1,612,4.37109e-06,138320794,0.987929
D.bocki,140010837,359168,1,612,4.37109e-06,138321406,0.987934
D.bocki,140010837,349175,1,612,4.37109e-06,138322018,0.987938
D.bocki,140010837,348851,1,612,4.37109e-06,138322630,0.987942
D.bocki,140010837,339544,1,612,4.37109e-06,138323242,0.987947
D.bocki,140010837,335588,1,612,4.37109e-06,138323854,0.987951
D.bocki,140010837,312546,1,612,4.37109e-06,138324466,0.987955
D.bocki,140010837,3122,1,612,4.37109e-06,138325078,0.98796
D.bocki,140010837,310771,1,612,4.37109e-06,138325690,0.987964
D.bocki,140010837,285204,1,612,4.37109e-06,138326302,0.987969
D.bocki,140010837,27964,1,612,4.37109e-06,138326914,0.987973
D.bocki,140010837,246616,1,612,4.37109e-06,138327526,0.987977
D.bocki,140010837,220268,1,612,4.37109e-06,138328138,0.987982
D.bocki,140010837,211105,1,612,4.37109e-06,138328750,0.987986
D.bocki,140010837,19516,1,612,4.37109e-06,138329362,0.98799
D.bocki,140010837,178027,1,612,4.37109e-06,138329974,0.987995
D.bocki,140010837,170162,1,612,4.37109e-06,138330586,0.987999
D.bocki,140010837,127102,1,612,4.37109e-06,138331198,0.988004
D.bocki,140010837,125237,1,612,4.37109e-06,138331810,0.988008
D.bocki,140010837,104734,1,612,4.37109e-06,138332422,0.988012
D.bocki,140010837,78184,1,611,4.36395e-06,138333033,0.988017
D.bocki,140010837,76040,1,611,4.36395e-06,138333644,0.988021
D.bocki,140010837,63363,1,611,4.36395e-06,138334255,0.988025
D.bocki,140010837,45383,1,611,4.36395e-06,138334866,0.98803
D.bocki,140010837,448526,1,611,4.36395e-06,138335477,0.988034
D.bocki,140010837,417544,1,611,4.36395e-06,138336088,0.988038
D.bocki,140010837,402143,1,611,4.36395e-06,138336699,0.988043
D.bocki,140010837,380082,1,611,4.36395e-06,138337310,0.988047
D.bocki,140010837,356039,1,611,4.36395e-06,138337921,0.988052
D.bocki,140010837,349479,1,611,4.36395e-06,138338532,0.988056
D.bocki,140010837,315271,1,611,4.36395e-06,138339143,0.98806
D.bocki,140010837,281144,1,611,4.36395e-06,138339754,0.988065
D.bocki,140010837,279035,1,611,4.36395e-06,138340365,0.988069
D.bocki,140010837,278143,1,611,4.36395e-06,138340976,0.988073
D.bocki,140010837,26072,1,611,4.36395e-06,138341587,0.988078
D.bocki,140010837,24256,1,611,4.36395e-06,138342198,0.988082
D.bocki,140010837,232713,1,611,4.36395e-06,138342809,0.988086
D.bocki,140010837,219577,1,611,4.36395e-06,138343420,0.988091
D.bocki,140010837,214226,1,611,4.36395e-06,138344031,0.988095
D.bocki,140010837,209900,1,611,4.36395e-06,138344642,0.9881
D.bocki,140010837,166819,1,611,4.36395e-06,138345253,0.988104
D.bocki,140010837,155447,1,611,4.36395e-06,138345864,0.988108
D.bocki,140010837,149719,1,611,4.36395e-06,138346475,0.988113
D.bocki,140010837,148149,1,611,4.36395e-06,138347086,0.988117
D.bocki,140010837,112527,1,611,4.36395e-06,138347697,0.988121
D.bocki,140010837,111330,1,611,4.36395e-06,138348308,0.988126
D.bocki,140010837,98676,1,610,4.35681e-06,138348918,0.98813
D.bocki,140010837,454737,1,610,4.35681e-06,138349528,0.988134
D.bocki,140010837,452986,1,610,4.35681e-06,138350138,0.988139
D.bocki,140010837,449037,1,610,4.35681e-06,138350748,0.988143
D.bocki,140010837,387406,1,610,4.35681e-06,138351358,0.988147
D.bocki,140010837,360129,1,610,4.35681e-06,138351968,0.988152
D.bocki,140010837,359649,1,610,4.35681e-06,138352578,0.988156
D.bocki,140010837,343076,1,610,4.35681e-06,138353188,0.988161
D.bocki,140010837,295809,1,610,4.35681e-06,138353798,0.988165
D.bocki,140010837,282988,1,610,4.35681e-06,138354408,0.988169
D.bocki,140010837,273359,1,610,4.35681e-06,138355018,0.988174
D.bocki,140010837,262130,1,610,4.35681e-06,138355628,0.988178
D.bocki,140010837,249788,1,610,4.35681e-06,138356238,0.988182
D.bocki,140010837,212082,1,610,4.35681e-06,138356848,0.988187
D.bocki,140010837,189349,1,610,4.35681e-06,138357458,0.988191
D.bocki,140010837,166035,1,610,4.35681e-06,138358068,0.988195
D.bocki,140010837,15912,1,610,4.35681e-06,138358678,0.9882
D.bocki,140010837,135510,1,610,4.35681e-06,138359288,0.988204
D.bocki,140010837,11424,1,610,4.35681e-06,138359898,0.988208
D.bocki,140010837,103029,1,610,4.35681e-06,138360508,0.988213
D.bocki,140010837,70999,1,609,4.34966e-06,138361117,0.988217
D.bocki,140010837,51005,1,609,4.34966e-06,138361726,0.988222
D.bocki,140010837,454210,1,609,4.34966e-06,138362335,0.988226
D.bocki,140010837,453934,1,609,4.34966e-06,138362944,0.98823
D.bocki,140010837,451832,1,609,4.34966e-06,138363553,0.988235
D.bocki,140010837,423760,1,609,4.34966e-06,138364162,0.988239
D.bocki,140010837,394993,1,609,4.34966e-06,138364771,0.988243
D.bocki,140010837,381599,1,609,4.34966e-06,138365380,0.988248
D.bocki,140010837,367497,1,609,4.34966e-06,138365989,0.988252
D.bocki,140010837,340191,1,609,4.34966e-06,138366598,0.988256
D.bocki,140010837,333301,1,609,4.34966e-06,138367207,0.988261
D.bocki,140010837,309057,1,609,4.34966e-06,138367816,0.988265
D.bocki,140010837,296209,1,609,4.34966e-06,138368425,0.988269
D.bocki,140010837,257638,1,609,4.34966e-06,138369034,0.988274
D.bocki,140010837,230987,1,609,4.34966e-06,138369643,0.988278
D.bocki,140010837,216610,1,609,4.34966e-06,138370252,0.988282
D.bocki,140010837,194525,1,609,4.34966e-06,138370861,0.988287
D.bocki,140010837,192781,1,609,4.34966e-06,138371470,0.988291
D.bocki,140010837,165813,1,609,4.34966e-06,138372079,0.988295
D.bocki,140010837,135635,1,609,4.34966e-06,138372688,0.9883
D.bocki,140010837,132043,1,609,4.34966e-06,138373297,0.988304
D.bocki,140010837,126972,1,609,4.34966e-06,138373906,0.988309
D.bocki,140010837,80827,1,608,4.34252e-06,138374514,0.988313
D.bocki,140010837,77793,1,608,4.34252e-06,138375122,0.988317
D.bocki,140010837,68110,1,608,4.34252e-06,138375730,0.988322
D.bocki,140010837,454642,1,608,4.34252e-06,138376338,0.988326
D.bocki,140010837,440486,1,608,4.34252e-06,138376946,0.98833
D.bocki,140010837,411875,1,608,4.34252e-06,138377554,0.988335
D.bocki,140010837,40128,1,608,4.34252e-06,138378162,0.988339
D.bocki,140010837,373662,1,608,4.34252e-06,138378770,0.988343
D.bocki,140010837,367795,1,608,4.34252e-06,138379378,0.988348
D.bocki,140010837,318235,1,608,4.34252e-06,138379986,0.988352
D.bocki,140010837,287979,1,608,4.34252e-06,138380594,0.988356
D.bocki,140010837,281700,1,608,4.34252e-06,138381202,0.988361
D.bocki,140010837,268404,1,608,4.34252e-06,138381810,0.988365
D.bocki,140010837,241537,1,608,4.34252e-06,138382418,0.988369
D.bocki,140010837,212169,1,608,4.34252e-06,138383026,0.988374
D.bocki,140010837,183423,1,608,4.34252e-06,138383634,0.988378
D.bocki,140010837,174393,1,608,4.34252e-06,138384242,0.988382
D.bocki,140010837,131565,1,608,4.34252e-06,138384850,0.988387
D.bocki,140010837,121749,1,608,4.34252e-06,138385458,0.988391
D.bocki,140010837,109908,1,608,4.34252e-06,138386066,0.988395
D.bocki,140010837,107231,1,608,4.34252e-06,138386674,0.9884
D.bocki,140010837,81034,1,607,4.33538e-06,138387281,0.988404
D.bocki,140010837,76158,1,607,4.33538e-06,138387888,0.988408
D.bocki,140010837,49340,1,607,4.33538e-06,138388495,0.988413
D.bocki,140010837,453438,1,607,4.33538e-06,138389102,0.988417
D.bocki,140010837,434134,1,607,4.33538e-06,138389709,0.988421
D.bocki,140010837,356925,1,607,4.33538e-06,138390316,0.988426
D.bocki,140010837,353081,1,607,4.33538e-06,138390923,0.98843
D.bocki,140010837,328927,1,607,4.33538e-06,138391530,0.988434
D.bocki,140010837,324627,1,607,4.33538e-06,138392137,0.988439
D.bocki,140010837,306109,1,607,4.33538e-06,138392744,0.988443
D.bocki,140010837,299314,1,607,4.33538e-06,138393351,0.988447
D.bocki,140010837,271949,1,607,4.33538e-06,138393958,0.988452
D.bocki,140010837,257298,1,607,4.33538e-06,138394565,0.988456
D.bocki,140010837,251242,1,607,4.33538e-06,138395172,0.98846
D.bocki,140010837,238978,1,607,4.33538e-06,138395779,0.988465
D.bocki,140010837,209486,1,607,4.33538e-06,138396386,0.988469
D.bocki,140010837,196166,1,607,4.33538e-06,138396993,0.988473
D.bocki,140010837,170284,1,607,4.33538e-06,138397600,0.988478
D.bocki,140010837,142606,1,607,4.33538e-06,138398207,0.988482
D.bocki,140010837,130707,1,607,4.33538e-06,138398814,0.988486
D.bocki,140010837,120658,1,607,4.33538e-06,138399421,0.988491
D.bocki,140010837,11824,1,607,4.33538e-06,138400028,0.988495
D.bocki,140010837,114238,1,607,4.33538e-06,138400635,0.988499
D.bocki,140010837,113544,1,607,4.33538e-06,138401242,0.988504
D.bocki,140010837,87699,1,606,4.32824e-06,138401848,0.988508
D.bocki,140010837,6959,1,606,4.32824e-06,138402454,0.988512
D.bocki,140010837,401610,1,606,4.32824e-06,138403060,0.988517
D.bocki,140010837,385981,1,606,4.32824e-06,138403666,0.988521
D.bocki,140010837,382136,1,606,4.32824e-06,138404272,0.988525
D.bocki,140010837,378638,1,606,4.32824e-06,138404878,0.98853
D.bocki,140010837,371585,1,606,4.32824e-06,138405484,0.988534
D.bocki,140010837,331563,1,606,4.32824e-06,138406090,0.988538
D.bocki,140010837,318305,1,606,4.32824e-06,138406696,0.988543
D.bocki,140010837,260662,1,606,4.32824e-06,138407302,0.988547
D.bocki,140010837,242071,1,606,4.32824e-06,138407908,0.988551
D.bocki,140010837,227553,1,606,4.32824e-06,138408514,0.988556
D.bocki,140010837,224430,1,606,4.32824e-06,138409120,0.98856
D.bocki,140010837,21641,1,606,4.32824e-06,138409726,0.988564
D.bocki,140010837,204240,1,606,4.32824e-06,138410332,0.988569
D.bocki,140010837,196322,1,606,4.32824e-06,138410938,0.988573
D.bocki,140010837,194909,1,606,4.32824e-06,138411544,0.988577
D.bocki,140010837,193695,1,606,4.32824e-06,138412150,0.988582
D.bocki,140010837,192160,1,606,4.32824e-06,138412756,0.988586
D.bocki,140010837,184204,1,606,4.32824e-06,138413362,0.98859
D.bocki,140010837,183118,1,606,4.32824e-06,138413968,0.988595
D.bocki,140010837,102603,1,606,4.32824e-06,138414574,0.988599
D.bocki,140010837,83379,1,605,4.32109e-06,138415179,0.988603
D.bocki,140010837,75082,1,605,4.32109e-06,138415784,0.988608
D.bocki,140010837,451791,1,605,4.32109e-06,138416389,0.988612
D.bocki,140010837,451637,1,605,4.32109e-06,138416994,0.988616
D.bocki,140010837,442181,1,605,4.32109e-06,138417599,0.988621
D.bocki,140010837,41633,1,605,4.32109e-06,138418204,0.988625
D.bocki,140010837,372699,1,605,4.32109e-06,138418809,0.988629
D.bocki,140010837,331414,1,605,4.32109e-06,138419414,0.988634
D.bocki,140010837,327112,1,605,4.32109e-06,138420019,0.988638
D.bocki,140010837,32611,1,605,4.32109e-06,138420624,0.988642
D.bocki,140010837,323489,1,605,4.32109e-06,138421229,0.988647
D.bocki,140010837,313105,1,605,4.32109e-06,138421834,0.988651
D.bocki,140010837,29639,1,605,4.32109e-06,138422439,0.988655
D.bocki,140010837,278493,1,605,4.32109e-06,138423044,0.988659
D.bocki,140010837,243396,1,605,4.32109e-06,138423649,0.988664
D.bocki,140010837,23585,1,605,4.32109e-06,138424254,0.988668
D.bocki,140010837,233245,1,605,4.32109e-06,138424859,0.988672
D.bocki,140010837,228356,1,605,4.32109e-06,138425464,0.988677
D.bocki,140010837,185230,1,605,4.32109e-06,138426069,0.988681
D.bocki,140010837,171203,1,605,4.32109e-06,138426674,0.988685
D.bocki,140010837,160888,1,605,4.32109e-06,138427279,0.98869
D.bocki,140010837,155794,1,605,4.32109e-06,138427884,0.988694
D.bocki,140010837,135708,1,605,4.32109e-06,138428489,0.988698
D.bocki,140010837,9828,1,604,4.31395e-06,138429093,0.988703
D.bocki,140010837,69969,1,604,4.31395e-06,138429697,0.988707
D.bocki,140010837,52096,1,604,4.31395e-06,138430301,0.988711
D.bocki,140010837,407949,1,604,4.31395e-06,138430905,0.988716
D.bocki,140010837,397749,1,604,4.31395e-06,138431509,0.98872
D.bocki,140010837,392825,1,604,4.31395e-06,138432113,0.988724
D.bocki,140010837,387512,1,604,4.31395e-06,138432717,0.988729
D.bocki,140010837,34720,1,604,4.31395e-06,138433321,0.988733
D.bocki,140010837,301218,1,604,4.31395e-06,138433925,0.988737
D.bocki,140010837,300257,1,604,4.31395e-06,138434529,0.988742
D.bocki,140010837,268985,1,604,4.31395e-06,138435133,0.988746
D.bocki,140010837,267002,1,604,4.31395e-06,138435737,0.98875
D.bocki,140010837,260708,1,604,4.31395e-06,138436341,0.988754
D.bocki,140010837,254245,1,604,4.31395e-06,138436945,0.988759
D.bocki,140010837,207104,1,604,4.31395e-06,138437549,0.988763
D.bocki,140010837,191453,1,604,4.31395e-06,138438153,0.988767
D.bocki,140010837,178713,1,604,4.31395e-06,138438757,0.988772
D.bocki,140010837,170649,1,604,4.31395e-06,138439361,0.988776
D.bocki,140010837,151975,1,604,4.31395e-06,138439965,0.98878
D.bocki,140010837,149918,1,604,4.31395e-06,138440569,0.988785
D.bocki,140010837,140273,1,604,4.31395e-06,138441173,0.988789
D.bocki,140010837,134596,1,604,4.31395e-06,138441777,0.988793
D.bocki,140010837,75642,1,603,4.30681e-06,138442380,0.988798
D.bocki,140010837,74850,1,603,4.30681e-06,138442983,0.988802
D.bocki,140010837,51234,1,603,4.30681e-06,138443586,0.988806
D.bocki,140010837,45162,1,603,4.30681e-06,138444189,0.988811
D.bocki,140010837,416342,1,603,4.30681e-06,138444792,0.988815
D.bocki,140010837,385543,1,603,4.30681e-06,138445395,0.988819
D.bocki,140010837,378336,1,603,4.30681e-06,138445998,0.988823
D.bocki,140010837,356833,1,603,4.30681e-06,138446601,0.988828
D.bocki,140010837,324890,1,603,4.30681e-06,138447204,0.988832
D.bocki,140010837,300345,1,603,4.30681e-06,138447807,0.988836
D.bocki,140010837,244081,1,603,4.30681e-06,138448410,0.988841
D.bocki,140010837,233760,1,603,4.30681e-06,138449013,0.988845
D.bocki,140010837,214417,1,603,4.30681e-06,138449616,0.988849
D.bocki,140010837,212806,1,603,4.30681e-06,138450219,0.988854
D.bocki,140010837,211290,1,603,4.30681e-06,138450822,0.988858
D.bocki,140010837,210685,1,603,4.30681e-06,138451425,0.988862
D.bocki,140010837,171308,1,603,4.30681e-06,138452028,0.988867
D.bocki,140010837,152566,1,603,4.30681e-06,138452631,0.988871
D.bocki,140010837,90918,1,602,4.29967e-06,138453233,0.988875
D.bocki,140010837,83119,1,602,4.29967e-06,138453835,0.988879
D.bocki,140010837,47927,1,602,4.29967e-06,138454437,0.988884
D.bocki,140010837,431160,1,602,4.29967e-06,138455039,0.988888
D.bocki,140010837,389829,1,602,4.29967e-06,138455641,0.988892
D.bocki,140010837,372477,1,602,4.29967e-06,138456243,0.988897
D.bocki,140010837,360039,1,602,4.29967e-06,138456845,0.988901
D.bocki,140010837,358139,1,602,4.29967e-06,138457447,0.988905
D.bocki,140010837,333820,1,602,4.29967e-06,138458049,0.98891
D.bocki,140010837,321460,1,602,4.29967e-06,138458651,0.988914
D.bocki,140010837,300970,1,602,4.29967e-06,138459253,0.988918
D.bocki,140010837,298584,1,602,4.29967e-06,138459855,0.988922
D.bocki,140010837,265961,1,602,4.29967e-06,138460457,0.988927
D.bocki,140010837,219114,1,602,4.29967e-06,138461059,0.988931
D.bocki,140010837,218081,1,602,4.29967e-06,138461661,0.988935
D.bocki,140010837,182805,1,602,4.29967e-06,138462263,0.98894
D.bocki,140010837,13867,1,602,4.29967e-06,138462865,0.988944
D.bocki,140010837,131409,1,602,4.29967e-06,138463467,0.988948
D.bocki,140010837,121501,1,602,4.29967e-06,138464069,0.988953
D.bocki,140010837,103811,1,602,4.29967e-06,138464671,0.988957
D.bocki,140010837,101865,1,602,4.29967e-06,138465273,0.988961
D.bocki,140010837,93317,1,601,4.29252e-06,138465874,0.988965
D.bocki,140010837,8671,1,601,4.29252e-06,138466475,0.98897
D.bocki,140010837,7540,1,601,4.29252e-06,138467076,0.988974
D.bocki,140010837,40159,1,601,4.29252e-06,138467677,0.988978
D.bocki,140010837,398127,1,601,4.29252e-06,138468278,0.988983
D.bocki,140010837,389572,1,601,4.29252e-06,138468879,0.988987
D.bocki,140010837,361017,1,601,4.29252e-06,138469480,0.988991
D.bocki,140010837,340592,1,601,4.29252e-06,138470081,0.988995
D.bocki,140010837,287156,1,601,4.29252e-06,138470682,0.989
D.bocki,140010837,271720,1,601,4.29252e-06,138471283,0.989004
D.bocki,140010837,251335,1,601,4.29252e-06,138471884,0.989008
D.bocki,140010837,222448,1,601,4.29252e-06,138472485,0.989013
D.bocki,140010837,214125,1,601,4.29252e-06,138473086,0.989017
D.bocki,140010837,205221,1,601,4.29252e-06,138473687,0.989021
D.bocki,140010837,181796,1,601,4.29252e-06,138474288,0.989025
D.bocki,140010837,17270,1,601,4.29252e-06,138474889,0.98903
D.bocki,140010837,159189,1,601,4.29252e-06,138475490,0.989034
D.bocki,140010837,142840,1,601,4.29252e-06,138476091,0.989038
D.bocki,140010837,142670,1,601,4.29252e-06,138476692,0.989043
D.bocki,140010837,78217,1,600,4.28538e-06,138477292,0.989047
D.bocki,140010837,454404,1,600,4.28538e-06,138477892,0.989051
D.bocki,140010837,454239,1,600,4.28538e-06,138478492,0.989056
D.bocki,140010837,44798,1,600,4.28538e-06,138479092,0.98906
D.bocki,140010837,445501,1,600,4.28538e-06,138479692,0.989064
D.bocki,140010837,437690,1,600,4.28538e-06,138480292,0.989068
D.bocki,140010837,431969,1,600,4.28538e-06,138480892,0.989073
D.bocki,140010837,428665,1,600,4.28538e-06,138481492,0.989077
D.bocki,140010837,41725,1,600,4.28538e-06,138482092,0.989081
D.bocki,140010837,396676,1,600,4.28538e-06,138482692,0.989086
D.bocki,140010837,396173,1,600,4.28538e-06,138483292,0.98909
D.bocki,140010837,385450,1,600,4.28538e-06,138483892,0.989094
D.bocki,140010837,385420,1,600,4.28538e-06,138484492,0.989098
D.bocki,140010837,380667,1,600,4.28538e-06,138485092,0.989103
D.bocki,140010837,37972,1,600,4.28538e-06,138485692,0.989107
D.bocki,140010837,375785,1,600,4.28538e-06,138486292,0.989111
D.bocki,140010837,359324,1,600,4.28538e-06,138486892,0.989116
D.bocki,140010837,346521,1,600,4.28538e-06,138487492,0.98912
D.bocki,140010837,331056,1,600,4.28538e-06,138488092,0.989124
D.bocki,140010837,324414,1,600,4.28538e-06,138488692,0.989128
D.bocki,140010837,29679,1,600,4.28538e-06,138489292,0.989133
D.bocki,140010837,250428,1,600,4.28538e-06,138489892,0.989137
D.bocki,140010837,242101,1,600,4.28538e-06,138490492,0.989141
D.bocki,140010837,19438,1,600,4.28538e-06,138491092,0.989146
D.bocki,140010837,156652,1,600,4.28538e-06,138491692,0.98915
D.bocki,140010837,131519,1,600,4.28538e-06,138492292,0.989154
D.bocki,140010837,80792,1,599,4.27824e-06,138492891,0.989158
D.bocki,140010837,78245,1,599,4.27824e-06,138493490,0.989163
D.bocki,140010837,68348,1,599,4.27824e-06,138494089,0.989167
D.bocki,140010837,452084,1,599,4.27824e-06,138494688,0.989171
D.bocki,140010837,447909,1,599,4.27824e-06,138495287,0.989175
D.bocki,140010837,430505,1,599,4.27824e-06,138495886,0.98918
D.bocki,140010837,423165,1,599,4.27824e-06,138496485,0.989184
D.bocki,140010837,372574,1,599,4.27824e-06,138497084,0.989188
D.bocki,140010837,360421,1,599,4.27824e-06,138497683,0.989193
D.bocki,140010837,349551,1,599,4.27824e-06,138498282,0.989197
D.bocki,140010837,341487,1,599,4.27824e-06,138498881,0.989201
D.bocki,140010837,299756,1,599,4.27824e-06,138499480,0.989205
D.bocki,140010837,258965,1,599,4.27824e-06,138500079,0.98921
D.bocki,140010837,252770,1,599,4.27824e-06,138500678,0.989214
D.bocki,140010837,234097,1,599,4.27824e-06,138501277,0.989218
D.bocki,140010837,231399,1,599,4.27824e-06,138501876,0.989223
D.bocki,140010837,22664,1,599,4.27824e-06,138502475,0.989227
D.bocki,140010837,225384,1,599,4.27824e-06,138503074,0.989231
D.bocki,140010837,222430,1,599,4.27824e-06,138503673,0.989235
D.bocki,140010837,214289,1,599,4.27824e-06,138504272,0.98924
D.bocki,140010837,194320,1,599,4.27824e-06,138504871,0.989244
D.bocki,140010837,191374,1,599,4.27824e-06,138505470,0.989248
D.bocki,140010837,156285,1,599,4.27824e-06,138506069,0.989252
D.bocki,140010837,154365,1,599,4.27824e-06,138506668,0.989257
D.bocki,140010837,151194,1,599,4.27824e-06,138507267,0.989261
D.bocki,140010837,142605,1,599,4.27824e-06,138507866,0.989265
D.bocki,140010837,120450,1,599,4.27824e-06,138508465,0.98927
D.bocki,140010837,11571,1,599,4.27824e-06,138509064,0.989274
D.bocki,140010837,104160,1,599,4.27824e-06,138509663,0.989278
D.bocki,140010837,453715,1,598,4.2711e-06,138510261,0.989282
D.bocki,140010837,453675,1,598,4.2711e-06,138510859,0.989287
D.bocki,140010837,450866,1,598,4.2711e-06,138511457,0.989291
D.bocki,140010837,447245,1,598,4.2711e-06,138512055,0.989295
D.bocki,140010837,414048,1,598,4.2711e-06,138512653,0.9893
D.bocki,140010837,407919,1,598,4.2711e-06,138513251,0.989304
D.bocki,140010837,40232,1,598,4.2711e-06,138513849,0.989308
D.bocki,140010837,400994,1,598,4.2711e-06,138514447,0.989312
D.bocki,140010837,361373,1,598,4.2711e-06,138515045,0.989317
D.bocki,140010837,345823,1,598,4.2711e-06,138515643,0.989321
D.bocki,140010837,331637,1,598,4.2711e-06,138516241,0.989325
D.bocki,140010837,331057,1,598,4.2711e-06,138516839,0.989329
D.bocki,140010837,327247,1,598,4.2711e-06,138517437,0.989334
D.bocki,140010837,314814,1,598,4.2711e-06,138518035,0.989338
D.bocki,140010837,310443,1,598,4.2711e-06,138518633,0.989342
D.bocki,140010837,267746,1,598,4.2711e-06,138519231,0.989346
D.bocki,140010837,227927,1,598,4.2711e-06,138519829,0.989351
D.bocki,140010837,214288,1,598,4.2711e-06,138520427,0.989355
D.bocki,140010837,201507,1,598,4.2711e-06,138521025,0.989359
D.bocki,140010837,194319,1,598,4.2711e-06,138521623,0.989364
D.bocki,140010837,167269,1,598,4.2711e-06,138522221,0.989368
D.bocki,140010837,161888,1,598,4.2711e-06,138522819,0.989372
D.bocki,140010837,141964,1,598,4.2711e-06,138523417,0.989376
D.bocki,140010837,13158,1,598,4.2711e-06,138524015,0.989381
D.bocki,140010837,10821,1,598,4.2711e-06,138524613,0.989385
D.bocki,140010837,450699,1,597,4.26396e-06,138525210,0.989389
D.bocki,140010837,448795,1,597,4.26396e-06,138525807,0.989393
D.bocki,140010837,436136,1,597,4.26396e-06,138526404,0.989398
D.bocki,140010837,421533,1,597,4.26396e-06,138527001,0.989402
D.bocki,140010837,391504,1,597,4.26396e-06,138527598,0.989406
D.bocki,140010837,384862,1,597,4.26396e-06,138528195,0.989411
D.bocki,140010837,379251,1,597,4.26396e-06,138528792,0.989415
D.bocki,140010837,37690,1,597,4.26396e-06,138529389,0.989419
D.bocki,140010837,35552,1,597,4.26396e-06,138529986,0.989423
D.bocki,140010837,323366,1,597,4.26396e-06,138530583,0.989428
D.bocki,140010837,282143,1,597,4.26396e-06,138531180,0.989432
D.bocki,140010837,227255,1,597,4.26396e-06,138531777,0.989436
D.bocki,140010837,21189,1,597,4.26396e-06,138532374,0.98944
D.bocki,140010837,203247,1,597,4.26396e-06,138532971,0.989445
D.bocki,140010837,19216,1,597,4.26396e-06,138533568,0.989449
D.bocki,140010837,185997,1,597,4.26396e-06,138534165,0.989453
D.bocki,140010837,170673,1,597,4.26396e-06,138534762,0.989457
D.bocki,140010837,137430,1,597,4.26396e-06,138535359,0.989462
D.bocki,140010837,130587,1,597,4.26396e-06,138535956,0.989466
D.bocki,140010837,451360,1,596,4.25681e-06,138536552,0.98947
D.bocki,140010837,434395,1,596,4.25681e-06,138537148,0.989474
D.bocki,140010837,431841,1,596,4.25681e-06,138537744,0.989479
D.bocki,140010837,41666,1,596,4.25681e-06,138538340,0.989483
D.bocki,140010837,388156,1,596,4.25681e-06,138538936,0.989487
D.bocki,140010837,370274,1,596,4.25681e-06,138539532,0.989491
D.bocki,140010837,329528,1,596,4.25681e-06,138540128,0.989496
D.bocki,140010837,265852,1,596,4.25681e-06,138540724,0.9895
D.bocki,140010837,227728,1,596,4.25681e-06,138541320,0.989504
D.bocki,140010837,198098,1,596,4.25681e-06,138541916,0.989509
D.bocki,140010837,188577,1,596,4.25681e-06,138542512,0.989513
D.bocki,140010837,180557,1,596,4.25681e-06,138543108,0.989517
D.bocki,140010837,174575,1,596,4.25681e-06,138543704,0.989521
D.bocki,140010837,170793,1,596,4.25681e-06,138544300,0.989526
D.bocki,140010837,127421,1,596,4.25681e-06,138544896,0.98953
D.bocki,140010837,100726,1,596,4.25681e-06,138545492,0.989534
D.bocki,140010837,93621,1,595,4.24967e-06,138546087,0.989538
D.bocki,140010837,88850,1,595,4.24967e-06,138546682,0.989543
D.bocki,140010837,81057,1,595,4.24967e-06,138547277,0.989547
D.bocki,140010837,60034,1,595,4.24967e-06,138547872,0.989551
D.bocki,140010837,38969,1,595,4.24967e-06,138548467,0.989555
D.bocki,140010837,372266,1,595,4.24967e-06,138549062,0.98956
D.bocki,140010837,320165,1,595,4.24967e-06,138549657,0.989564
D.bocki,140010837,298079,1,595,4.24967e-06,138550252,0.989568
D.bocki,140010837,274244,1,595,4.24967e-06,138550847,0.989572
D.bocki,140010837,247209,1,595,4.24967e-06,138551442,0.989577
D.bocki,140010837,237040,1,595,4.24967e-06,138552037,0.989581
D.bocki,140010837,176759,1,595,4.24967e-06,138552632,0.989585
D.bocki,140010837,174535,1,595,4.24967e-06,138553227,0.989589
D.bocki,140010837,164809,1,595,4.24967e-06,138553822,0.989594
D.bocki,140010837,133094,1,595,4.24967e-06,138554417,0.989598
D.bocki,140010837,126129,1,595,4.24967e-06,138555012,0.989602
D.bocki,140010837,103705,1,595,4.24967e-06,138555607,0.989606
D.bocki,140010837,87525,1,594,4.24253e-06,138556201,0.989611
D.bocki,140010837,53914,1,594,4.24253e-06,138556795,0.989615
D.bocki,140010837,452293,1,594,4.24253e-06,138557389,0.989619
D.bocki,140010837,4488,1,594,4.24253e-06,138557983,0.989623
D.bocki,140010837,448172,1,594,4.24253e-06,138558577,0.989628
D.bocki,140010837,400554,1,594,4.24253e-06,138559171,0.989632
D.bocki,140010837,387907,1,594,4.24253e-06,138559765,0.989636
D.bocki,140010837,386014,1,594,4.24253e-06,138560359,0.98964
D.bocki,140010837,38504,1,594,4.24253e-06,138560953,0.989644
D.bocki,140010837,329973,1,594,4.24253e-06,138561547,0.989649
D.bocki,140010837,324747,1,594,4.24253e-06,138562141,0.989653
D.bocki,140010837,309783,1,594,4.24253e-06,138562735,0.989657
D.bocki,140010837,290666,1,594,4.24253e-06,138563329,0.989661
D.bocki,140010837,286938,1,594,4.24253e-06,138563923,0.989666
D.bocki,140010837,281482,1,594,4.24253e-06,138564517,0.98967
D.bocki,140010837,2409,1,594,4.24253e-06,138565111,0.989674
D.bocki,140010837,224766,1,594,4.24253e-06,138565705,0.989678
D.bocki,140010837,208423,1,594,4.24253e-06,138566299,0.989683
D.bocki,140010837,170625,1,594,4.24253e-06,138566893,0.989687
D.bocki,140010837,165341,1,594,4.24253e-06,138567487,0.989691
D.bocki,140010837,161167,1,594,4.24253e-06,138568081,0.989695
D.bocki,140010837,141382,1,594,4.24253e-06,138568675,0.9897
D.bocki,140010837,124439,1,594,4.24253e-06,138569269,0.989704
D.bocki,140010837,11901,1,594,4.24253e-06,138569863,0.989708
D.bocki,140010837,107071,1,594,4.24253e-06,138570457,0.989712
D.bocki,140010837,59388,1,593,4.23539e-06,138571050,0.989717
D.bocki,140010837,5210,1,593,4.23539e-06,138571643,0.989721
D.bocki,140010837,46611,1,593,4.23539e-06,138572236,0.989725
D.bocki,140010837,454470,1,593,4.23539e-06,138572829,0.989729
D.bocki,140010837,443209,1,593,4.23539e-06,138573422,0.989734
D.bocki,140010837,426948,1,593,4.23539e-06,138574015,0.989738
D.bocki,140010837,419133,1,593,4.23539e-06,138574608,0.989742
D.bocki,140010837,366387,1,593,4.23539e-06,138575201,0.989746
D.bocki,140010837,362325,1,593,4.23539e-06,138575794,0.98975
D.bocki,140010837,32548,1,593,4.23539e-06,138576387,0.989755
D.bocki,140010837,282352,1,593,4.23539e-06,138576980,0.989759
D.bocki,140010837,263351,1,593,4.23539e-06,138577573,0.989763
D.bocki,140010837,250969,1,593,4.23539e-06,138578166,0.989767
D.bocki,140010837,230026,1,593,4.23539e-06,138578759,0.989772
D.bocki,140010837,175758,1,593,4.23539e-06,138579352,0.989776
D.bocki,140010837,165318,1,593,4.23539e-06,138579945,0.98978
D.bocki,140010837,153189,1,593,4.23539e-06,138580538,0.989784
D.bocki,140010837,126227,1,593,4.23539e-06,138581131,0.989789
D.bocki,140010837,112017,1,593,4.23539e-06,138581724,0.989793
D.bocki,140010837,8228,1,592,4.22824e-06,138582316,0.989797
D.bocki,140010837,66557,1,592,4.22824e-06,138582908,0.989801
D.bocki,140010837,46454,1,592,4.22824e-06,138583500,0.989806
D.bocki,140010837,453124,1,592,4.22824e-06,138584092,0.98981
D.bocki,140010837,39557,1,592,4.22824e-06,138584684,0.989814
D.bocki,140010837,383038,1,592,4.22824e-06,138585276,0.989818
D.bocki,140010837,372422,1,592,4.22824e-06,138585868,0.989822
D.bocki,140010837,358344,1,592,4.22824e-06,138586460,0.989827
D.bocki,140010837,344327,1,592,4.22824e-06,138587052,0.989831
D.bocki,140010837,343633,1,592,4.22824e-06,138587644,0.989835
D.bocki,140010837,331882,1,592,4.22824e-06,138588236,0.989839
D.bocki,140010837,326856,1,592,4.22824e-06,138588828,0.989844
D.bocki,140010837,237665,1,592,4.22824e-06,138589420,0.989848
D.bocki,140010837,217518,1,592,4.22824e-06,138590012,0.989852
D.bocki,140010837,2168,1,592,4.22824e-06,138590604,0.989856
D.bocki,140010837,210732,1,592,4.22824e-06,138591196,0.98986
D.bocki,140010837,186643,1,592,4.22824e-06,138591788,0.989865
D.bocki,140010837,176655,1,592,4.22824e-06,138592380,0.989869
D.bocki,140010837,174221,1,592,4.22824e-06,138592972,0.989873
D.bocki,140010837,162416,1,592,4.22824e-06,138593564,0.989877
D.bocki,140010837,157117,1,592,4.22824e-06,138594156,0.989882
D.bocki,140010837,8430,1,591,4.2211e-06,138594747,0.989886
D.bocki,140010837,77864,1,591,4.2211e-06,138595338,0.98989
D.bocki,140010837,68885,1,591,4.2211e-06,138595929,0.989894
D.bocki,140010837,58037,1,591,4.2211e-06,138596520,0.989899
D.bocki,140010837,450032,1,591,4.2211e-06,138597111,0.989903
D.bocki,140010837,446860,1,591,4.2211e-06,138597702,0.989907
D.bocki,140010837,433573,1,591,4.2211e-06,138598293,0.989911
D.bocki,140010837,43002,1,591,4.2211e-06,138598884,0.989915
D.bocki,140010837,399645,1,591,4.2211e-06,138599475,0.98992
D.bocki,140010837,373772,1,591,4.2211e-06,138600066,0.989924
D.bocki,140010837,367658,1,591,4.2211e-06,138600657,0.989928
D.bocki,140010837,342668,1,591,4.2211e-06,138601248,0.989932
D.bocki,140010837,326928,1,591,4.2211e-06,138601839,0.989937
D.bocki,140010837,296319,1,591,4.2211e-06,138602430,0.989941
D.bocki,140010837,271765,1,591,4.2211e-06,138603021,0.989945
D.bocki,140010837,256239,1,591,4.2211e-06,138603612,0.989949
D.bocki,140010837,254648,1,591,4.2211e-06,138604203,0.989953
D.bocki,140010837,221022,1,591,4.2211e-06,138604794,0.989958
D.bocki,140010837,203032,1,591,4.2211e-06,138605385,0.989962
D.bocki,140010837,20035,1,591,4.2211e-06,138605976,0.989966
D.bocki,140010837,169343,1,591,4.2211e-06,138606567,0.98997
D.bocki,140010837,161856,1,591,4.2211e-06,138607158,0.989974
D.bocki,140010837,157918,1,591,4.2211e-06,138607749,0.989979
D.bocki,140010837,153725,1,591,4.2211e-06,138608340,0.989983
D.bocki,140010837,150940,1,591,4.2211e-06,138608931,0.989987
D.bocki,140010837,12905,1,591,4.2211e-06,138609522,0.989991
D.bocki,140010837,95210,1,590,4.21396e-06,138610112,0.989996
D.bocki,140010837,62683,1,590,4.21396e-06,138610702,0.99
D.bocki,140010837,58298,1,590,4.21396e-06,138611292,0.990004
D.bocki,140010837,51263,1,590,4.21396e-06,138611882,0.990008
D.bocki,140010837,430119,1,590,4.21396e-06,138612472,0.990012
D.bocki,140010837,426143,1,590,4.21396e-06,138613062,0.990017
D.bocki,140010837,417723,1,590,4.21396e-06,138613652,0.990021
D.bocki,140010837,4094,1,590,4.21396e-06,138614242,0.990025
D.bocki,140010837,402463,1,590,4.21396e-06,138614832,0.990029
D.bocki,140010837,393895,1,590,4.21396e-06,138615422,0.990034
D.bocki,140010837,346424,1,590,4.21396e-06,138616012,0.990038
D.bocki,140010837,341144,1,590,4.21396e-06,138616602,0.990042
D.bocki,140010837,322027,1,590,4.21396e-06,138617192,0.990046
D.bocki,140010837,2826,1,590,4.21396e-06,138617782,0.99005
D.bocki,140010837,259202,1,590,4.21396e-06,138618372,0.990055
D.bocki,140010837,218435,1,590,4.21396e-06,138618962,0.990059
D.bocki,140010837,212991,1,590,4.21396e-06,138619552,0.990063
D.bocki,140010837,2019,1,590,4.21396e-06,138620142,0.990067
D.bocki,140010837,185804,1,590,4.21396e-06,138620732,0.990071
D.bocki,140010837,135868,1,590,4.21396e-06,138621322,0.990076
D.bocki,140010837,110831,1,590,4.21396e-06,138621912,0.99008
D.bocki,140010837,93787,1,589,4.20682e-06,138622501,0.990084
D.bocki,140010837,65121,1,589,4.20682e-06,138623090,0.990088
D.bocki,140010837,53660,1,589,4.20682e-06,138623679,0.990092
D.bocki,140010837,436603,1,589,4.20682e-06,138624268,0.990097
D.bocki,140010837,41878,1,589,4.20682e-06,138624857,0.990101
D.bocki,140010837,414950,1,589,4.20682e-06,138625446,0.990105
D.bocki,140010837,412381,1,589,4.20682e-06,138626035,0.990109
D.bocki,140010837,406629,1,589,4.20682e-06,138626624,0.990114
D.bocki,140010837,32610,1,589,4.20682e-06,138627213,0.990118
D.bocki,140010837,31390,1,589,4.20682e-06,138627802,0.990122
D.bocki,140010837,312206,1,589,4.20682e-06,138628391,0.990126
D.bocki,140010837,306371,1,589,4.20682e-06,138628980,0.99013
D.bocki,140010837,299852,1,589,4.20682e-06,138629569,0.990135
D.bocki,140010837,296357,1,589,4.20682e-06,138630158,0.990139
D.bocki,140010837,246980,1,589,4.20682e-06,138630747,0.990143
D.bocki,140010837,221656,1,589,4.20682e-06,138631336,0.990147
D.bocki,140010837,197178,1,589,4.20682e-06,138631925,0.990151
D.bocki,140010837,193020,1,589,4.20682e-06,138632514,0.990156
D.bocki,140010837,186796,1,589,4.20682e-06,138633103,0.99016
D.bocki,140010837,159600,1,589,4.20682e-06,138633692,0.990164
D.bocki,140010837,119177,1,589,4.20682e-06,138634281,0.990168
D.bocki,140010837,86,1,588,4.19967e-06,138634869,0.990172
D.bocki,140010837,83891,1,588,4.19967e-06,138635457,0.990177
D.bocki,140010837,60458,1,588,4.19967e-06,138636045,0.990181
D.bocki,140010837,59639,1,588,4.19967e-06,138636633,0.990185
D.bocki,140010837,52365,1,588,4.19967e-06,138637221,0.990189
D.bocki,140010837,439590,1,588,4.19967e-06,138637809,0.990193
D.bocki,140010837,41188,1,588,4.19967e-06,138638397,0.990198
D.bocki,140010837,4093,1,588,4.19967e-06,138638985,0.990202
D.bocki,140010837,398603,1,588,4.19967e-06,138639573,0.990206
D.bocki,140010837,392284,1,588,4.19967e-06,138640161,0.99021
D.bocki,140010837,382642,1,588,4.19967e-06,138640749,0.990214
D.bocki,140010837,35456,1,588,4.19967e-06,138641337,0.990219
D.bocki,140010837,346190,1,588,4.19967e-06,138641925,0.990223
D.bocki,140010837,3337,1,588,4.19967e-06,138642513,0.990227
D.bocki,140010837,330924,1,588,4.19967e-06,138643101,0.990231
D.bocki,140010837,328792,1,588,4.19967e-06,138643689,0.990235
D.bocki,140010837,315391,1,588,4.19967e-06,138644277,0.99024
D.bocki,140010837,312985,1,588,4.19967e-06,138644865,0.990244
D.bocki,140010837,26542,1,588,4.19967e-06,138645453,0.990248
D.bocki,140010837,243885,1,588,4.19967e-06,138646041,0.990252
D.bocki,140010837,237381,1,588,4.19967e-06,138646629,0.990256
D.bocki,140010837,157802,1,588,4.19967e-06,138647217,0.990261
D.bocki,140010837,129979,1,588,4.19967e-06,138647805,0.990265
D.bocki,140010837,114829,1,588,4.19967e-06,138648393,0.990269
D.bocki,140010837,109740,1,588,4.19967e-06,138648981,0.990273
D.bocki,140010837,108223,1,588,4.19967e-06,138649569,0.990277
D.bocki,140010837,106161,1,588,4.19967e-06,138650157,0.990282
D.bocki,140010837,9760,1,587,4.19253e-06,138650744,0.990286
D.bocki,140010837,73640,1,587,4.19253e-06,138651331,0.99029
D.bocki,140010837,73201,1,587,4.19253e-06,138651918,0.990294
D.bocki,140010837,53266,1,587,4.19253e-06,138652505,0.990298
D.bocki,140010837,50301,1,587,4.19253e-06,138653092,0.990303
D.bocki,140010837,446718,1,587,4.19253e-06,138653679,0.990307
D.bocki,140010837,43101,1,587,4.19253e-06,138654266,0.990311
D.bocki,140010837,410436,1,587,4.19253e-06,138654853,0.990315
D.bocki,140010837,406343,1,587,4.19253e-06,138655440,0.990319
D.bocki,140010837,385980,1,587,4.19253e-06,138656027,0.990324
D.bocki,140010837,385859,1,587,4.19253e-06,138656614,0.990328
D.bocki,140010837,370014,1,587,4.19253e-06,138657201,0.990332
D.bocki,140010837,333893,1,587,4.19253e-06,138657788,0.990336
D.bocki,140010837,330893,1,587,4.19253e-06,138658375,0.99034
D.bocki,140010837,321260,1,587,4.19253e-06,138658962,0.990344
D.bocki,140010837,307802,1,587,4.19253e-06,138659549,0.990349
D.bocki,140010837,29835,1,587,4.19253e-06,138660136,0.990353
D.bocki,140010837,265471,1,587,4.19253e-06,138660723,0.990357
D.bocki,140010837,252490,1,587,4.19253e-06,138661310,0.990361
D.bocki,140010837,137304,1,587,4.19253e-06,138661897,0.990365
D.bocki,140010837,136540,1,587,4.19253e-06,138662484,0.99037
D.bocki,140010837,128819,1,587,4.19253e-06,138663071,0.990374
D.bocki,140010837,125460,1,587,4.19253e-06,138663658,0.990378
D.bocki,140010837,95899,1,586,4.18539e-06,138664244,0.990382
D.bocki,140010837,76347,1,586,4.18539e-06,138664830,0.990386
D.bocki,140010837,5704,1,586,4.18539e-06,138665416,0.990391
D.bocki,140010837,454312,1,586,4.18539e-06,138666002,0.990395
D.bocki,140010837,431234,1,586,4.18539e-06,138666588,0.990399
D.bocki,140010837,431161,1,586,4.18539e-06,138667174,0.990403
D.bocki,140010837,406286,1,586,4.18539e-06,138667760,0.990407
D.bocki,140010837,375688,1,586,4.18539e-06,138668346,0.990412
D.bocki,140010837,359420,1,586,4.18539e-06,138668932,0.990416
D.bocki,140010837,311964,1,586,4.18539e-06,138669518,0.99042
D.bocki,140010837,305836,1,586,4.18539e-06,138670104,0.990424
D.bocki,140010837,28713,1,586,4.18539e-06,138670690,0.990428
D.bocki,140010837,268011,1,586,4.18539e-06,138671276,0.990432
D.bocki,140010837,242534,1,586,4.18539e-06,138671862,0.990437
D.bocki,140010837,235138,1,586,4.18539e-06,138672448,0.990441
D.bocki,140010837,206764,1,586,4.18539e-06,138673034,0.990445
D.bocki,140010837,204239,1,586,4.18539e-06,138673620,0.990449
D.bocki,140010837,195932,1,586,4.18539e-06,138674206,0.990453
D.bocki,140010837,193818,1,586,4.18539e-06,138674792,0.990458
D.bocki,140010837,18771,1,586,4.18539e-06,138675378,0.990462
D.bocki,140010837,184818,1,586,4.18539e-06,138675964,0.990466
D.bocki,140010837,111321,1,586,4.18539e-06,138676550,0.99047
D.bocki,140010837,110830,1,586,4.18539e-06,138677136,0.990474
D.bocki,140010837,87413,1,585,4.17825e-06,138677721,0.990478
D.bocki,140010837,58773,1,585,4.17825e-06,138678306,0.990483
D.bocki,140010837,52364,1,585,4.17825e-06,138678891,0.990487
D.bocki,140010837,436895,1,585,4.17825e-06,138679476,0.990491
D.bocki,140010837,402910,1,585,4.17825e-06,138680061,0.990495
D.bocki,140010837,399086,1,585,4.17825e-06,138680646,0.990499
D.bocki,140010837,367278,1,585,4.17825e-06,138681231,0.990504
D.bocki,140010837,341143,1,585,4.17825e-06,138681816,0.990508
D.bocki,140010837,339704,1,585,4.17825e-06,138682401,0.990512
D.bocki,140010837,323254,1,585,4.17825e-06,138682986,0.990516
D.bocki,140010837,321522,1,585,4.17825e-06,138683571,0.99052
D.bocki,140010837,321387,1,585,4.17825e-06,138684156,0.990524
D.bocki,140010837,299135,1,585,4.17825e-06,138684741,0.990529
D.bocki,140010837,295174,1,585,4.17825e-06,138685326,0.990533
D.bocki,140010837,245402,1,585,4.17825e-06,138685911,0.990537
D.bocki,140010837,224429,1,585,4.17825e-06,138686496,0.990541
D.bocki,140010837,219991,1,585,4.17825e-06,138687081,0.990545
D.bocki,140010837,2194,1,585,4.17825e-06,138687666,0.99055
D.bocki,140010837,187526,1,585,4.17825e-06,138688251,0.990554
D.bocki,140010837,14902,1,585,4.17825e-06,138688836,0.990558
D.bocki,140010837,121979,1,585,4.17825e-06,138689421,0.990562
D.bocki,140010837,115947,1,585,4.17825e-06,138690006,0.990566
D.bocki,140010837,57145,1,584,4.17111e-06,138690590,0.99057
D.bocki,140010837,49516,1,584,4.17111e-06,138691174,0.990575
D.bocki,140010837,449720,1,584,4.17111e-06,138691758,0.990579
D.bocki,140010837,449121,1,584,4.17111e-06,138692342,0.990583
D.bocki,140010837,403411,1,584,4.17111e-06,138692926,0.990587
D.bocki,140010837,371863,1,584,4.17111e-06,138693510,0.990591
D.bocki,140010837,336071,1,584,4.17111e-06,138694094,0.990595
D.bocki,140010837,328554,1,584,4.17111e-06,138694678,0.9906
D.bocki,140010837,325746,1,584,4.17111e-06,138695262,0.990604
D.bocki,140010837,306823,1,584,4.17111e-06,138695846,0.990608
D.bocki,140010837,238734,1,584,4.17111e-06,138696430,0.990612
D.bocki,140010837,215873,1,584,4.17111e-06,138697014,0.990616
D.bocki,140010837,203641,1,584,4.17111e-06,138697598,0.99062
D.bocki,140010837,200904,1,584,4.17111e-06,138698182,0.990625
D.bocki,140010837,178431,1,584,4.17111e-06,138698766,0.990629
D.bocki,140010837,164277,1,584,4.17111e-06,138699350,0.990633
D.bocki,140010837,157853,1,584,4.17111e-06,138699934,0.990637
D.bocki,140010837,154407,1,584,4.17111e-06,138700518,0.990641
D.bocki,140010837,147002,1,584,4.17111e-06,138701102,0.990645
D.bocki,140010837,146473,1,584,4.17111e-06,138701686,0.99065
D.bocki,140010837,140870,1,584,4.17111e-06,138702270,0.990654
D.bocki,140010837,114535,1,584,4.17111e-06,138702854,0.990658
D.bocki,140010837,82670,1,583,4.16396e-06,138703437,0.990662
D.bocki,140010837,54844,1,583,4.16396e-06,138704020,0.990666
D.bocki,140010837,451957,1,583,4.16396e-06,138704603,0.99067
D.bocki,140010837,451354,1,583,4.16396e-06,138705186,0.990675
D.bocki,140010837,442290,1,583,4.16396e-06,138705769,0.990679
D.bocki,140010837,441015,1,583,4.16396e-06,138706352,0.990683
D.bocki,140010837,430919,1,583,4.16396e-06,138706935,0.990687
D.bocki,140010837,412100,1,583,4.16396e-06,138707518,0.990691
D.bocki,140010837,380551,1,583,4.16396e-06,138708101,0.990695
D.bocki,140010837,346458,1,583,4.16396e-06,138708684,0.9907
D.bocki,140010837,301580,1,583,4.16396e-06,138709267,0.990704
D.bocki,140010837,263245,1,583,4.16396e-06,138709850,0.990708
D.bocki,140010837,216747,1,583,4.16396e-06,138710433,0.990712
D.bocki,140010837,209170,1,583,4.16396e-06,138711016,0.990716
D.bocki,140010837,206130,1,583,4.16396e-06,138711599,0.99072
D.bocki,140010837,195655,1,583,4.16396e-06,138712182,0.990725
D.bocki,140010837,191452,1,583,4.16396e-06,138712765,0.990729
D.bocki,140010837,176352,1,583,4.16396e-06,138713348,0.990733
D.bocki,140010837,148764,1,583,4.16396e-06,138713931,0.990737
D.bocki,140010837,141047,1,583,4.16396e-06,138714514,0.990741
D.bocki,140010837,107995,1,583,4.16396e-06,138715097,0.990745
D.bocki,140010837,104366,1,583,4.16396e-06,138715680,0.99075
D.bocki,140010837,72823,1,582,4.15682e-06,138716262,0.990754
D.bocki,140010837,68039,1,582,4.15682e-06,138716844,0.990758
D.bocki,140010837,4388,1,582,4.15682e-06,138717426,0.990762
D.bocki,140010837,427524,1,582,4.15682e-06,138718008,0.990766
D.bocki,140010837,336872,1,582,4.15682e-06,138718590,0.99077
D.bocki,140010837,323546,1,582,4.15682e-06,138719172,0.990775
D.bocki,140010837,303952,1,582,4.15682e-06,138719754,0.990779
D.bocki,140010837,285936,1,582,4.15682e-06,138720336,0.990783
D.bocki,140010837,282172,1,582,4.15682e-06,138720918,0.990787
D.bocki,140010837,234487,1,582,4.15682e-06,138721500,0.990791
D.bocki,140010837,216949,1,582,4.15682e-06,138722082,0.990795
D.bocki,140010837,21334,1,582,4.15682e-06,138722664,0.990799
D.bocki,140010837,208738,1,582,4.15682e-06,138723246,0.990804
D.bocki,140010837,196498,1,582,4.15682e-06,138723828,0.990808
D.bocki,140010837,194845,1,582,4.15682e-06,138724410,0.990812
D.bocki,140010837,184183,1,582,4.15682e-06,138724992,0.990816
D.bocki,140010837,179548,1,582,4.15682e-06,138725574,0.99082
D.bocki,140010837,130843,1,582,4.15682e-06,138726156,0.990824
D.bocki,140010837,105910,1,582,4.15682e-06,138726738,0.990829
D.bocki,140010837,100129,1,582,4.15682e-06,138727320,0.990833
D.bocki,140010837,86904,1,581,4.14968e-06,138727901,0.990837
D.bocki,140010837,79217,1,581,4.14968e-06,138728482,0.990841
D.bocki,140010837,58272,1,581,4.14968e-06,138729063,0.990845
D.bocki,140010837,46533,1,581,4.14968e-06,138729644,0.990849
D.bocki,140010837,454820,1,581,4.14968e-06,138730225,0.990853
D.bocki,140010837,421105,1,581,4.14968e-06,138730806,0.990858
D.bocki,140010837,384067,1,581,4.14968e-06,138731387,0.990862
D.bocki,140010837,370939,1,581,4.14968e-06,138731968,0.990866
D.bocki,140010837,339843,1,581,4.14968e-06,138732549,0.99087
D.bocki,140010837,338045,1,581,4.14968e-06,138733130,0.990874
D.bocki,140010837,331443,1,581,4.14968e-06,138733711,0.990878
D.bocki,140010837,284801,1,581,4.14968e-06,138734292,0.990883
D.bocki,140010837,270426,1,581,4.14968e-06,138734873,0.990887
D.bocki,140010837,25206,1,581,4.14968e-06,138735454,0.990891
D.bocki,140010837,235518,1,581,4.14968e-06,138736035,0.990895
D.bocki,140010837,193021,1,581,4.14968e-06,138736616,0.990899
D.bocki,140010837,191246,1,581,4.14968e-06,138737197,0.990903
D.bocki,140010837,187198,1,581,4.14968e-06,138737778,0.990907
D.bocki,140010837,182015,1,581,4.14968e-06,138738359,0.990912
D.bocki,140010837,178181,1,581,4.14968e-06,138738940,0.990916
D.bocki,140010837,173140,1,581,4.14968e-06,138739521,0.99092
D.bocki,140010837,10086,1,581,4.14968e-06,138740102,0.990924
D.bocki,140010837,94046,1,580,4.14254e-06,138740682,0.990928
D.bocki,140010837,87496,1,580,4.14254e-06,138741262,0.990932
D.bocki,140010837,73969,1,580,4.14254e-06,138741842,0.990936
D.bocki,140010837,65122,1,580,4.14254e-06,138742422,0.990941
D.bocki,140010837,5776,1,580,4.14254e-06,138743002,0.990945
D.bocki,140010837,56347,1,580,4.14254e-06,138743582,0.990949
D.bocki,140010837,47058,1,580,4.14254e-06,138744162,0.990953
D.bocki,140010837,449593,1,580,4.14254e-06,138744742,0.990957
D.bocki,140010837,438553,1,580,4.14254e-06,138745322,0.990961
D.bocki,140010837,417151,1,580,4.14254e-06,138745902,0.990965
D.bocki,140010837,407660,1,580,4.14254e-06,138746482,0.99097
D.bocki,140010837,395607,1,580,4.14254e-06,138747062,0.990974
D.bocki,140010837,395151,1,580,4.14254e-06,138747642,0.990978
D.bocki,140010837,39390,1,580,4.14254e-06,138748222,0.990982
D.bocki,140010837,382805,1,580,4.14254e-06,138748802,0.990986
D.bocki,140010837,336125,1,580,4.14254e-06,138749382,0.99099
D.bocki,140010837,326751,1,580,4.14254e-06,138749962,0.990994
D.bocki,140010837,209378,1,580,4.14254e-06,138750542,0.990999
D.bocki,140010837,205638,1,580,4.14254e-06,138751122,0.991003
D.bocki,140010837,205508,1,580,4.14254e-06,138751702,0.991007
D.bocki,140010837,188896,1,580,4.14254e-06,138752282,0.991011
D.bocki,140010837,162791,1,580,4.14254e-06,138752862,0.991015
D.bocki,140010837,151682,1,580,4.14254e-06,138753442,0.991019
D.bocki,140010837,134858,1,580,4.14254e-06,138754022,0.991023
D.bocki,140010837,111002,1,580,4.14254e-06,138754602,0.991028
D.bocki,140010837,71987,1,579,4.13539e-06,138755181,0.991032
D.bocki,140010837,62534,1,579,4.13539e-06,138755760,0.991036
D.bocki,140010837,454257,1,579,4.13539e-06,138756339,0.99104
D.bocki,140010837,448102,1,579,4.13539e-06,138756918,0.991044
D.bocki,140010837,437262,1,579,4.13539e-06,138757497,0.991048
D.bocki,140010837,430690,1,579,4.13539e-06,138758076,0.991052
D.bocki,140010837,396228,1,579,4.13539e-06,138758655,0.991057
D.bocki,140010837,347028,1,579,4.13539e-06,138759234,0.991061
D.bocki,140010837,340683,1,579,4.13539e-06,138759813,0.991065
D.bocki,140010837,305431,1,579,4.13539e-06,138760392,0.991069
D.bocki,140010837,252185,1,579,4.13539e-06,138760971,0.991073
D.bocki,140010837,211770,1,579,4.13539e-06,138761550,0.991077
D.bocki,140010837,11119,1,579,4.13539e-06,138762129,0.991081
D.bocki,140010837,110425,1,579,4.13539e-06,138762708,0.991085
D.bocki,140010837,106383,1,579,4.13539e-06,138763287,0.99109
D.bocki,140010837,102402,1,579,4.13539e-06,138763866,0.991094
D.bocki,140010837,76260,1,578,4.12825e-06,138764444,0.991098
D.bocki,140010837,54108,1,578,4.12825e-06,138765022,0.991102
D.bocki,140010837,454718,1,578,4.12825e-06,138765600,0.991106
D.bocki,140010837,44429,1,578,4.12825e-06,138766178,0.99111
D.bocki,140010837,43835,1,578,4.12825e-06,138766756,0.991114
D.bocki,140010837,430173,1,578,4.12825e-06,138767334,0.991119
D.bocki,140010837,416978,1,578,4.12825e-06,138767912,0.991123
D.bocki,140010837,407184,1,578,4.12825e-06,138768490,0.991127
D.bocki,140010837,387101,1,578,4.12825e-06,138769068,0.991131
D.bocki,140010837,381433,1,578,4.12825e-06,138769646,0.991135
D.bocki,140010837,365967,1,578,4.12825e-06,138770224,0.991139
D.bocki,140010837,352239,1,578,4.12825e-06,138770802,0.991143
D.bocki,140010837,33164,1,578,4.12825e-06,138771380,0.991147
D.bocki,140010837,326785,1,578,4.12825e-06,138771958,0.991152
D.bocki,140010837,291522,1,578,4.12825e-06,138772536,0.991156
D.bocki,140010837,239682,1,578,4.12825e-06,138773114,0.99116
D.bocki,140010837,21762,1,578,4.12825e-06,138773692,0.991164
D.bocki,140010837,183422,1,578,4.12825e-06,138774270,0.991168
D.bocki,140010837,153071,1,578,4.12825e-06,138774848,0.991172
D.bocki,140010837,139670,1,578,4.12825e-06,138775426,0.991176
D.bocki,140010837,123303,1,578,4.12825e-06,138776004,0.99118
D.bocki,140010837,10617,1,578,4.12825e-06,138776582,0.991185
D.bocki,140010837,106061,1,578,4.12825e-06,138777160,0.991189
D.bocki,140010837,93242,1,577,4.12111e-06,138777737,0.991193
D.bocki,140010837,51469,1,577,4.12111e-06,138778314,0.991197
D.bocki,140010837,48717,1,577,4.12111e-06,138778891,0.991201
D.bocki,140010837,412775,1,577,4.12111e-06,138779468,0.991205
D.bocki,140010837,337159,1,577,4.12111e-06,138780045,0.991209
D.bocki,140010837,291686,1,577,4.12111e-06,138780622,0.991213
D.bocki,140010837,254822,1,577,4.12111e-06,138781199,0.991218
D.bocki,140010837,218191,1,577,4.12111e-06,138781776,0.991222
D.bocki,140010837,204526,1,577,4.12111e-06,138782353,0.991226
D.bocki,140010837,190546,1,577,4.12111e-06,138782930,0.99123
D.bocki,140010837,183286,1,577,4.12111e-06,138783507,0.991234
D.bocki,140010837,172648,1,577,4.12111e-06,138784084,0.991238
D.bocki,140010837,17003,1,577,4.12111e-06,138784661,0.991242
D.bocki,140010837,149374,1,577,4.12111e-06,138785238,0.991246
D.bocki,140010837,144958,1,577,4.12111e-06,138785815,0.991251
D.bocki,140010837,143870,1,577,4.12111e-06,138786392,0.991255
D.bocki,140010837,103321,1,577,4.12111e-06,138786969,0.991259
D.bocki,140010837,72460,1,576,4.11397e-06,138787545,0.991263
D.bocki,140010837,59904,1,576,4.11397e-06,138788121,0.991267
D.bocki,140010837,54046,1,576,4.11397e-06,138788697,0.991271
D.bocki,140010837,50981,1,576,4.11397e-06,138789273,0.991275
D.bocki,140010837,45161,1,576,4.11397e-06,138789849,0.991279
D.bocki,140010837,450603,1,576,4.11397e-06,138790425,0.991283
D.bocki,140010837,419008,1,576,4.11397e-06,138791001,0.991288
D.bocki,140010837,39671,1,576,4.11397e-06,138791577,0.991292
D.bocki,140010837,359271,1,576,4.11397e-06,138792153,0.991296
D.bocki,140010837,35660,1,576,4.11397e-06,138792729,0.9913
D.bocki,140010837,319478,1,576,4.11397e-06,138793305,0.991304
D.bocki,140010837,304302,1,576,4.11397e-06,138793881,0.991308
D.bocki,140010837,291523,1,576,4.11397e-06,138794457,0.991312
D.bocki,140010837,271149,1,576,4.11397e-06,138795033,0.991316
D.bocki,140010837,256963,1,576,4.11397e-06,138795609,0.99132
D.bocki,140010837,239318,1,576,4.11397e-06,138796185,0.991325
D.bocki,140010837,230192,1,576,4.11397e-06,138796761,0.991329
D.bocki,140010837,228498,1,576,4.11397e-06,138797337,0.991333
D.bocki,140010837,223221,1,576,4.11397e-06,138797913,0.991337
D.bocki,140010837,200936,1,576,4.11397e-06,138798489,0.991341
D.bocki,140010837,199378,1,576,4.11397e-06,138799065,0.991345
D.bocki,140010837,18631,1,576,4.11397e-06,138799641,0.991349
D.bocki,140010837,157701,1,576,4.11397e-06,138800217,0.991353
D.bocki,140010837,148798,1,576,4.11397e-06,138800793,0.991357
D.bocki,140010837,148420,1,576,4.11397e-06,138801369,0.991362
D.bocki,140010837,134953,1,576,4.11397e-06,138801945,0.991366
D.bocki,140010837,13188,1,576,4.11397e-06,138802521,0.99137
D.bocki,140010837,101524,1,576,4.11397e-06,138803097,0.991374
D.bocki,140010837,101522,1,576,4.11397e-06,138803673,0.991378
D.bocki,140010837,84389,1,575,4.10682e-06,138804248,0.991382
D.bocki,140010837,78421,1,575,4.10682e-06,138804823,0.991386
D.bocki,140010837,70309,1,575,4.10682e-06,138805398,0.99139
D.bocki,140010837,52611,1,575,4.10682e-06,138805973,0.991394
D.bocki,140010837,454766,1,575,4.10682e-06,138806548,0.991399
D.bocki,140010837,443819,1,575,4.10682e-06,138807123,0.991403
D.bocki,140010837,419216,1,575,4.10682e-06,138807698,0.991407
D.bocki,140010837,419096,1,575,4.10682e-06,138808273,0.991411
D.bocki,140010837,408111,1,575,4.10682e-06,138808848,0.991415
D.bocki,140010837,399253,1,575,4.10682e-06,138809423,0.991419
D.bocki,140010837,397037,1,575,4.10682e-06,138809998,0.991423
D.bocki,140010837,380997,1,575,4.10682e-06,138810573,0.991427
D.bocki,140010837,370972,1,575,4.10682e-06,138811148,0.991431
D.bocki,140010837,354472,1,575,4.10682e-06,138811723,0.991436
D.bocki,140010837,346739,1,575,4.10682e-06,138812298,0.99144
D.bocki,140010837,301609,1,575,4.10682e-06,138812873,0.991444
D.bocki,140010837,294349,1,575,4.10682e-06,138813448,0.991448
D.bocki,140010837,267144,1,575,4.10682e-06,138814023,0.991452
D.bocki,140010837,253973,1,575,4.10682e-06,138814598,0.991456
D.bocki,140010837,248173,1,575,4.10682e-06,138815173,0.99146
D.bocki,140010837,240716,1,575,4.10682e-06,138815748,0.991464
D.bocki,140010837,198464,1,575,4.10682e-06,138816323,0.991468
D.bocki,140010837,197703,1,575,4.10682e-06,138816898,0.991473
D.bocki,140010837,17407,1,575,4.10682e-06,138817473,0.991477
D.bocki,140010837,170792,1,575,4.10682e-06,138818048,0.991481
D.bocki,140010837,161816,1,575,4.10682e-06,138818623,0.991485
D.bocki,140010837,124440,1,575,4.10682e-06,138819198,0.991489
D.bocki,140010837,111086,1,575,4.10682e-06,138819773,0.991493
D.bocki,140010837,92807,1,574,4.09968e-06,138820347,0.991497
D.bocki,140010837,82258,1,574,4.09968e-06,138820921,0.991501
D.bocki,140010837,63260,1,574,4.09968e-06,138821495,0.991505
D.bocki,140010837,452638,1,574,4.09968e-06,138822069,0.991509
D.bocki,140010837,451176,1,574,4.09968e-06,138822643,0.991514
D.bocki,140010837,418668,1,574,4.09968e-06,138823217,0.991518
D.bocki,140010837,416638,1,574,4.09968e-06,138823791,0.991522
D.bocki,140010837,384793,1,574,4.09968e-06,138824365,0.991526
D.bocki,140010837,375438,1,574,4.09968e-06,138824939,0.99153
D.bocki,140010837,324810,1,574,4.09968e-06,138825513,0.991534
D.bocki,140010837,318855,1,574,4.09968e-06,138826087,0.991538
D.bocki,140010837,303092,1,574,4.09968e-06,138826661,0.991542
D.bocki,140010837,293070,1,574,4.09968e-06,138827235,0.991546
D.bocki,140010837,26749,1,574,4.09968e-06,138827809,0.99155
D.bocki,140010837,263206,1,574,4.09968e-06,138828383,0.991555
D.bocki,140010837,238199,1,574,4.09968e-06,138828957,0.991559
D.bocki,140010837,228417,1,574,4.09968e-06,138829531,0.991563
D.bocki,140010837,220539,1,574,4.09968e-06,138830105,0.991567
D.bocki,140010837,216699,1,574,4.09968e-06,138830679,0.991571
D.bocki,140010837,159501,1,574,4.09968e-06,138831253,0.991575
D.bocki,140010837,107467,1,574,4.09968e-06,138831827,0.991579
D.bocki,140010837,65341,1,573,4.09254e-06,138832400,0.991583
D.bocki,140010837,56634,1,573,4.09254e-06,138832973,0.991587
D.bocki,140010837,50654,1,573,4.09254e-06,138833546,0.991591
D.bocki,140010837,49787,1,573,4.09254e-06,138834119,0.991596
D.bocki,140010837,452598,1,573,4.09254e-06,138834692,0.9916
D.bocki,140010837,39300,1,573,4.09254e-06,138835265,0.991604
D.bocki,140010837,367767,1,573,4.09254e-06,138835838,0.991608
D.bocki,140010837,354340,1,573,4.09254e-06,138836411,0.991612
D.bocki,140010837,339415,1,573,4.09254e-06,138836984,0.991616
D.bocki,140010837,333060,1,573,4.09254e-06,138837557,0.99162
D.bocki,140010837,308497,1,573,4.09254e-06,138838130,0.991624
D.bocki,140010837,304446,1,573,4.09254e-06,138838703,0.991628
D.bocki,140010837,299428,1,573,4.09254e-06,138839276,0.991632
D.bocki,140010837,298011,1,573,4.09254e-06,138839849,0.991636
D.bocki,140010837,290667,1,573,4.09254e-06,138840422,0.991641
D.bocki,140010837,218272,1,573,4.09254e-06,138840995,0.991645
D.bocki,140010837,203747,1,573,4.09254e-06,138841568,0.991649
D.bocki,140010837,191875,1,573,4.09254e-06,138842141,0.991653
D.bocki,140010837,170056,1,573,4.09254e-06,138842714,0.991657
D.bocki,140010837,164568,1,573,4.09254e-06,138843287,0.991661
D.bocki,140010837,152937,1,573,4.09254e-06,138843860,0.991665
D.bocki,140010837,13866,1,573,4.09254e-06,138844433,0.991669
D.bocki,140010837,103207,1,573,4.09254e-06,138845006,0.991673
D.bocki,140010837,85850,1,572,4.0854e-06,138845578,0.991677
D.bocki,140010837,68783,1,572,4.0854e-06,138846150,0.991681
D.bocki,140010837,63319,1,572,4.0854e-06,138846722,0.991686
D.bocki,140010837,454549,1,572,4.0854e-06,138847294,0.99169
D.bocki,140010837,449772,1,572,4.0854e-06,138847866,0.991694
D.bocki,140010837,434266,1,572,4.0854e-06,138848438,0.991698
D.bocki,140010837,374903,1,572,4.0854e-06,138849010,0.991702
D.bocki,140010837,358812,1,572,4.0854e-06,138849582,0.991706
D.bocki,140010837,357238,1,572,4.0854e-06,138850154,0.99171
D.bocki,140010837,354662,1,572,4.0854e-06,138850726,0.991714
D.bocki,140010837,337037,1,572,4.0854e-06,138851298,0.991718
D.bocki,140010837,328762,1,572,4.0854e-06,138851870,0.991722
D.bocki,140010837,328712,1,572,4.0854e-06,138852442,0.991726
D.bocki,140010837,287421,1,572,4.0854e-06,138853014,0.99173
D.bocki,140010837,269823,1,572,4.0854e-06,138853586,0.991735
D.bocki,140010837,260560,1,572,4.0854e-06,138854158,0.991739
D.bocki,140010837,239605,1,572,4.0854e-06,138854730,0.991743
D.bocki,140010837,238223,1,572,4.0854e-06,138855302,0.991747
D.bocki,140010837,216112,1,572,4.0854e-06,138855874,0.991751
D.bocki,140010837,164071,1,572,4.0854e-06,138856446,0.991755
D.bocki,140010837,154958,1,572,4.0854e-06,138857018,0.991759
D.bocki,140010837,117545,1,572,4.0854e-06,138857590,0.991763
D.bocki,140010837,110324,1,572,4.0854e-06,138858162,0.991767
D.bocki,140010837,5412,1,571,4.07826e-06,138858733,0.991771
D.bocki,140010837,454785,1,571,4.07826e-06,138859304,0.991775
D.bocki,140010837,436849,1,571,4.07826e-06,138859875,0.991779
D.bocki,140010837,431098,1,571,4.07826e-06,138860446,0.991784
D.bocki,140010837,395441,1,571,4.07826e-06,138861017,0.991788
D.bocki,140010837,395235,1,571,4.07826e-06,138861588,0.991792
D.bocki,140010837,358346,1,571,4.07826e-06,138862159,0.991796
D.bocki,140010837,345669,1,571,4.07826e-06,138862730,0.9918
D.bocki,140010837,329311,1,571,4.07826e-06,138863301,0.991804
D.bocki,140010837,316235,1,571,4.07826e-06,138863872,0.991808
D.bocki,140010837,316040,1,571,4.07826e-06,138864443,0.991812
D.bocki,140010837,305868,1,571,4.07826e-06,138865014,0.991816
D.bocki,140010837,296843,1,571,4.07826e-06,138865585,0.99182
D.bocki,140010837,273723,1,571,4.07826e-06,138866156,0.991824
D.bocki,140010837,268845,1,571,4.07826e-06,138866727,0.991828
D.bocki,140010837,260993,1,571,4.07826e-06,138867298,0.991832
D.bocki,140010837,255797,1,571,4.07826e-06,138867869,0.991837
D.bocki,140010837,244678,1,571,4.07826e-06,138868440,0.991841
D.bocki,140010837,23405,1,571,4.07826e-06,138869011,0.991845
D.bocki,140010837,190173,1,571,4.07826e-06,138869582,0.991849
D.bocki,140010837,188232,1,571,4.07826e-06,138870153,0.991853
D.bocki,140010837,179858,1,571,4.07826e-06,138870724,0.991857
D.bocki,140010837,17540,1,571,4.07826e-06,138871295,0.991861
D.bocki,140010837,169791,1,571,4.07826e-06,138871866,0.991865
D.bocki,140010837,156241,1,571,4.07826e-06,138872437,0.991869
D.bocki,140010837,135870,1,571,4.07826e-06,138873008,0.991873
D.bocki,140010837,134327,1,571,4.07826e-06,138873579,0.991877
D.bocki,140010837,99276,1,570,4.07111e-06,138874149,0.991881
D.bocki,140010837,83093,1,570,4.07111e-06,138874719,0.991885
D.bocki,140010837,81722,1,570,4.07111e-06,138875289,0.99189
D.bocki,140010837,67921,1,570,4.07111e-06,138875859,0.991894
D.bocki,140010837,59456,1,570,4.07111e-06,138876429,0.991898
D.bocki,140010837,451257,1,570,4.07111e-06,138876999,0.991902
D.bocki,140010837,438095,1,570,4.07111e-06,138877569,0.991906
D.bocki,140010837,415467,1,570,4.07111e-06,138878139,0.99191
D.bocki,140010837,402533,1,570,4.07111e-06,138878709,0.991914
D.bocki,140010837,394578,1,570,4.07111e-06,138879279,0.991918
D.bocki,140010837,388697,1,570,4.07111e-06,138879849,0.991922
D.bocki,140010837,387877,1,570,4.07111e-06,138880419,0.991926
D.bocki,140010837,373789,1,570,4.07111e-06,138880989,0.99193
D.bocki,140010837,326425,1,570,4.07111e-06,138881559,0.991934
D.bocki,140010837,30866,1,570,4.07111e-06,138882129,0.991938
D.bocki,140010837,296920,1,570,4.07111e-06,138882699,0.991942
D.bocki,140010837,29541,1,570,4.07111e-06,138883269,0.991947
D.bocki,140010837,292214,1,570,4.07111e-06,138883839,0.991951
D.bocki,140010837,289711,1,570,4.07111e-06,138884409,0.991955
D.bocki,140010837,266430,1,570,4.07111e-06,138884979,0.991959
D.bocki,140010837,22938,1,570,4.07111e-06,138885549,0.991963
D.bocki,140010837,225650,1,570,4.07111e-06,138886119,0.991967
D.bocki,140010837,191874,1,570,4.07111e-06,138886689,0.991971
D.bocki,140010837,185709,1,570,4.07111e-06,138887259,0.991975
D.bocki,140010837,152317,1,570,4.07111e-06,138887829,0.991979
D.bocki,140010837,149115,1,570,4.07111e-06,138888399,0.991983
D.bocki,140010837,11607,1,570,4.07111e-06,138888969,0.991987
D.bocki,140010837,90723,1,569,4.06397e-06,138889538,0.991991
D.bocki,140010837,65264,1,569,4.06397e-06,138890107,0.991995
D.bocki,140010837,46900,1,569,4.06397e-06,138890676,0.991999
D.bocki,140010837,438552,1,569,4.06397e-06,138891245,0.992004
D.bocki,140010837,41039,1,569,4.06397e-06,138891814,0.992008
D.bocki,140010837,395529,1,569,4.06397e-06,138892383,0.992012
D.bocki,140010837,376211,1,569,4.06397e-06,138892952,0.992016
D.bocki,140010837,347190,1,569,4.06397e-06,138893521,0.99202
D.bocki,140010837,317272,1,569,4.06397e-06,138894090,0.992024
D.bocki,140010837,311088,1,569,4.06397e-06,138894659,0.992028
D.bocki,140010837,30035,1,569,4.06397e-06,138895228,0.992032
D.bocki,140010837,27498,1,569,4.06397e-06,138895797,0.992036
D.bocki,140010837,271721,1,569,4.06397e-06,138896366,0.99204
D.bocki,140010837,266714,1,569,4.06397e-06,138896935,0.992044
D.bocki,140010837,264755,1,569,4.06397e-06,138897504,0.992048
D.bocki,140010837,238302,1,569,4.06397e-06,138898073,0.992052
D.bocki,140010837,235298,1,569,4.06397e-06,138898642,0.992056
D.bocki,140010837,219484,1,569,4.06397e-06,138899211,0.99206
D.bocki,140010837,190875,1,569,4.06397e-06,138899780,0.992064
D.bocki,140010837,18810,1,569,4.06397e-06,138900349,0.992069
D.bocki,140010837,151425,1,569,4.06397e-06,138900918,0.992073
D.bocki,140010837,146595,1,569,4.06397e-06,138901487,0.992077
D.bocki,140010837,106848,1,569,4.06397e-06,138902056,0.992081
D.bocki,140010837,75021,1,568,4.05683e-06,138902624,0.992085
D.bocki,140010837,72544,1,568,4.05683e-06,138903192,0.992089
D.bocki,140010837,67568,1,568,4.05683e-06,138903760,0.992093
D.bocki,140010837,454459,1,568,4.05683e-06,138904328,0.992097
D.bocki,140010837,440213,1,568,4.05683e-06,138904896,0.992101
D.bocki,140010837,433574,1,568,4.05683e-06,138905464,0.992105
D.bocki,140010837,415504,1,568,4.05683e-06,138906032,0.992109
D.bocki,140010837,391965,1,568,4.05683e-06,138906600,0.992113
D.bocki,140010837,37880,1,568,4.05683e-06,138907168,0.992117
D.bocki,140010837,36197,1,568,4.05683e-06,138907736,0.992121
D.bocki,140010837,342781,1,568,4.05683e-06,138908304,0.992125
D.bocki,140010837,309060,1,568,4.05683e-06,138908872,0.992129
D.bocki,140010837,289975,1,568,4.05683e-06,138909440,0.992133
D.bocki,140010837,285225,1,568,4.05683e-06,138910008,0.992138
D.bocki,140010837,270538,1,568,4.05683e-06,138910576,0.992142
D.bocki,140010837,267470,1,568,4.05683e-06,138911144,0.992146
D.bocki,140010837,238120,1,568,4.05683e-06,138911712,0.99215
D.bocki,140010837,225540,1,568,4.05683e-06,138912280,0.992154
D.bocki,140010837,183862,1,568,4.05683e-06,138912848,0.992158
D.bocki,140010837,146301,1,568,4.05683e-06,138913416,0.992162
D.bocki,140010837,144404,1,568,4.05683e-06,138913984,0.992166
D.bocki,140010837,109172,1,568,4.05683e-06,138914552,0.99217
D.bocki,140010837,86078,1,567,4.04969e-06,138915119,0.992174
D.bocki,140010837,70884,1,567,4.04969e-06,138915686,0.992178
D.bocki,140010837,69514,1,567,4.04969e-06,138916253,0.992182
D.bocki,140010837,44428,1,567,4.04969e-06,138916820,0.992186
D.bocki,140010837,443821,1,567,4.04969e-06,138917387,0.99219
D.bocki,140010837,439291,1,567,4.04969e-06,138917954,0.992194
D.bocki,140010837,432821,1,567,4.04969e-06,138918521,0.992198
D.bocki,140010837,408475,1,567,4.04969e-06,138919088,0.992202
D.bocki,140010837,40056,1,567,4.04969e-06,138919655,0.992206
D.bocki,140010837,379824,1,567,4.04969e-06,138920222,0.99221
D.bocki,140010837,354392,1,567,4.04969e-06,138920789,0.992215
D.bocki,140010837,347457,1,567,4.04969e-06,138921356,0.992219
D.bocki,140010837,302458,1,567,4.04969e-06,138921923,0.992223
D.bocki,140010837,297580,1,567,4.04969e-06,138922490,0.992227
D.bocki,140010837,21439,1,567,4.04969e-06,138923057,0.992231
D.bocki,140010837,212970,1,567,4.04969e-06,138923624,0.992235
D.bocki,140010837,207189,1,567,4.04969e-06,138924191,0.992239
D.bocki,140010837,20178,1,567,4.04969e-06,138924758,0.992243
D.bocki,140010837,19643,1,567,4.04969e-06,138925325,0.992247
D.bocki,140010837,189348,1,567,4.04969e-06,138925892,0.992251
D.bocki,140010837,188895,1,567,4.04969e-06,138926459,0.992255
D.bocki,140010837,176030,1,567,4.04969e-06,138927026,0.992259
D.bocki,140010837,167268,1,567,4.04969e-06,138927593,0.992263
D.bocki,140010837,158972,1,567,4.04969e-06,138928160,0.992267
D.bocki,140010837,130807,1,567,4.04969e-06,138928727,0.992271
D.bocki,140010837,103349,1,567,4.04969e-06,138929294,0.992275
D.bocki,140010837,100025,1,567,4.04969e-06,138929861,0.992279
D.bocki,140010837,68719,1,566,4.04254e-06,138930427,0.992283
D.bocki,140010837,41552,1,566,4.04254e-06,138930993,0.992287
D.bocki,140010837,41491,1,566,4.04254e-06,138931559,0.992291
D.bocki,140010837,386240,1,566,4.04254e-06,138932125,0.992296
D.bocki,140010837,372417,1,566,4.04254e-06,138932691,0.9923
D.bocki,140010837,362937,1,566,4.04254e-06,138933257,0.992304
D.bocki,140010837,32897,1,566,4.04254e-06,138933823,0.992308
D.bocki,140010837,327532,1,566,4.04254e-06,138934389,0.992312
D.bocki,140010837,284188,1,566,4.04254e-06,138934955,0.992316
D.bocki,140010837,272816,1,566,4.04254e-06,138935521,0.99232
D.bocki,140010837,258495,1,566,4.04254e-06,138936087,0.992324
D.bocki,140010837,250451,1,566,4.04254e-06,138936653,0.992328
D.bocki,140010837,241906,1,566,4.04254e-06,138937219,0.992332
D.bocki,140010837,195513,1,566,4.04254e-06,138937785,0.992336
D.bocki,140010837,194650,1,566,4.04254e-06,138938351,0.99234
D.bocki,140010837,16228,1,566,4.04254e-06,138938917,0.992344
D.bocki,140010837,161815,1,566,4.04254e-06,138939483,0.992348
D.bocki,140010837,157451,1,566,4.04254e-06,138940049,0.992352
D.bocki,140010837,157335,1,566,4.04254e-06,138940615,0.992356
D.bocki,140010837,110756,1,566,4.04254e-06,138941181,0.99236
D.bocki,140010837,58323,1,565,4.0354e-06,138941746,0.992364
D.bocki,140010837,47275,1,565,4.0354e-06,138942311,0.992368
D.bocki,140010837,454708,1,565,4.0354e-06,138942876,0.992372
D.bocki,140010837,441017,1,565,4.0354e-06,138943441,0.992376
D.bocki,140010837,433322,1,565,4.0354e-06,138944006,0.99238
D.bocki,140010837,413345,1,565,4.0354e-06,138944571,0.992384
D.bocki,140010837,404710,1,565,4.0354e-06,138945136,0.992388
D.bocki,140010837,39791,1,565,4.0354e-06,138945701,0.992392
D.bocki,140010837,392759,1,565,4.0354e-06,138946266,0.992397
D.bocki,140010837,388116,1,565,4.0354e-06,138946831,0.992401
D.bocki,140010837,350064,1,565,4.0354e-06,138947396,0.992405
D.bocki,140010837,325269,1,565,4.0354e-06,138947961,0.992409
D.bocki,140010837,322522,1,565,4.0354e-06,138948526,0.992413
D.bocki,140010837,321107,1,565,4.0354e-06,138949091,0.992417
D.bocki,140010837,318507,1,565,4.0354e-06,138949656,0.992421
D.bocki,140010837,29980,1,565,4.0354e-06,138950221,0.992425
D.bocki,140010837,27338,1,565,4.0354e-06,138950786,0.992429
D.bocki,140010837,266947,1,565,4.0354e-06,138951351,0.992433
D.bocki,140010837,262503,1,565,4.0354e-06,138951916,0.992437
D.bocki,140010837,260273,1,565,4.0354e-06,138952481,0.992441
D.bocki,140010837,257425,1,565,4.0354e-06,138953046,0.992445
D.bocki,140010837,244964,1,565,4.0354e-06,138953611,0.992449
D.bocki,140010837,242335,1,565,4.0354e-06,138954176,0.992453
D.bocki,140010837,212453,1,565,4.0354e-06,138954741,0.992457
D.bocki,140010837,206840,1,565,4.0354e-06,138955306,0.992461
D.bocki,140010837,187719,1,565,4.0354e-06,138955871,0.992465
D.bocki,140010837,162792,1,565,4.0354e-06,138956436,0.992469
D.bocki,140010837,133067,1,565,4.0354e-06,138957001,0.992473
D.bocki,140010837,131778,1,565,4.0354e-06,138957566,0.992477
D.bocki,140010837,126163,1,565,4.0354e-06,138958131,0.992481
D.bocki,140010837,119202,1,565,4.0354e-06,138958696,0.992485
D.bocki,140010837,118636,1,565,4.0354e-06,138959261,0.992489
D.bocki,140010837,11225,1,565,4.0354e-06,138959826,0.992493
D.bocki,140010837,105434,1,565,4.0354e-06,138960391,0.992497
D.bocki,140010837,81927,1,564,4.02826e-06,138960955,0.992501
D.bocki,140010837,623,1,564,4.02826e-06,138961519,0.992505
D.bocki,140010837,454553,1,564,4.02826e-06,138962083,0.992509
D.bocki,140010837,445819,1,564,4.02826e-06,138962647,0.992514
D.bocki,140010837,442987,1,564,4.02826e-06,138963211,0.992518
D.bocki,140010837,428809,1,564,4.02826e-06,138963775,0.992522
D.bocki,140010837,377578,1,564,4.02826e-06,138964339,0.992526
D.bocki,140010837,363285,1,564,4.02826e-06,138964903,0.99253
D.bocki,140010837,346489,1,564,4.02826e-06,138965467,0.992534
D.bocki,140010837,337597,1,564,4.02826e-06,138966031,0.992538
D.bocki,140010837,310597,1,564,4.02826e-06,138966595,0.992542
D.bocki,140010837,302383,1,564,4.02826e-06,138967159,0.992546
D.bocki,140010837,293597,1,564,4.02826e-06,138967723,0.99255
D.bocki,140010837,292502,1,564,4.02826e-06,138968287,0.992554
D.bocki,140010837,285935,1,564,4.02826e-06,138968851,0.992558
D.bocki,140010837,280254,1,564,4.02826e-06,138969415,0.992562
D.bocki,140010837,276517,1,564,4.02826e-06,138969979,0.992566
D.bocki,140010837,268467,1,564,4.02826e-06,138970543,0.99257
D.bocki,140010837,257974,1,564,4.02826e-06,138971107,0.992574
D.bocki,140010837,246721,1,564,4.02826e-06,138971671,0.992578
D.bocki,140010837,242783,1,564,4.02826e-06,138972235,0.992582
D.bocki,140010837,231698,1,564,4.02826e-06,138972799,0.992586
D.bocki,140010837,228445,1,564,4.02826e-06,138973363,0.99259
D.bocki,140010837,208312,1,564,4.02826e-06,138973927,0.992594
D.bocki,140010837,180614,1,564,4.02826e-06,138974491,0.992598
D.bocki,140010837,106410,1,564,4.02826e-06,138975055,0.992602
D.bocki,140010837,87366,1,563,4.02112e-06,138975618,0.992606
D.bocki,140010837,66975,1,563,4.02112e-06,138976181,0.99261
D.bocki,140010837,51645,1,563,4.02112e-06,138976744,0.992614
D.bocki,140010837,454267,1,563,4.02112e-06,138977307,0.992618
D.bocki,140010837,453203,1,563,4.02112e-06,138977870,0.992622
D.bocki,140010837,436163,1,563,4.02112e-06,138978433,0.992626
D.bocki,140010837,417426,1,563,4.02112e-06,138978996,0.99263
D.bocki,140010837,405672,1,563,4.02112e-06,138979559,0.992634
D.bocki,140010837,388371,1,563,4.02112e-06,138980122,0.992638
D.bocki,140010837,382275,1,563,4.02112e-06,138980685,0.992642
D.bocki,140010837,370710,1,563,4.02112e-06,138981248,0.992646
D.bocki,140010837,304079,1,563,4.02112e-06,138981811,0.99265
D.bocki,140010837,28914,1,563,4.02112e-06,138982374,0.992654
D.bocki,140010837,282602,1,563,4.02112e-06,138982937,0.992658
D.bocki,140010837,281903,1,563,4.02112e-06,138983500,0.992662
D.bocki,140010837,279347,1,563,4.02112e-06,138984063,0.992666
D.bocki,140010837,267143,1,563,4.02112e-06,138984626,0.99267
D.bocki,140010837,248956,1,563,4.02112e-06,138985189,0.992675
D.bocki,140010837,245363,1,563,4.02112e-06,138985752,0.992679
D.bocki,140010837,244921,1,563,4.02112e-06,138986315,0.992683
D.bocki,140010837,235405,1,563,4.02112e-06,138986878,0.992687
D.bocki,140010837,228355,1,563,4.02112e-06,138987441,0.992691
D.bocki,140010837,213302,1,563,4.02112e-06,138988004,0.992695
D.bocki,140010837,211142,1,563,4.02112e-06,138988567,0.992699
D.bocki,140010837,18749,1,563,4.02112e-06,138989130,0.992703
D.bocki,140010837,185773,1,563,4.02112e-06,138989693,0.992707
D.bocki,140010837,171462,1,563,4.02112e-06,138990256,0.992711
D.bocki,140010837,159524,1,563,4.02112e-06,138990819,0.992715
D.bocki,140010837,145462,1,563,4.02112e-06,138991382,0.992719
D.bocki,140010837,131957,1,563,4.02112e-06,138991945,0.992723
D.bocki,140010837,130462,1,563,4.02112e-06,138992508,0.992727
D.bocki,140010837,123164,1,563,4.02112e-06,138993071,0.992731
D.bocki,140010837,119795,1,563,4.02112e-06,138993634,0.992735
D.bocki,140010837,113737,1,563,4.02112e-06,138994197,0.992739
D.bocki,140010837,42562,1,562,4.01398e-06,138994759,0.992743
D.bocki,140010837,391689,1,562,4.01398e-06,138995321,0.992747
D.bocki,140010837,374934,1,562,4.01398e-06,138995883,0.992751
D.bocki,140010837,37391,1,562,4.01398e-06,138996445,0.992755
D.bocki,140010837,360254,1,562,4.01398e-06,138997007,0.992759
D.bocki,140010837,354502,1,562,4.01398e-06,138997569,0.992763
D.bocki,140010837,325037,1,562,4.01398e-06,138998131,0.992767
D.bocki,140010837,322698,1,562,4.01398e-06,138998693,0.992771
D.bocki,140010837,31703,1,562,4.01398e-06,138999255,0.992775
D.bocki,140010837,274415,1,562,4.01398e-06,138999817,0.992779
D.bocki,140010837,238092,1,562,4.01398e-06,139000379,0.992783
D.bocki,140010837,21545,1,562,4.01398e-06,139000941,0.992787
D.bocki,140010837,156787,1,562,4.01398e-06,139001503,0.992791
D.bocki,140010837,106437,1,562,4.01398e-06,139002065,0.992795
D.bocki,140010837,103028,1,562,4.01398e-06,139002627,0.992799
D.bocki,140010837,87868,1,561,4.00683e-06,139003188,0.992803
D.bocki,140010837,87412,1,561,4.00683e-06,139003749,0.992807
D.bocki,140010837,6165,1,561,4.00683e-06,139004310,0.992811
D.bocki,140010837,54879,1,561,4.00683e-06,139004871,0.992815
D.bocki,140010837,51904,1,561,4.00683e-06,139005432,0.992819
D.bocki,140010837,50617,1,561,4.00683e-06,139005993,0.992823
D.bocki,140010837,454751,1,561,4.00683e-06,139006554,0.992827
D.bocki,140010837,437410,1,561,4.00683e-06,139007115,0.992831
D.bocki,140010837,416695,1,561,4.00683e-06,139007676,0.992835
D.bocki,140010837,404063,1,561,4.00683e-06,139008237,0.992839
D.bocki,140010837,392757,1,561,4.00683e-06,139008798,0.992843
D.bocki,140010837,330137,1,561,4.00683e-06,139009359,0.992847
D.bocki,140010837,322857,1,561,4.00683e-06,139009920,0.992851
D.bocki,140010837,314604,1,561,4.00683e-06,139010481,0.992855
D.bocki,140010837,289572,1,561,4.00683e-06,139011042,0.992859
D.bocki,140010837,269317,1,561,4.00683e-06,139011603,0.992863
D.bocki,140010837,259295,1,561,4.00683e-06,139012164,0.992867
D.bocki,140010837,218193,1,561,4.00683e-06,139012725,0.992871
D.bocki,140010837,216948,1,561,4.00683e-06,139013286,0.992875
D.bocki,140010837,197989,1,561,4.00683e-06,139013847,0.992879
D.bocki,140010837,180886,1,561,4.00683e-06,139014408,0.992883
D.bocki,140010837,178000,1,561,4.00683e-06,139014969,0.992887
D.bocki,140010837,174812,1,561,4.00683e-06,139015530,0.992891
D.bocki,140010837,171711,1,561,4.00683e-06,139016091,0.992895
D.bocki,140010837,151160,1,561,4.00683e-06,139016652,0.992899
D.bocki,140010837,12081,1,561,4.00683e-06,139017213,0.992903
D.bocki,140010837,119855,1,561,4.00683e-06,139017774,0.992907
D.bocki,140010837,114918,1,561,4.00683e-06,139018335,0.992911
D.bocki,140010837,9496,1,560,3.99969e-06,139018895,0.992915
D.bocki,140010837,90649,1,560,3.99969e-06,139019455,0.992919
D.bocki,140010837,87183,1,560,3.99969e-06,139020015,0.992923
D.bocki,140010837,55753,1,560,3.99969e-06,139020575,0.992927
D.bocki,140010837,453372,1,560,3.99969e-06,139021135,0.992931
D.bocki,140010837,451297,1,560,3.99969e-06,139021695,0.992935
D.bocki,140010837,375352,1,560,3.99969e-06,139022255,0.992939
D.bocki,140010837,340685,1,560,3.99969e-06,139022815,0.992943
D.bocki,140010837,299503,1,560,3.99969e-06,139023375,0.992947
D.bocki,140010837,289855,1,560,3.99969e-06,139023935,0.992951
D.bocki,140010837,275101,1,560,3.99969e-06,139024495,0.992955
D.bocki,140010837,26910,1,560,3.99969e-06,139025055,0.992959
D.bocki,140010837,242532,1,560,3.99969e-06,139025615,0.992963
D.bocki,140010837,241536,1,560,3.99969e-06,139026175,0.992967
D.bocki,140010837,210150,1,560,3.99969e-06,139026735,0.992971
D.bocki,140010837,176125,1,560,3.99969e-06,139027295,0.992975
D.bocki,140010837,14588,1,560,3.99969e-06,139027855,0.992979
D.bocki,140010837,138327,1,560,3.99969e-06,139028415,0.992983
D.bocki,140010837,133093,1,560,3.99969e-06,139028975,0.992987
D.bocki,140010837,127041,1,560,3.99969e-06,139029535,0.992991
D.bocki,140010837,123075,1,560,3.99969e-06,139030095,0.992995
D.bocki,140010837,122333,1,560,3.99969e-06,139030655,0.992999
D.bocki,140010837,112887,1,560,3.99969e-06,139031215,0.993003
D.bocki,140010837,92644,1,559,3.99255e-06,139031774,0.993007
D.bocki,140010837,53581,1,559,3.99255e-06,139032333,0.993011
D.bocki,140010837,454297,1,559,3.99255e-06,139032892,0.993015
D.bocki,140010837,449771,1,559,3.99255e-06,139033451,0.993019
D.bocki,140010837,436039,1,559,3.99255e-06,139034010,0.993023
D.bocki,140010837,431099,1,559,3.99255e-06,139034569,0.993027
D.bocki,140010837,424541,1,559,3.99255e-06,139035128,0.993031
D.bocki,140010837,412934,1,559,3.99255e-06,139035687,0.993035
D.bocki,140010837,341792,1,559,3.99255e-06,139036246,0.993039
D.bocki,140010837,329157,1,559,3.99255e-06,139036805,0.993043
D.bocki,140010837,300220,1,559,3.99255e-06,139037364,0.993047
D.bocki,140010837,299087,1,559,3.99255e-06,139037923,0.993051
D.bocki,140010837,287710,1,559,3.99255e-06,139038482,0.993055
D.bocki,140010837,262438,1,559,3.99255e-06,139039041,0.993059
D.bocki,140010837,262437,1,559,3.99255e-06,139039600,0.993063
D.bocki,140010837,212391,1,559,3.99255e-06,139040159,0.993067
D.bocki,140010837,175695,1,559,3.99255e-06,139040718,0.993071
D.bocki,140010837,15201,1,559,3.99255e-06,139041277,0.993075
D.bocki,140010837,149267,1,559,3.99255e-06,139041836,0.993079
D.bocki,140010837,145889,1,559,3.99255e-06,139042395,0.993083
D.bocki,140010837,124730,1,559,3.99255e-06,139042954,0.993087
D.bocki,140010837,92838,1,558,3.98541e-06,139043512,0.993091
D.bocki,140010837,92523,1,558,3.98541e-06,139044070,0.993095
D.bocki,140010837,81632,1,558,3.98541e-06,139044628,0.993099
D.bocki,140010837,8160,1,558,3.98541e-06,139045186,0.993103
D.bocki,140010837,76878,1,558,3.98541e-06,139045744,0.993107
D.bocki,140010837,67951,1,558,3.98541e-06,139046302,0.993111
D.bocki,140010837,66010,1,558,3.98541e-06,139046860,0.993115
D.bocki,140010837,51046,1,558,3.98541e-06,139047418,0.993119
D.bocki,140010837,48773,1,558,3.98541e-06,139047976,0.993123
D.bocki,140010837,451049,1,558,3.98541e-06,139048534,0.993127
D.bocki,140010837,438520,1,558,3.98541e-06,139049092,0.993131
D.bocki,140010837,434756,1,558,3.98541e-06,139049650,0.993135
D.bocki,140010837,40660,1,558,3.98541e-06,139050208,0.993139
D.bocki,140010837,378490,1,558,3.98541e-06,139050766,0.993143
D.bocki,140010837,370193,1,558,3.98541e-06,139051324,0.993147
D.bocki,140010837,357387,1,558,3.98541e-06,139051882,0.993151
D.bocki,140010837,347624,1,558,3.98541e-06,139052440,0.993155
D.bocki,140010837,344600,1,558,3.98541e-06,139052998,0.993159
D.bocki,140010837,33189,1,558,3.98541e-06,139053556,0.993163
D.bocki,140010837,324156,1,558,3.98541e-06,139054114,0.993167
D.bocki,140010837,322827,1,558,3.98541e-06,139054672,0.993171
D.bocki,140010837,309983,1,558,3.98541e-06,139055230,0.993175
D.bocki,140010837,285874,1,558,3.98541e-06,139055788,0.993179
D.bocki,140010837,284922,1,558,3.98541e-06,139056346,0.993183
D.bocki,140010837,265447,1,558,3.98541e-06,139056904,0.993187
D.bocki,140010837,24924,1,558,3.98541e-06,139057462,0.993191
D.bocki,140010837,235952,1,558,3.98541e-06,139058020,0.993195
D.bocki,140010837,219376,1,558,3.98541e-06,139058578,0.993199
D.bocki,140010837,206026,1,558,3.98541e-06,139059136,0.993203
D.bocki,140010837,186725,1,558,3.98541e-06,139059694,0.993207
D.bocki,140010837,180337,1,558,3.98541e-06,139060252,0.993211
D.bocki,140010837,156788,1,558,3.98541e-06,139060810,0.993215
D.bocki,140010837,141104,1,558,3.98541e-06,139061368,0.993219
D.bocki,140010837,13691,1,558,3.98541e-06,139061926,0.993223
D.bocki,140010837,115269,1,558,3.98541e-06,139062484,0.993227
D.bocki,140010837,83175,1,557,3.97826e-06,139063041,0.993231
D.bocki,140010837,74168,1,557,3.97826e-06,139063598,0.993235
D.bocki,140010837,450900,1,557,3.97826e-06,139064155,0.993239
D.bocki,140010837,417725,1,557,3.97826e-06,139064712,0.993242
D.bocki,140010837,413374,1,557,3.97826e-06,139065269,0.993246
D.bocki,140010837,411824,1,557,3.97826e-06,139065826,0.99325
D.bocki,140010837,408054,1,557,3.97826e-06,139066383,0.993254
D.bocki,140010837,398527,1,557,3.97826e-06,139066940,0.993258
D.bocki,140010837,390359,1,557,3.97826e-06,139067497,0.993262
D.bocki,140010837,386141,1,557,3.97826e-06,139068054,0.993266
D.bocki,140010837,381122,1,557,3.97826e-06,139068611,0.99327
D.bocki,140010837,379143,1,557,3.97826e-06,139069168,0.993274
D.bocki,140010837,371534,1,557,3.97826e-06,139069725,0.993278
D.bocki,140010837,364569,1,557,3.97826e-06,139070282,0.993282
D.bocki,140010837,364341,1,557,3.97826e-06,139070839,0.993286
D.bocki,140010837,357601,1,557,3.97826e-06,139071396,0.99329
D.bocki,140010837,351467,1,557,3.97826e-06,139071953,0.993294
D.bocki,140010837,349615,1,557,3.97826e-06,139072510,0.993298
D.bocki,140010837,340978,1,557,3.97826e-06,139073067,0.993302
D.bocki,140010837,326710,1,557,3.97826e-06,139073624,0.993306
D.bocki,140010837,315232,1,557,3.97826e-06,139074181,0.99331
D.bocki,140010837,309107,1,557,3.97826e-06,139074738,0.993314
D.bocki,140010837,301576,1,557,3.97826e-06,139075295,0.993318
D.bocki,140010837,28417,1,557,3.97826e-06,139075852,0.993322
D.bocki,140010837,271838,1,557,3.97826e-06,139076409,0.993326
D.bocki,140010837,264611,1,557,3.97826e-06,139076966,0.99333
D.bocki,140010837,251840,1,557,3.97826e-06,139077523,0.993334
D.bocki,140010837,250345,1,557,3.97826e-06,139078080,0.993338
D.bocki,140010837,230052,1,557,3.97826e-06,139078637,0.993342
D.bocki,140010837,22166,1,557,3.97826e-06,139079194,0.993346
D.bocki,140010837,216294,1,557,3.97826e-06,139079751,0.99335
D.bocki,140010837,21546,1,557,3.97826e-06,139080308,0.993354
D.bocki,140010837,207812,1,557,3.97826e-06,139080865,0.993358
D.bocki,140010837,200876,1,557,3.97826e-06,139081422,0.993362
D.bocki,140010837,192628,1,557,3.97826e-06,139081979,0.993366
D.bocki,140010837,171832,1,557,3.97826e-06,139082536,0.99337
D.bocki,140010837,170907,1,557,3.97826e-06,139083093,0.993374
D.bocki,140010837,152748,1,557,3.97826e-06,139083650,0.993378
D.bocki,140010837,137906,1,557,3.97826e-06,139084207,0.993382
D.bocki,140010837,117223,1,557,3.97826e-06,139084764,0.993386
D.bocki,140010837,101082,1,557,3.97826e-06,139085321,0.99339
D.bocki,140010837,98260,1,556,3.97112e-06,139085877,0.993394
D.bocki,140010837,79359,1,556,3.97112e-06,139086433,0.993398
D.bocki,140010837,54298,1,556,3.97112e-06,139086989,0.993402
D.bocki,140010837,47196,1,556,3.97112e-06,139087545,0.993406
D.bocki,140010837,444317,1,556,3.97112e-06,139088101,0.99341
D.bocki,140010837,444022,1,556,3.97112e-06,139088657,0.993414
D.bocki,140010837,441384,1,556,3.97112e-06,139089213,0.993417
D.bocki,140010837,429455,1,556,3.97112e-06,139089769,0.993421
D.bocki,140010837,408539,1,556,3.97112e-06,139090325,0.993425
D.bocki,140010837,405018,1,556,3.97112e-06,139090881,0.993429
D.bocki,140010837,403859,1,556,3.97112e-06,139091437,0.993433
D.bocki,140010837,398342,1,556,3.97112e-06,139091993,0.993437
D.bocki,140010837,381879,1,556,3.97112e-06,139092549,0.993441
D.bocki,140010837,379233,1,556,3.97112e-06,139093105,0.993445
D.bocki,140010837,349508,1,556,3.97112e-06,139093661,0.993449
D.bocki,140010837,347458,1,556,3.97112e-06,139094217,0.993453
D.bocki,140010837,294495,1,556,3.97112e-06,139094773,0.993457
D.bocki,140010837,279675,1,556,3.97112e-06,139095329,0.993461
D.bocki,140010837,271214,1,556,3.97112e-06,139095885,0.993465
D.bocki,140010837,259518,1,556,3.97112e-06,139096441,0.993469
D.bocki,140010837,249459,1,556,3.97112e-06,139096997,0.993473
D.bocki,140010837,241878,1,556,3.97112e-06,139097553,0.993477
D.bocki,140010837,225879,1,556,3.97112e-06,139098109,0.993481
D.bocki,140010837,222939,1,556,3.97112e-06,139098665,0.993485
D.bocki,140010837,211530,1,556,3.97112e-06,139099221,0.993489
D.bocki,140010837,210199,1,556,3.97112e-06,139099777,0.993493
D.bocki,140010837,180846,1,556,3.97112e-06,139100333,0.993497
D.bocki,140010837,180615,1,556,3.97112e-06,139100889,0.993501
D.bocki,140010837,158973,1,556,3.97112e-06,139101445,0.993505
D.bocki,140010837,154590,1,556,3.97112e-06,139102001,0.993509
D.bocki,140010837,152565,1,556,3.97112e-06,139102557,0.993513
D.bocki,140010837,133721,1,556,3.97112e-06,139103113,0.993517
D.bocki,140010837,129085,1,556,3.97112e-06,139103669,0.993521
D.bocki,140010837,104367,1,556,3.97112e-06,139104225,0.993525
D.bocki,140010837,103550,1,556,3.97112e-06,139104781,0.993529
D.bocki,140010837,78310,1,555,3.96398e-06,139105336,0.993533
D.bocki,140010837,64784,1,555,3.96398e-06,139105891,0.993537
D.bocki,140010837,454419,1,555,3.96398e-06,139106446,0.993541
D.bocki,140010837,423164,1,555,3.96398e-06,139107001,0.993545
D.bocki,140010837,386241,1,555,3.96398e-06,139107556,0.993548
D.bocki,140010837,374575,1,555,3.96398e-06,139108111,0.993552
D.bocki,140010837,360897,1,555,3.96398e-06,139108666,0.993556
D.bocki,140010837,353041,1,555,3.96398e-06,139109221,0.99356
D.bocki,140010837,31282,1,555,3.96398e-06,139109776,0.993564
D.bocki,140010837,311704,1,555,3.96398e-06,139110331,0.993568
D.bocki,140010837,289573,1,555,3.96398e-06,139110886,0.993572
D.bocki,140010837,276977,1,555,3.96398e-06,139111441,0.993576
D.bocki,140010837,240340,1,555,3.96398e-06,139111996,0.99358
D.bocki,140010837,231697,1,555,3.96398e-06,139112551,0.993584
D.bocki,140010837,227300,1,555,3.96398e-06,139113106,0.993588
D.bocki,140010837,226943,1,555,3.96398e-06,139113661,0.993592
D.bocki,140010837,191819,1,555,3.96398e-06,139114216,0.993596
D.bocki,140010837,19020,1,555,3.96398e-06,139114771,0.9936
D.bocki,140010837,187826,1,555,3.96398e-06,139115326,0.993604
D.bocki,140010837,183491,1,555,3.96398e-06,139115881,0.993608
D.bocki,140010837,179123,1,555,3.96398e-06,139116436,0.993612
D.bocki,140010837,178460,1,555,3.96398e-06,139116991,0.993616
D.bocki,140010837,170516,1,555,3.96398e-06,139117546,0.99362
D.bocki,140010837,154817,1,555,3.96398e-06,139118101,0.993624
D.bocki,140010837,144959,1,555,3.96398e-06,139118656,0.993628
D.bocki,140010837,131616,1,555,3.96398e-06,139119211,0.993632
D.bocki,140010837,125059,1,555,3.96398e-06,139119766,0.993636
D.bocki,140010837,122716,1,555,3.96398e-06,139120321,0.99364
D.bocki,140010837,113131,1,555,3.96398e-06,139120876,0.993644
D.bocki,140010837,111320,1,555,3.96398e-06,139121431,0.993648
D.bocki,140010837,10780,1,555,3.96398e-06,139121986,0.993652
D.bocki,140010837,93217,1,554,3.95684e-06,139122540,0.993656
D.bocki,140010837,90328,1,554,3.95684e-06,139123094,0.993659
D.bocki,140010837,87621,1,554,3.95684e-06,139123648,0.993663
D.bocki,140010837,77223,1,554,3.95684e-06,139124202,0.993667
D.bocki,140010837,67222,1,554,3.95684e-06,139124756,0.993671
D.bocki,140010837,441287,1,554,3.95684e-06,139125310,0.993675
D.bocki,140010837,413789,1,554,3.95684e-06,139125864,0.993679
D.bocki,140010837,401893,1,554,3.95684e-06,139126418,0.993683
D.bocki,140010837,393340,1,554,3.95684e-06,139126972,0.993687
D.bocki,140010837,375091,1,554,3.95684e-06,139127526,0.993691
D.bocki,140010837,368129,1,554,3.95684e-06,139128080,0.993695
D.bocki,140010837,353407,1,554,3.95684e-06,139128634,0.993699
D.bocki,140010837,352069,1,554,3.95684e-06,139129188,0.993703
D.bocki,140010837,349935,1,554,3.95684e-06,139129742,0.993707
D.bocki,140010837,325949,1,554,3.95684e-06,139130296,0.993711
D.bocki,140010837,324838,1,554,3.95684e-06,139130850,0.993715
D.bocki,140010837,323393,1,554,3.95684e-06,139131404,0.993719
D.bocki,140010837,293916,1,554,3.95684e-06,139131958,0.993723
D.bocki,140010837,289205,1,554,3.95684e-06,139132512,0.993727
D.bocki,140010837,271004,1,554,3.95684e-06,139133066,0.993731
D.bocki,140010837,257637,1,554,3.95684e-06,139133620,0.993735
D.bocki,140010837,229322,1,554,3.95684e-06,139134174,0.993739
D.bocki,140010837,226046,1,554,3.95684e-06,139134728,0.993743
D.bocki,140010837,20179,1,554,3.95684e-06,139135282,0.993747
D.bocki,140010837,135739,1,554,3.95684e-06,139135836,0.99375
D.bocki,140010837,126414,1,554,3.95684e-06,139136390,0.993754
D.bocki,140010837,116521,1,554,3.95684e-06,139136944,0.993758
D.bocki,140010837,99482,1,553,3.94969e-06,139137497,0.993762
D.bocki,140010837,65639,1,553,3.94969e-06,139138050,0.993766
D.bocki,140010837,430669,1,553,3.94969e-06,139138603,0.99377
D.bocki,140010837,429516,1,553,3.94969e-06,139139156,0.993774
D.bocki,140010837,416604,1,553,3.94969e-06,139139709,0.993778
D.bocki,140010837,408751,1,553,3.94969e-06,139140262,0.993782
D.bocki,140010837,397809,1,553,3.94969e-06,139140815,0.993786
D.bocki,140010837,3705,1,553,3.94969e-06,139141368,0.99379
D.bocki,140010837,366714,1,553,3.94969e-06,139141921,0.993794
D.bocki,140010837,366664,1,553,3.94969e-06,139142474,0.993798
D.bocki,140010837,363860,1,553,3.94969e-06,139143027,0.993802
D.bocki,140010837,339462,1,553,3.94969e-06,139143580,0.993806
D.bocki,140010837,315909,1,553,3.94969e-06,139144133,0.99381
D.bocki,140010837,272918,1,553,3.94969e-06,139144686,0.993814
D.bocki,140010837,272766,1,553,3.94969e-06,139145239,0.993818
D.bocki,140010837,272532,1,553,3.94969e-06,139145792,0.993822
D.bocki,140010837,258097,1,553,3.94969e-06,139146345,0.993826
D.bocki,140010837,247139,1,553,3.94969e-06,139146898,0.993829
D.bocki,140010837,246254,1,553,3.94969e-06,139147451,0.993833
D.bocki,140010837,244162,1,553,3.94969e-06,139148004,0.993837
D.bocki,140010837,243580,1,553,3.94969e-06,139148557,0.993841
D.bocki,140010837,228604,1,553,3.94969e-06,139149110,0.993845
D.bocki,140010837,217349,1,553,3.94969e-06,139149663,0.993849
D.bocki,140010837,213910,1,553,3.94969e-06,139150216,0.993853
D.bocki,140010837,172297,1,553,3.94969e-06,139150769,0.993857
D.bocki,140010837,151024,1,553,3.94969e-06,139151322,0.993861
D.bocki,140010837,130368,1,553,3.94969e-06,139151875,0.993865
D.bocki,140010837,89199,1,552,3.94255e-06,139152427,0.993869
D.bocki,140010837,451362,1,552,3.94255e-06,139152979,0.993873
D.bocki,140010837,443066,1,552,3.94255e-06,139153531,0.993877
D.bocki,140010837,420244,1,552,3.94255e-06,139154083,0.993881
D.bocki,140010837,348237,1,552,3.94255e-06,139154635,0.993885
D.bocki,140010837,348083,1,552,3.94255e-06,139155187,0.993889
D.bocki,140010837,341111,1,552,3.94255e-06,139155739,0.993893
D.bocki,140010837,313653,1,552,3.94255e-06,139156291,0.993897
D.bocki,140010837,263488,1,552,3.94255e-06,139156843,0.993901
D.bocki,140010837,245559,1,552,3.94255e-06,139157395,0.993904
D.bocki,140010837,239136,1,552,3.94255e-06,139157947,0.993908
D.bocki,140010837,228696,1,552,3.94255e-06,139158499,0.993912
D.bocki,140010837,225880,1,552,3.94255e-06,139159051,0.993916
D.bocki,140010837,205481,1,552,3.94255e-06,139159603,0.99392
D.bocki,140010837,18379,1,552,3.94255e-06,139160155,0.993924
D.bocki,140010837,152171,1,552,3.94255e-06,139160707,0.993928
D.bocki,140010837,141991,1,552,3.94255e-06,139161259,0.993932
D.bocki,140010837,138581,1,552,3.94255e-06,139161811,0.993936
D.bocki,140010837,121238,1,552,3.94255e-06,139162363,0.99394
D.bocki,140010837,117805,1,552,3.94255e-06,139162915,0.993944
D.bocki,140010837,95582,1,551,3.93541e-06,139163466,0.993948
D.bocki,140010837,91790,1,551,3.93541e-06,139164017,0.993952
D.bocki,140010837,86293,1,551,3.93541e-06,139164568,0.993956
D.bocki,140010837,5130,1,551,3.93541e-06,139165119,0.99396
D.bocki,140010837,453655,1,551,3.93541e-06,139165670,0.993964
D.bocki,140010837,443041,1,551,3.93541e-06,139166221,0.993967
D.bocki,140010837,440683,1,551,3.93541e-06,139166772,0.993971
D.bocki,140010837,426832,1,551,3.93541e-06,139167323,0.993975
D.bocki,140010837,404890,1,551,3.93541e-06,139167874,0.993979
D.bocki,140010837,398154,1,551,3.93541e-06,139168425,0.993983
D.bocki,140010837,391796,1,551,3.93541e-06,139168976,0.993987
D.bocki,140010837,374974,1,551,3.93541e-06,139169527,0.993991
D.bocki,140010837,374503,1,551,3.93541e-06,139170078,0.993995
D.bocki,140010837,3445,1,551,3.93541e-06,139170629,0.993999
D.bocki,140010837,331260,1,551,3.93541e-06,139171180,0.994003
D.bocki,140010837,323752,1,551,3.93541e-06,139171731,0.994007
D.bocki,140010837,313873,1,551,3.93541e-06,139172282,0.994011
D.bocki,140010837,291393,1,551,3.93541e-06,139172833,0.994015
D.bocki,140010837,289319,1,551,3.93541e-06,139173384,0.994019
D.bocki,140010837,28773,1,551,3.93541e-06,139173935,0.994023
D.bocki,140010837,27831,1,551,3.93541e-06,139174486,0.994027
D.bocki,140010837,277239,1,551,3.93541e-06,139175037,0.99403
D.bocki,140010837,277006,1,551,3.93541e-06,139175588,0.994034
D.bocki,140010837,267425,1,551,3.93541e-06,139176139,0.994038
D.bocki,140010837,259007,1,551,3.93541e-06,139176690,0.994042
D.bocki,140010837,253345,1,551,3.93541e-06,139177241,0.994046
D.bocki,140010837,246005,1,551,3.93541e-06,139177792,0.99405
D.bocki,140010837,228085,1,551,3.93541e-06,139178343,0.994054
D.bocki,140010837,196231,1,551,3.93541e-06,139178894,0.994058
D.bocki,140010837,194424,1,551,3.93541e-06,139179445,0.994062
D.bocki,140010837,18893,1,551,3.93541e-06,139179996,0.994066
D.bocki,140010837,187019,1,551,3.93541e-06,139180547,0.99407
D.bocki,140010837,181717,1,551,3.93541e-06,139181098,0.994074
D.bocki,140010837,173475,1,551,3.93541e-06,139181649,0.994078
D.bocki,140010837,148823,1,551,3.93541e-06,139182200,0.994082
D.bocki,140010837,134530,1,551,3.93541e-06,139182751,0.994086
D.bocki,140010837,128660,1,551,3.93541e-06,139183302,0.994089
D.bocki,140010837,111026,1,551,3.93541e-06,139183853,0.994093
D.bocki,140010837,106028,1,551,3.93541e-06,139184404,0.994097
D.bocki,140010837,9399,1,550,3.92827e-06,139184954,0.994101
D.bocki,140010837,89888,1,550,3.92827e-06,139185504,0.994105
D.bocki,140010837,48460,1,550,3.92827e-06,139186054,0.994109
D.bocki,140010837,454101,1,550,3.92827e-06,139186604,0.994113
D.bocki,140010837,453648,1,550,3.92827e-06,139187154,0.994117
D.bocki,140010837,452388,1,550,3.92827e-06,139187704,0.994121
D.bocki,140010837,443704,1,550,3.92827e-06,139188254,0.994125
D.bocki,140010837,420560,1,550,3.92827e-06,139188804,0.994129
D.bocki,140010837,398651,1,550,3.92827e-06,139189354,0.994133
D.bocki,140010837,373210,1,550,3.92827e-06,139189904,0.994137
D.bocki,140010837,333211,1,550,3.92827e-06,139190454,0.994141
D.bocki,140010837,320106,1,550,3.92827e-06,139191004,0.994145
D.bocki,140010837,316280,1,550,3.92827e-06,139191554,0.994148
D.bocki,140010837,315942,1,550,3.92827e-06,139192104,0.994152
D.bocki,140010837,277983,1,550,3.92827e-06,139192654,0.994156
D.bocki,140010837,271890,1,550,3.92827e-06,139193204,0.99416
D.bocki,140010837,249683,1,550,3.92827e-06,139193754,0.994164
D.bocki,140010837,248682,1,550,3.92827e-06,139194304,0.994168
D.bocki,140010837,24472,1,550,3.92827e-06,139194854,0.994172
D.bocki,140010837,240273,1,550,3.92827e-06,139195404,0.994176
D.bocki,140010837,238735,1,550,3.92827e-06,139195954,0.99418
D.bocki,140010837,202803,1,550,3.92827e-06,139196504,0.994184
D.bocki,140010837,201124,1,550,3.92827e-06,139197054,0.994188
D.bocki,140010837,189322,1,550,3.92827e-06,139197604,0.994192
D.bocki,140010837,185043,1,550,3.92827e-06,139198154,0.994196
D.bocki,140010837,176969,1,550,3.92827e-06,139198704,0.994199
D.bocki,140010837,134221,1,550,3.92827e-06,139199254,0.994203
D.bocki,140010837,124506,1,550,3.92827e-06,139199804,0.994207
D.bocki,140010837,100301,1,550,3.92827e-06,139200354,0.994211
D.bocki,140010837,91657,1,549,3.92113e-06,139200903,0.994215
D.bocki,140010837,73136,1,549,3.92113e-06,139201452,0.994219
D.bocki,140010837,54689,1,549,3.92113e-06,139202001,0.994223
D.bocki,140010837,426118,1,549,3.92113e-06,139202550,0.994227
D.bocki,140010837,424398,1,549,3.92113e-06,139203099,0.994231
D.bocki,140010837,41956,1,549,3.92113e-06,139203648,0.994235
D.bocki,140010837,408503,1,549,3.92113e-06,139204197,0.994239
D.bocki,140010837,376362,1,549,3.92113e-06,139204746,0.994243
D.bocki,140010837,354439,1,549,3.92113e-06,139205295,0.994247
D.bocki,140010837,352004,1,549,3.92113e-06,139205844,0.99425
D.bocki,140010837,341461,1,549,3.92113e-06,139206393,0.994254
D.bocki,140010837,336514,1,549,3.92113e-06,139206942,0.994258
D.bocki,140010837,334055,1,549,3.92113e-06,139207491,0.994262
D.bocki,140010837,328975,1,549,3.92113e-06,139208040,0.994266
D.bocki,140010837,319427,1,549,3.92113e-06,139208589,0.99427
D.bocki,140010837,313934,1,549,3.92113e-06,139209138,0.994274
D.bocki,140010837,313798,1,549,3.92113e-06,139209687,0.994278
D.bocki,140010837,292503,1,549,3.92113e-06,139210236,0.994282
D.bocki,140010837,288329,1,549,3.92113e-06,139210785,0.994286
D.bocki,140010837,287326,1,549,3.92113e-06,139211334,0.99429
D.bocki,140010837,267574,1,549,3.92113e-06,139211883,0.994294
D.bocki,140010837,261259,1,549,3.92113e-06,139212432,0.994298
D.bocki,140010837,251651,1,549,3.92113e-06,139212981,0.994301
D.bocki,140010837,240558,1,549,3.92113e-06,139213530,0.994305
D.bocki,140010837,235206,1,549,3.92113e-06,139214079,0.994309
D.bocki,140010837,232376,1,549,3.92113e-06,139214628,0.994313
D.bocki,140010837,169947,1,549,3.92113e-06,139215177,0.994317
D.bocki,140010837,160051,1,549,3.92113e-06,139215726,0.994321
D.bocki,140010837,10120,1,549,3.92113e-06,139216275,0.994325
D.bocki,140010837,96164,1,548,3.91398e-06,139216823,0.994329
D.bocki,140010837,90652,1,548,3.91398e-06,139217371,0.994333
D.bocki,140010837,88479,1,548,3.91398e-06,139217919,0.994337
D.bocki,140010837,67449,1,548,3.91398e-06,139218467,0.994341
D.bocki,140010837,452107,1,548,3.91398e-06,139219015,0.994345
D.bocki,140010837,418173,1,548,3.91398e-06,139219563,0.994348
D.bocki,140010837,414182,1,548,3.91398e-06,139220111,0.994352
D.bocki,140010837,407596,1,548,3.91398e-06,139220659,0.994356
D.bocki,140010837,405506,1,548,3.91398e-06,139221207,0.99436
D.bocki,140010837,405118,1,548,3.91398e-06,139221755,0.994364
D.bocki,140010837,379292,1,548,3.91398e-06,139222303,0.994368
D.bocki,140010837,358000,1,548,3.91398e-06,139222851,0.994372
D.bocki,140010837,340289,1,548,3.91398e-06,139223399,0.994376
D.bocki,140010837,330298,1,548,3.91398e-06,139223947,0.99438
D.bocki,140010837,305430,1,548,3.91398e-06,139224495,0.994384
D.bocki,140010837,305357,1,548,3.91398e-06,139225043,0.994388
D.bocki,140010837,292996,1,548,3.91398e-06,139225591,0.994392
D.bocki,140010837,292794,1,548,3.91398e-06,139226139,0.994395
D.bocki,140010837,277616,1,548,3.91398e-06,139226687,0.994399
D.bocki,140010837,231110,1,548,3.91398e-06,139227235,0.994403
D.bocki,140010837,229099,1,548,3.91398e-06,139227783,0.994407
D.bocki,140010837,222787,1,548,3.91398e-06,139228331,0.994411
D.bocki,140010837,208337,1,548,3.91398e-06,139228879,0.994415
D.bocki,140010837,198431,1,548,3.91398e-06,139229427,0.994419
D.bocki,140010837,194651,1,548,3.91398e-06,139229975,0.994423
D.bocki,140010837,163880,1,548,3.91398e-06,139230523,0.994427
D.bocki,140010837,154856,1,548,3.91398e-06,139231071,0.994431
D.bocki,140010837,14901,1,548,3.91398e-06,139231619,0.994435
D.bocki,140010837,122208,1,548,3.91398e-06,139232167,0.994439
D.bocki,140010837,85978,1,547,3.90684e-06,139232714,0.994442
D.bocki,140010837,56280,1,547,3.90684e-06,139233261,0.994446
D.bocki,140010837,453857,1,547,3.90684e-06,139233808,0.99445
D.bocki,140010837,452199,1,547,3.90684e-06,139234355,0.994454
D.bocki,140010837,451557,1,547,3.90684e-06,139234902,0.994458
D.bocki,140010837,448101,1,547,3.90684e-06,139235449,0.994462
D.bocki,140010837,434427,1,547,3.90684e-06,139235996,0.994466
D.bocki,140010837,432716,1,547,3.90684e-06,139236543,0.99447
D.bocki,140010837,413075,1,547,3.90684e-06,139237090,0.994474
D.bocki,140010837,40735,1,547,3.90684e-06,139237637,0.994478
D.bocki,140010837,349041,1,547,3.90684e-06,139238184,0.994481
D.bocki,140010837,310769,1,547,3.90684e-06,139238731,0.994485
D.bocki,140010837,309338,1,547,3.90684e-06,139239278,0.994489
D.bocki,140010837,308781,1,547,3.90684e-06,139239825,0.994493
D.bocki,140010837,267940,1,547,3.90684e-06,139240372,0.994497
D.bocki,140010837,251810,1,547,3.90684e-06,139240919,0.994501
D.bocki,140010837,251505,1,547,3.90684e-06,139241466,0.994505
D.bocki,140010837,24649,1,547,3.90684e-06,139242013,0.994509
D.bocki,140010837,24224,1,547,3.90684e-06,139242560,0.994513
D.bocki,140010837,240980,1,547,3.90684e-06,139243107,0.994517
D.bocki,140010837,223152,1,547,3.90684e-06,139243654,0.994521
D.bocki,140010837,220397,1,547,3.90684e-06,139244201,0.994524
D.bocki,140010837,195449,1,547,3.90684e-06,139244748,0.994528
D.bocki,140010837,152656,1,547,3.90684e-06,139245295,0.994532
D.bocki,140010837,148954,1,547,3.90684e-06,139245842,0.994536
D.bocki,140010837,140138,1,547,3.90684e-06,139246389,0.99454
D.bocki,140010837,127736,1,547,3.90684e-06,139246936,0.994544
D.bocki,140010837,120598,1,547,3.90684e-06,139247483,0.994548
D.bocki,140010837,117144,1,547,3.90684e-06,139248030,0.994552
D.bocki,140010837,114189,1,547,3.90684e-06,139248577,0.994556
D.bocki,140010837,108841,1,547,3.90684e-06,139249124,0.99456
D.bocki,140010837,10656,1,547,3.90684e-06,139249671,0.994564
D.bocki,140010837,95810,1,546,3.8997e-06,139250217,0.994567
D.bocki,140010837,82933,1,546,3.8997e-06,139250763,0.994571
D.bocki,140010837,81315,1,546,3.8997e-06,139251309,0.994575
D.bocki,140010837,63657,1,546,3.8997e-06,139251855,0.994579
D.bocki,140010837,49454,1,546,3.8997e-06,139252401,0.994583
D.bocki,140010837,430781,1,546,3.8997e-06,139252947,0.994587
D.bocki,140010837,411678,1,546,3.8997e-06,139253493,0.994591
D.bocki,140010837,39360,1,546,3.8997e-06,139254039,0.994595
D.bocki,140010837,386393,1,546,3.8997e-06,139254585,0.994599
D.bocki,140010837,378159,1,546,3.8997e-06,139255131,0.994603
D.bocki,140010837,375436,1,546,3.8997e-06,139255677,0.994606
D.bocki,140010837,373513,1,546,3.8997e-06,139256223,0.99461
D.bocki,140010837,362358,1,546,3.8997e-06,139256769,0.994614
D.bocki,140010837,357181,1,546,3.8997e-06,139257315,0.994618
D.bocki,140010837,309305,1,546,3.8997e-06,139257861,0.994622
D.bocki,140010837,296320,1,546,3.8997e-06,139258407,0.994626
D.bocki,140010837,263552,1,546,3.8997e-06,139258953,0.99463
D.bocki,140010837,223802,1,546,3.8997e-06,139259499,0.994634
D.bocki,140010837,204915,1,546,3.8997e-06,139260045,0.994638
D.bocki,140010837,204627,1,546,3.8997e-06,139260591,0.994642
D.bocki,140010837,202757,1,546,3.8997e-06,139261137,0.994645
D.bocki,140010837,20063,1,546,3.8997e-06,139261683,0.994649
D.bocki,140010837,19107,1,546,3.8997e-06,139262229,0.994653
D.bocki,140010837,181741,1,546,3.8997e-06,139262775,0.994657
D.bocki,140010837,176212,1,546,3.8997e-06,139263321,0.994661
D.bocki,140010837,173161,1,546,3.8997e-06,139263867,0.994665
D.bocki,140010837,146825,1,546,3.8997e-06,139264413,0.994669
D.bocki,140010837,114381,1,546,3.8997e-06,139264959,0.994673
D.bocki,140010837,110503,1,546,3.8997e-06,139265505,0.994677
D.bocki,140010837,109602,1,546,3.8997e-06,139266051,0.994681
D.bocki,140010837,109088,1,546,3.8997e-06,139266597,0.994684
D.bocki,140010837,103873,1,546,3.8997e-06,139267143,0.994688
D.bocki,140010837,103348,1,546,3.8997e-06,139267689,0.994692
D.bocki,140010837,100962,1,546,3.8997e-06,139268235,0.994696
D.bocki,140010837,95843,1,545,3.89256e-06,139268780,0.9947
D.bocki,140010837,81104,1,545,3.89256e-06,139269325,0.994704
D.bocki,140010837,80009,1,545,3.89256e-06,139269870,0.994708
D.bocki,140010837,77687,1,545,3.89256e-06,139270415,0.994712
D.bocki,140010837,77653,1,545,3.89256e-06,139270960,0.994716
D.bocki,140010837,77256,1,545,3.89256e-06,139271505,0.994719
D.bocki,140010837,74770,1,545,3.89256e-06,139272050,0.994723
D.bocki,140010837,61624,1,545,3.89256e-06,139272595,0.994727
D.bocki,140010837,54843,1,545,3.89256e-06,139273140,0.994731
D.bocki,140010837,454761,1,545,3.89256e-06,139273685,0.994735
D.bocki,140010837,439614,1,545,3.89256e-06,139274230,0.994739
D.bocki,140010837,437543,1,545,3.89256e-06,139274775,0.994743
D.bocki,140010837,435868,1,545,3.89256e-06,139275320,0.994747
D.bocki,140010837,40626,1,545,3.89256e-06,139275865,0.994751
D.bocki,140010837,359745,1,545,3.89256e-06,139276410,0.994754
D.bocki,140010837,354501,1,545,3.89256e-06,139276955,0.994758
D.bocki,140010837,296842,1,545,3.89256e-06,139277500,0.994762
D.bocki,140010837,266584,1,545,3.89256e-06,139278045,0.994766
D.bocki,140010837,26388,1,545,3.89256e-06,139278590,0.99477
D.bocki,140010837,260608,1,545,3.89256e-06,139279135,0.994774
D.bocki,140010837,257158,1,545,3.89256e-06,139279680,0.994778
D.bocki,140010837,239224,1,545,3.89256e-06,139280225,0.994782
D.bocki,140010837,23541,1,545,3.89256e-06,139280770,0.994786
D.bocki,140010837,233515,1,545,3.89256e-06,139281315,0.99479
D.bocki,140010837,223051,1,545,3.89256e-06,139281860,0.994793
D.bocki,140010837,221882,1,545,3.89256e-06,139282405,0.994797
D.bocki,140010837,201260,1,545,3.89256e-06,139282950,0.994801
D.bocki,140010837,200022,1,545,3.89256e-06,139283495,0.994805
D.bocki,140010837,192223,1,545,3.89256e-06,139284040,0.994809
D.bocki,140010837,185017,1,545,3.89256e-06,139284585,0.994813
D.bocki,140010837,174813,1,545,3.89256e-06,139285130,0.994817
D.bocki,140010837,174321,1,545,3.89256e-06,139285675,0.994821
D.bocki,140010837,164186,1,545,3.89256e-06,139286220,0.994825
D.bocki,140010837,161343,1,545,3.89256e-06,139286765,0.994828
D.bocki,140010837,155355,1,545,3.89256e-06,139287310,0.994832
D.bocki,140010837,149268,1,545,3.89256e-06,139287855,0.994836
D.bocki,140010837,147195,1,545,3.89256e-06,139288400,0.99484
D.bocki,140010837,143260,1,545,3.89256e-06,139288945,0.994844
D.bocki,140010837,139049,1,545,3.89256e-06,139289490,0.994848
D.bocki,140010837,137113,1,545,3.89256e-06,139290035,0.994852
D.bocki,140010837,12157,1,545,3.89256e-06,139290580,0.994856
D.bocki,140010837,117622,1,545,3.89256e-06,139291125,0.99486
D.bocki,140010837,111658,1,545,3.89256e-06,139291670,0.994863
D.bocki,140010837,101056,1,545,3.89256e-06,139292215,0.994867
D.bocki,140010837,92719,1,544,3.88541e-06,139292759,0.994871
D.bocki,140010837,90676,1,544,3.88541e-06,139293303,0.994875
D.bocki,140010837,6568,1,544,3.88541e-06,139293847,0.994879
D.bocki,140010837,60483,1,544,3.88541e-06,139294391,0.994883
D.bocki,140010837,45979,1,544,3.88541e-06,139294935,0.994887
D.bocki,140010837,452046,1,544,3.88541e-06,139295479,0.994891
D.bocki,140010837,429625,1,544,3.88541e-06,139296023,0.994895
D.bocki,140010837,355612,1,544,3.88541e-06,139296567,0.994898
D.bocki,140010837,352199,1,544,3.88541e-06,139297111,0.994902
D.bocki,140010837,35186,1,544,3.88541e-06,139297655,0.994906
D.bocki,140010837,349477,1,544,3.88541e-06,139298199,0.99491
D.bocki,140010837,328352,1,544,3.88541e-06,139298743,0.994914
D.bocki,140010837,304594,1,544,3.88541e-06,139299287,0.994918
D.bocki,140010837,290602,1,544,3.88541e-06,139299831,0.994922
D.bocki,140010837,281480,1,544,3.88541e-06,139300375,0.994926
D.bocki,140010837,277814,1,544,3.88541e-06,139300919,0.99493
D.bocki,140010837,252000,1,544,3.88541e-06,139301463,0.994933
D.bocki,140010837,245657,1,544,3.88541e-06,139302007,0.994937
D.bocki,140010837,24287,1,544,3.88541e-06,139302551,0.994941
D.bocki,140010837,234435,1,544,3.88541e-06,139303095,0.994945
D.bocki,140010837,226137,1,544,3.88541e-06,139303639,0.994949
D.bocki,140010837,211740,1,544,3.88541e-06,139304183,0.994953
D.bocki,140010837,164070,1,544,3.88541e-06,139304727,0.994957
D.bocki,140010837,163299,1,544,3.88541e-06,139305271,0.994961
D.bocki,140010837,144677,1,544,3.88541e-06,139305815,0.994965
D.bocki,140010837,108588,1,544,3.88541e-06,139306359,0.994968
D.bocki,140010837,106008,1,544,3.88541e-06,139306903,0.994972
D.bocki,140010837,101256,1,544,3.88541e-06,139307447,0.994976
D.bocki,140010837,71310,1,543,3.87827e-06,139307990,0.99498
D.bocki,140010837,49339,1,543,3.87827e-06,139308533,0.994984
D.bocki,140010837,439533,1,543,3.87827e-06,139309076,0.994988
D.bocki,140010837,425917,1,543,3.87827e-06,139309619,0.994992
D.bocki,140010837,413825,1,543,3.87827e-06,139310162,0.994996
D.bocki,140010837,412718,1,543,3.87827e-06,139310705,0.994999
D.bocki,140010837,401168,1,543,3.87827e-06,139311248,0.995003
D.bocki,140010837,398600,1,543,3.87827e-06,139311791,0.995007
D.bocki,140010837,391607,1,543,3.87827e-06,139312334,0.995011
D.bocki,140010837,37559,1,543,3.87827e-06,139312877,0.995015
D.bocki,140010837,352489,1,543,3.87827e-06,139313420,0.995019
D.bocki,140010837,35046,1,543,3.87827e-06,139313963,0.995023
D.bocki,140010837,348261,1,543,3.87827e-06,139314506,0.995027
D.bocki,140010837,33904,1,543,3.87827e-06,139315049,0.99503
D.bocki,140010837,335360,1,543,3.87827e-06,139315592,0.995034
D.bocki,140010837,321021,1,543,3.87827e-06,139316135,0.995038
D.bocki,140010837,316831,1,543,3.87827e-06,139316678,0.995042
D.bocki,140010837,299695,1,543,3.87827e-06,139317221,0.995046
D.bocki,140010837,266457,1,543,3.87827e-06,139317764,0.99505
D.bocki,140010837,260107,1,543,3.87827e-06,139318307,0.995054
D.bocki,140010837,259958,1,543,3.87827e-06,139318850,0.995058
D.bocki,140010837,244642,1,543,3.87827e-06,139319393,0.995061
D.bocki,140010837,228384,1,543,3.87827e-06,139319936,0.995065
D.bocki,140010837,221901,1,543,3.87827e-06,139320479,0.995069
D.bocki,140010837,216811,1,543,3.87827e-06,139321022,0.995073
D.bocki,140010837,213394,1,543,3.87827e-06,139321565,0.995077
D.bocki,140010837,160777,1,543,3.87827e-06,139322108,0.995081
D.bocki,140010837,132828,1,543,3.87827e-06,139322651,0.995085
D.bocki,140010837,109021,1,543,3.87827e-06,139323194,0.995089
D.bocki,140010837,103272,1,543,3.87827e-06,139323737,0.995093
D.bocki,140010837,100500,1,543,3.87827e-06,139324280,0.995096
D.bocki,140010837,95455,1,542,3.87113e-06,139324822,0.9951
D.bocki,140010837,454383,1,542,3.87113e-06,139325364,0.995104
D.bocki,140010837,453020,1,542,3.87113e-06,139325906,0.995108
D.bocki,140010837,44545,1,542,3.87113e-06,139326448,0.995112
D.bocki,140010837,406252,1,542,3.87113e-06,139326990,0.995116
D.bocki,140010837,403766,1,542,3.87113e-06,139327532,0.99512
D.bocki,140010837,402346,1,542,3.87113e-06,139328074,0.995123
D.bocki,140010837,391795,1,542,3.87113e-06,139328616,0.995127
D.bocki,140010837,382044,1,542,3.87113e-06,139329158,0.995131
D.bocki,140010837,378702,1,542,3.87113e-06,139329700,0.995135
D.bocki,140010837,308029,1,542,3.87113e-06,139330242,0.995139
D.bocki,140010837,26200,1,542,3.87113e-06,139330784,0.995143
D.bocki,140010837,243341,1,542,3.87113e-06,139331326,0.995147
D.bocki,140010837,236065,1,542,3.87113e-06,139331868,0.995151
D.bocki,140010837,229532,1,542,3.87113e-06,139332410,0.995154
D.bocki,140010837,228114,1,542,3.87113e-06,139332952,0.995158
D.bocki,140010837,226327,1,542,3.87113e-06,139333494,0.995162
D.bocki,140010837,215755,1,542,3.87113e-06,139334036,0.995166
D.bocki,140010837,209040,1,542,3.87113e-06,139334578,0.99517
D.bocki,140010837,18665,1,542,3.87113e-06,139335120,0.995174
D.bocki,140010837,179681,1,542,3.87113e-06,139335662,0.995178
D.bocki,140010837,170396,1,542,3.87113e-06,139336204,0.995182
D.bocki,140010837,149182,1,542,3.87113e-06,139336746,0.995185
D.bocki,140010837,145430,1,542,3.87113e-06,139337288,0.995189
D.bocki,140010837,140221,1,542,3.87113e-06,139337830,0.995193
D.bocki,140010837,125705,1,542,3.87113e-06,139338372,0.995197
D.bocki,140010837,86175,1,541,3.86399e-06,139338913,0.995201
D.bocki,140010837,451876,1,541,3.86399e-06,139339454,0.995205
D.bocki,140010837,447079,1,541,3.86399e-06,139339995,0.995209
D.bocki,140010837,444880,1,541,3.86399e-06,139340536,0.995213
D.bocki,140010837,431008,1,541,3.86399e-06,139341077,0.995216
D.bocki,140010837,410104,1,541,3.86399e-06,139341618,0.99522
D.bocki,140010837,378538,1,541,3.86399e-06,139342159,0.995224
D.bocki,140010837,374291,1,541,3.86399e-06,139342700,0.995228
D.bocki,140010837,367184,1,541,3.86399e-06,139343241,0.995232
D.bocki,140010837,350370,1,541,3.86399e-06,139343782,0.995236
D.bocki,140010837,314280,1,541,3.86399e-06,139344323,0.99524
D.bocki,140010837,312049,1,541,3.86399e-06,139344864,0.995243
D.bocki,140010837,293557,1,541,3.86399e-06,139345405,0.995247
D.bocki,140010837,276780,1,541,3.86399e-06,139345946,0.995251
D.bocki,140010837,268352,1,541,3.86399e-06,139346487,0.995255
D.bocki,140010837,25730,1,541,3.86399e-06,139347028,0.995259
D.bocki,140010837,254511,1,541,3.86399e-06,139347569,0.995263
D.bocki,140010837,250892,1,541,3.86399e-06,139348110,0.995267
D.bocki,140010837,246614,1,541,3.86399e-06,139348651,0.99527
D.bocki,140010837,245401,1,541,3.86399e-06,139349192,0.995274
D.bocki,140010837,243943,1,541,3.86399e-06,139349733,0.995278
D.bocki,140010837,225203,1,541,3.86399e-06,139350274,0.995282
D.bocki,140010837,193931,1,541,3.86399e-06,139350815,0.995286
D.bocki,140010837,18892,1,541,3.86399e-06,139351356,0.99529
D.bocki,140010837,177138,1,541,3.86399e-06,139351897,0.995294
D.bocki,140010837,162516,1,541,3.86399e-06,139352438,0.995298
D.bocki,140010837,161016,1,541,3.86399e-06,139352979,0.995301
D.bocki,140010837,152291,1,541,3.86399e-06,139353520,0.995305
D.bocki,140010837,151296,1,541,3.86399e-06,139354061,0.995309
D.bocki,140010837,148561,1,541,3.86399e-06,139354602,0.995313
D.bocki,140010837,128534,1,541,3.86399e-06,139355143,0.995317
D.bocki,140010837,127938,1,541,3.86399e-06,139355684,0.995321
D.bocki,140010837,110805,1,541,3.86399e-06,139356225,0.995325
D.bocki,140010837,106696,1,541,3.86399e-06,139356766,0.995328
D.bocki,140010837,100471,1,541,3.86399e-06,139357307,0.995332
D.bocki,140010837,81033,1,540,3.85684e-06,139357847,0.995336
D.bocki,140010837,7514,1,540,3.85684e-06,139358387,0.99534
D.bocki,140010837,452250,1,540,3.85684e-06,139358927,0.995344
D.bocki,140010837,440650,1,540,3.85684e-06,139359467,0.995348
D.bocki,140010837,434854,1,540,3.85684e-06,139360007,0.995352
D.bocki,140010837,428600,1,540,3.85684e-06,139360547,0.995355
D.bocki,140010837,419867,1,540,3.85684e-06,139361087,0.995359
D.bocki,140010837,416636,1,540,3.85684e-06,139361627,0.995363
D.bocki,140010837,365769,1,540,3.85684e-06,139362167,0.995367
D.bocki,140010837,32898,1,540,3.85684e-06,139362707,0.995371
D.bocki,140010837,282479,1,540,3.85684e-06,139363247,0.995375
D.bocki,140010837,268612,1,540,3.85684e-06,139363787,0.995379
D.bocki,140010837,261176,1,540,3.85684e-06,139364327,0.995382
D.bocki,140010837,255149,1,540,3.85684e-06,139364867,0.995386
D.bocki,140010837,24540,1,540,3.85684e-06,139365407,0.99539
D.bocki,140010837,227008,1,540,3.85684e-06,139365947,0.995394
D.bocki,140010837,217135,1,540,3.85684e-06,139366487,0.995398
D.bocki,140010837,215091,1,540,3.85684e-06,139367027,0.995402
D.bocki,140010837,213465,1,540,3.85684e-06,139367567,0.995406
D.bocki,140010837,20665,1,540,3.85684e-06,139368107,0.995409
D.bocki,140010837,197352,1,540,3.85684e-06,139368647,0.995413
D.bocki,140010837,170737,1,540,3.85684e-06,139369187,0.995417
D.bocki,140010837,164001,1,540,3.85684e-06,139369727,0.995421
D.bocki,140010837,161887,1,540,3.85684e-06,139370267,0.995425
D.bocki,140010837,156715,1,540,3.85684e-06,139370807,0.995429
D.bocki,140010837,14730,1,540,3.85684e-06,139371347,0.995433
D.bocki,140010837,116923,1,540,3.85684e-06,139371887,0.995436
D.bocki,140010837,94543,1,539,3.8497e-06,139372426,0.99544
D.bocki,140010837,80381,1,539,3.8497e-06,139372965,0.995444
D.bocki,140010837,66121,1,539,3.8497e-06,139373504,0.995448
D.bocki,140010837,61933,1,539,3.8497e-06,139374043,0.995452
D.bocki,140010837,452691,1,539,3.8497e-06,139374582,0.995456
D.bocki,140010837,452276,1,539,3.8497e-06,139375121,0.99546
D.bocki,140010837,438942,1,539,3.8497e-06,139375660,0.995463
D.bocki,140010837,434809,1,539,3.8497e-06,139376199,0.995467
D.bocki,140010837,423532,1,539,3.8497e-06,139376738,0.995471
D.bocki,140010837,421362,1,539,3.8497e-06,139377277,0.995475
D.bocki,140010837,415123,1,539,3.8497e-06,139377816,0.995479
D.bocki,140010837,413325,1,539,3.8497e-06,139378355,0.995483
D.bocki,140010837,374203,1,539,3.8497e-06,139378894,0.995486
D.bocki,140010837,369019,1,539,3.8497e-06,139379433,0.99549
D.bocki,140010837,342735,1,539,3.8497e-06,139379972,0.995494
D.bocki,140010837,32927,1,539,3.8497e-06,139380511,0.995498
D.bocki,140010837,326423,1,539,3.8497e-06,139381050,0.995502
D.bocki,140010837,325365,1,539,3.8497e-06,139381589,0.995506
D.bocki,140010837,285618,1,539,3.8497e-06,139382128,0.99551
D.bocki,140010837,283717,1,539,3.8497e-06,139382667,0.995513
D.bocki,140010837,272234,1,539,3.8497e-06,139383206,0.995517
D.bocki,140010837,2574,1,539,3.8497e-06,139383745,0.995521
D.bocki,140010837,236242,1,539,3.8497e-06,139384284,0.995525
D.bocki,140010837,228416,1,539,3.8497e-06,139384823,0.995529
D.bocki,140010837,190492,1,539,3.8497e-06,139385362,0.995533
D.bocki,140010837,182593,1,539,3.8497e-06,139385901,0.995537
D.bocki,140010837,126130,1,539,3.8497e-06,139386440,0.99554
D.bocki,140010837,10687,1,539,3.8497e-06,139386979,0.995544
D.bocki,140010837,100302,1,539,3.8497e-06,139387518,0.995548
D.bocki,140010837,68567,1,538,3.84256e-06,139388056,0.995552
D.bocki,140010837,452663,1,538,3.84256e-06,139388594,0.995556
D.bocki,140010837,447428,1,538,3.84256e-06,139389132,0.99556
D.bocki,140010837,42586,1,538,3.84256e-06,139389670,0.995563
D.bocki,140010837,425016,1,538,3.84256e-06,139390208,0.995567
D.bocki,140010837,416603,1,538,3.84256e-06,139390746,0.995571
D.bocki,140010837,385068,1,538,3.84256e-06,139391284,0.995575
D.bocki,140010837,378366,1,538,3.84256e-06,139391822,0.995579
D.bocki,140010837,371801,1,538,3.84256e-06,139392360,0.995583
D.bocki,140010837,362049,1,538,3.84256e-06,139392898,0.995586
D.bocki,140010837,353080,1,538,3.84256e-06,139393436,0.99559
D.bocki,140010837,35010,1,538,3.84256e-06,139393974,0.995594
D.bocki,140010837,341486,1,538,3.84256e-06,139394512,0.995598
D.bocki,140010837,340818,1,538,3.84256e-06,139395050,0.995602
D.bocki,140010837,338840,1,538,3.84256e-06,139395588,0.995606
D.bocki,140010837,322206,1,538,3.84256e-06,139396126,0.99561
D.bocki,140010837,319456,1,538,3.84256e-06,139396664,0.995613
D.bocki,140010837,306934,1,538,3.84256e-06,139397202,0.995617
D.bocki,140010837,22097,1,538,3.84256e-06,139397740,0.995621
D.bocki,140010837,213741,1,538,3.84256e-06,139398278,0.995625
D.bocki,140010837,208338,1,538,3.84256e-06,139398816,0.995629
D.bocki,140010837,193771,1,538,3.84256e-06,139399354,0.995633
D.bocki,140010837,185902,1,538,3.84256e-06,139399892,0.995636
D.bocki,140010837,172080,1,538,3.84256e-06,139400430,0.99564
D.bocki,140010837,164336,1,538,3.84256e-06,139400968,0.995644
D.bocki,140010837,145393,1,538,3.84256e-06,139401506,0.995648
D.bocki,140010837,143224,1,538,3.84256e-06,139402044,0.995652
D.bocki,140010837,136730,1,538,3.84256e-06,139402582,0.995656
D.bocki,140010837,104771,1,538,3.84256e-06,139403120,0.99566
D.bocki,140010837,101523,1,538,3.84256e-06,139403658,0.995663
D.bocki,140010837,8597,1,537,3.83542e-06,139404195,0.995667
D.bocki,140010837,56475,1,537,3.83542e-06,139404732,0.995671
D.bocki,140010837,454461,1,537,3.83542e-06,139405269,0.995675
D.bocki,140010837,444316,1,537,3.83542e-06,139405806,0.995679
D.bocki,140010837,387100,1,537,3.83542e-06,139406343,0.995683
D.bocki,140010837,368545,1,537,3.83542e-06,139406880,0.995686
D.bocki,140010837,368506,1,537,3.83542e-06,139407417,0.99569
D.bocki,140010837,354736,1,537,3.83542e-06,139407954,0.995694
D.bocki,140010837,337890,1,537,3.83542e-06,139408491,0.995698
D.bocki,140010837,334119,1,537,3.83542e-06,139409028,0.995702
D.bocki,140010837,334084,1,537,3.83542e-06,139409565,0.995706
D.bocki,140010837,306816,1,537,3.83542e-06,139410102,0.995709
D.bocki,140010837,304078,1,537,3.83542e-06,139410639,0.995713
D.bocki,140010837,301121,1,537,3.83542e-06,139411176,0.995717
D.bocki,140010837,29598,1,537,3.83542e-06,139411713,0.995721
D.bocki,140010837,282860,1,537,3.83542e-06,139412250,0.995725
D.bocki,140010837,269017,1,537,3.83542e-06,139412787,0.995729
D.bocki,140010837,250346,1,537,3.83542e-06,139413324,0.995732
D.bocki,140010837,236295,1,537,3.83542e-06,139413861,0.995736
D.bocki,140010837,227610,1,537,3.83542e-06,139414398,0.99574
D.bocki,140010837,218271,1,537,3.83542e-06,139414935,0.995744
D.bocki,140010837,205409,1,537,3.83542e-06,139415472,0.995748
D.bocki,140010837,204703,1,537,3.83542e-06,139416009,0.995752
D.bocki,140010837,201872,1,537,3.83542e-06,139416546,0.995755
D.bocki,140010837,19644,1,537,3.83542e-06,139417083,0.995759
D.bocki,140010837,180816,1,537,3.83542e-06,139417620,0.995763
D.bocki,140010837,145967,1,537,3.83542e-06,139418157,0.995767
D.bocki,140010837,14276,1,537,3.83542e-06,139418694,0.995771
D.bocki,140010837,51071,1,536,3.82828e-06,139419230,0.995775
D.bocki,140010837,47797,1,536,3.82828e-06,139419766,0.995778
D.bocki,140010837,431067,1,536,3.82828e-06,139420302,0.995782
D.bocki,140010837,420865,1,536,3.82828e-06,139420838,0.995786
D.bocki,140010837,379620,1,536,3.82828e-06,139421374,0.99579
D.bocki,140010837,371198,1,536,3.82828e-06,139421910,0.995794
D.bocki,140010837,364944,1,536,3.82828e-06,139422446,0.995798
D.bocki,140010837,361186,1,536,3.82828e-06,139422982,0.995801
D.bocki,140010837,35911,1,536,3.82828e-06,139423518,0.995805
D.bocki,140010837,343181,1,536,3.82828e-06,139424054,0.995809
D.bocki,140010837,330794,1,536,3.82828e-06,139424590,0.995813
D.bocki,140010837,328422,1,536,3.82828e-06,139425126,0.995817
D.bocki,140010837,309304,1,536,3.82828e-06,139425662,0.995821
D.bocki,140010837,299588,1,536,3.82828e-06,139426198,0.995824
D.bocki,140010837,297643,1,536,3.82828e-06,139426734,0.995828
D.bocki,140010837,272333,1,536,3.82828e-06,139427270,0.995832
D.bocki,140010837,271395,1,536,3.82828e-06,139427806,0.995836
D.bocki,140010837,270703,1,536,3.82828e-06,139428342,0.99584
D.bocki,140010837,254196,1,536,3.82828e-06,139428878,0.995843
D.bocki,140010837,253063,1,536,3.82828e-06,139429414,0.995847
D.bocki,140010837,252582,1,536,3.82828e-06,139429950,0.995851
D.bocki,140010837,236244,1,536,3.82828e-06,139430486,0.995855
D.bocki,140010837,23462,1,536,3.82828e-06,139431022,0.995859
D.bocki,140010837,222311,1,536,3.82828e-06,139431558,0.995863
D.bocki,140010837,218130,1,536,3.82828e-06,139432094,0.995866
D.bocki,140010837,216906,1,536,3.82828e-06,139432630,0.99587
D.bocki,140010837,201842,1,536,3.82828e-06,139433166,0.995874
D.bocki,140010837,188036,1,536,3.82828e-06,139433702,0.995878
D.bocki,140010837,184508,1,536,3.82828e-06,139434238,0.995882
D.bocki,140010837,175331,1,536,3.82828e-06,139434774,0.995886
D.bocki,140010837,166409,1,536,3.82828e-06,139435310,0.995889
D.bocki,140010837,15306,1,536,3.82828e-06,139435846,0.995893
D.bocki,140010837,146914,1,536,3.82828e-06,139436382,0.995897
D.bocki,140010837,1288,1,536,3.82828e-06,139436918,0.995901
D.bocki,140010837,127234,1,536,3.82828e-06,139437454,0.995905
D.bocki,140010837,113954,1,536,3.82828e-06,139437990,0.995909
D.bocki,140010837,103163,1,536,3.82828e-06,139438526,0.995912
D.bocki,140010837,96374,1,535,3.82113e-06,139439061,0.995916
D.bocki,140010837,871,1,535,3.82113e-06,139439596,0.99592
D.bocki,140010837,81601,1,535,3.82113e-06,139440131,0.995924
D.bocki,140010837,74927,1,535,3.82113e-06,139440666,0.995928
D.bocki,140010837,62533,1,535,3.82113e-06,139441201,0.995931
D.bocki,140010837,59188,1,535,3.82113e-06,139441736,0.995935
D.bocki,140010837,55934,1,535,3.82113e-06,139442271,0.995939
D.bocki,140010837,52191,1,535,3.82113e-06,139442806,0.995943
D.bocki,140010837,452488,1,535,3.82113e-06,139443341,0.995947
D.bocki,140010837,451571,1,535,3.82113e-06,139443876,0.995951
D.bocki,140010837,430881,1,535,3.82113e-06,139444411,0.995954
D.bocki,140010837,381952,1,535,3.82113e-06,139444946,0.995958
D.bocki,140010837,375330,1,535,3.82113e-06,139445481,0.995962
D.bocki,140010837,353386,1,535,3.82113e-06,139446016,0.995966
D.bocki,140010837,333059,1,535,3.82113e-06,139446551,0.99597
D.bocki,140010837,325634,1,535,3.82113e-06,139447086,0.995974
D.bocki,140010837,324809,1,535,3.82113e-06,139447621,0.995977
D.bocki,140010837,303633,1,535,3.82113e-06,139448156,0.995981
D.bocki,140010837,235590,1,535,3.82113e-06,139448691,0.995985
D.bocki,140010837,211824,1,535,3.82113e-06,139449226,0.995989
D.bocki,140010837,16487,1,535,3.82113e-06,139449761,0.995993
D.bocki,140010837,161382,1,535,3.82113e-06,139450296,0.995996
D.bocki,140010837,124933,1,535,3.82113e-06,139450831,0.996
D.bocki,140010837,10452,1,535,3.82113e-06,139451366,0.996004
D.bocki,140010837,70557,1,534,3.81399e-06,139451900,0.996008
D.bocki,140010837,440782,1,534,3.81399e-06,139452434,0.996012
D.bocki,140010837,439121,1,534,3.81399e-06,139452968,0.996016
D.bocki,140010837,43376,1,534,3.81399e-06,139453502,0.996019
D.bocki,140010837,432316,1,534,3.81399e-06,139454036,0.996023
D.bocki,140010837,420743,1,534,3.81399e-06,139454570,0.996027
D.bocki,140010837,389889,1,534,3.81399e-06,139455104,0.996031
D.bocki,140010837,296076,1,534,3.81399e-06,139455638,0.996035
D.bocki,140010837,294437,1,534,3.81399e-06,139456172,0.996038
D.bocki,140010837,281767,1,534,3.81399e-06,139456706,0.996042
D.bocki,140010837,278914,1,534,3.81399e-06,139457240,0.996046
D.bocki,140010837,272021,1,534,3.81399e-06,139457774,0.99605
D.bocki,140010837,264178,1,534,3.81399e-06,139458308,0.996054
D.bocki,140010837,19923,1,534,3.81399e-06,139458842,0.996057
D.bocki,140010837,184775,1,534,3.81399e-06,139459376,0.996061
D.bocki,140010837,184077,1,534,3.81399e-06,139459910,0.996065
D.bocki,140010837,179490,1,534,3.81399e-06,139460444,0.996069
D.bocki,140010837,176405,1,534,3.81399e-06,139460978,0.996073
D.bocki,140010837,158754,1,534,3.81399e-06,139461512,0.996077
D.bocki,140010837,158478,1,534,3.81399e-06,139462046,0.99608
D.bocki,140010837,155965,1,534,3.81399e-06,139462580,0.996084
D.bocki,140010837,146472,1,534,3.81399e-06,139463114,0.996088
D.bocki,140010837,127481,1,534,3.81399e-06,139463648,0.996092
D.bocki,140010837,11025,1,534,3.81399e-06,139464182,0.996096
D.bocki,140010837,98904,1,533,3.80685e-06,139464715,0.996099
D.bocki,140010837,83513,1,533,3.80685e-06,139465248,0.996103
D.bocki,140010837,5901,1,533,3.80685e-06,139465781,0.996107
D.bocki,140010837,48137,1,533,3.80685e-06,139466314,0.996111
D.bocki,140010837,454004,1,533,3.80685e-06,139466847,0.996115
D.bocki,140010837,452188,1,533,3.80685e-06,139467380,0.996118
D.bocki,140010837,401522,1,533,3.80685e-06,139467913,0.996122
D.bocki,140010837,399725,1,533,3.80685e-06,139468446,0.996126
D.bocki,140010837,394612,1,533,3.80685e-06,139468979,0.99613
D.bocki,140010837,382312,1,533,3.80685e-06,139469512,0.996134
D.bocki,140010837,322913,1,533,3.80685e-06,139470045,0.996137
D.bocki,140010837,319302,1,533,3.80685e-06,139470578,0.996141
D.bocki,140010837,311367,1,533,3.80685e-06,139471111,0.996145
D.bocki,140010837,250859,1,533,3.80685e-06,139471644,0.996149
D.bocki,140010837,23192,1,533,3.80685e-06,139472177,0.996153
D.bocki,140010837,228149,1,533,3.80685e-06,139472710,0.996157
D.bocki,140010837,226203,1,533,3.80685e-06,139473243,0.99616
D.bocki,140010837,216544,1,533,3.80685e-06,139473776,0.996164
D.bocki,140010837,211337,1,533,3.80685e-06,139474309,0.996168
D.bocki,140010837,181169,1,533,3.80685e-06,139474842,0.996172
D.bocki,140010837,169414,1,533,3.80685e-06,139475375,0.996176
D.bocki,140010837,144129,1,533,3.80685e-06,139475908,0.996179
D.bocki,140010837,137026,1,533,3.80685e-06,139476441,0.996183
D.bocki,140010837,112354,1,533,3.80685e-06,139476974,0.996187
D.bocki,140010837,77999,1,532,3.79971e-06,139477506,0.996191
D.bocki,140010837,77968,1,532,3.79971e-06,139478038,0.996195
D.bocki,140010837,55079,1,532,3.79971e-06,139478570,0.996198
D.bocki,140010837,452325,1,532,3.79971e-06,139479102,0.996202
D.bocki,140010837,440112,1,532,3.79971e-06,139479634,0.996206
D.bocki,140010837,43375,1,532,3.79971e-06,139480166,0.99621
D.bocki,140010837,427612,1,532,3.79971e-06,139480698,0.996214
D.bocki,140010837,426912,1,532,3.79971e-06,139481230,0.996217
D.bocki,140010837,401130,1,532,3.79971e-06,139481762,0.996221
D.bocki,140010837,354661,1,532,3.79971e-06,139482294,0.996225
D.bocki,140010837,35392,1,532,3.79971e-06,139482826,0.996229
D.bocki,140010837,328190,1,532,3.79971e-06,139483358,0.996233
D.bocki,140010837,327752,1,532,3.79971e-06,139483890,0.996236
D.bocki,140010837,327198,1,532,3.79971e-06,139484422,0.99624
D.bocki,140010837,305658,1,532,3.79971e-06,139484954,0.996244
D.bocki,140010837,292976,1,532,3.79971e-06,139485486,0.996248
D.bocki,140010837,253039,1,532,3.79971e-06,139486018,0.996252
D.bocki,140010837,242533,1,532,3.79971e-06,139486550,0.996255
D.bocki,140010837,2370,1,532,3.79971e-06,139487082,0.996259
D.bocki,140010837,204807,1,532,3.79971e-06,139487614,0.996263
D.bocki,140010837,194681,1,532,3.79971e-06,139488146,0.996267
D.bocki,140010837,190072,1,532,3.79971e-06,139488678,0.996271
D.bocki,140010837,166244,1,532,3.79971e-06,139489210,0.996274
D.bocki,140010837,166217,1,532,3.79971e-06,139489742,0.996278
D.bocki,140010837,158554,1,532,3.79971e-06,139490274,0.996282
D.bocki,140010837,153748,1,532,3.79971e-06,139490806,0.996286
D.bocki,140010837,151873,1,532,3.79971e-06,139491338,0.99629
D.bocki,140010837,147608,1,532,3.79971e-06,139491870,0.996293
D.bocki,140010837,14529,1,532,3.79971e-06,139492402,0.996297
D.bocki,140010837,130872,1,532,3.79971e-06,139492934,0.996301
D.bocki,140010837,128990,1,532,3.79971e-06,139493466,0.996305
D.bocki,140010837,128662,1,532,3.79971e-06,139493998,0.996309
D.bocki,140010837,121337,1,532,3.79971e-06,139494530,0.996312
D.bocki,140010837,101211,1,532,3.79971e-06,139495062,0.996316
D.bocki,140010837,90814,1,531,3.79256e-06,139495593,0.99632
D.bocki,140010837,454080,1,531,3.79256e-06,139496124,0.996324
D.bocki,140010837,42717,1,531,3.79256e-06,139496655,0.996328
D.bocki,140010837,404889,1,531,3.79256e-06,139497186,0.996331
D.bocki,140010837,392926,1,531,3.79256e-06,139497717,0.996335
D.bocki,140010837,392615,1,531,3.79256e-06,139498248,0.996339
D.bocki,140010837,388115,1,531,3.79256e-06,139498779,0.996343
D.bocki,140010837,384413,1,531,3.79256e-06,139499310,0.996347
D.bocki,140010837,365170,1,531,3.79256e-06,139499841,0.99635
D.bocki,140010837,355350,1,531,3.79256e-06,139500372,0.996354
D.bocki,140010837,330423,1,531,3.79256e-06,139500903,0.996358
D.bocki,140010837,325326,1,531,3.79256e-06,139501434,0.996362
D.bocki,140010837,320790,1,531,3.79256e-06,139501965,0.996365
D.bocki,140010837,320481,1,531,3.79256e-06,139502496,0.996369
D.bocki,140010837,310306,1,531,3.79256e-06,139503027,0.996373
D.bocki,140010837,305895,1,531,3.79256e-06,139503558,0.996377
D.bocki,140010837,257667,1,531,3.79256e-06,139504089,0.996381
D.bocki,140010837,248197,1,531,3.79256e-06,139504620,0.996384
D.bocki,140010837,244740,1,531,3.79256e-06,139505151,0.996388
D.bocki,140010837,238366,1,531,3.79256e-06,139505682,0.996392
D.bocki,140010837,208795,1,531,3.79256e-06,139506213,0.996396
D.bocki,140010837,192873,1,531,3.79256e-06,139506744,0.9964
D.bocki,140010837,166457,1,531,3.79256e-06,139507275,0.996403
D.bocki,140010837,149775,1,531,3.79256e-06,139507806,0.996407
D.bocki,140010837,131466,1,531,3.79256e-06,139508337,0.996411
D.bocki,140010837,100075,1,531,3.79256e-06,139508868,0.996415
D.bocki,140010837,97202,1,530,3.78542e-06,139509398,0.996419
D.bocki,140010837,90867,1,530,3.78542e-06,139509928,0.996422
D.bocki,140010837,78387,1,530,3.78542e-06,139510458,0.996426
D.bocki,140010837,45319,1,530,3.78542e-06,139510988,0.99643
D.bocki,140010837,452650,1,530,3.78542e-06,139511518,0.996434
D.bocki,140010837,43924,1,530,3.78542e-06,139512048,0.996437
D.bocki,140010837,434337,1,530,3.78542e-06,139512578,0.996441
D.bocki,140010837,408594,1,530,3.78542e-06,139513108,0.996445
D.bocki,140010837,396705,1,530,3.78542e-06,139513638,0.996449
D.bocki,140010837,336665,1,530,3.78542e-06,139514168,0.996453
D.bocki,140010837,308559,1,530,3.78542e-06,139514698,0.996456
D.bocki,140010837,297543,1,530,3.78542e-06,139515228,0.99646
D.bocki,140010837,267714,1,530,3.78542e-06,139515758,0.996464
D.bocki,140010837,264112,1,530,3.78542e-06,139516288,0.996468
D.bocki,140010837,250309,1,530,3.78542e-06,139516818,0.996472
D.bocki,140010837,233786,1,530,3.78542e-06,139517348,0.996475
D.bocki,140010837,221498,1,530,3.78542e-06,139517878,0.996479
D.bocki,140010837,218480,1,530,3.78542e-06,139518408,0.996483
D.bocki,140010837,19375,1,530,3.78542e-06,139518938,0.996487
D.bocki,140010837,191373,1,530,3.78542e-06,139519468,0.99649
D.bocki,140010837,178711,1,530,3.78542e-06,139519998,0.996494
D.bocki,140010837,176908,1,530,3.78542e-06,139520528,0.996498
D.bocki,140010837,155415,1,530,3.78542e-06,139521058,0.996502
D.bocki,140010837,123853,1,530,3.78542e-06,139521588,0.996506
D.bocki,140010837,122108,1,530,3.78542e-06,139522118,0.996509
D.bocki,140010837,99091,1,529,3.77828e-06,139522647,0.996513
D.bocki,140010837,88477,1,529,3.77828e-06,139523176,0.996517
D.bocki,140010837,60387,1,529,3.77828e-06,139523705,0.996521
D.bocki,140010837,443016,1,529,3.77828e-06,139524234,0.996525
D.bocki,140010837,425843,1,529,3.77828e-06,139524763,0.996528
D.bocki,140010837,412577,1,529,3.77828e-06,139525292,0.996532
D.bocki,140010837,406711,1,529,3.77828e-06,139525821,0.996536
D.bocki,140010837,403291,1,529,3.77828e-06,139526350,0.99654
D.bocki,140010837,399141,1,529,3.77828e-06,139526879,0.996543
D.bocki,140010837,366689,1,529,3.77828e-06,139527408,0.996547
D.bocki,140010837,35830,1,529,3.77828e-06,139527937,0.996551
D.bocki,140010837,356580,1,529,3.77828e-06,139528466,0.996555
D.bocki,140010837,321858,1,529,3.77828e-06,139528995,0.996559
D.bocki,140010837,319695,1,529,3.77828e-06,139529524,0.996562
D.bocki,140010837,317401,1,529,3.77828e-06,139530053,0.996566
D.bocki,140010837,308223,1,529,3.77828e-06,139530582,0.99657
D.bocki,140010837,277940,1,529,3.77828e-06,139531111,0.996574
D.bocki,140010837,272475,1,529,3.77828e-06,139531640,0.996577
D.bocki,140010837,243716,1,529,3.77828e-06,139532169,0.996581
D.bocki,140010837,243715,1,529,3.77828e-06,139532698,0.996585
D.bocki,140010837,238027,1,529,3.77828e-06,139533227,0.996589
D.bocki,140010837,203607,1,529,3.77828e-06,139533756,0.996593
D.bocki,140010837,19136,1,529,3.77828e-06,139534285,0.996596
D.bocki,140010837,158897,1,529,3.77828e-06,139534814,0.9966
D.bocki,140010837,131099,1,529,3.77828e-06,139535343,0.996604
D.bocki,140010837,121062,1,529,3.77828e-06,139535872,0.996608
D.bocki,140010837,115270,1,529,3.77828e-06,139536401,0.996611
D.bocki,140010837,109741,1,529,3.77828e-06,139536930,0.996615
D.bocki,140010837,10075,1,529,3.77828e-06,139537459,0.996619
D.bocki,140010837,97057,1,528,3.77114e-06,139537987,0.996623
D.bocki,140010837,93185,1,528,3.77114e-06,139538515,0.996627
D.bocki,140010837,69192,1,528,3.77114e-06,139539043,0.99663
D.bocki,140010837,5869,1,528,3.77114e-06,139539571,0.996634
D.bocki,140010837,46640,1,528,3.77114e-06,139540099,0.996638
D.bocki,140010837,443642,1,528,3.77114e-06,139540627,0.996642
D.bocki,140010837,42836,1,528,3.77114e-06,139541155,0.996645
D.bocki,140010837,36198,1,528,3.77114e-06,139541683,0.996649
D.bocki,140010837,348910,1,528,3.77114e-06,139542211,0.996653
D.bocki,140010837,324889,1,528,3.77114e-06,139542739,0.996657
D.bocki,140010837,315731,1,528,3.77114e-06,139543267,0.99666
D.bocki,140010837,313,1,528,3.77114e-06,139543795,0.996664
D.bocki,140010837,287884,1,528,3.77114e-06,139544323,0.996668
D.bocki,140010837,282377,1,528,3.77114e-06,139544851,0.996672
D.bocki,140010837,281640,1,528,3.77114e-06,139545379,0.996676
D.bocki,140010837,243102,1,528,3.77114e-06,139545907,0.996679
D.bocki,140010837,230952,1,528,3.77114e-06,139546435,0.996683
D.bocki,140010837,221048,1,528,3.77114e-06,139546963,0.996687
D.bocki,140010837,209602,1,528,3.77114e-06,139547491,0.996691
D.bocki,140010837,168109,1,528,3.77114e-06,139548019,0.996694
D.bocki,140010837,155309,1,528,3.77114e-06,139548547,0.996698
D.bocki,140010837,129361,1,528,3.77114e-06,139549075,0.996702
D.bocki,140010837,128005,1,528,3.77114e-06,139549603,0.996706
D.bocki,140010837,120375,1,528,3.77114e-06,139550131,0.996709
D.bocki,140010837,116087,1,528,3.77114e-06,139550659,0.996713
D.bocki,140010837,87495,1,527,3.76399e-06,139551186,0.996717
D.bocki,140010837,80996,1,527,3.76399e-06,139551713,0.996721
D.bocki,140010837,80037,1,527,3.76399e-06,139552240,0.996725
D.bocki,140010837,79761,1,527,3.76399e-06,139552767,0.996728
D.bocki,140010837,452224,1,527,3.76399e-06,139553294,0.996732
D.bocki,140010837,451143,1,527,3.76399e-06,139553821,0.996736
D.bocki,140010837,434780,1,527,3.76399e-06,139554348,0.99674
D.bocki,140010837,42673,1,527,3.76399e-06,139554875,0.996743
D.bocki,140010837,424746,1,527,3.76399e-06,139555402,0.996747
D.bocki,140010837,411943,1,527,3.76399e-06,139555929,0.996751
D.bocki,140010837,407516,1,527,3.76399e-06,139556456,0.996755
D.bocki,140010837,403797,1,527,3.76399e-06,139556983,0.996758
D.bocki,140010837,398681,1,527,3.76399e-06,139557510,0.996762
D.bocki,140010837,384153,1,527,3.76399e-06,139558037,0.996766
D.bocki,140010837,383876,1,527,3.76399e-06,139558564,0.99677
D.bocki,140010837,38080,1,527,3.76399e-06,139559091,0.996773
D.bocki,140010837,349584,1,527,3.76399e-06,139559618,0.996777
D.bocki,140010837,341274,1,527,3.76399e-06,139560145,0.996781
D.bocki,140010837,338471,1,527,3.76399e-06,139560672,0.996785
D.bocki,140010837,324129,1,527,3.76399e-06,139561199,0.996789
D.bocki,140010837,324036,1,527,3.76399e-06,139561726,0.996792
D.bocki,140010837,321520,1,527,3.76399e-06,139562253,0.996796
D.bocki,140010837,314746,1,527,3.76399e-06,139562780,0.9968
D.bocki,140010837,295617,1,527,3.76399e-06,139563307,0.996804
D.bocki,140010837,213786,1,527,3.76399e-06,139563834,0.996807
D.bocki,140010837,196621,1,527,3.76399e-06,139564361,0.996811
D.bocki,140010837,160864,1,527,3.76399e-06,139564888,0.996815
D.bocki,140010837,15305,1,527,3.76399e-06,139565415,0.996819
D.bocki,140010837,146550,1,527,3.76399e-06,139565942,0.996822
D.bocki,140010837,128989,1,527,3.76399e-06,139566469,0.996826
D.bocki,140010837,123021,1,527,3.76399e-06,139566996,0.99683
D.bocki,140010837,116418,1,527,3.76399e-06,139567523,0.996834
D.bocki,140010837,84468,1,526,3.75685e-06,139568049,0.996837
D.bocki,140010837,53448,1,526,3.75685e-06,139568575,0.996841
D.bocki,140010837,47591,1,526,3.75685e-06,139569101,0.996845
D.bocki,140010837,433719,1,526,3.75685e-06,139569627,0.996849
D.bocki,140010837,412672,1,526,3.75685e-06,139570153,0.996853
D.bocki,140010837,40597,1,526,3.75685e-06,139570679,0.996856
D.bocki,140010837,388672,1,526,3.75685e-06,139571205,0.99686
D.bocki,140010837,38475,1,526,3.75685e-06,139571731,0.996864
D.bocki,140010837,367469,1,526,3.75685e-06,139572257,0.996868
D.bocki,140010837,354735,1,526,3.75685e-06,139572783,0.996871
D.bocki,140010837,32584,1,526,3.75685e-06,139573309,0.996875
D.bocki,140010837,324413,1,526,3.75685e-06,139573835,0.996879
D.bocki,140010837,315456,1,526,3.75685e-06,139574361,0.996883
D.bocki,140010837,305541,1,526,3.75685e-06,139574887,0.996886
D.bocki,140010837,290428,1,526,3.75685e-06,139575413,0.99689
D.bocki,140010837,247073,1,526,3.75685e-06,139575939,0.996894
D.bocki,140010837,229963,1,526,3.75685e-06,139576465,0.996898
D.bocki,140010837,227552,1,526,3.75685e-06,139576991,0.996901
D.bocki,140010837,221878,1,526,3.75685e-06,139577517,0.996905
D.bocki,140010837,213743,1,526,3.75685e-06,139578043,0.996909
D.bocki,140010837,205970,1,526,3.75685e-06,139578569,0.996913
D.bocki,140010837,185901,1,526,3.75685e-06,139579095,0.996916
D.bocki,140010837,175058,1,526,3.75685e-06,139579621,0.99692
D.bocki,140010837,160695,1,526,3.75685e-06,139580147,0.996924
D.bocki,140010837,123135,1,526,3.75685e-06,139580673,0.996928
D.bocki,140010837,122779,1,526,3.75685e-06,139581199,0.996931
D.bocki,140010837,11796,1,526,3.75685e-06,139581725,0.996935
D.bocki,140010837,112097,1,526,3.75685e-06,139582251,0.996939
D.bocki,140010837,110254,1,526,3.75685e-06,139582777,0.996943
D.bocki,140010837,106615,1,526,3.75685e-06,139583303,0.996946
D.bocki,140010837,95978,1,525,3.74971e-06,139583828,0.99695
D.bocki,140010837,82820,1,525,3.74971e-06,139584353,0.996954
D.bocki,140010837,69778,1,525,3.74971e-06,139584878,0.996958
D.bocki,140010837,66105,1,525,3.74971e-06,139585403,0.996961
D.bocki,140010837,53065,1,525,3.74971e-06,139585928,0.996965
D.bocki,140010837,452705,1,525,3.74971e-06,139586453,0.996969
D.bocki,140010837,422545,1,525,3.74971e-06,139586978,0.996973
D.bocki,140010837,328299,1,525,3.74971e-06,139587503,0.996976
D.bocki,140010837,299746,1,525,3.74971e-06,139588028,0.99698
D.bocki,140010837,299025,1,525,3.74971e-06,139588553,0.996984
D.bocki,140010837,28622,1,525,3.74971e-06,139589078,0.996988
D.bocki,140010837,26324,1,525,3.74971e-06,139589603,0.996991
D.bocki,140010837,254306,1,525,3.74971e-06,139590128,0.996995
D.bocki,140010837,213909,1,525,3.74971e-06,139590653,0.996999
D.bocki,140010837,200185,1,525,3.74971e-06,139591178,0.997003
D.bocki,140010837,198560,1,525,3.74971e-06,139591703,0.997006
D.bocki,140010837,197629,1,525,3.74971e-06,139592228,0.99701
D.bocki,140010837,196114,1,525,3.74971e-06,139592753,0.997014
D.bocki,140010837,185865,1,525,3.74971e-06,139593278,0.997018
D.bocki,140010837,18276,1,525,3.74971e-06,139593803,0.997021
D.bocki,140010837,177590,1,525,3.74971e-06,139594328,0.997025
D.bocki,140010837,143656,1,525,3.74971e-06,139594853,0.997029
D.bocki,140010837,142457,1,525,3.74971e-06,139595378,0.997033
D.bocki,140010837,95694,1,524,3.74257e-06,139595902,0.997036
D.bocki,140010837,92330,1,524,3.74257e-06,139596426,0.99704
D.bocki,140010837,49543,1,524,3.74257e-06,139596950,0.997044
D.bocki,140010837,454471,1,524,3.74257e-06,139597474,0.997048
D.bocki,140010837,450713,1,524,3.74257e-06,139597998,0.997051
D.bocki,140010837,432911,1,524,3.74257e-06,139598522,0.997055
D.bocki,140010837,425096,1,524,3.74257e-06,139599046,0.997059
D.bocki,140010837,419298,1,524,3.74257e-06,139599570,0.997063
D.bocki,140010837,401550,1,524,3.74257e-06,139600094,0.997066
D.bocki,140010837,395809,1,524,3.74257e-06,139600618,0.99707
D.bocki,140010837,393374,1,524,3.74257e-06,139601142,0.997074
D.bocki,140010837,374119,1,524,3.74257e-06,139601666,0.997078
D.bocki,140010837,361913,1,524,3.74257e-06,139602190,0.997081
D.bocki,140010837,357180,1,524,3.74257e-06,139602714,0.997085
D.bocki,140010837,330509,1,524,3.74257e-06,139603238,0.997089
D.bocki,140010837,328440,1,524,3.74257e-06,139603762,0.997093
D.bocki,140010837,302892,1,524,3.74257e-06,139604286,0.997096
D.bocki,140010837,289318,1,524,3.74257e-06,139604810,0.9971
D.bocki,140010837,288655,1,524,3.74257e-06,139605334,0.997104
D.bocki,140010837,273511,1,524,3.74257e-06,139605858,0.997108
D.bocki,140010837,26474,1,524,3.74257e-06,139606382,0.997111
D.bocki,140010837,261514,1,524,3.74257e-06,139606906,0.997115
D.bocki,140010837,25451,1,524,3.74257e-06,139607430,0.997119
D.bocki,140010837,252281,1,524,3.74257e-06,139607954,0.997122
D.bocki,140010837,229006,1,524,3.74257e-06,139608478,0.997126
D.bocki,140010837,212893,1,524,3.74257e-06,139609002,0.99713
D.bocki,140010837,20975,1,524,3.74257e-06,139609526,0.997134
D.bocki,140010837,16767,1,524,3.74257e-06,139610050,0.997137
D.bocki,140010837,162880,1,524,3.74257e-06,139610574,0.997141
D.bocki,140010837,161164,1,524,3.74257e-06,139611098,0.997145
D.bocki,140010837,156169,1,524,3.74257e-06,139611622,0.997149
D.bocki,140010837,148996,1,524,3.74257e-06,139612146,0.997152
D.bocki,140010837,126476,1,524,3.74257e-06,139612670,0.997156
D.bocki,140010837,125127,1,524,3.74257e-06,139613194,0.99716
D.bocki,140010837,119201,1,524,3.74257e-06,139613718,0.997164
D.bocki,140010837,79953,1,523,3.73543e-06,139614241,0.997167
D.bocki,140010837,454858,1,523,3.73543e-06,139614764,0.997171
D.bocki,140010837,442504,1,523,3.73543e-06,139615287,0.997175
D.bocki,140010837,441463,1,523,3.73543e-06,139615810,0.997179
D.bocki,140010837,432029,1,523,3.73543e-06,139616333,0.997182
D.bocki,140010837,384354,1,523,3.73543e-06,139616856,0.997186
D.bocki,140010837,358286,1,523,3.73543e-06,139617379,0.99719
D.bocki,140010837,330987,1,523,3.73543e-06,139617902,0.997194
D.bocki,140010837,330547,1,523,3.73543e-06,139618425,0.997197
D.bocki,140010837,305542,1,523,3.73543e-06,139618948,0.997201
D.bocki,140010837,298628,1,523,3.73543e-06,139619471,0.997205
D.bocki,140010837,286534,1,523,3.73543e-06,139619994,0.997208
D.bocki,140010837,266914,1,523,3.73543e-06,139620517,0.997212
D.bocki,140010837,265618,1,523,3.73543e-06,139621040,0.997216
D.bocki,140010837,23937,1,523,3.73543e-06,139621563,0.99722
D.bocki,140010837,2231,1,523,3.73543e-06,139622086,0.997223
D.bocki,140010837,200328,1,523,3.73543e-06,139622609,0.997227
D.bocki,140010837,177302,1,523,3.73543e-06,139623132,0.997231
D.bocki,140010837,177080,1,523,3.73543e-06,139623655,0.997235
D.bocki,140010837,167602,1,523,3.73543e-06,139624178,0.997238
D.bocki,140010837,161166,1,523,3.73543e-06,139624701,0.997242
D.bocki,140010837,136133,1,523,3.73543e-06,139625224,0.997246
D.bocki,140010837,133624,1,523,3.73543e-06,139625747,0.99725
D.bocki,140010837,13115,1,523,3.73543e-06,139626270,0.997253
D.bocki,140010837,121063,1,523,3.73543e-06,139626793,0.997257
D.bocki,140010837,112297,1,523,3.73543e-06,139627316,0.997261
D.bocki,140010837,110424,1,523,3.73543e-06,139627839,0.997265
D.bocki,140010837,95750,1,522,3.72828e-06,139628361,0.997268
D.bocki,140010837,94096,1,522,3.72828e-06,139628883,0.997272
D.bocki,140010837,80759,1,522,3.72828e-06,139629405,0.997276
D.bocki,140010837,67780,1,522,3.72828e-06,139629927,0.997279
D.bocki,140010837,42207,1,522,3.72828e-06,139630449,0.997283
D.bocki,140010837,409412,1,522,3.72828e-06,139630971,0.997287
D.bocki,140010837,407550,1,522,3.72828e-06,139631493,0.997291
D.bocki,140010837,402078,1,522,3.72828e-06,139632015,0.997294
D.bocki,140010837,401520,1,522,3.72828e-06,139632537,0.997298
D.bocki,140010837,396073,1,522,3.72828e-06,139633059,0.997302
D.bocki,140010837,382949,1,522,3.72828e-06,139633581,0.997306
D.bocki,140010837,369020,1,522,3.72828e-06,139634103,0.997309
D.bocki,140010837,364052,1,522,3.72828e-06,139634625,0.997313
D.bocki,140010837,352775,1,522,3.72828e-06,139635147,0.997317
D.bocki,140010837,345642,1,522,3.72828e-06,139635669,0.99732
D.bocki,140010837,344093,1,522,3.72828e-06,139636191,0.997324
D.bocki,140010837,340440,1,522,3.72828e-06,139636713,0.997328
D.bocki,140010837,322912,1,522,3.72828e-06,139637235,0.997332
D.bocki,140010837,307839,1,522,3.72828e-06,139637757,0.997335
D.bocki,140010837,281143,1,522,3.72828e-06,139638279,0.997339
D.bocki,140010837,272652,1,522,3.72828e-06,139638801,0.997343
D.bocki,140010837,262098,1,522,3.72828e-06,139639323,0.997347
D.bocki,140010837,258352,1,522,3.72828e-06,139639845,0.99735
D.bocki,140010837,224669,1,522,3.72828e-06,139640367,0.997354
D.bocki,140010837,209721,1,522,3.72828e-06,139640889,0.997358
D.bocki,140010837,204154,1,522,3.72828e-06,139641411,0.997361
D.bocki,140010837,203455,1,522,3.72828e-06,139641933,0.997365
D.bocki,140010837,189971,1,522,3.72828e-06,139642455,0.997369
D.bocki,140010837,112496,1,522,3.72828e-06,139642977,0.997373
D.bocki,140010837,104250,1,522,3.72828e-06,139643499,0.997376
D.bocki,140010837,10305,1,522,3.72828e-06,139644021,0.99738
D.bocki,140010837,102750,1,522,3.72828e-06,139644543,0.997384
D.bocki,140010837,89123,1,521,3.72114e-06,139645064,0.997388
D.bocki,140010837,71200,1,521,3.72114e-06,139645585,0.997391
D.bocki,140010837,451848,1,521,3.72114e-06,139646106,0.997395
D.bocki,140010837,447198,1,521,3.72114e-06,139646627,0.997399
D.bocki,140010837,442698,1,521,3.72114e-06,139647148,0.997402
D.bocki,140010837,442258,1,521,3.72114e-06,139647669,0.997406
D.bocki,140010837,434895,1,521,3.72114e-06,139648190,0.99741
D.bocki,140010837,427751,1,521,3.72114e-06,139648711,0.997414
D.bocki,140010837,413373,1,521,3.72114e-06,139649232,0.997417
D.bocki,140010837,387538,1,521,3.72114e-06,139649753,0.997421
D.bocki,140010837,378995,1,521,3.72114e-06,139650274,0.997425
D.bocki,140010837,374089,1,521,3.72114e-06,139650795,0.997428
D.bocki,140010837,343862,1,521,3.72114e-06,139651316,0.997432
D.bocki,140010837,341485,1,521,3.72114e-06,139651837,0.997436
D.bocki,140010837,325635,1,521,3.72114e-06,139652358,0.99744
D.bocki,140010837,314956,1,521,3.72114e-06,139652879,0.997443
D.bocki,140010837,285472,1,521,3.72114e-06,139653400,0.997447
D.bocki,140010837,284457,1,521,3.72114e-06,139653921,0.997451
D.bocki,140010837,275812,1,521,3.72114e-06,139654442,0.997455
D.bocki,140010837,274694,1,521,3.72114e-06,139654963,0.997458
D.bocki,140010837,273110,1,521,3.72114e-06,139655484,0.997462
D.bocki,140010837,259375,1,521,3.72114e-06,139656005,0.997466
D.bocki,140010837,255089,1,521,3.72114e-06,139656526,0.997469
D.bocki,140010837,245110,1,521,3.72114e-06,139657047,0.997473
D.bocki,140010837,237996,1,521,3.72114e-06,139657568,0.997477
D.bocki,140010837,225186,1,521,3.72114e-06,139658089,0.997481
D.bocki,140010837,215967,1,521,3.72114e-06,139658610,0.997484
D.bocki,140010837,210197,1,521,3.72114e-06,139659131,0.997488
D.bocki,140010837,204131,1,521,3.72114e-06,139659652,0.997492
D.bocki,140010837,197731,1,521,3.72114e-06,139660173,0.997495
D.bocki,140010837,171069,1,521,3.72114e-06,139660694,0.997499
D.bocki,140010837,16531,1,521,3.72114e-06,139661215,0.997503
D.bocki,140010837,153389,1,521,3.72114e-06,139661736,0.997507
D.bocki,140010837,119627,1,521,3.72114e-06,139662257,0.99751
D.bocki,140010837,112495,1,521,3.72114e-06,139662778,0.997514
D.bocki,140010837,97058,1,520,3.714e-06,139663298,0.997518
D.bocki,140010837,93935,1,520,3.714e-06,139663818,0.997521
D.bocki,140010837,81830,1,520,3.714e-06,139664338,0.997525
D.bocki,140010837,74580,1,520,3.714e-06,139664858,0.997529
D.bocki,140010837,55906,1,520,3.714e-06,139665378,0.997533
D.bocki,140010837,453228,1,520,3.714e-06,139665898,0.997536
D.bocki,140010837,451278,1,520,3.714e-06,139666418,0.99754
D.bocki,140010837,440447,1,520,3.714e-06,139666938,0.997544
D.bocki,140010837,435085,1,520,3.714e-06,139667458,0.997547
D.bocki,140010837,434426,1,520,3.714e-06,139667978,0.997551
D.bocki,140010837,426911,1,520,3.714e-06,139668498,0.997555
D.bocki,140010837,410157,1,520,3.714e-06,139669018,0.997559
D.bocki,140010837,403827,1,520,3.714e-06,139669538,0.997562
D.bocki,140010837,380853,1,520,3.714e-06,139670058,0.997566
D.bocki,140010837,371421,1,520,3.714e-06,139670578,0.99757
D.bocki,140010837,362683,1,520,3.714e-06,139671098,0.997573
D.bocki,140010837,351529,1,520,3.714e-06,139671618,0.997577
D.bocki,140010837,336455,1,520,3.714e-06,139672138,0.997581
D.bocki,140010837,31432,1,520,3.714e-06,139672658,0.997585
D.bocki,140010837,312489,1,520,3.714e-06,139673178,0.997588
D.bocki,140010837,310637,1,520,3.714e-06,139673698,0.997592
D.bocki,140010837,300139,1,520,3.714e-06,139674218,0.997596
D.bocki,140010837,272406,1,520,3.714e-06,139674738,0.997599
D.bocki,140010837,226813,1,520,3.714e-06,139675258,0.997603
D.bocki,140010837,197730,1,520,3.714e-06,139675778,0.997607
D.bocki,140010837,184342,1,520,3.714e-06,139676298,0.997611
D.bocki,140010837,177831,1,520,3.714e-06,139676818,0.997614
D.bocki,140010837,155575,1,520,3.714e-06,139677338,0.997618
D.bocki,140010837,153878,1,520,3.714e-06,139677858,0.997622
D.bocki,140010837,127536,1,520,3.714e-06,139678378,0.997625
D.bocki,140010837,126007,1,520,3.714e-06,139678898,0.997629
D.bocki,140010837,104948,1,520,3.714e-06,139679418,0.997633
D.bocki,140010837,97809,1,519,3.70686e-06,139679937,0.997637
D.bocki,140010837,8670,1,519,3.70686e-06,139680456,0.99764
D.bocki,140010837,74926,1,519,3.70686e-06,139680975,0.997644
D.bocki,140010837,72186,1,519,3.70686e-06,139681494,0.997648
D.bocki,140010837,6625,1,519,3.70686e-06,139682013,0.997651
D.bocki,140010837,52469,1,519,3.70686e-06,139682532,0.997655
D.bocki,140010837,452843,1,519,3.70686e-06,139683051,0.997659
D.bocki,140010837,452303,1,519,3.70686e-06,139683570,0.997663
D.bocki,140010837,446235,1,519,3.70686e-06,139684089,0.997666
D.bocki,140010837,442177,1,519,3.70686e-06,139684608,0.99767
D.bocki,140010837,400008,1,519,3.70686e-06,139685127,0.997674
D.bocki,140010837,386106,1,519,3.70686e-06,139685646,0.997677
D.bocki,140010837,382727,1,519,3.70686e-06,139686165,0.997681
D.bocki,140010837,374599,1,519,3.70686e-06,139686684,0.997685
D.bocki,140010837,366969,1,519,3.70686e-06,139687203,0.997689
D.bocki,140010837,317456,1,519,3.70686e-06,139687722,0.997692
D.bocki,140010837,287420,1,519,3.70686e-06,139688241,0.997696
D.bocki,140010837,256351,1,519,3.70686e-06,139688760,0.9977
D.bocki,140010837,230332,1,519,3.70686e-06,139689279,0.997703
D.bocki,140010837,228603,1,519,3.70686e-06,139689798,0.997707
D.bocki,140010837,199619,1,519,3.70686e-06,139690317,0.997711
D.bocki,140010837,198917,1,519,3.70686e-06,139690836,0.997714
D.bocki,140010837,195896,1,519,3.70686e-06,139691355,0.997718
D.bocki,140010837,180106,1,519,3.70686e-06,139691874,0.997722
D.bocki,140010837,176819,1,519,3.70686e-06,139692393,0.997726
D.bocki,140010837,169117,1,519,3.70686e-06,139692912,0.997729
D.bocki,140010837,139205,1,519,3.70686e-06,139693431,0.997733
D.bocki,140010837,126574,1,519,3.70686e-06,139693950,0.997737
D.bocki,140010837,124855,1,519,3.70686e-06,139694469,0.99774
D.bocki,140010837,73137,1,518,3.69971e-06,139694987,0.997744
D.bocki,140010837,58880,1,518,3.69971e-06,139695505,0.997748
D.bocki,140010837,51235,1,518,3.69971e-06,139696023,0.997752
D.bocki,140010837,452354,1,518,3.69971e-06,139696541,0.997755
D.bocki,140010837,381878,1,518,3.69971e-06,139697059,0.997759
D.bocki,140010837,381849,1,518,3.69971e-06,139697577,0.997763
D.bocki,140010837,364642,1,518,3.69971e-06,139698095,0.997766
D.bocki,140010837,364437,1,518,3.69971e-06,139698613,0.99777
D.bocki,140010837,364213,1,518,3.69971e-06,139699131,0.997774
D.bocki,140010837,354912,1,518,3.69971e-06,139699649,0.997777
D.bocki,140010837,322628,1,518,3.69971e-06,139700167,0.997781
D.bocki,140010837,319365,1,518,3.69971e-06,139700685,0.997785
D.bocki,140010837,300482,1,518,3.69971e-06,139701203,0.997788
D.bocki,140010837,272177,1,518,3.69971e-06,139701721,0.997792
D.bocki,140010837,266882,1,518,3.69971e-06,139702239,0.997796
D.bocki,140010837,266456,1,518,3.69971e-06,139702757,0.9978
D.bocki,140010837,262211,1,518,3.69971e-06,139703275,0.997803
D.bocki,140010837,25355,1,518,3.69971e-06,139703793,0.997807
D.bocki,140010837,250176,1,518,3.69971e-06,139704311,0.997811
D.bocki,140010837,199620,1,518,3.69971e-06,139704829,0.997814
D.bocki,140010837,17444,1,518,3.69971e-06,139705347,0.997818
D.bocki,140010837,126204,1,518,3.69971e-06,139705865,0.997822
D.bocki,140010837,65957,1,517,3.69257e-06,139706382,0.997825
D.bocki,140010837,65149,1,517,3.69257e-06,139706899,0.997829
D.bocki,140010837,6393,1,517,3.69257e-06,139707416,0.997833
D.bocki,140010837,55648,1,517,3.69257e-06,139707933,0.997837
D.bocki,140010837,449773,1,517,3.69257e-06,139708450,0.99784
D.bocki,140010837,442289,1,517,3.69257e-06,139708967,0.997844
D.bocki,140010837,435056,1,517,3.69257e-06,139709484,0.997848
D.bocki,140010837,424772,1,517,3.69257e-06,139710001,0.997851
D.bocki,140010837,42384,1,517,3.69257e-06,139710518,0.997855
D.bocki,140010837,406748,1,517,3.69257e-06,139711035,0.997859
D.bocki,140010837,404355,1,517,3.69257e-06,139711552,0.997862
D.bocki,140010837,38384,1,517,3.69257e-06,139712069,0.997866
D.bocki,140010837,371447,1,517,3.69257e-06,139712586,0.99787
D.bocki,140010837,368433,1,517,3.69257e-06,139713103,0.997873
D.bocki,140010837,351230,1,517,3.69257e-06,139713620,0.997877
D.bocki,140010837,345253,1,517,3.69257e-06,139714137,0.997881
D.bocki,140010837,331842,1,517,3.69257e-06,139714654,0.997885
D.bocki,140010837,31954,1,517,3.69257e-06,139715171,0.997888
D.bocki,140010837,307122,1,517,3.69257e-06,139715688,0.997892
D.bocki,140010837,288133,1,517,3.69257e-06,139716205,0.997896
D.bocki,140010837,279828,1,517,3.69257e-06,139716722,0.997899
D.bocki,140010837,253841,1,517,3.69257e-06,139717239,0.997903
D.bocki,140010837,253634,1,517,3.69257e-06,139717756,0.997907
D.bocki,140010837,231816,1,517,3.69257e-06,139718273,0.99791
D.bocki,140010837,225649,1,517,3.69257e-06,139718790,0.997914
D.bocki,140010837,21438,1,517,3.69257e-06,139719307,0.997918
D.bocki,140010837,185584,1,517,3.69257e-06,139719824,0.997921
D.bocki,140010837,184507,1,517,3.69257e-06,139720341,0.997925
D.bocki,140010837,176758,1,517,3.69257e-06,139720858,0.997929
D.bocki,140010837,164807,1,517,3.69257e-06,139721375,0.997933
D.bocki,140010837,15947,1,517,3.69257e-06,139721892,0.997936
D.bocki,140010837,158621,1,517,3.69257e-06,139722409,0.99794
D.bocki,140010837,154220,1,517,3.69257e-06,139722926,0.997944
D.bocki,140010837,135154,1,517,3.69257e-06,139723443,0.997947
D.bocki,140010837,131517,1,517,3.69257e-06,139723960,0.997951
D.bocki,140010837,130948,1,517,3.69257e-06,139724477,0.997955
D.bocki,140010837,117143,1,517,3.69257e-06,139724994,0.997958
D.bocki,140010837,94127,1,516,3.68543e-06,139725510,0.997962
D.bocki,140010837,85849,1,516,3.68543e-06,139726026,0.997966
D.bocki,140010837,57352,1,516,3.68543e-06,139726542,0.997969
D.bocki,140010837,453779,1,516,3.68543e-06,139727058,0.997973
D.bocki,140010837,450413,1,516,3.68543e-06,139727574,0.997977
D.bocki,140010837,450293,1,516,3.68543e-06,139728090,0.997981
D.bocki,140010837,444872,1,516,3.68543e-06,139728606,0.997984
D.bocki,140010837,440754,1,516,3.68543e-06,139729122,0.997988
D.bocki,140010837,398128,1,516,3.68543e-06,139729638,0.997992
D.bocki,140010837,396858,1,516,3.68543e-06,139730154,0.997995
D.bocki,140010837,346084,1,516,3.68543e-06,139730670,0.997999
D.bocki,140010837,332759,1,516,3.68543e-06,139731186,0.998003
D.bocki,140010837,329310,1,516,3.68543e-06,139731702,0.998006
D.bocki,140010837,308065,1,516,3.68543e-06,139732218,0.99801
D.bocki,140010837,289204,1,516,3.68543e-06,139732734,0.998014
D.bocki,140010837,277672,1,516,3.68543e-06,139733250,0.998017
D.bocki,140010837,241090,1,516,3.68543e-06,139733766,0.998021
D.bocki,140010837,231993,1,516,3.68543e-06,139734282,0.998025
D.bocki,140010837,182495,1,516,3.68543e-06,139734798,0.998028
D.bocki,140010837,170480,1,516,3.68543e-06,139735314,0.998032
D.bocki,140010837,158500,1,516,3.68543e-06,139735830,0.998036
D.bocki,140010837,138825,1,516,3.68543e-06,139736346,0.99804
D.bocki,140010837,13623,1,516,3.68543e-06,139736862,0.998043
D.bocki,140010837,110323,1,516,3.68543e-06,139737378,0.998047
D.bocki,140010837,107323,1,516,3.68543e-06,139737894,0.998051
D.bocki,140010837,10119,1,516,3.68543e-06,139738410,0.998054
D.bocki,140010837,78480,1,515,3.67829e-06,139738925,0.998058
D.bocki,140010837,54367,1,515,3.67829e-06,139739440,0.998062
D.bocki,140010837,452483,1,515,3.67829e-06,139739955,0.998065
D.bocki,140010837,442045,1,515,3.67829e-06,139740470,0.998069
D.bocki,140010837,413375,1,515,3.67829e-06,139740985,0.998073
D.bocki,140010837,393001,1,515,3.67829e-06,139741500,0.998076
D.bocki,140010837,390258,1,515,3.67829e-06,139742015,0.99808
D.bocki,140010837,384827,1,515,3.67829e-06,139742530,0.998084
D.bocki,140010837,380797,1,515,3.67829e-06,139743045,0.998087
D.bocki,140010837,373069,1,515,3.67829e-06,139743560,0.998091
D.bocki,140010837,357503,1,515,3.67829e-06,139744075,0.998095
D.bocki,140010837,34654,1,515,3.67829e-06,139744590,0.998098
D.bocki,140010837,338719,1,515,3.67829e-06,139745105,0.998102
D.bocki,140010837,329129,1,515,3.67829e-06,139745620,0.998106
D.bocki,140010837,320572,1,515,3.67829e-06,139746135,0.998109
D.bocki,140010837,31061,1,515,3.67829e-06,139746650,0.998113
D.bocki,140010837,30865,1,515,3.67829e-06,139747165,0.998117
D.bocki,140010837,305835,1,515,3.67829e-06,139747680,0.99812
D.bocki,140010837,303893,1,515,3.67829e-06,139748195,0.998124
D.bocki,140010837,29977,1,515,3.67829e-06,139748710,0.998128
D.bocki,140010837,297733,1,515,3.67829e-06,139749225,0.998131
D.bocki,140010837,292851,1,515,3.67829e-06,139749740,0.998135
D.bocki,140010837,288011,1,515,3.67829e-06,139750255,0.998139
D.bocki,140010837,285202,1,515,3.67829e-06,139750770,0.998143
D.bocki,140010837,276914,1,515,3.67829e-06,139751285,0.998146
D.bocki,140010837,236584,1,515,3.67829e-06,139751800,0.99815
D.bocki,140010837,205000,1,515,3.67829e-06,139752315,0.998154
D.bocki,140010837,197478,1,515,3.67829e-06,139752830,0.998157
D.bocki,140010837,168484,1,515,3.67829e-06,139753345,0.998161
D.bocki,140010837,155963,1,515,3.67829e-06,139753860,0.998165
D.bocki,140010837,135125,1,515,3.67829e-06,139754375,0.998168
D.bocki,140010837,12903,1,515,3.67829e-06,139754890,0.998172
D.bocki,140010837,10878,1,515,3.67829e-06,139755405,0.998176
D.bocki,140010837,107069,1,515,3.67829e-06,139755920,0.998179
D.bocki,140010837,95104,1,514,3.67114e-06,139756434,0.998183
D.bocki,140010837,60587,1,514,3.67114e-06,139756948,0.998187
D.bocki,140010837,445222,1,514,3.67114e-06,139757462,0.99819
D.bocki,140010837,419868,1,514,3.67114e-06,139757976,0.998194
D.bocki,140010837,412885,1,514,3.67114e-06,139758490,0.998198
D.bocki,140010837,407702,1,514,3.67114e-06,139759004,0.998201
D.bocki,140010837,406082,1,514,3.67114e-06,139759518,0.998205
D.bocki,140010837,392049,1,514,3.67114e-06,139760032,0.998209
D.bocki,140010837,386662,1,514,3.67114e-06,139760546,0.998212
D.bocki,140010837,372733,1,514,3.67114e-06,139761060,0.998216
D.bocki,140010837,358475,1,514,3.67114e-06,139761574,0.99822
D.bocki,140010837,354364,1,514,3.67114e-06,139762088,0.998223
D.bocki,140010837,352730,1,514,3.67114e-06,139762602,0.998227
D.bocki,140010837,35217,1,514,3.67114e-06,139763116,0.998231
D.bocki,140010837,334851,1,514,3.67114e-06,139763630,0.998234
D.bocki,140010837,326927,1,514,3.67114e-06,139764144,0.998238
D.bocki,140010837,326388,1,514,3.67114e-06,139764658,0.998242
D.bocki,140010837,321322,1,514,3.67114e-06,139765172,0.998245
D.bocki,140010837,30732,1,514,3.67114e-06,139765686,0.998249
D.bocki,140010837,286668,1,514,3.67114e-06,139766200,0.998253
D.bocki,140010837,284770,1,514,3.67114e-06,139766714,0.998256
D.bocki,140010837,24614,1,514,3.67114e-06,139767228,0.99826
D.bocki,140010837,240107,1,514,3.67114e-06,139767742,0.998264
D.bocki,140010837,232457,1,514,3.67114e-06,139768256,0.998267
D.bocki,140010837,197050,1,514,3.67114e-06,139768770,0.998271
D.bocki,140010837,191499,1,514,3.67114e-06,139769284,0.998275
D.bocki,140010837,184263,1,514,3.67114e-06,139769798,0.998278
D.bocki,140010837,157801,1,514,3.67114e-06,139770312,0.998282
D.bocki,140010837,14673,1,514,3.67114e-06,139770826,0.998286
D.bocki,140010837,137651,1,514,3.67114e-06,139771340,0.998289
D.bocki,140010837,12948,1,514,3.67114e-06,139771854,0.998293
D.bocki,140010837,115625,1,514,3.67114e-06,139772368,0.998297
D.bocki,140010837,115624,1,514,3.67114e-06,139772882,0.9983
D.bocki,140010837,107437,1,514,3.67114e-06,139773396,0.998304
D.bocki,140010837,73352,1,513,3.664e-06,139773909,0.998308
D.bocki,140010837,72978,1,513,3.664e-06,139774422,0.998311
D.bocki,140010837,57444,1,513,3.664e-06,139774935,0.998315
D.bocki,140010837,54336,1,513,3.664e-06,139775448,0.998319
D.bocki,140010837,418667,1,513,3.664e-06,139775961,0.998322
D.bocki,140010837,416664,1,513,3.664e-06,139776474,0.998326
D.bocki,140010837,387906,1,513,3.664e-06,139776987,0.99833
D.bocki,140010837,380769,1,513,3.664e-06,139777500,0.998333
D.bocki,140010837,374063,1,513,3.664e-06,139778013,0.998337
D.bocki,140010837,370047,1,513,3.664e-06,139778526,0.998341
D.bocki,140010837,362961,1,513,3.664e-06,139779039,0.998344
D.bocki,140010837,359351,1,513,3.664e-06,139779552,0.998348
D.bocki,140010837,322828,1,513,3.664e-06,139780065,0.998352
D.bocki,140010837,308558,1,513,3.664e-06,139780578,0.998355
D.bocki,140010837,266946,1,513,3.664e-06,139781091,0.998359
D.bocki,140010837,256565,1,513,3.664e-06,139781604,0.998363
D.bocki,140010837,213221,1,513,3.664e-06,139782117,0.998366
D.bocki,140010837,210115,1,513,3.664e-06,139782630,0.99837
D.bocki,140010837,180003,1,513,3.664e-06,139783143,0.998374
D.bocki,140010837,164566,1,513,3.664e-06,139783656,0.998377
D.bocki,140010837,162790,1,513,3.664e-06,139784169,0.998381
D.bocki,140010837,150273,1,513,3.664e-06,139784682,0.998385
D.bocki,140010837,138303,1,513,3.664e-06,139785195,0.998388
D.bocki,140010837,114949,1,513,3.664e-06,139785708,0.998392
D.bocki,140010837,110536,1,513,3.664e-06,139786221,0.998396
D.bocki,140010837,80894,1,512,3.65686e-06,139786733,0.998399
D.bocki,140010837,66635,1,512,3.65686e-06,139787245,0.998403
D.bocki,140010837,65496,1,512,3.65686e-06,139787757,0.998407
D.bocki,140010837,53372,1,512,3.65686e-06,139788269,0.99841
D.bocki,140010837,453901,1,512,3.65686e-06,139788781,0.998414
D.bocki,140010837,452593,1,512,3.65686e-06,139789293,0.998418
D.bocki,140010837,449173,1,512,3.65686e-06,139789805,0.998421
D.bocki,140010837,440417,1,512,3.65686e-06,139790317,0.998425
D.bocki,140010837,438905,1,512,3.65686e-06,139790829,0.998429
D.bocki,140010837,430209,1,512,3.65686e-06,139791341,0.998432
D.bocki,140010837,429661,1,512,3.65686e-06,139791853,0.998436
D.bocki,140010837,426877,1,512,3.65686e-06,139792365,0.99844
D.bocki,140010837,398719,1,512,3.65686e-06,139792877,0.998443
D.bocki,140010837,379201,1,512,3.65686e-06,139793389,0.998447
D.bocki,140010837,370015,1,512,3.65686e-06,139793901,0.998451
D.bocki,140010837,357879,1,512,3.65686e-06,139794413,0.998454
D.bocki,140010837,352105,1,512,3.65686e-06,139794925,0.998458
D.bocki,140010837,336035,1,512,3.65686e-06,139795437,0.998462
D.bocki,140010837,29889,1,512,3.65686e-06,139795949,0.998465
D.bocki,140010837,297734,1,512,3.65686e-06,139796461,0.998469
D.bocki,140010837,29480,1,512,3.65686e-06,139796973,0.998473
D.bocki,140010837,269582,1,512,3.65686e-06,139797485,0.998476
D.bocki,140010837,250727,1,512,3.65686e-06,139797997,0.99848
D.bocki,140010837,243081,1,512,3.65686e-06,139798509,0.998483
D.bocki,140010837,234932,1,512,3.65686e-06,139799021,0.998487
D.bocki,140010837,234110,1,512,3.65686e-06,139799533,0.998491
D.bocki,140010837,227664,1,512,3.65686e-06,139800045,0.998494
D.bocki,140010837,226621,1,512,3.65686e-06,139800557,0.998498
D.bocki,140010837,226410,1,512,3.65686e-06,139801069,0.998502
D.bocki,140010837,223519,1,512,3.65686e-06,139801581,0.998505
D.bocki,140010837,217666,1,512,3.65686e-06,139802093,0.998509
D.bocki,140010837,192983,1,512,3.65686e-06,139802605,0.998513
D.bocki,140010837,152439,1,512,3.65686e-06,139803117,0.998516
D.bocki,140010837,144237,1,512,3.65686e-06,139803629,0.99852
D.bocki,140010837,138445,1,512,3.65686e-06,139804141,0.998524
D.bocki,140010837,135992,1,512,3.65686e-06,139804653,0.998527
D.bocki,140010837,119329,1,512,3.65686e-06,139805165,0.998531
D.bocki,140010837,100023,1,512,3.65686e-06,139805677,0.998535
D.bocki,140010837,88975,1,511,3.64972e-06,139806188,0.998538
D.bocki,140010837,86843,1,511,3.64972e-06,139806699,0.998542
D.bocki,140010837,79272,1,511,3.64972e-06,139807210,0.998546
D.bocki,140010837,68625,1,511,3.64972e-06,139807721,0.998549
D.bocki,140010837,64522,1,511,3.64972e-06,139808232,0.998553
D.bocki,140010837,453789,1,511,3.64972e-06,139808743,0.998557
D.bocki,140010837,452667,1,511,3.64972e-06,139809254,0.99856
D.bocki,140010837,45203,1,511,3.64972e-06,139809765,0.998564
D.bocki,140010837,452005,1,511,3.64972e-06,139810276,0.998568
D.bocki,140010837,437986,1,511,3.64972e-06,139810787,0.998571
D.bocki,140010837,418174,1,511,3.64972e-06,139811298,0.998575
D.bocki,140010837,408996,1,511,3.64972e-06,139811809,0.998578
D.bocki,140010837,395759,1,511,3.64972e-06,139812320,0.998582
D.bocki,140010837,380798,1,511,3.64972e-06,139812831,0.998586
D.bocki,140010837,379028,1,511,3.64972e-06,139813342,0.998589
D.bocki,140010837,371450,1,511,3.64972e-06,139813853,0.998593
D.bocki,140010837,355184,1,511,3.64972e-06,139814364,0.998597
D.bocki,140010837,328553,1,511,3.64972e-06,139814875,0.9986
D.bocki,140010837,328552,1,511,3.64972e-06,139815386,0.998604
D.bocki,140010837,310104,1,511,3.64972e-06,139815897,0.998608
D.bocki,140010837,263849,1,511,3.64972e-06,139816408,0.998611
D.bocki,140010837,240075,1,511,3.64972e-06,139816919,0.998615
D.bocki,140010837,212115,1,511,3.64972e-06,139817430,0.998619
D.bocki,140010837,192541,1,511,3.64972e-06,139817941,0.998622
D.bocki,140010837,19242,1,511,3.64972e-06,139818452,0.998626
D.bocki,140010837,173767,1,511,3.64972e-06,139818963,0.99863
D.bocki,140010837,169728,1,511,3.64972e-06,139819474,0.998633
D.bocki,140010837,169204,1,511,3.64972e-06,139819985,0.998637
D.bocki,140010837,139920,1,511,3.64972e-06,139820496,0.998641
D.bocki,140010837,139800,1,511,3.64972e-06,139821007,0.998644
D.bocki,140010837,133755,1,511,3.64972e-06,139821518,0.998648
D.bocki,140010837,120924,1,511,3.64972e-06,139822029,0.998651
D.bocki,140010837,100024,1,511,3.64972e-06,139822540,0.998655
D.bocki,140010837,88001,1,510,3.64258e-06,139823050,0.998659
D.bocki,140010837,69666,1,510,3.64258e-06,139823560,0.998662
D.bocki,140010837,56238,1,510,3.64258e-06,139824070,0.998666
D.bocki,140010837,46144,1,510,3.64258e-06,139824580,0.99867
D.bocki,140010837,453419,1,510,3.64258e-06,139825090,0.998673
D.bocki,140010837,448678,1,510,3.64258e-06,139825600,0.998677
D.bocki,140010837,443496,1,510,3.64258e-06,139826110,0.998681
D.bocki,140010837,442178,1,510,3.64258e-06,139826620,0.998684
D.bocki,140010837,425810,1,510,3.64258e-06,139827130,0.998688
D.bocki,140010837,394752,1,510,3.64258e-06,139827640,0.998692
D.bocki,140010837,334556,1,510,3.64258e-06,139828150,0.998695
D.bocki,140010837,329312,1,510,3.64258e-06,139828660,0.998699
D.bocki,140010837,328819,1,510,3.64258e-06,139829170,0.998702
D.bocki,140010837,323910,1,510,3.64258e-06,139829680,0.998706
D.bocki,140010837,314813,1,510,3.64258e-06,139830190,0.99871
D.bocki,140010837,310442,1,510,3.64258e-06,139830700,0.998713
D.bocki,140010837,305939,1,510,3.64258e-06,139831210,0.998717
D.bocki,140010837,303190,1,510,3.64258e-06,139831720,0.998721
D.bocki,140010837,301796,1,510,3.64258e-06,139832230,0.998724
D.bocki,140010837,289035,1,510,3.64258e-06,139832740,0.998728
D.bocki,140010837,280062,1,510,3.64258e-06,139833250,0.998732
D.bocki,140010837,252457,1,510,3.64258e-06,139833760,0.998735
D.bocki,140010837,247492,1,510,3.64258e-06,139834270,0.998739
D.bocki,140010837,215904,1,510,3.64258e-06,139834780,0.998743
D.bocki,140010837,191700,1,510,3.64258e-06,139835290,0.998746
D.bocki,140010837,18072,1,510,3.64258e-06,139835800,0.99875
D.bocki,140010837,179308,1,510,3.64258e-06,139836310,0.998753
D.bocki,140010837,177012,1,510,3.64258e-06,139836820,0.998757
D.bocki,140010837,134127,1,510,3.64258e-06,139837330,0.998761
D.bocki,140010837,130265,1,510,3.64258e-06,139837840,0.998764
D.bocki,140010837,128659,1,510,3.64258e-06,139838350,0.998768
D.bocki,140010837,124441,1,510,3.64258e-06,139838860,0.998772
D.bocki,140010837,10210,1,510,3.64258e-06,139839370,0.998775
D.bocki,140010837,97817,1,509,3.63543e-06,139839879,0.998779
D.bocki,140010837,83208,1,509,3.63543e-06,139840388,0.998783
D.bocki,140010837,69968,1,509,3.63543e-06,139840897,0.998786
D.bocki,140010837,58484,1,509,3.63543e-06,139841406,0.99879
D.bocki,140010837,58151,1,509,3.63543e-06,139841915,0.998794
D.bocki,140010837,46556,1,509,3.63543e-06,139842424,0.998797
D.bocki,140010837,444250,1,509,3.63543e-06,139842933,0.998801
D.bocki,140010837,432157,1,509,3.63543e-06,139843442,0.998804
D.bocki,140010837,396009,1,509,3.63543e-06,139843951,0.998808
D.bocki,140010837,393136,1,509,3.63543e-06,139844460,0.998812
D.bocki,140010837,384264,1,509,3.63543e-06,139844969,0.998815
D.bocki,140010837,367560,1,509,3.63543e-06,139845478,0.998819
D.bocki,140010837,363720,1,509,3.63543e-06,139845987,0.998823
D.bocki,140010837,362789,1,509,3.63543e-06,139846496,0.998826
D.bocki,140010837,360892,1,509,3.63543e-06,139847005,0.99883
D.bocki,140010837,325675,1,509,3.63543e-06,139847514,0.998833
D.bocki,140010837,3202,1,509,3.63543e-06,139848023,0.998837
D.bocki,140010837,300593,1,509,3.63543e-06,139848532,0.998841
D.bocki,140010837,295511,1,509,3.63543e-06,139849041,0.998844
D.bocki,140010837,290351,1,509,3.63543e-06,139849550,0.998848
D.bocki,140010837,289926,1,509,3.63543e-06,139850059,0.998852
D.bocki,140010837,264878,1,509,3.63543e-06,139850568,0.998855
D.bocki,140010837,257576,1,509,3.63543e-06,139851077,0.998859
D.bocki,140010837,254647,1,509,3.63543e-06,139851586,0.998863
D.bocki,140010837,245223,1,509,3.63543e-06,139852095,0.998866
D.bocki,140010837,24286,1,509,3.63543e-06,139852604,0.99887
D.bocki,140010837,221349,1,509,3.63543e-06,139853113,0.998873
D.bocki,140010837,207215,1,509,3.63543e-06,139853622,0.998877
D.bocki,140010837,190073,1,509,3.63543e-06,139854131,0.998881
D.bocki,140010837,185516,1,509,3.63543e-06,139854640,0.998884
D.bocki,140010837,185397,1,509,3.63543e-06,139855149,0.998888
D.bocki,140010837,161275,1,509,3.63543e-06,139855658,0.998892
D.bocki,140010837,156216,1,509,3.63543e-06,139856167,0.998895
D.bocki,140010837,141990,1,509,3.63543e-06,139856676,0.998899
D.bocki,140010837,134432,1,509,3.63543e-06,139857185,0.998903
D.bocki,140010837,125897,1,509,3.63543e-06,139857694,0.998906
D.bocki,140010837,78277,1,508,3.62829e-06,139858202,0.99891
D.bocki,140010837,420013,1,508,3.62829e-06,139858710,0.998913
D.bocki,140010837,406401,1,508,3.62829e-06,139859218,0.998917
D.bocki,140010837,403681,1,508,3.62829e-06,139859726,0.998921
D.bocki,140010837,35965,1,508,3.62829e-06,139860234,0.998924
D.bocki,140010837,332994,1,508,3.62829e-06,139860742,0.998928
D.bocki,140010837,287594,1,508,3.62829e-06,139861250,0.998932
D.bocki,140010837,285403,1,508,3.62829e-06,139861758,0.998935
D.bocki,140010837,235699,1,508,3.62829e-06,139862266,0.998939
D.bocki,140010837,2312,1,508,3.62829e-06,139862774,0.998942
D.bocki,140010837,227726,1,508,3.62829e-06,139863282,0.998946
D.bocki,140010837,22350,1,508,3.62829e-06,139863790,0.99895
D.bocki,140010837,217880,1,508,3.62829e-06,139864298,0.998953
D.bocki,140010837,152779,1,508,3.62829e-06,139864806,0.998957
D.bocki,140010837,140371,1,508,3.62829e-06,139865314,0.998961
D.bocki,140010837,133251,1,508,3.62829e-06,139865822,0.998964
D.bocki,140010837,12904,1,508,3.62829e-06,139866330,0.998968
D.bocki,140010837,115901,1,508,3.62829e-06,139866838,0.998972
D.bocki,140010837,10450,1,508,3.62829e-06,139867346,0.998975
D.bocki,140010837,98093,1,507,3.62115e-06,139867853,0.998979
D.bocki,140010837,81593,1,507,3.62115e-06,139868360,0.998982
D.bocki,140010837,6187,1,507,3.62115e-06,139868867,0.998986
D.bocki,140010837,450164,1,507,3.62115e-06,139869374,0.99899
D.bocki,140010837,44902,1,507,3.62115e-06,139869881,0.998993
D.bocki,140010837,43284,1,507,3.62115e-06,139870388,0.998997
D.bocki,140010837,43144,1,507,3.62115e-06,139870895,0.999
D.bocki,140010837,424773,1,507,3.62115e-06,139871402,0.999004
D.bocki,140010837,405990,1,507,3.62115e-06,139871909,0.999008
D.bocki,140010837,400089,1,507,3.62115e-06,139872416,0.999011
D.bocki,140010837,394101,1,507,3.62115e-06,139872923,0.999015
D.bocki,140010837,382084,1,507,3.62115e-06,139873430,0.999019
D.bocki,140010837,377010,1,507,3.62115e-06,139873937,0.999022
D.bocki,140010837,368128,1,507,3.62115e-06,139874444,0.999026
D.bocki,140010837,35661,1,507,3.62115e-06,139874951,0.999029
D.bocki,140010837,340495,1,507,3.62115e-06,139875458,0.999033
D.bocki,140010837,335417,1,507,3.62115e-06,139875965,0.999037
D.bocki,140010837,297428,1,507,3.62115e-06,139876472,0.99904
D.bocki,140010837,295083,1,507,3.62115e-06,139876979,0.999044
D.bocki,140010837,268583,1,507,3.62115e-06,139877486,0.999048
D.bocki,140010837,263775,1,507,3.62115e-06,139877993,0.999051
D.bocki,140010837,257356,1,507,3.62115e-06,139878500,0.999055
D.bocki,140010837,255203,1,507,3.62115e-06,139879007,0.999058
D.bocki,140010837,252689,1,507,3.62115e-06,139879514,0.999062
D.bocki,140010837,240002,1,507,3.62115e-06,139880021,0.999066
D.bocki,140010837,234257,1,507,3.62115e-06,139880528,0.999069
D.bocki,140010837,233046,1,507,3.62115e-06,139881035,0.999073
D.bocki,140010837,228084,1,507,3.62115e-06,139881542,0.999077
D.bocki,140010837,219762,1,507,3.62115e-06,139882049,0.99908
D.bocki,140010837,21437,1,507,3.62115e-06,139882556,0.999084
D.bocki,140010837,194928,1,507,3.62115e-06,139883063,0.999087
D.bocki,140010837,15394,1,507,3.62115e-06,139883570,0.999091
D.bocki,140010837,141322,1,507,3.62115e-06,139884077,0.999095
D.bocki,140010837,122863,1,507,3.62115e-06,139884584,0.999098
D.bocki,140010837,113622,1,507,3.62115e-06,139885091,0.999102
D.bocki,140010837,107162,1,507,3.62115e-06,139885598,0.999106
D.bocki,140010837,104341,1,507,3.62115e-06,139886105,0.999109
D.bocki,140010837,91246,1,506,3.61401e-06,139886611,0.999113
D.bocki,140010837,89806,1,506,3.61401e-06,139887117,0.999116
D.bocki,140010837,68076,1,506,3.61401e-06,139887623,0.99912
D.bocki,140010837,67980,1,506,3.61401e-06,139888129,0.999124
D.bocki,140010837,66596,1,506,3.61401e-06,139888635,0.999127
D.bocki,140010837,65549,1,506,3.61401e-06,139889141,0.999131
D.bocki,140010837,52133,1,506,3.61401e-06,139889647,0.999134
D.bocki,140010837,48372,1,506,3.61401e-06,139890153,0.999138
D.bocki,140010837,452528,1,506,3.61401e-06,139890659,0.999142
D.bocki,140010837,436973,1,506,3.61401e-06,139891165,0.999145
D.bocki,140010837,425842,1,506,3.61401e-06,139891671,0.999149
D.bocki,140010837,412134,1,506,3.61401e-06,139892177,0.999152
D.bocki,140010837,411602,1,506,3.61401e-06,139892683,0.999156
D.bocki,140010837,405599,1,506,3.61401e-06,139893189,0.99916
D.bocki,140010837,34311,1,506,3.61401e-06,139893695,0.999163
D.bocki,140010837,336068,1,506,3.61401e-06,139894201,0.999167
D.bocki,140010837,299455,1,506,3.61401e-06,139894707,0.999171
D.bocki,140010837,295181,1,506,3.61401e-06,139895213,0.999174
D.bocki,140010837,294212,1,506,3.61401e-06,139895719,0.999178
D.bocki,140010837,253708,1,506,3.61401e-06,139896225,0.999181
D.bocki,140010837,210569,1,506,3.61401e-06,139896731,0.999185
D.bocki,140010837,198500,1,506,3.61401e-06,139897237,0.999189
D.bocki,140010837,183613,1,506,3.61401e-06,139897743,0.999192
D.bocki,140010837,178555,1,506,3.61401e-06,139898249,0.999196
D.bocki,140010837,177175,1,506,3.61401e-06,139898755,0.999199
D.bocki,140010837,150587,1,506,3.61401e-06,139899261,0.999203
D.bocki,140010837,145888,1,506,3.61401e-06,139899767,0.999207
D.bocki,140010837,127103,1,506,3.61401e-06,139900273,0.99921
D.bocki,140010837,98829,1,505,3.60686e-06,139900778,0.999214
D.bocki,140010837,94888,1,505,3.60686e-06,139901283,0.999218
D.bocki,140010837,86813,1,505,3.60686e-06,139901788,0.999221
D.bocki,140010837,60336,1,505,3.60686e-06,139902293,0.999225
D.bocki,140010837,453170,1,505,3.60686e-06,139902798,0.999228
D.bocki,140010837,447481,1,505,3.60686e-06,139903303,0.999232
D.bocki,140010837,438992,1,505,3.60686e-06,139903808,0.999236
D.bocki,140010837,427433,1,505,3.60686e-06,139904313,0.999239
D.bocki,140010837,426799,1,505,3.60686e-06,139904818,0.999243
D.bocki,140010837,41456,1,505,3.60686e-06,139905323,0.999246
D.bocki,140010837,411280,1,505,3.60686e-06,139905828,0.99925
D.bocki,140010837,403680,1,505,3.60686e-06,139906333,0.999254
D.bocki,140010837,395440,1,505,3.60686e-06,139906838,0.999257
D.bocki,140010837,394672,1,505,3.60686e-06,139907343,0.999261
D.bocki,140010837,393780,1,505,3.60686e-06,139907848,0.999264
D.bocki,140010837,385329,1,505,3.60686e-06,139908353,0.999268
D.bocki,140010837,380004,1,505,3.60686e-06,139908858,0.999272
D.bocki,140010837,374062,1,505,3.60686e-06,139909363,0.999275
D.bocki,140010837,348691,1,505,3.60686e-06,139909868,0.999279
D.bocki,140010837,325891,1,505,3.60686e-06,139910373,0.999282
D.bocki,140010837,32198,1,505,3.60686e-06,139910878,0.999286
D.bocki,140010837,303129,1,505,3.60686e-06,139911383,0.99929
D.bocki,140010837,300657,1,505,3.60686e-06,139911888,0.999293
D.bocki,140010837,299427,1,505,3.60686e-06,139912393,0.999297
D.bocki,140010837,295512,1,505,3.60686e-06,139912898,0.9993
D.bocki,140010837,252378,1,505,3.60686e-06,139913403,0.999304
D.bocki,140010837,249053,1,505,3.60686e-06,139913908,0.999308
D.bocki,140010837,248830,1,505,3.60686e-06,139914413,0.999311
D.bocki,140010837,237933,1,505,3.60686e-06,139914918,0.999315
D.bocki,140010837,231,1,505,3.60686e-06,139915423,0.999319
D.bocki,140010837,189791,1,505,3.60686e-06,139915928,0.999322
D.bocki,140010837,185228,1,505,3.60686e-06,139916433,0.999326
D.bocki,140010837,164635,1,505,3.60686e-06,139916938,0.999329
D.bocki,140010837,155222,1,505,3.60686e-06,139917443,0.999333
D.bocki,140010837,144998,1,505,3.60686e-06,139917948,0.999337
D.bocki,140010837,123568,1,505,3.60686e-06,139918453,0.99934
D.bocki,140010837,116752,1,505,3.60686e-06,139918958,0.999344
D.bocki,140010837,110452,1,505,3.60686e-06,139919463,0.999347
D.bocki,140010837,100725,1,505,3.60686e-06,139919968,0.999351
D.bocki,140010837,69919,1,504,3.59972e-06,139920472,0.999355
D.bocki,140010837,67779,1,504,3.59972e-06,139920976,0.999358
D.bocki,140010837,435433,1,504,3.59972e-06,139921480,0.999362
D.bocki,140010837,434991,1,504,3.59972e-06,139921984,0.999365
D.bocki,140010837,404179,1,504,3.59972e-06,139922488,0.999369
D.bocki,140010837,402366,1,504,3.59972e-06,139922992,0.999373
D.bocki,140010837,383108,1,504,3.59972e-06,139923496,0.999376
D.bocki,140010837,364400,1,504,3.59972e-06,139924000,0.99938
D.bocki,140010837,364051,1,504,3.59972e-06,139924504,0.999383
D.bocki,140010837,362322,1,504,3.59972e-06,139925008,0.999387
D.bocki,140010837,3608,1,504,3.59972e-06,139925512,0.999391
D.bocki,140010837,342218,1,504,3.59972e-06,139926016,0.999394
D.bocki,140010837,322407,1,504,3.59972e-06,139926520,0.999398
D.bocki,140010837,320336,1,504,3.59972e-06,139927024,0.999401
D.bocki,140010837,314002,1,504,3.59972e-06,139927528,0.999405
D.bocki,140010837,303335,1,504,3.59972e-06,139928032,0.999409
D.bocki,140010837,29978,1,504,3.59972e-06,139928536,0.999412
D.bocki,140010837,297642,1,504,3.59972e-06,139929040,0.999416
D.bocki,140010837,297222,1,504,3.59972e-06,139929544,0.999419
D.bocki,140010837,2827,1,504,3.59972e-06,139930048,0.999423
D.bocki,140010837,27865,1,504,3.59972e-06,139930552,0.999427
D.bocki,140010837,278341,1,504,3.59972e-06,139931056,0.99943
D.bocki,140010837,252649,1,504,3.59972e-06,139931560,0.999434
D.bocki,140010837,239476,1,504,3.59972e-06,139932064,0.999437
D.bocki,140010837,232340,1,504,3.59972e-06,139932568,0.999441
D.bocki,140010837,226904,1,504,3.59972e-06,139933072,0.999445
D.bocki,140010837,216336,1,504,3.59972e-06,139933576,0.999448
D.bocki,140010837,215937,1,504,3.59972e-06,139934080,0.999452
D.bocki,140010837,210373,1,504,3.59972e-06,139934584,0.999455
D.bocki,140010837,209240,1,504,3.59972e-06,139935088,0.999459
D.bocki,140010837,20034,1,504,3.59972e-06,139935592,0.999463
D.bocki,140010837,198432,1,504,3.59972e-06,139936096,0.999466
D.bocki,140010837,192693,1,504,3.59972e-06,139936600,0.99947
D.bocki,140010837,161104,1,504,3.59972e-06,139937104,0.999473
D.bocki,140010837,121864,1,504,3.59972e-06,139937608,0.999477
D.bocki,140010837,112671,1,504,3.59972e-06,139938112,0.999481
D.bocki,140010837,111322,1,504,3.59972e-06,139938616,0.999484
D.bocki,140010837,110643,1,504,3.59972e-06,139939120,0.999488
D.bocki,140010837,110127,1,504,3.59972e-06,139939624,0.999491
D.bocki,140010837,108222,1,504,3.59972e-06,139940128,0.999495
D.bocki,140010837,92432,1,503,3.59258e-06,139940631,0.999499
D.bocki,140010837,89032,1,503,3.59258e-06,139941134,0.999502
D.bocki,140010837,84147,1,503,3.59258e-06,139941637,0.999506
D.bocki,140010837,75506,1,503,3.59258e-06,139942140,0.999509
D.bocki,140010837,72273,1,503,3.59258e-06,139942643,0.999513
D.bocki,140010837,45758,1,503,3.59258e-06,139943146,0.999517
D.bocki,140010837,45267,1,503,3.59258e-06,139943649,0.99952
D.bocki,140010837,420652,1,503,3.59258e-06,139944152,0.999524
D.bocki,140010837,391688,1,503,3.59258e-06,139944655,0.999527
D.bocki,140010837,389421,1,503,3.59258e-06,139945158,0.999531
D.bocki,140010837,372931,1,503,3.59258e-06,139945661,0.999534
D.bocki,140010837,364945,1,503,3.59258e-06,139946164,0.999538
D.bocki,140010837,324625,1,503,3.59258e-06,139946667,0.999542
D.bocki,140010837,313652,1,503,3.59258e-06,139947170,0.999545
D.bocki,140010837,281804,1,503,3.59258e-06,139947673,0.999549
D.bocki,140010837,281763,1,503,3.59258e-06,139948176,0.999552
D.bocki,140010837,275385,1,503,3.59258e-06,139948679,0.999556
D.bocki,140010837,269607,1,503,3.59258e-06,139949182,0.99956
D.bocki,140010837,25387,1,503,3.59258e-06,139949685,0.999563
D.bocki,140010837,251141,1,503,3.59258e-06,139950188,0.999567
D.bocki,140010837,241260,1,503,3.59258e-06,139950691,0.99957
D.bocki,140010837,221168,1,503,3.59258e-06,139951194,0.999574
D.bocki,140010837,214167,1,503,3.59258e-06,139951697,0.999578
D.bocki,140010837,203933,1,503,3.59258e-06,139952200,0.999581
D.bocki,140010837,199867,1,503,3.59258e-06,139952703,0.999585
D.bocki,140010837,194469,1,503,3.59258e-06,139953206,0.999588
D.bocki,140010837,182872,1,503,3.59258e-06,139953709,0.999592
D.bocki,140010837,180054,1,503,3.59258e-06,139954212,0.999596
D.bocki,140010837,178025,1,503,3.59258e-06,139954715,0.999599
D.bocki,140010837,1765,1,503,3.59258e-06,139955218,0.999603
D.bocki,140010837,174894,1,503,3.59258e-06,139955721,0.999606
D.bocki,140010837,163049,1,503,3.59258e-06,139956224,0.99961
D.bocki,140010837,152111,1,503,3.59258e-06,139956727,0.999614
D.bocki,140010837,147405,1,503,3.59258e-06,139957230,0.999617
D.bocki,140010837,132607,1,503,3.59258e-06,139957733,0.999621
D.bocki,140010837,82694,1,502,3.58544e-06,139958235,0.999624
D.bocki,140010837,76514,1,502,3.58544e-06,139958737,0.999628
D.bocki,140010837,66888,1,502,3.58544e-06,139959239,0.999631
D.bocki,140010837,61533,1,502,3.58544e-06,139959741,0.999635
D.bocki,140010837,55816,1,502,3.58544e-06,139960243,0.999639
D.bocki,140010837,52558,1,502,3.58544e-06,139960745,0.999642
D.bocki,140010837,443232,1,502,3.58544e-06,139961247,0.999646
D.bocki,140010837,435866,1,502,3.58544e-06,139961749,0.999649
D.bocki,140010837,432912,1,502,3.58544e-06,139962251,0.999653
D.bocki,140010837,415503,1,502,3.58544e-06,139962753,0.999657
D.bocki,140010837,411700,1,502,3.58544e-06,139963255,0.99966
D.bocki,140010837,395101,1,502,3.58544e-06,139963757,0.999664
D.bocki,140010837,391162,1,502,3.58544e-06,139964259,0.999667
D.bocki,140010837,370909,1,502,3.58544e-06,139964761,0.999671
D.bocki,140010837,336601,1,502,3.58544e-06,139965263,0.999674
D.bocki,140010837,297941,1,502,3.58544e-06,139965765,0.999678
D.bocki,140010837,287947,1,502,3.58544e-06,139966267,0.999682
D.bocki,140010837,284890,1,502,3.58544e-06,139966769,0.999685
D.bocki,140010837,279085,1,502,3.58544e-06,139967271,0.999689
D.bocki,140010837,275647,1,502,3.58544e-06,139967773,0.999692
D.bocki,140010837,243080,1,502,3.58544e-06,139968275,0.999696
D.bocki,140010837,23625,1,502,3.58544e-06,139968777,0.9997
D.bocki,140010837,234366,1,502,3.58544e-06,139969279,0.999703
D.bocki,140010837,230829,1,502,3.58544e-06,139969781,0.999707
D.bocki,140010837,21602,1,502,3.58544e-06,139970283,0.99971
D.bocki,140010837,205480,1,502,3.58544e-06,139970785,0.999714
D.bocki,140010837,201648,1,502,3.58544e-06,139971287,0.999718
D.bocki,140010837,181442,1,502,3.58544e-06,139971789,0.999721
D.bocki,140010837,160887,1,502,3.58544e-06,139972291,0.999725
D.bocki,140010837,156068,1,502,3.58544e-06,139972793,0.999728
D.bocki,140010837,14785,1,502,3.58544e-06,139973295,0.999732
D.bocki,140010837,134697,1,502,3.58544e-06,139973797,0.999735
D.bocki,140010837,134400,1,502,3.58544e-06,139974299,0.999739
D.bocki,140010837,116962,1,502,3.58544e-06,139974801,0.999743
D.bocki,140010837,104733,1,502,3.58544e-06,139975303,0.999746
D.bocki,140010837,75507,1,501,3.57829e-06,139975804,0.99975
D.bocki,140010837,75337,1,501,3.57829e-06,139976305,0.999753
D.bocki,140010837,63876,1,501,3.57829e-06,139976806,0.999757
D.bocki,140010837,62888,1,501,3.57829e-06,139977307,0.999761
D.bocki,140010837,46453,1,501,3.57829e-06,139977808,0.999764
D.bocki,140010837,454489,1,501,3.57829e-06,139978309,0.999768
D.bocki,140010837,425949,1,501,3.57829e-06,139978810,0.999771
D.bocki,140010837,401549,1,501,3.57829e-06,139979311,0.999775
D.bocki,140010837,375914,1,501,3.57829e-06,139979812,0.999778
D.bocki,140010837,37160,1,501,3.57829e-06,139980313,0.999782
D.bocki,140010837,360731,1,501,3.57829e-06,139980814,0.999786
D.bocki,140010837,358001,1,501,3.57829e-06,139981315,0.999789
D.bocki,140010837,350968,1,501,3.57829e-06,139981816,0.999793
D.bocki,140010837,341791,1,501,3.57829e-06,139982317,0.999796
D.bocki,140010837,315270,1,501,3.57829e-06,139982818,0.9998
D.bocki,140010837,312863,1,501,3.57829e-06,139983319,0.999803
D.bocki,140010837,303128,1,501,3.57829e-06,139983820,0.999807
D.bocki,140010837,291685,1,501,3.57829e-06,139984321,0.999811
D.bocki,140010837,281058,1,501,3.57829e-06,139984822,0.999814
D.bocki,140010837,28040,1,501,3.57829e-06,139985323,0.999818
D.bocki,140010837,260389,1,501,3.57829e-06,139985824,0.999821
D.bocki,140010837,242135,1,501,3.57829e-06,139986325,0.999825
D.bocki,140010837,225173,1,501,3.57829e-06,139986826,0.999829
D.bocki,140010837,221346,1,501,3.57829e-06,139987327,0.999832
D.bocki,140010837,194524,1,501,3.57829e-06,139987828,0.999836
D.bocki,140010837,183551,1,501,3.57829e-06,139988329,0.999839
D.bocki,140010837,183239,1,501,3.57829e-06,139988830,0.999843
D.bocki,140010837,163999,1,501,3.57829e-06,139989331,0.999846
D.bocki,140010837,161646,1,501,3.57829e-06,139989832,0.99985
D.bocki,140010837,156460,1,501,3.57829e-06,139990333,0.999854
D.bocki,140010837,153844,1,501,3.57829e-06,139990834,0.999857
D.bocki,140010837,143387,1,501,3.57829e-06,139991335,0.999861
D.bocki,140010837,142056,1,501,3.57829e-06,139991836,0.999864
D.bocki,140010837,127233,1,501,3.57829e-06,139992337,0.999868
D.bocki,140010837,93902,1,500,3.57115e-06,139992837,0.999871
D.bocki,140010837,79983,1,500,3.57115e-06,139993337,0.999875
D.bocki,140010837,67035,1,500,3.57115e-06,139993837,0.999879
D.bocki,140010837,6132,1,500,3.57115e-06,139994337,0.999882
D.bocki,140010837,5806,1,500,3.57115e-06,139994837,0.999886
D.bocki,140010837,452750,1,500,3.57115e-06,139995337,0.999889
D.bocki,140010837,450888,1,500,3.57115e-06,139995837,0.999893
D.bocki,140010837,450832,1,500,3.57115e-06,139996337,0.999896
D.bocki,140010837,441956,1,500,3.57115e-06,139996837,0.9999
D.bocki,140010837,435869,1,500,3.57115e-06,139997337,0.999904
D.bocki,140010837,408417,1,500,3.57115e-06,139997837,0.999907
D.bocki,140010837,392322,1,500,3.57115e-06,139998337,0.999911
D.bocki,140010837,371983,1,500,3.57115e-06,139998837,0.999914
D.bocki,140010837,369861,1,500,3.57115e-06,139999337,0.999918
D.bocki,140010837,356638,1,500,3.57115e-06,139999837,0.999921
D.bocki,140010837,354339,1,500,3.57115e-06,140000337,0.999925
D.bocki,140010837,350120,1,500,3.57115e-06,140000837,0.999929
D.bocki,140010837,312862,1,500,3.57115e-06,140001337,0.999932
D.bocki,140010837,30443,1,500,3.57115e-06,140001837,0.999936
D.bocki,140010837,304282,1,500,3.57115e-06,140002337,0.999939
D.bocki,140010837,300799,1,500,3.57115e-06,140002837,0.999943
D.bocki,140010837,290204,1,500,3.57115e-06,140003337,0.999946
D.bocki,140010837,27962,1,500,3.57115e-06,140003837,0.99995
D.bocki,140010837,278913,1,500,3.57115e-06,140004337,0.999954
D.bocki,140010837,230216,1,500,3.57115e-06,140004837,0.999957
D.bocki,140010837,213828,1,500,3.57115e-06,140005337,0.999961
D.bocki,140010837,201841,1,500,3.57115e-06,140005837,0.999964
D.bocki,140010837,19374,1,500,3.57115e-06,140006337,0.999968
D.bocki,140010837,175450,1,500,3.57115e-06,140006837,0.999971
D.bocki,140010837,169986,1,500,3.57115e-06,140007337,0.999975
D.bocki,140010837,165115,1,500,3.57115e-06,140007837,0.999979
D.bocki,140010837,162444,1,500,3.57115e-06,140008337,0.999982
D.bocki,140010837,158587,1,500,3.57115e-06,140008837,0.999986
D.bocki,140010837,139287,1,500,3.57115e-06,140009337,0.999989
D.bocki,140010837,133894,1,500,3.57115e-06,140009837,0.999993
D.bocki,140010837,107068,1,500,3.57115e-06,140010337,0.999996
D.bocki,140010837,106436,1,500,3.57115e-06,140010837,1
